home_score,away_score,AgeH1,IntCapsH1,IntGoalsH1,U21CapsH1,U21GoalsH1,HeightH1,WeightH1,AerialAbilityH1,CommandOfAreaH1,CommunicationH1,EccentricityH1,HandlingH1,KickingH1,OneOnOnesH1,ReflexesH1,RushingOutH1,TendencyToPunchH1,ThrowingH1,CornersH1,CrossingH1,DribblingH1,FinishingH1,FirstTouchH1,FreekicksH1,HeadingH1,LongShotsH1,LongthrowsH1,MarkingH1,PassingH1,PenaltyTakingH1,TacklingH1,TechniqueH1,AggressionH1,AnticipationH1,BraveryH1,ComposureH1,ConcentrationH1,VisionH1,DecisionsH1,DeterminationH1,FlairH1,LeadershipH1,OffTheBallH1,PositioningH1,TeamworkH1,WorkrateH1,AccelerationH1,AgilityH1,BalanceH1,JumpingH1,LeftFootH1,NaturalFitnessH1,PaceH1,RightFootH1,StaminaH1,StrengthH1,ConsistencyH1,DirtinessH1,ImportantMatchesH1,InjuryPronessH1,VersatilityH1,AdaptabilityH1,AmbitionH1,LoyaltyH1,PressureH1,ProfessionalH1,SportsmanshipH1,TemperamentH1,ControversyH1,AgeH2,IntCapsH2,IntGoalsH2,U21CapsH2,U21GoalsH2,HeightH2,WeightH2,AerialAbilityH2,CommandOfAreaH2,CommunicationH2,EccentricityH2,HandlingH2,KickingH2,OneOnOnesH2,ReflexesH2,RushingOutH2,TendencyToPunchH2,ThrowingH2,CornersH2,CrossingH2,DribblingH2,FinishingH2,FirstTouchH2,FreekicksH2,HeadingH2,LongShotsH2,LongthrowsH2,MarkingH2,PassingH2,PenaltyTakingH2,TacklingH2,TechniqueH2,AggressionH2,AnticipationH2,BraveryH2,ComposureH2,ConcentrationH2,VisionH2,DecisionsH2,DeterminationH2,FlairH2,LeadershipH2,OffTheBallH2,PositioningH2,TeamworkH2,WorkrateH2,AccelerationH2,AgilityH2,BalanceH2,JumpingH2,LeftFootH2,NaturalFitnessH2,PaceH2,RightFootH2,StaminaH2,StrengthH2,ConsistencyH2,DirtinessH2,ImportantMatchesH2,InjuryPronessH2,VersatilityH2,AdaptabilityH2,AmbitionH2,LoyaltyH2,PressureH2,ProfessionalH2,SportsmanshipH2,TemperamentH2,ControversyH2,AgeH3,IntCapsH3,IntGoalsH3,U21CapsH3,U21GoalsH3,HeightH3,WeightH3,AerialAbilityH3,CommandOfAreaH3,CommunicationH3,EccentricityH3,HandlingH3,KickingH3,OneOnOnesH3,ReflexesH3,RushingOutH3,TendencyToPunchH3,ThrowingH3,CornersH3,CrossingH3,DribblingH3,FinishingH3,FirstTouchH3,FreekicksH3,HeadingH3,LongShotsH3,LongthrowsH3,MarkingH3,PassingH3,PenaltyTakingH3,TacklingH3,TechniqueH3,AggressionH3,AnticipationH3,BraveryH3,ComposureH3,ConcentrationH3,VisionH3,DecisionsH3,DeterminationH3,FlairH3,LeadershipH3,OffTheBallH3,PositioningH3,TeamworkH3,WorkrateH3,AccelerationH3,AgilityH3,BalanceH3,JumpingH3,LeftFootH3,NaturalFitnessH3,PaceH3,RightFootH3,StaminaH3,StrengthH3,ConsistencyH3,DirtinessH3,ImportantMatchesH3,InjuryPronessH3,VersatilityH3,AdaptabilityH3,AmbitionH3,LoyaltyH3,PressureH3,ProfessionalH3,SportsmanshipH3,TemperamentH3,ControversyH3,AgeH4,IntCapsH4,IntGoalsH4,U21CapsH4,U21GoalsH4,HeightH4,WeightH4,AerialAbilityH4,CommandOfAreaH4,CommunicationH4,EccentricityH4,HandlingH4,KickingH4,OneOnOnesH4,ReflexesH4,RushingOutH4,TendencyToPunchH4,ThrowingH4,CornersH4,CrossingH4,DribblingH4,FinishingH4,FirstTouchH4,FreekicksH4,HeadingH4,LongShotsH4,LongthrowsH4,MarkingH4,PassingH4,PenaltyTakingH4,TacklingH4,TechniqueH4,AggressionH4,AnticipationH4,BraveryH4,ComposureH4,ConcentrationH4,VisionH4,DecisionsH4,DeterminationH4,FlairH4,LeadershipH4,OffTheBallH4,PositioningH4,TeamworkH4,WorkrateH4,AccelerationH4,AgilityH4,BalanceH4,JumpingH4,LeftFootH4,NaturalFitnessH4,PaceH4,RightFootH4,StaminaH4,StrengthH4,ConsistencyH4,DirtinessH4,ImportantMatchesH4,InjuryPronessH4,VersatilityH4,AdaptabilityH4,AmbitionH4,LoyaltyH4,PressureH4,ProfessionalH4,SportsmanshipH4,TemperamentH4,ControversyH4,AgeH5,IntCapsH5,IntGoalsH5,U21CapsH5,U21GoalsH5,HeightH5,WeightH5,AerialAbilityH5,CommandOfAreaH5,CommunicationH5,EccentricityH5,HandlingH5,KickingH5,OneOnOnesH5,ReflexesH5,RushingOutH5,TendencyToPunchH5,ThrowingH5,CornersH5,CrossingH5,DribblingH5,FinishingH5,FirstTouchH5,FreekicksH5,HeadingH5,LongShotsH5,LongthrowsH5,MarkingH5,PassingH5,PenaltyTakingH5,TacklingH5,TechniqueH5,AggressionH5,AnticipationH5,BraveryH5,ComposureH5,ConcentrationH5,VisionH5,DecisionsH5,DeterminationH5,FlairH5,LeadershipH5,OffTheBallH5,PositioningH5,TeamworkH5,WorkrateH5,AccelerationH5,AgilityH5,BalanceH5,JumpingH5,LeftFootH5,NaturalFitnessH5,PaceH5,RightFootH5,StaminaH5,StrengthH5,ConsistencyH5,DirtinessH5,ImportantMatchesH5,InjuryPronessH5,VersatilityH5,AdaptabilityH5,AmbitionH5,LoyaltyH5,PressureH5,ProfessionalH5,SportsmanshipH5,TemperamentH5,ControversyH5,AgeH6,IntCapsH6,IntGoalsH6,U21CapsH6,U21GoalsH6,HeightH6,WeightH6,AerialAbilityH6,CommandOfAreaH6,CommunicationH6,EccentricityH6,HandlingH6,KickingH6,OneOnOnesH6,ReflexesH6,RushingOutH6,TendencyToPunchH6,ThrowingH6,CornersH6,CrossingH6,DribblingH6,FinishingH6,FirstTouchH6,FreekicksH6,HeadingH6,LongShotsH6,LongthrowsH6,MarkingH6,PassingH6,PenaltyTakingH6,TacklingH6,TechniqueH6,AggressionH6,AnticipationH6,BraveryH6,ComposureH6,ConcentrationH6,VisionH6,DecisionsH6,DeterminationH6,FlairH6,LeadershipH6,OffTheBallH6,PositioningH6,TeamworkH6,WorkrateH6,AccelerationH6,AgilityH6,BalanceH6,JumpingH6,LeftFootH6,NaturalFitnessH6,PaceH6,RightFootH6,StaminaH6,StrengthH6,ConsistencyH6,DirtinessH6,ImportantMatchesH6,InjuryPronessH6,VersatilityH6,AdaptabilityH6,AmbitionH6,LoyaltyH6,PressureH6,ProfessionalH6,SportsmanshipH6,TemperamentH6,ControversyH6,AgeH7,IntCapsH7,IntGoalsH7,U21CapsH7,U21GoalsH7,HeightH7,WeightH7,AerialAbilityH7,CommandOfAreaH7,CommunicationH7,EccentricityH7,HandlingH7,KickingH7,OneOnOnesH7,ReflexesH7,RushingOutH7,TendencyToPunchH7,ThrowingH7,CornersH7,CrossingH7,DribblingH7,FinishingH7,FirstTouchH7,FreekicksH7,HeadingH7,LongShotsH7,LongthrowsH7,MarkingH7,PassingH7,PenaltyTakingH7,TacklingH7,TechniqueH7,AggressionH7,AnticipationH7,BraveryH7,ComposureH7,ConcentrationH7,VisionH7,DecisionsH7,DeterminationH7,FlairH7,LeadershipH7,OffTheBallH7,PositioningH7,TeamworkH7,WorkrateH7,AccelerationH7,AgilityH7,BalanceH7,JumpingH7,LeftFootH7,NaturalFitnessH7,PaceH7,RightFootH7,StaminaH7,StrengthH7,ConsistencyH7,DirtinessH7,ImportantMatchesH7,InjuryPronessH7,VersatilityH7,AdaptabilityH7,AmbitionH7,LoyaltyH7,PressureH7,ProfessionalH7,SportsmanshipH7,TemperamentH7,ControversyH7,AgeH8,IntCapsH8,IntGoalsH8,U21CapsH8,U21GoalsH8,HeightH8,WeightH8,AerialAbilityH8,CommandOfAreaH8,CommunicationH8,EccentricityH8,HandlingH8,KickingH8,OneOnOnesH8,ReflexesH8,RushingOutH8,TendencyToPunchH8,ThrowingH8,CornersH8,CrossingH8,DribblingH8,FinishingH8,FirstTouchH8,FreekicksH8,HeadingH8,LongShotsH8,LongthrowsH8,MarkingH8,PassingH8,PenaltyTakingH8,TacklingH8,TechniqueH8,AggressionH8,AnticipationH8,BraveryH8,ComposureH8,ConcentrationH8,VisionH8,DecisionsH8,DeterminationH8,FlairH8,LeadershipH8,OffTheBallH8,PositioningH8,TeamworkH8,WorkrateH8,AccelerationH8,AgilityH8,BalanceH8,JumpingH8,LeftFootH8,NaturalFitnessH8,PaceH8,RightFootH8,StaminaH8,StrengthH8,ConsistencyH8,DirtinessH8,ImportantMatchesH8,InjuryPronessH8,VersatilityH8,AdaptabilityH8,AmbitionH8,LoyaltyH8,PressureH8,ProfessionalH8,SportsmanshipH8,TemperamentH8,ControversyH8,AgeH9,IntCapsH9,IntGoalsH9,U21CapsH9,U21GoalsH9,HeightH9,WeightH9,AerialAbilityH9,CommandOfAreaH9,CommunicationH9,EccentricityH9,HandlingH9,KickingH9,OneOnOnesH9,ReflexesH9,RushingOutH9,TendencyToPunchH9,ThrowingH9,CornersH9,CrossingH9,DribblingH9,FinishingH9,FirstTouchH9,FreekicksH9,HeadingH9,LongShotsH9,LongthrowsH9,MarkingH9,PassingH9,PenaltyTakingH9,TacklingH9,TechniqueH9,AggressionH9,AnticipationH9,BraveryH9,ComposureH9,ConcentrationH9,VisionH9,DecisionsH9,DeterminationH9,FlairH9,LeadershipH9,OffTheBallH9,PositioningH9,TeamworkH9,WorkrateH9,AccelerationH9,AgilityH9,BalanceH9,JumpingH9,LeftFootH9,NaturalFitnessH9,PaceH9,RightFootH9,StaminaH9,StrengthH9,ConsistencyH9,DirtinessH9,ImportantMatchesH9,InjuryPronessH9,VersatilityH9,AdaptabilityH9,AmbitionH9,LoyaltyH9,PressureH9,ProfessionalH9,SportsmanshipH9,TemperamentH9,ControversyH9,AgeH10,IntCapsH10,IntGoalsH10,U21CapsH10,U21GoalsH10,HeightH10,WeightH10,AerialAbilityH10,CommandOfAreaH10,CommunicationH10,EccentricityH10,HandlingH10,KickingH10,OneOnOnesH10,ReflexesH10,RushingOutH10,TendencyToPunchH10,ThrowingH10,CornersH10,CrossingH10,DribblingH10,FinishingH10,FirstTouchH10,FreekicksH10,HeadingH10,LongShotsH10,LongthrowsH10,MarkingH10,PassingH10,PenaltyTakingH10,TacklingH10,TechniqueH10,AggressionH10,AnticipationH10,BraveryH10,ComposureH10,ConcentrationH10,VisionH10,DecisionsH10,DeterminationH10,FlairH10,LeadershipH10,OffTheBallH10,PositioningH10,TeamworkH10,WorkrateH10,AccelerationH10,AgilityH10,BalanceH10,JumpingH10,LeftFootH10,NaturalFitnessH10,PaceH10,RightFootH10,StaminaH10,StrengthH10,ConsistencyH10,DirtinessH10,ImportantMatchesH10,InjuryPronessH10,VersatilityH10,AdaptabilityH10,AmbitionH10,LoyaltyH10,PressureH10,ProfessionalH10,SportsmanshipH10,TemperamentH10,ControversyH10,AgeH11,IntCapsH11,IntGoalsH11,U21CapsH11,U21GoalsH11,HeightH11,WeightH11,AerialAbilityH11,CommandOfAreaH11,CommunicationH11,EccentricityH11,HandlingH11,KickingH11,OneOnOnesH11,ReflexesH11,RushingOutH11,TendencyToPunchH11,ThrowingH11,CornersH11,CrossingH11,DribblingH11,FinishingH11,FirstTouchH11,FreekicksH11,HeadingH11,LongShotsH11,LongthrowsH11,MarkingH11,PassingH11,PenaltyTakingH11,TacklingH11,TechniqueH11,AggressionH11,AnticipationH11,BraveryH11,ComposureH11,ConcentrationH11,VisionH11,DecisionsH11,DeterminationH11,FlairH11,LeadershipH11,OffTheBallH11,PositioningH11,TeamworkH11,WorkrateH11,AccelerationH11,AgilityH11,BalanceH11,JumpingH11,LeftFootH11,NaturalFitnessH11,PaceH11,RightFootH11,StaminaH11,StrengthH11,ConsistencyH11,DirtinessH11,ImportantMatchesH11,InjuryPronessH11,VersatilityH11,AdaptabilityH11,AmbitionH11,LoyaltyH11,PressureH11,ProfessionalH11,SportsmanshipH11,TemperamentH11,ControversyH11,AgeA1,IntCapsA1,IntGoalsA1,U21CapsA1,U21GoalsA1,HeightA1,WeightA1,AerialAbilityA1,CommandOfAreaA1,CommunicationA1,EccentricityA1,HandlingA1,KickingA1,OneOnOnesA1,ReflexesA1,RushingOutA1,TendencyToPunchA1,ThrowingA1,CornersA1,CrossingA1,DribblingA1,FinishingA1,FirstTouchA1,FreekicksA1,HeadingA1,LongShotsA1,LongthrowsA1,MarkingA1,PassingA1,PenaltyTakingA1,TacklingA1,TechniqueA1,AggressionA1,AnticipationA1,BraveryA1,ComposureA1,ConcentrationA1,VisionA1,DecisionsA1,DeterminationA1,FlairA1,LeadershipA1,OffTheBallA1,PositioningA1,TeamworkA1,WorkrateA1,AccelerationA1,AgilityA1,BalanceA1,JumpingA1,LeftFootA1,NaturalFitnessA1,PaceA1,RightFootA1,StaminaA1,StrengthA1,ConsistencyA1,DirtinessA1,ImportantMatchesA1,InjuryPronessA1,VersatilityA1,AdaptabilityA1,AmbitionA1,LoyaltyA1,PressureA1,ProfessionalA1,SportsmanshipA1,TemperamentA1,ControversyA1,AgeA2,IntCapsA2,IntGoalsA2,U21CapsA2,U21GoalsA2,HeightA2,WeightA2,AerialAbilityA2,CommandOfAreaA2,CommunicationA2,EccentricityA2,HandlingA2,KickingA2,OneOnOnesA2,ReflexesA2,RushingOutA2,TendencyToPunchA2,ThrowingA2,CornersA2,CrossingA2,DribblingA2,FinishingA2,FirstTouchA2,FreekicksA2,HeadingA2,LongShotsA2,LongthrowsA2,MarkingA2,PassingA2,PenaltyTakingA2,TacklingA2,TechniqueA2,AggressionA2,AnticipationA2,BraveryA2,ComposureA2,ConcentrationA2,VisionA2,DecisionsA2,DeterminationA2,FlairA2,LeadershipA2,OffTheBallA2,PositioningA2,TeamworkA2,WorkrateA2,AccelerationA2,AgilityA2,BalanceA2,JumpingA2,LeftFootA2,NaturalFitnessA2,PaceA2,RightFootA2,StaminaA2,StrengthA2,ConsistencyA2,DirtinessA2,ImportantMatchesA2,InjuryPronessA2,VersatilityA2,AdaptabilityA2,AmbitionA2,LoyaltyA2,PressureA2,ProfessionalA2,SportsmanshipA2,TemperamentA2,ControversyA2,AgeA3,IntCapsA3,IntGoalsA3,U21CapsA3,U21GoalsA3,HeightA3,WeightA3,AerialAbilityA3,CommandOfAreaA3,CommunicationA3,EccentricityA3,HandlingA3,KickingA3,OneOnOnesA3,ReflexesA3,RushingOutA3,TendencyToPunchA3,ThrowingA3,CornersA3,CrossingA3,DribblingA3,FinishingA3,FirstTouchA3,FreekicksA3,HeadingA3,LongShotsA3,LongthrowsA3,MarkingA3,PassingA3,PenaltyTakingA3,TacklingA3,TechniqueA3,AggressionA3,AnticipationA3,BraveryA3,ComposureA3,ConcentrationA3,VisionA3,DecisionsA3,DeterminationA3,FlairA3,LeadershipA3,OffTheBallA3,PositioningA3,TeamworkA3,WorkrateA3,AccelerationA3,AgilityA3,BalanceA3,JumpingA3,LeftFootA3,NaturalFitnessA3,PaceA3,RightFootA3,StaminaA3,StrengthA3,ConsistencyA3,DirtinessA3,ImportantMatchesA3,InjuryPronessA3,VersatilityA3,AdaptabilityA3,AmbitionA3,LoyaltyA3,PressureA3,ProfessionalA3,SportsmanshipA3,TemperamentA3,ControversyA3,AgeA4,IntCapsA4,IntGoalsA4,U21CapsA4,U21GoalsA4,HeightA4,WeightA4,AerialAbilityA4,CommandOfAreaA4,CommunicationA4,EccentricityA4,HandlingA4,KickingA4,OneOnOnesA4,ReflexesA4,RushingOutA4,TendencyToPunchA4,ThrowingA4,CornersA4,CrossingA4,DribblingA4,FinishingA4,FirstTouchA4,FreekicksA4,HeadingA4,LongShotsA4,LongthrowsA4,MarkingA4,PassingA4,PenaltyTakingA4,TacklingA4,TechniqueA4,AggressionA4,AnticipationA4,BraveryA4,ComposureA4,ConcentrationA4,VisionA4,DecisionsA4,DeterminationA4,FlairA4,LeadershipA4,OffTheBallA4,PositioningA4,TeamworkA4,WorkrateA4,AccelerationA4,AgilityA4,BalanceA4,JumpingA4,LeftFootA4,NaturalFitnessA4,PaceA4,RightFootA4,StaminaA4,StrengthA4,ConsistencyA4,DirtinessA4,ImportantMatchesA4,InjuryPronessA4,VersatilityA4,AdaptabilityA4,AmbitionA4,LoyaltyA4,PressureA4,ProfessionalA4,SportsmanshipA4,TemperamentA4,ControversyA4,AgeA5,IntCapsA5,IntGoalsA5,U21CapsA5,U21GoalsA5,HeightA5,WeightA5,AerialAbilityA5,CommandOfAreaA5,CommunicationA5,EccentricityA5,HandlingA5,KickingA5,OneOnOnesA5,ReflexesA5,RushingOutA5,TendencyToPunchA5,ThrowingA5,CornersA5,CrossingA5,DribblingA5,FinishingA5,FirstTouchA5,FreekicksA5,HeadingA5,LongShotsA5,LongthrowsA5,MarkingA5,PassingA5,PenaltyTakingA5,TacklingA5,TechniqueA5,AggressionA5,AnticipationA5,BraveryA5,ComposureA5,ConcentrationA5,VisionA5,DecisionsA5,DeterminationA5,FlairA5,LeadershipA5,OffTheBallA5,PositioningA5,TeamworkA5,WorkrateA5,AccelerationA5,AgilityA5,BalanceA5,JumpingA5,LeftFootA5,NaturalFitnessA5,PaceA5,RightFootA5,StaminaA5,StrengthA5,ConsistencyA5,DirtinessA5,ImportantMatchesA5,InjuryPronessA5,VersatilityA5,AdaptabilityA5,AmbitionA5,LoyaltyA5,PressureA5,ProfessionalA5,SportsmanshipA5,TemperamentA5,ControversyA5,AgeA6,IntCapsA6,IntGoalsA6,U21CapsA6,U21GoalsA6,HeightA6,WeightA6,AerialAbilityA6,CommandOfAreaA6,CommunicationA6,EccentricityA6,HandlingA6,KickingA6,OneOnOnesA6,ReflexesA6,RushingOutA6,TendencyToPunchA6,ThrowingA6,CornersA6,CrossingA6,DribblingA6,FinishingA6,FirstTouchA6,FreekicksA6,HeadingA6,LongShotsA6,LongthrowsA6,MarkingA6,PassingA6,PenaltyTakingA6,TacklingA6,TechniqueA6,AggressionA6,AnticipationA6,BraveryA6,ComposureA6,ConcentrationA6,VisionA6,DecisionsA6,DeterminationA6,FlairA6,LeadershipA6,OffTheBallA6,PositioningA6,TeamworkA6,WorkrateA6,AccelerationA6,AgilityA6,BalanceA6,JumpingA6,LeftFootA6,NaturalFitnessA6,PaceA6,RightFootA6,StaminaA6,StrengthA6,ConsistencyA6,DirtinessA6,ImportantMatchesA6,InjuryPronessA6,VersatilityA6,AdaptabilityA6,AmbitionA6,LoyaltyA6,PressureA6,ProfessionalA6,SportsmanshipA6,TemperamentA6,ControversyA6,AgeA7,IntCapsA7,IntGoalsA7,U21CapsA7,U21GoalsA7,HeightA7,WeightA7,AerialAbilityA7,CommandOfAreaA7,CommunicationA7,EccentricityA7,HandlingA7,KickingA7,OneOnOnesA7,ReflexesA7,RushingOutA7,TendencyToPunchA7,ThrowingA7,CornersA7,CrossingA7,DribblingA7,FinishingA7,FirstTouchA7,FreekicksA7,HeadingA7,LongShotsA7,LongthrowsA7,MarkingA7,PassingA7,PenaltyTakingA7,TacklingA7,TechniqueA7,AggressionA7,AnticipationA7,BraveryA7,ComposureA7,ConcentrationA7,VisionA7,DecisionsA7,DeterminationA7,FlairA7,LeadershipA7,OffTheBallA7,PositioningA7,TeamworkA7,WorkrateA7,AccelerationA7,AgilityA7,BalanceA7,JumpingA7,LeftFootA7,NaturalFitnessA7,PaceA7,RightFootA7,StaminaA7,StrengthA7,ConsistencyA7,DirtinessA7,ImportantMatchesA7,InjuryPronessA7,VersatilityA7,AdaptabilityA7,AmbitionA7,LoyaltyA7,PressureA7,ProfessionalA7,SportsmanshipA7,TemperamentA7,ControversyA7,AgeA8,IntCapsA8,IntGoalsA8,U21CapsA8,U21GoalsA8,HeightA8,WeightA8,AerialAbilityA8,CommandOfAreaA8,CommunicationA8,EccentricityA8,HandlingA8,KickingA8,OneOnOnesA8,ReflexesA8,RushingOutA8,TendencyToPunchA8,ThrowingA8,CornersA8,CrossingA8,DribblingA8,FinishingA8,FirstTouchA8,FreekicksA8,HeadingA8,LongShotsA8,LongthrowsA8,MarkingA8,PassingA8,PenaltyTakingA8,TacklingA8,TechniqueA8,AggressionA8,AnticipationA8,BraveryA8,ComposureA8,ConcentrationA8,VisionA8,DecisionsA8,DeterminationA8,FlairA8,LeadershipA8,OffTheBallA8,PositioningA8,TeamworkA8,WorkrateA8,AccelerationA8,AgilityA8,BalanceA8,JumpingA8,LeftFootA8,NaturalFitnessA8,PaceA8,RightFootA8,StaminaA8,StrengthA8,ConsistencyA8,DirtinessA8,ImportantMatchesA8,InjuryPronessA8,VersatilityA8,AdaptabilityA8,AmbitionA8,LoyaltyA8,PressureA8,ProfessionalA8,SportsmanshipA8,TemperamentA8,ControversyA8,AgeA9,IntCapsA9,IntGoalsA9,U21CapsA9,U21GoalsA9,HeightA9,WeightA9,AerialAbilityA9,CommandOfAreaA9,CommunicationA9,EccentricityA9,HandlingA9,KickingA9,OneOnOnesA9,ReflexesA9,RushingOutA9,TendencyToPunchA9,ThrowingA9,CornersA9,CrossingA9,DribblingA9,FinishingA9,FirstTouchA9,FreekicksA9,HeadingA9,LongShotsA9,LongthrowsA9,MarkingA9,PassingA9,PenaltyTakingA9,TacklingA9,TechniqueA9,AggressionA9,AnticipationA9,BraveryA9,ComposureA9,ConcentrationA9,VisionA9,DecisionsA9,DeterminationA9,FlairA9,LeadershipA9,OffTheBallA9,PositioningA9,TeamworkA9,WorkrateA9,AccelerationA9,AgilityA9,BalanceA9,JumpingA9,LeftFootA9,NaturalFitnessA9,PaceA9,RightFootA9,StaminaA9,StrengthA9,ConsistencyA9,DirtinessA9,ImportantMatchesA9,InjuryPronessA9,VersatilityA9,AdaptabilityA9,AmbitionA9,LoyaltyA9,PressureA9,ProfessionalA9,SportsmanshipA9,TemperamentA9,ControversyA9,AgeA10,IntCapsA10,IntGoalsA10,U21CapsA10,U21GoalsA10,HeightA10,WeightA10,AerialAbilityA10,CommandOfAreaA10,CommunicationA10,EccentricityA10,HandlingA10,KickingA10,OneOnOnesA10,ReflexesA10,RushingOutA10,TendencyToPunchA10,ThrowingA10,CornersA10,CrossingA10,DribblingA10,FinishingA10,FirstTouchA10,FreekicksA10,HeadingA10,LongShotsA10,LongthrowsA10,MarkingA10,PassingA10,PenaltyTakingA10,TacklingA10,TechniqueA10,AggressionA10,AnticipationA10,BraveryA10,ComposureA10,ConcentrationA10,VisionA10,DecisionsA10,DeterminationA10,FlairA10,LeadershipA10,OffTheBallA10,PositioningA10,TeamworkA10,WorkrateA10,AccelerationA10,AgilityA10,BalanceA10,JumpingA10,LeftFootA10,NaturalFitnessA10,PaceA10,RightFootA10,StaminaA10,StrengthA10,ConsistencyA10,DirtinessA10,ImportantMatchesA10,InjuryPronessA10,VersatilityA10,AdaptabilityA10,AmbitionA10,LoyaltyA10,PressureA10,ProfessionalA10,SportsmanshipA10,TemperamentA10,ControversyA10,AgeA11,IntCapsA11,IntGoalsA11,U21CapsA11,U21GoalsA11,HeightA11,WeightA11,AerialAbilityA11,CommandOfAreaA11,CommunicationA11,EccentricityA11,HandlingA11,KickingA11,OneOnOnesA11,ReflexesA11,RushingOutA11,TendencyToPunchA11,ThrowingA11,CornersA11,CrossingA11,DribblingA11,FinishingA11,FirstTouchA11,FreekicksA11,HeadingA11,LongShotsA11,LongthrowsA11,MarkingA11,PassingA11,PenaltyTakingA11,TacklingA11,TechniqueA11,AggressionA11,AnticipationA11,BraveryA11,ComposureA11,ConcentrationA11,VisionA11,DecisionsA11,DeterminationA11,FlairA11,LeadershipA11,OffTheBallA11,PositioningA11,TeamworkA11,WorkrateA11,AccelerationA11,AgilityA11,BalanceA11,JumpingA11,LeftFootA11,NaturalFitnessA11,PaceA11,RightFootA11,StaminaA11,StrengthA11,ConsistencyA11,DirtinessA11,ImportantMatchesA11,InjuryPronessA11,VersatilityA11,AdaptabilityA11,AmbitionA11,LoyaltyA11,PressureA11,ProfessionalA11,SportsmanshipA11,TemperamentA11,ControversyA11
3,3,33.0,44.0,0.0,5.0,0.0,193.0,78.0,17.0,15.0,14.0,2.0,13.0,12.0,13.0,17.0,12.0,8.0,12.0,10.0,2.0,1.0,1.0,7.0,12.0,9.0,3.0,3.0,1.0,7.0,2.0,1.0,8.0,8.0,15.0,10.0,14.0,14.0,5.0,14.0,15.0,2.0,10.0,4.0,16.0,10.0,9.0,6.0,13.0,15.0,16.0,20.0,10.0,6.0,8.0,9.0,12.0,15.0,3.0,17.0,11.0,12.0,11.0,15.0,17.0,19.0,19.0,14.0,20.0,7.0,24.0,13.0,0.0,5.0,0.0,176.0,71.0,2.0,1.0,2.0,1.0,1.0,1.0,4.0,1.0,3.0,1.0,2.0,11.0,12.0,10.0,8.0,11.0,11.0,7.0,14.0,15.0,7.0,13.0,11.0,10.0,12.0,8.0,8.0,6.0,9.0,9.0,12.0,10.0,10.0,10.0,7.0,13.0,9.0,12.0,14.0,16.0,15.0,11.0,9.0,6.0,10.0,15.0,20.0,12.0,10.0,13.0,5.0,9.0,18.0,12.0,8.0,10.0,13.0,13.0,16.0,15.0,15.0,3.0,30.0,77.0,1.0,5.0,0.0,175.0,78.0,3.0,2.0,1.0,2.0,2.0,2.0,2.0,1.0,1.0,1.0,3.0,12.0,11.0,14.0,6.0,14.0,9.0,7.0,8.0,11.0,8.0,11.0,12.0,13.0,14.0,8.0,13.0,8.0,14.0,10.0,12.0,11.0,12.0,9.0,9.0,13.0,11.0,14.0,14.0,13.0,10.0,11.0,8.0,20.0,14.0,12.0,13.0,15.0,9.0,14.0,10.0,8.0,8.0,6.0,18.0,13.0,16.0,11.0,15.0,17.0,12.0,2.0,24.0,7.0,0.0,3.0,0.0,193.0,91.0,1.0,1.0,2.0,1.0,3.0,1.0,4.0,1.0,3.0,3.0,2.0,6.0,9.0,13.0,8.0,14.0,13.0,18.0,9.0,9.0,12.0,14.0,8.0,15.0,13.0,17.0,15.0,14.0,15.0,9.0,12.0,10.0,15.0,11.0,13.0,13.0,15.0,11.0,13.0,14.0,14.0,16.0,18.0,12.0,13.0,16.0,20.0,14.0,19.0,14.0,11.0,14.0,8.0,11.0,18.0,18.0,11.0,13.0,15.0,12.0,11.0,3.0,24.0,18.0,2.0,21.0,2.0,194.0,77.0,3.0,1.0,1.0,3.0,1.0,3.0,1.0,1.0,2.0,1.0,2.0,7.0,12.0,11.0,13.0,15.0,10.0,11.0,13.0,7.0,13.0,16.0,15.0,13.0,14.0,9.0,14.0,8.0,16.0,12.0,15.0,16.0,9.0,14.0,11.0,12.0,15.0,14.0,11.0,8.0,9.0,10.0,14.0,13.0,9.0,9.0,20.0,12.0,10.0,14.0,6.0,13.0,9.0,8.0,17.0,10.0,18.0,14.0,18.0,12.0,10.0,1.0,17.0,0.0,0.0,0.0,0.0,187.0,0.0,3.0,2.0,3.0,1.0,2.0,1.0,1.0,3.0,1.0,3.0,3.0,6.0,5.0,4.0,5.0,7.0,4.0,8.0,6.0,5.0,10.0,6.0,5.0,12.0,6.0,12.0,8.0,11.0,7.0,8.0,4.0,10.0,8.0,10.0,1.0,8.0,9.0,14.0,10.0,13.0,11.0,13.0,14.0,8.0,14.0,11.0,20.0,11.0,8.0,12.0,14.0,7.0,6.0,7.0,7.0,6.0,15.0,8.0,11.0,5.0,7.0,10.0,24.0,0.0,0.0,20.0,4.0,183.0,79.0,1.0,2.0,4.0,2.0,3.0,3.0,3.0,1.0,1.0,1.0,3.0,16.0,13.0,12.0,13.0,14.0,13.0,11.0,13.0,10.0,7.0,14.0,12.0,8.0,15.0,11.0,14.0,8.0,9.0,10.0,14.0,11.0,14.0,12.0,9.0,12.0,10.0,13.0,13.0,13.0,14.0,9.0,10.0,13.0,12.0,13.0,20.0,14.0,11.0,11.0,9.0,10.0,8.0,16.0,13.0,15.0,7.0,9.0,17.0,8.0,7.0,4.0,25.0,1.0,0.0,3.0,1.0,176.0,70.0,2.0,2.0,3.0,2.0,4.0,3.0,2.0,3.0,2.0,2.0,3.0,10.0,13.0,15.0,11.0,16.0,7.0,4.0,10.0,8.0,5.0,9.0,6.0,6.0,16.0,5.0,9.0,9.0,8.0,7.0,12.0,9.0,12.0,20.0,8.0,14.0,7.0,7.0,14.0,14.0,13.0,13.0,7.0,20.0,11.0,14.0,13.0,9.0,9.0,8.0,7.0,9.0,13.0,7.0,7.0,14.0,13.0,12.0,14.0,12.0,17.0,7.0,21.0,8.0,0.0,2.0,1.0,184.0,75.0,3.0,2.0,2.0,3.0,3.0,2.0,3.0,3.0,3.0,2.0,4.0,6.0,8.0,13.0,9.0,13.0,5.0,13.0,6.0,10.0,12.0,11.0,10.0,15.0,13.0,15.0,13.0,13.0,13.0,14.0,10.0,11.0,11.0,9.0,8.0,6.0,11.0,14.0,15.0,15.0,14.0,14.0,13.0,11.0,12.0,14.0,20.0,13.0,14.0,13.0,7.0,13.0,9.0,9.0,15.0,15.0,12.0,11.0,11.0,15.0,14.0,2.0,25.0,29.0,3.0,6.0,0.0,180.0,70.0,3.0,1.0,2.0,2.0,1.0,2.0,3.0,2.0,3.0,4.0,1.0,11.0,14.0,11.0,10.0,13.0,13.0,11.0,12.0,6.0,10.0,10.0,6.0,10.0,13.0,16.0,8.0,13.0,9.0,8.0,10.0,10.0,19.0,11.0,10.0,11.0,10.0,17.0,19.0,15.0,14.0,16.0,10.0,20.0,16.0,15.0,9.0,18.0,12.0,11.0,11.0,12.0,3.0,14.0,15.0,17.0,9.0,11.0,15.0,10.0,9.0,6.0,25.0,7.0,0.0,11.0,3.0,175.0,64.0,1.0,1.0,2.0,2.0,1.0,2.0,2.0,1.0,2.0,2.0,3.0,8.0,13.0,12.0,16.0,14.0,10.0,13.0,17.0,2.0,2.0,12.0,15.0,4.0,15.0,16.0,17.0,11.0,13.0,8.0,10.0,12.0,15.0,14.0,5.0,16.0,8.0,7.0,14.0,16.0,11.0,13.0,7.0,20.0,11.0,14.0,12.0,15.0,9.0,15.0,15.0,14.0,2.0,9.0,10.0,7.0,15.0,17.0,6.0,6.0,7.0,13.0,32.0,12.0,0.0,3.0,0.0,187.0,87.0,11.0,13.0,14.0,16.0,14.0,14.0,16.0,16.0,12.0,14.0,13.0,5.0,1.0,10.0,1.0,9.0,8.0,7.0,2.0,3.0,1.0,11.0,2.0,2.0,10.0,7.0,13.0,15.0,11.0,12.0,9.0,10.0,16.0,2.0,10.0,2.0,11.0,12.0,12.0,10.0,14.0,15.0,15.0,7.0,15.0,9.0,20.0,14.0,15.0,15.0,3.0,13.0,5.0,11.0,12.0,12.0,13.0,11.0,17.0,17.0,11.0,12.0,25.0,4.0,0.0,23.0,0.0,185.0,83.0,1.0,3.0,2.0,1.0,2.0,3.0,1.0,2.0,3.0,3.0,2.0,4.0,9.0,11.0,6.0,11.0,5.0,13.0,6.0,10.0,14.0,12.0,9.0,16.0,12.0,16.0,14.0,15.0,12.0,11.0,11.0,13.0,15.0,7.0,13.0,9.0,13.0,14.0,15.0,13.0,13.0,17.0,13.0,20.0,15.0,14.0,9.0,16.0,17.0,12.0,13.0,13.0,5.0,12.0,14.0,13.0,14.0,11.0,15.0,12.0,14.0,10.0,34.0,27.0,3.0,0.0,0.0,175.0,70.0,2.0,1.0,2.0,2.0,2.0,1.0,1.0,4.0,3.0,4.0,2.0,8.0,13.0,14.0,14.0,16.0,8.0,13.0,10.0,3.0,5.0,13.0,15.0,7.0,16.0,6.0,14.0,13.0,13.0,14.0,13.0,13.0,16.0,15.0,9.0,15.0,9.0,15.0,15.0,14.0,14.0,12.0,9.0,12.0,13.0,15.0,20.0,11.0,8.0,14.0,2.0,13.0,10.0,14.0,15.0,13.0,17.0,15.0,17.0,17.0,15.0,4.0,23.0,1.0,0.0,5.0,3.0,181.0,75.0,3.0,3.0,1.0,3.0,2.0,2.0,3.0,1.0,4.0,3.0,2.0,4.0,7.0,13.0,18.0,16.0,5.0,15.0,12.0,4.0,5.0,12.0,16.0,5.0,14.0,8.0,18.0,11.0,18.0,13.0,10.0,17.0,16.0,14.0,16.0,17.0,6.0,10.0,12.0,15.0,16.0,16.0,11.0,11.0,14.0,14.0,20.0,15.0,13.0,17.0,6.0,17.0,9.0,7.0,14.0,17.0,13.0,16.0,10.0,10.0,10.0,8.0,30.0,56.0,4.0,32.0,6.0,183.0,77.0,1.0,1.0,1.0,4.0,2.0,3.0,2.0,2.0,3.0,3.0,1.0,14.0,13.0,13.0,13.0,16.0,11.0,11.0,11.0,6.0,10.0,16.0,13.0,13.0,16.0,16.0,14.0,14.0,14.0,10.0,15.0,14.0,14.0,12.0,12.0,15.0,12.0,10.0,12.0,11.0,11.0,16.0,11.0,10.0,14.0,12.0,20.0,13.0,15.0,12.0,13.0,15.0,12.0,13.0,15.0,15.0,12.0,11.0,8.0,13.0,15.0,7.0,36.0,17.0,0.0,0.0,0.0,181.0,85.0,1.0,1.0,1.0,4.0,3.0,2.0,1.0,2.0,2.0,2.0,2.0,6.0,11.0,7.0,6.0,12.0,8.0,12.0,10.0,14.0,14.0,12.0,10.0,15.0,11.0,16.0,13.0,18.0,12.0,12.0,10.0,11.0,17.0,8.0,14.0,10.0,13.0,16.0,15.0,12.0,13.0,14.0,12.0,5.0,10.0,11.0,20.0,12.0,15.0,12.0,14.0,15.0,13.0,11.0,16.0,17.0,15.0,17.0,19.0,18.0,18.0,4.0,28.0,50.0,6.0,4.0,0.0,185.0,81.0,2.0,2.0,2.0,2.0,1.0,2.0,1.0,4.0,2.0,3.0,3.0,10.0,12.0,13.0,11.0,14.0,13.0,13.0,15.0,10.0,12.0,16.0,12.0,14.0,14.0,13.0,14.0,11.0,13.0,13.0,15.0,13.0,11.0,8.0,11.0,12.0,15.0,15.0,12.0,10.0,10.0,8.0,13.0,13.0,10.0,10.0,20.0,12.0,15.0,12.0,8.0,11.0,10.0,12.0,13.0,14.0,10.0,9.0,12.0,12.0,12.0,13.0,28.0,95.0,7.0,18.0,0.0,171.0,76.0,2.0,3.0,1.0,1.0,2.0,2.0,2.0,1.0,3.0,1.0,1.0,7.0,8.0,10.0,9.0,11.0,6.0,10.0,10.0,12.0,16.0,13.0,4.0,15.0,11.0,17.0,16.0,19.0,12.0,14.0,10.0,12.0,17.0,9.0,14.0,10.0,16.0,16.0,18.0,14.0,14.0,16.0,9.0,9.0,14.0,13.0,20.0,17.0,14.0,15.0,11.0,15.0,4.0,14.0,14.0,15.0,14.0,15.0,14.0,9.0,7.0,14.0,25.0,8.0,0.0,17.0,0.0,186.0,83.0,1.0,1.0,1.0,1.0,1.0,1.0,1.0,1.0,1.0,1.0,1.0,11.0,14.0,12.0,8.0,13.0,8.0,11.0,10.0,10.0,13.0,13.0,10.0,14.0,14.0,13.0,13.0,13.0,14.0,12.0,11.0,12.0,14.0,10.0,9.0,13.0,12.0,13.0,15.0,15.0,13.0,14.0,12.0,12.0,13.0,15.0,20.0,14.0,13.0,13.0,14.0,13.0,10.0,14.0,13.0,13.0,13.0,13.0,14.0,14.0,17.0,5.0,28.0,21.0,0.0,14.0,1.0,195.0,81.0,2.0,1.0,2.0,1.0,1.0,2.0,1.0,3.0,3.0,2.0,3.0,5.0,6.0,8.0,9.0,10.0,5.0,19.0,7.0,7.0,14.0,12.0,8.0,14.0,10.0,14.0,12.0,15.0,12.0,10.0,11.0,12.0,13.0,6.0,14.0,6.0,12.0,14.0,15.0,12.0,11.0,15.0,19.0,9.0,12.0,12.0,20.0,13.0,14.0,10.0,14.0,14.0,10.0,7.0,14.0,15.0,15.0,10.0,15.0,12.0,13.0,5.0,24.0,57.0,18.0,7.0,1.0,169.0,72.0,1.0,3.0,1.0,1.0,3.0,2.0,1.0,3.0,2.0,2.0,4.0,12.0,14.0,15.0,12.0,17.0,13.0,4.0,14.0,4.0,6.0,14.0,10.0,6.0,15.0,14.0,12.0,13.0,11.0,9.0,13.0,10.0,14.0,18.0,5.0,15.0,6.0,10.0,10.0,16.0,17.0,16.0,5.0,20.0,10.0,14.0,12.0,14.0,13.0,12.0,8.0,12.0,8.0,14.0,10.0,15.0,13.0,13.0,16.0,12.0,14.0,8.0
1,1,29.0,82.0,0.0,8.0,0.0,188.0,78.0,12.0,12.0,14.0,14.0,17.0,8.0,15.0,18.0,17.0,18.0,11.0,5.0,2.0,3.0,2.0,11.0,10.0,1.0,9.0,3.0,7.0,10.0,1.0,13.0,8.0,10.0,14.0,18.0,14.0,16.0,9.0,16.0,15.0,6.0,16.0,3.0,17.0,14.0,8.0,15.0,17.0,15.0,15.0,20.0,15.0,14.0,6.0,15.0,14.0,15.0,10.0,15.0,5.0,1.0,14.0,15.0,17.0,18.0,17.0,18.0,18.0,4.0,26.0,19.0,0.0,7.0,0.0,183.0,74.0,2.0,1.0,1.0,1.0,3.0,2.0,2.0,1.0,2.0,2.0,3.0,13.0,13.0,14.0,7.0,12.0,12.0,15.0,7.0,14.0,12.0,12.0,6.0,13.0,12.0,11.0,13.0,15.0,13.0,13.0,11.0,9.0,13.0,10.0,12.0,12.0,12.0,15.0,16.0,18.0,15.0,15.0,12.0,10.0,13.0,18.0,20.0,15.0,15.0,13.0,5.0,12.0,6.0,14.0,9.0,15.0,14.0,7.0,8.0,12.0,11.0,7.0,29.0,82.0,6.0,0.0,0.0,189.0,79.0,3.0,1.0,3.0,3.0,2.0,3.0,3.0,1.0,2.0,2.0,4.0,7.0,7.0,13.0,8.0,13.0,11.0,14.0,9.0,12.0,14.0,14.0,8.0,16.0,14.0,9.0,14.0,14.0,18.0,13.0,14.0,15.0,16.0,13.0,12.0,10.0,14.0,15.0,15.0,13.0,14.0,13.0,15.0,20.0,12.0,12.0,10.0,16.0,16.0,14.0,10.0,13.0,11.0,12.0,13.0,17.0,13.0,16.0,8.0,9.0,9.0,10.0,15.0,0.0,0.0,0.0,0.0,175.0,0.0,2.0,1.0,1.0,1.0,2.0,2.0,3.0,3.0,3.0,1.0,2.0,6.0,9.0,7.0,4.0,9.0,8.0,2.0,6.0,2.0,5.0,4.0,5.0,5.0,13.0,5.0,6.0,6.0,5.0,6.0,5.0,6.0,5.0,11.0,6.0,7.0,3.0,9.0,13.0,8.0,8.0,10.0,9.0,20.0,6.0,9.0,9.0,8.0,4.0,4.0,15.0,9.0,9.0,7.0,6.0,4.0,7.0,5.0,14.0,9.0,9.0,7.0,31.0,12.0,7.0,9.0,6.0,179.0,72.0,2.0,2.0,1.0,3.0,3.0,3.0,2.0,2.0,2.0,2.0,1.0,7.0,11.0,12.0,14.0,11.0,13.0,14.0,12.0,6.0,6.0,13.0,16.0,8.0,13.0,16.0,14.0,15.0,12.0,14.0,13.0,14.0,16.0,14.0,15.0,15.0,10.0,14.0,15.0,14.0,15.0,14.0,10.0,15.0,15.0,15.0,20.0,15.0,12.0,14.0,15.0,3.0,7.0,11.0,8.0,15.0,15.0,6.0,18.0,7.0,7.0,8.0,24.0,11.0,3.0,3.0,0.0,178.0,75.0,3.0,2.0,1.0,2.0,1.0,4.0,2.0,2.0,2.0,2.0,3.0,11.0,12.0,16.0,9.0,11.0,11.0,7.0,15.0,5.0,5.0,10.0,6.0,6.0,13.0,8.0,8.0,10.0,7.0,12.0,10.0,11.0,13.0,16.0,10.0,11.0,9.0,11.0,13.0,16.0,13.0,13.0,8.0,20.0,12.0,16.0,16.0,15.0,11.0,9.0,4.0,10.0,7.0,9.0,12.0,10.0,13.0,12.0,13.0,10.0,14.0,6.0,29.0,3.0,0.0,13.0,1.0,195.0,85.0,2.0,2.0,3.0,1.0,1.0,1.0,3.0,3.0,3.0,1.0,2.0,4.0,5.0,8.0,7.0,13.0,6.0,19.0,8.0,5.0,16.0,14.0,8.0,15.0,13.0,13.0,16.0,15.0,13.0,13.0,11.0,12.0,13.0,13.0,15.0,8.0,15.0,15.0,14.0,9.0,10.0,11.0,19.0,9.0,9.0,11.0,20.0,14.0,17.0,12.0,14.0,10.0,13.0,15.0,13.0,12.0,13.0,12.0,14.0,14.0,13.0,11.0,26.0,31.0,3.0,0.0,0.0,187.0,80.0,3.0,2.0,3.0,1.0,1.0,1.0,3.0,1.0,3.0,2.0,3.0,12.0,13.0,15.0,14.0,15.0,12.0,13.0,13.0,5.0,4.0,15.0,12.0,9.0,15.0,10.0,12.0,12.0,14.0,12.0,15.0,12.0,15.0,14.0,6.0,14.0,10.0,12.0,13.0,13.0,14.0,13.0,14.0,15.0,12.0,15.0,20.0,14.0,14.0,10.0,4.0,12.0,8.0,12.0,8.0,14.0,13.0,13.0,17.0,15.0,15.0,6.0,24.0,61.0,9.0,3.0,1.0,177.0,71.0,2.0,1.0,1.0,2.0,2.0,3.0,1.0,1.0,3.0,1.0,3.0,13.0,15.0,13.0,13.0,16.0,17.0,7.0,12.0,3.0,4.0,16.0,11.0,3.0,18.0,5.0,14.0,7.0,15.0,12.0,17.0,16.0,14.0,13.0,8.0,16.0,4.0,13.0,16.0,14.0,16.0,12.0,7.0,16.0,15.0,13.0,20.0,15.0,11.0,15.0,4.0,12.0,6.0,15.0,17.0,17.0,18.0,16.0,15.0,18.0,17.0,4.0,23.0,25.0,0.0,0.0,0.0,181.0,77.0,1.0,2.0,3.0,1.0,2.0,2.0,3.0,1.0,3.0,2.0,3.0,13.0,15.0,12.0,6.0,14.0,14.0,14.0,6.0,11.0,14.0,14.0,10.0,14.0,13.0,13.0,15.0,18.0,15.0,13.0,14.0,14.0,17.0,9.0,6.0,13.0,15.0,14.0,15.0,13.0,13.0,15.0,10.0,20.0,13.0,11.0,8.0,14.0,14.0,15.0,6.0,9.0,5.0,11.0,10.0,13.0,14.0,9.0,15.0,13.0,12.0,4.0,21.0,19.0,3.0,0.0,0.0,187.0,78.0,3.0,2.0,3.0,1.0,1.0,1.0,1.0,1.0,1.0,2.0,3.0,9.0,12.0,13.0,10.0,15.0,10.0,9.0,12.0,9.0,11.0,14.0,10.0,13.0,16.0,17.0,14.0,16.0,16.0,11.0,14.0,11.0,17.0,13.0,10.0,14.0,12.0,12.0,17.0,12.0,13.0,15.0,14.0,20.0,14.0,12.0,12.0,17.0,13.0,12.0,13.0,13.0,11.0,8.0,14.0,16.0,10.0,13.0,12.0,14.0,10.0,12.0,30.0,42.0,0.0,13.0,0.0,195.0,88.0,16.0,13.0,14.0,6.0,14.0,13.0,13.0,15.0,12.0,10.0,14.0,1.0,8.0,5.0,2.0,8.0,2.0,8.0,2.0,5.0,3.0,9.0,5.0,3.0,8.0,10.0,12.0,10.0,14.0,10.0,10.0,14.0,13.0,3.0,14.0,3.0,12.0,14.0,12.0,8.0,13.0,18.0,18.0,17.0,14.0,11.0,20.0,14.0,17.0,14.0,4.0,14.0,4.0,1.0,12.0,13.0,14.0,9.0,15.0,13.0,13.0,5.0,16.0,0.0,0.0,0.0,0.0,172.0,0.0,1.0,1.0,1.0,1.0,3.0,3.0,2.0,1.0,2.0,1.0,1.0,5.0,5.0,6.0,4.0,8.0,7.0,2.0,4.0,2.0,4.0,6.0,3.0,3.0,5.0,15.0,6.0,3.0,5.0,4.0,5.0,8.0,6.0,13.0,2.0,4.0,3.0,13.0,13.0,9.0,12.0,5.0,4.0,20.0,13.0,11.0,8.0,11.0,4.0,3.0,11.0,4.0,3.0,7.0,8.0,13.0,7.0,14.0,6.0,4.0,5.0,11.0,36.0,46.0,2.0,0.0,0.0,170.0,65.0,3.0,3.0,2.0,3.0,1.0,3.0,3.0,3.0,1.0,1.0,3.0,15.0,13.0,14.0,10.0,16.0,14.0,6.0,12.0,7.0,11.0,16.0,13.0,13.0,16.0,14.0,14.0,15.0,13.0,13.0,16.0,14.0,15.0,14.0,14.0,11.0,13.0,16.0,8.0,9.0,8.0,11.0,5.0,12.0,7.0,9.0,20.0,7.0,9.0,14.0,14.0,13.0,18.0,10.0,12.0,13.0,13.0,14.0,15.0,12.0,5.0,13.0,16.0,0.0,0.0,0.0,0.0,175.0,0.0,7.0,9.0,7.0,10.0,10.0,4.0,3.0,10.0,14.0,6.0,4.0,3.0,3.0,1.0,2.0,1.0,5.0,1.0,1.0,3.0,3.0,1.0,1.0,3.0,3.0,7.0,4.0,11.0,4.0,5.0,4.0,9.0,8.0,1.0,5.0,3.0,7.0,6.0,9.0,12.0,6.0,8.0,8.0,9.0,13.0,11.0,20.0,5.0,4.0,11.0,8.0,11.0,3.0,3.0,11.0,15.0,5.0,10.0,9.0,10.0,3.0,7.0,22.0,0.0,0.0,0.0,0.0,174.0,70.0,2.0,1.0,2.0,1.0,2.0,2.0,3.0,2.0,2.0,2.0,3.0,13.0,12.0,13.0,9.0,13.0,8.0,6.0,8.0,3.0,3.0,12.0,6.0,3.0,13.0,10.0,10.0,8.0,9.0,6.0,11.0,9.0,8.0,14.0,3.0,12.0,6.0,8.0,8.0,14.0,15.0,8.0,8.0,20.0,8.0,14.0,15.0,8.0,8.0,8.0,8.0,1.0,6.0,11.0,13.0,9.0,12.0,10.0,12.0,12.0,14.0,13.0,28.0,0.0,0.0,0.0,0.0,182.0,71.0,3.0,4.0,2.0,3.0,2.0,1.0,4.0,1.0,2.0,4.0,1.0,2.0,5.0,2.0,3.0,7.0,5.0,11.0,3.0,8.0,10.0,7.0,5.0,11.0,5.0,10.0,10.0,10.0,11.0,13.0,4.0,10.0,9.0,1.0,5.0,2.0,11.0,12.0,10.0,9.0,10.0,10.0,11.0,9.0,11.0,9.0,20.0,12.0,15.0,10.0,5.0,9.0,3.0,8.0,13.0,11.0,10.0,12.0,14.0,11.0,18.0,7.0,32.0,12.0,0.0,0.0,0.0,188.0,78.0,2.0,1.0,3.0,3.0,3.0,2.0,3.0,1.0,1.0,3.0,1.0,3.0,6.0,11.0,8.0,11.0,3.0,15.0,6.0,9.0,15.0,11.0,5.0,16.0,12.0,13.0,15.0,14.0,13.0,14.0,10.0,13.0,15.0,9.0,14.0,7.0,15.0,13.0,14.0,12.0,14.0,15.0,14.0,20.0,15.0,14.0,10.0,15.0,14.0,15.0,12.0,14.0,8.0,10.0,14.0,13.0,13.0,13.0,14.0,14.0,13.0,4.0,31.0,1.0,0.0,0.0,0.0,175.0,73.0,1.0,2.0,4.0,3.0,3.0,4.0,1.0,1.0,2.0,1.0,2.0,16.0,14.0,14.0,10.0,17.0,12.0,6.0,10.0,3.0,9.0,18.0,11.0,12.0,16.0,12.0,17.0,12.0,15.0,14.0,17.0,15.0,13.0,16.0,13.0,15.0,13.0,17.0,14.0,12.0,14.0,12.0,7.0,12.0,15.0,13.0,20.0,12.0,10.0,12.0,9.0,13.0,5.0,14.0,16.0,14.0,14.0,15.0,18.0,14.0,14.0,3.0,34.0,11.0,0.0,0.0,0.0,178.0,71.0,4.0,1.0,1.0,1.0,3.0,4.0,3.0,2.0,2.0,2.0,2.0,15.0,17.0,11.0,9.0,13.0,15.0,12.0,13.0,11.0,12.0,15.0,8.0,14.0,13.0,13.0,12.0,13.0,13.0,14.0,13.0,14.0,14.0,10.0,16.0,13.0,13.0,14.0,14.0,13.0,12.0,14.0,9.0,20.0,16.0,14.0,7.0,12.0,12.0,15.0,10.0,13.0,6.0,14.0,11.0,12.0,18.0,15.0,18.0,15.0,14.0,12.0,30.0,0.0,0.0,0.0,0.0,174.0,70.0,3.0,3.0,2.0,3.0,3.0,1.0,2.0,2.0,1.0,2.0,1.0,10.0,9.0,12.0,10.0,11.0,13.0,9.0,9.0,5.0,10.0,9.0,10.0,7.0,12.0,10.0,12.0,11.0,11.0,11.0,11.0,12.0,11.0,10.0,10.0,12.0,11.0,11.0,12.0,11.0,10.0,11.0,10.0,20.0,13.0,11.0,11.0,11.0,10.0,12.0,3.0,10.0,10.0,15.0,11.0,11.0,11.0,9.0,12.0,8.0,11.0,10.0,24.0,42.0,25.0,11.0,4.0,175.0,72.0,3.0,3.0,3.0,4.0,1.0,3.0,1.0,1.0,2.0,3.0,3.0,6.0,12.0,16.0,15.0,16.0,6.0,5.0,12.0,3.0,4.0,12.0,11.0,6.0,15.0,8.0,16.0,7.0,13.0,11.0,12.0,13.0,13.0,17.0,5.0,17.0,7.0,10.0,10.0,18.0,17.0,11.0,6.0,20.0,14.0,18.0,9.0,14.0,8.0,14.0,4.0,16.0,6.0,14.0,15.0,17.0,10.0,14.0,11.0,10.0,14.0,9.0
1,0,28.0,17.0,0.0,9.0,0.0,193.0,88.0,14.0,11.0,12.0,8.0,15.0,14.0,15.0,18.0,13.0,13.0,13.0,7.0,3.0,1.0,3.0,10.0,10.0,4.0,3.0,1.0,1.0,10.0,5.0,1.0,8.0,10.0,15.0,14.0,14.0,14.0,10.0,12.0,14.0,1.0,5.0,2.0,15.0,11.0,10.0,11.0,16.0,13.0,14.0,6.0,14.0,11.0,20.0,13.0,14.0,12.0,1.0,13.0,4.0,12.0,16.0,15.0,15.0,13.0,15.0,16.0,14.0,3.0,24.0,17.0,4.0,7.0,3.0,172.0,71.0,2.0,3.0,3.0,2.0,2.0,1.0,1.0,1.0,2.0,2.0,2.0,11.0,13.0,18.0,13.0,16.0,12.0,5.0,15.0,3.0,8.0,15.0,10.0,11.0,18.0,11.0,14.0,12.0,17.0,13.0,17.0,14.0,15.0,18.0,6.0,15.0,13.0,15.0,15.0,15.0,17.0,15.0,6.0,12.0,13.0,13.0,20.0,14.0,11.0,14.0,8.0,14.0,9.0,11.0,14.0,16.0,12.0,13.0,17.0,13.0,15.0,4.0,26.0,27.0,0.0,27.0,4.0,183.0,67.0,1.0,3.0,4.0,2.0,3.0,2.0,2.0,1.0,3.0,1.0,2.0,12.0,13.0,12.0,11.0,15.0,11.0,11.0,12.0,4.0,13.0,16.0,10.0,14.0,14.0,14.0,14.0,14.0,15.0,15.0,14.0,15.0,17.0,13.0,16.0,14.0,15.0,17.0,18.0,13.0,13.0,13.0,12.0,8.0,18.0,14.0,20.0,18.0,14.0,15.0,8.0,15.0,9.0,13.0,15.0,17.0,17.0,17.0,18.0,13.0,15.0,6.0,26.0,21.0,6.0,15.0,4.0,183.0,79.0,1.0,2.0,1.0,2.0,1.0,3.0,1.0,3.0,1.0,3.0,1.0,7.0,12.0,15.0,16.0,16.0,10.0,11.0,13.0,3.0,7.0,13.0,13.0,7.0,16.0,12.0,15.0,11.0,15.0,14.0,14.0,13.0,11.0,15.0,4.0,16.0,5.0,12.0,12.0,14.0,17.0,16.0,11.0,20.0,10.0,13.0,13.0,14.0,13.0,15.0,5.0,15.0,14.0,9.0,13.0,18.0,13.0,13.0,14.0,13.0,16.0,8.0,27.0,0.0,0.0,0.0,0.0,176.0,70.0,2.0,1.0,2.0,3.0,1.0,2.0,1.0,3.0,1.0,3.0,2.0,7.0,7.0,11.0,6.0,11.0,7.0,7.0,8.0,5.0,1.0,8.0,10.0,2.0,13.0,6.0,10.0,6.0,8.0,8.0,11.0,9.0,14.0,12.0,5.0,11.0,4.0,9.0,10.0,16.0,14.0,12.0,7.0,5.0,10.0,14.0,20.0,9.0,9.0,12.0,6.0,14.0,11.0,6.0,9.0,11.0,13.0,10.0,11.0,16.0,16.0,6.0,23.0,3.0,0.0,10.0,0.0,171.0,64.0,1.0,3.0,2.0,2.0,1.0,1.0,1.0,4.0,2.0,1.0,2.0,7.0,13.0,13.0,7.0,14.0,9.0,7.0,14.0,9.0,11.0,13.0,7.0,15.0,14.0,14.0,13.0,14.0,13.0,11.0,12.0,12.0,15.0,12.0,7.0,14.0,10.0,15.0,16.0,16.0,15.0,14.0,8.0,20.0,15.0,16.0,5.0,17.0,13.0,12.0,9.0,13.0,7.0,11.0,13.0,13.0,14.0,12.0,15.0,14.0,13.0,8.0,28.0,26.0,0.0,1.0,0.0,173.0,73.0,2.0,1.0,4.0,2.0,1.0,3.0,3.0,2.0,1.0,2.0,3.0,11.0,13.0,17.0,13.0,17.0,10.0,6.0,11.0,2.0,10.0,15.0,9.0,10.0,18.0,9.0,15.0,11.0,15.0,12.0,15.0,14.0,15.0,17.0,12.0,16.0,13.0,15.0,17.0,13.0,16.0,15.0,6.0,16.0,15.0,10.0,20.0,15.0,10.0,15.0,7.0,14.0,11.0,12.0,13.0,14.0,16.0,13.0,15.0,12.0,13.0,9.0,18.0,0.0,0.0,0.0,0.0,187.0,0.0,3.0,3.0,1.0,1.0,1.0,2.0,3.0,2.0,4.0,3.0,1.0,6.0,7.0,10.0,11.0,10.0,7.0,9.0,9.0,6.0,4.0,8.0,8.0,4.0,9.0,8.0,10.0,8.0,9.0,7.0,9.0,7.0,13.0,11.0,6.0,10.0,5.0,8.0,9.0,11.0,10.0,11.0,14.0,10.0,10.0,12.0,20.0,9.0,8.0,11.0,8.0,11.0,9.0,9.0,6.0,12.0,11.0,14.0,12.0,13.0,13.0,8.0,26.0,31.0,0.0,7.0,2.0,168.0,62.0,2.0,3.0,1.0,2.0,3.0,1.0,2.0,1.0,3.0,1.0,1.0,8.0,9.0,13.0,9.0,15.0,7.0,7.0,8.0,3.0,14.0,15.0,6.0,13.0,15.0,13.0,15.0,15.0,15.0,15.0,13.0,14.0,13.0,12.0,8.0,14.0,13.0,17.0,18.0,13.0,15.0,14.0,6.0,11.0,15.0,12.0,20.0,15.0,10.0,14.0,6.0,15.0,8.0,11.0,10.0,14.0,14.0,13.0,15.0,15.0,12.0,2.0,20.0,0.0,0.0,4.0,0.0,176.0,70.0,2.0,4.0,3.0,3.0,1.0,2.0,3.0,3.0,3.0,2.0,2.0,9.0,12.0,15.0,11.0,12.0,5.0,6.0,10.0,3.0,8.0,12.0,8.0,8.0,14.0,9.0,12.0,5.0,13.0,9.0,13.0,11.0,12.0,14.0,4.0,13.0,9.0,12.0,12.0,17.0,15.0,12.0,8.0,11.0,13.0,16.0,20.0,12.0,12.0,10.0,4.0,13.0,7.0,13.0,13.0,15.0,10.0,13.0,14.0,13.0,10.0,7.0,31.0,85.0,5.0,13.0,0.0,191.0,81.0,1.0,4.0,2.0,3.0,1.0,1.0,1.0,3.0,2.0,3.0,2.0,2.0,5.0,9.0,9.0,11.0,2.0,17.0,3.0,5.0,15.0,13.0,2.0,16.0,12.0,14.0,16.0,16.0,13.0,12.0,7.0,14.0,17.0,7.0,9.0,12.0,16.0,14.0,12.0,12.0,13.0,14.0,16.0,8.0,14.0,13.0,20.0,13.0,16.0,17.0,11.0,15.0,10.0,4.0,14.0,16.0,16.0,13.0,16.0,15.0,13.0,8.0,28.0,2.0,0.0,5.0,0.0,190.0,84.0,13.0,9.0,11.0,9.0,12.0,13.0,13.0,18.0,14.0,15.0,13.0,7.0,2.0,1.0,3.0,9.0,11.0,5.0,2.0,2.0,1.0,8.0,6.0,3.0,9.0,13.0,10.0,16.0,17.0,10.0,6.0,9.0,10.0,5.0,11.0,4.0,10.0,12.0,13.0,12.0,15.0,12.0,15.0,10.0,14.0,13.0,20.0,13.0,12.0,13.0,4.0,11.0,7.0,11.0,18.0,9.0,12.0,10.0,13.0,15.0,15.0,3.0,28.0,6.0,0.0,8.0,0.0,184.0,79.0,3.0,2.0,1.0,4.0,3.0,3.0,3.0,3.0,3.0,3.0,2.0,11.0,12.0,7.0,7.0,11.0,8.0,10.0,10.0,10.0,13.0,11.0,9.0,15.0,12.0,14.0,12.0,13.0,12.0,15.0,8.0,13.0,8.0,7.0,10.0,10.0,15.0,15.0,12.0,9.0,9.0,12.0,11.0,12.0,7.0,11.0,20.0,11.0,12.0,15.0,10.0,10.0,8.0,12.0,9.0,8.0,15.0,11.0,13.0,12.0,13.0,6.0,30.0,0.0,0.0,0.0,0.0,183.0,90.0,3.0,2.0,2.0,3.0,2.0,2.0,1.0,3.0,2.0,2.0,2.0,7.0,8.0,8.0,9.0,12.0,7.0,13.0,10.0,2.0,8.0,12.0,5.0,8.0,11.0,9.0,11.0,7.0,12.0,12.0,8.0,9.0,2.0,9.0,13.0,13.0,8.0,7.0,8.0,14.0,11.0,14.0,10.0,5.0,13.0,9.0,20.0,9.0,14.0,9.0,5.0,9.0,7.0,9.0,15.0,11.0,11.0,12.0,12.0,3.0,7.0,1.0,24.0,26.0,0.0,2.0,0.0,176.0,70.0,2.0,3.0,1.0,1.0,3.0,2.0,2.0,1.0,2.0,1.0,1.0,15.0,16.0,16.0,10.0,15.0,12.0,5.0,12.0,8.0,2.0,13.0,9.0,5.0,16.0,13.0,11.0,11.0,12.0,9.0,12.0,10.0,10.0,18.0,4.0,11.0,7.0,9.0,11.0,15.0,15.0,15.0,8.0,20.0,13.0,14.0,16.0,12.0,11.0,3.0,13.0,14.0,6.0,12.0,10.0,8.0,8.0,8.0,9.0,7.0,6.0,16.0,27.0,31.0,1.0,18.0,1.0,178.0,68.0,2.0,1.0,2.0,2.0,3.0,3.0,1.0,3.0,4.0,4.0,1.0,8.0,8.0,8.0,8.0,11.0,7.0,10.0,12.0,4.0,14.0,12.0,10.0,14.0,10.0,19.0,12.0,19.0,8.0,16.0,10.0,10.0,14.0,8.0,10.0,10.0,10.0,17.0,17.0,11.0,11.0,12.0,9.0,17.0,7.0,12.0,20.0,14.0,12.0,14.0,13.0,12.0,15.0,10.0,11.0,12.0,16.0,12.0,18.0,11.0,13.0,5.0,31.0,17.0,5.0,0.0,0.0,189.0,85.0,3.0,1.0,1.0,2.0,1.0,3.0,1.0,1.0,4.0,3.0,3.0,6.0,10.0,13.0,15.0,14.0,12.0,15.0,13.0,3.0,5.0,13.0,12.0,7.0,14.0,13.0,16.0,17.0,16.0,15.0,12.0,15.0,14.0,16.0,4.0,15.0,9.0,9.0,12.0,12.0,14.0,16.0,14.0,10.0,7.0,13.0,20.0,13.0,16.0,11.0,7.0,13.0,11.0,8.0,12.0,15.0,8.0,14.0,13.0,10.0,12.0,12.0,29.0,26.0,2.0,0.0,0.0,179.0,71.0,2.0,3.0,2.0,3.0,1.0,2.0,3.0,1.0,1.0,1.0,2.0,8.0,10.0,12.0,13.0,13.0,8.0,8.0,10.0,6.0,8.0,12.0,9.0,10.0,13.0,13.0,16.0,9.0,10.0,13.0,10.0,13.0,13.0,12.0,13.0,17.0,12.0,16.0,16.0,13.0,13.0,9.0,9.0,11.0,14.0,13.0,20.0,15.0,9.0,13.0,8.0,16.0,3.0,18.0,14.0,16.0,16.0,11.0,15.0,10.0,14.0,5.0,33.0,75.0,6.0,19.0,0.0,187.0,83.0,2.0,3.0,3.0,1.0,2.0,3.0,1.0,3.0,1.0,1.0,3.0,7.0,7.0,10.0,5.0,12.0,5.0,12.0,6.0,10.0,12.0,12.0,8.0,13.0,13.0,9.0,18.0,9.0,12.0,18.0,8.0,15.0,12.0,6.0,14.0,10.0,18.0,20.0,17.0,12.0,15.0,15.0,14.0,8.0,18.0,14.0,20.0,16.0,13.0,19.0,3.0,16.0,3.0,18.0,16.0,12.0,18.0,16.0,19.0,16.0,17.0,4.0,25.0,4.0,0.0,14.0,2.0,183.0,73.0,1.0,3.0,1.0,3.0,3.0,2.0,2.0,2.0,2.0,3.0,4.0,6.0,9.0,7.0,6.0,14.0,6.0,13.0,8.0,7.0,13.0,14.0,8.0,14.0,13.0,9.0,15.0,10.0,16.0,15.0,13.0,13.0,10.0,11.0,12.0,10.0,15.0,16.0,8.0,11.0,11.0,11.0,10.0,9.0,10.0,12.0,20.0,11.0,11.0,17.0,12.0,4.0,4.0,9.0,7.0,12.0,15.0,13.0,14.0,15.0,14.0,6.0,29.0,7.0,0.0,0.0,0.0,185.0,80.0,1.0,1.0,4.0,4.0,1.0,2.0,1.0,3.0,1.0,1.0,3.0,5.0,7.0,10.0,6.0,10.0,6.0,14.0,6.0,7.0,14.0,10.0,10.0,13.0,10.0,15.0,14.0,16.0,11.0,14.0,8.0,11.0,15.0,8.0,12.0,8.0,13.0,13.0,15.0,12.0,12.0,15.0,14.0,20.0,11.0,12.0,10.0,14.0,14.0,15.0,14.0,13.0,9.0,9.0,10.0,8.0,15.0,10.0,14.0,10.0,11.0,7.0,28.0,0.0,0.0,0.0,0.0,173.0,73.0,3.0,3.0,1.0,4.0,1.0,2.0,2.0,1.0,2.0,3.0,1.0,13.0,15.0,13.0,9.0,13.0,11.0,4.0,13.0,8.0,9.0,13.0,11.0,10.0,14.0,16.0,12.0,15.0,13.0,9.0,12.0,12.0,12.0,14.0,8.0,14.0,9.0,12.0,14.0,15.0,15.0,7.0,5.0,20.0,12.0,14.0,10.0,14.0,7.0,10.0,13.0,12.0,5.0,15.0,13.0,11.0,11.0,10.0,10.0,7.0,12.0,8.0
0,4,33.0,4.0,0.0,0.0,0.0,192.0,86.0,14.0,8.0,10.0,14.0,10.0,11.0,16.0,16.0,9.0,6.0,12.0,4.0,3.0,2.0,1.0,7.0,8.0,7.0,2.0,3.0,1.0,10.0,1.0,2.0,4.0,14.0,11.0,18.0,6.0,9.0,5.0,8.0,12.0,5.0,6.0,10.0,10.0,6.0,9.0,9.0,13.0,13.0,16.0,8.0,12.0,9.0,20.0,12.0,14.0,9.0,9.0,13.0,12.0,11.0,16.0,11.0,8.0,12.0,13.0,12.0,12.0,5.0,33.0,28.0,0.0,18.0,0.0,183.0,72.0,1.0,3.0,2.0,4.0,1.0,1.0,2.0,1.0,3.0,3.0,3.0,9.0,11.0,14.0,7.0,14.0,9.0,11.0,10.0,13.0,12.0,12.0,10.0,13.0,14.0,11.0,11.0,11.0,13.0,11.0,9.0,12.0,11.0,12.0,8.0,14.0,14.0,13.0,13.0,13.0,15.0,12.0,12.0,11.0,14.0,12.0,20.0,13.0,12.0,16.0,8.0,11.0,8.0,15.0,11.0,10.0,13.0,14.0,12.0,14.0,14.0,12.0,27.0,1.0,0.0,15.0,0.0,182.0,80.0,1.0,3.0,1.0,3.0,2.0,1.0,2.0,2.0,3.0,2.0,1.0,4.0,8.0,7.0,4.0,8.0,5.0,15.0,7.0,14.0,16.0,8.0,5.0,13.0,8.0,18.0,9.0,17.0,8.0,14.0,8.0,8.0,17.0,6.0,13.0,8.0,11.0,12.0,14.0,12.0,11.0,15.0,13.0,10.0,17.0,12.0,20.0,13.0,15.0,12.0,13.0,15.0,3.0,15.0,16.0,17.0,13.0,10.0,16.0,5.0,5.0,15.0,31.0,43.0,2.0,0.0,0.0,183.0,77.0,2.0,1.0,4.0,1.0,1.0,1.0,3.0,3.0,3.0,2.0,2.0,5.0,11.0,8.0,8.0,10.0,7.0,15.0,9.0,8.0,14.0,13.0,7.0,13.0,11.0,14.0,14.0,18.0,13.0,13.0,8.0,12.0,16.0,7.0,14.0,8.0,14.0,15.0,16.0,12.0,12.0,14.0,13.0,8.0,14.0,12.0,20.0,13.0,15.0,15.0,14.0,13.0,6.0,10.0,8.0,16.0,13.0,13.0,14.0,10.0,11.0,12.0,33.0,49.0,9.0,0.0,0.0,193.0,83.0,3.0,1.0,2.0,2.0,1.0,2.0,2.0,1.0,2.0,4.0,2.0,9.0,13.0,12.0,17.0,14.0,15.0,15.0,17.0,9.0,6.0,13.0,17.0,5.0,14.0,7.0,15.0,8.0,15.0,10.0,13.0,15.0,10.0,11.0,10.0,15.0,6.0,13.0,6.0,7.0,8.0,16.0,16.0,20.0,12.0,9.0,10.0,11.0,16.0,12.0,4.0,10.0,8.0,4.0,12.0,16.0,10.0,16.0,13.0,13.0,12.0,11.0,25.0,2.0,0.0,9.0,1.0,180.0,72.0,1.0,1.0,1.0,4.0,3.0,2.0,1.0,1.0,2.0,3.0,3.0,14.0,14.0,11.0,12.0,14.0,14.0,9.0,13.0,6.0,9.0,15.0,12.0,9.0,15.0,6.0,11.0,6.0,14.0,10.0,14.0,12.0,7.0,11.0,10.0,12.0,9.0,14.0,13.0,9.0,12.0,8.0,9.0,20.0,8.0,11.0,9.0,11.0,8.0,9.0,12.0,11.0,10.0,12.0,7.0,10.0,12.0,7.0,12.0,8.0,12.0,1.0,26.0,2.0,0.0,8.0,0.0,183.0,79.0,2.0,1.0,1.0,3.0,2.0,1.0,2.0,2.0,3.0,1.0,3.0,12.0,12.0,12.0,11.0,13.0,12.0,7.0,8.0,6.0,7.0,12.0,11.0,7.0,13.0,13.0,12.0,8.0,10.0,10.0,10.0,9.0,11.0,12.0,6.0,14.0,7.0,14.0,13.0,13.0,12.0,13.0,11.0,12.0,12.0,12.0,20.0,13.0,11.0,12.0,12.0,12.0,8.0,14.0,15.0,11.0,10.0,8.0,12.0,11.0,13.0,4.0,29.0,2.0,0.0,18.0,1.0,175.0,71.0,1.0,3.0,3.0,1.0,2.0,3.0,2.0,3.0,1.0,1.0,3.0,13.0,14.0,13.0,10.0,15.0,14.0,8.0,12.0,5.0,5.0,13.0,14.0,6.0,16.0,14.0,10.0,12.0,10.0,10.0,12.0,10.0,6.0,15.0,7.0,9.0,5.0,13.0,14.0,12.0,13.0,12.0,6.0,12.0,8.0,11.0,20.0,13.0,9.0,10.0,11.0,12.0,11.0,12.0,13.0,7.0,11.0,8.0,12.0,7.0,10.0,12.0,32.0,0.0,0.0,0.0,0.0,175.0,70.0,1.0,3.0,3.0,2.0,1.0,3.0,3.0,3.0,1.0,3.0,1.0,13.0,13.0,13.0,8.0,11.0,13.0,7.0,13.0,10.0,6.0,12.0,12.0,10.0,12.0,11.0,12.0,10.0,11.0,11.0,9.0,9.0,13.0,13.0,7.0,12.0,9.0,15.0,15.0,13.0,13.0,12.0,8.0,10.0,14.0,12.0,20.0,14.0,11.0,12.0,9.0,13.0,7.0,8.0,7.0,14.0,12.0,12.0,13.0,12.0,12.0,11.0,25.0,4.0,0.0,0.0,0.0,186.0,83.0,2.0,2.0,2.0,3.0,2.0,1.0,3.0,3.0,4.0,1.0,1.0,14.0,14.0,10.0,9.0,12.0,12.0,11.0,8.0,10.0,10.0,12.0,9.0,10.0,13.0,11.0,10.0,8.0,13.0,8.0,9.0,9.0,9.0,9.0,8.0,10.0,9.0,13.0,13.0,10.0,12.0,13.0,14.0,20.0,8.0,14.0,8.0,14.0,12.0,10.0,10.0,13.0,6.0,12.0,11.0,9.0,10.0,10.0,12.0,14.0,6.0,5.0,30.0,21.0,3.0,13.0,2.0,180.0,72.0,1.0,2.0,2.0,2.0,2.0,2.0,3.0,3.0,2.0,1.0,3.0,15.0,14.0,16.0,11.0,15.0,13.0,8.0,10.0,4.0,4.0,14.0,12.0,7.0,18.0,9.0,13.0,7.0,15.0,7.0,15.0,11.0,8.0,18.0,11.0,11.0,7.0,13.0,10.0,13.0,14.0,7.0,7.0,8.0,11.0,12.0,20.0,12.0,9.0,12.0,10.0,12.0,8.0,16.0,14.0,10.0,8.0,12.0,13.0,6.0,7.0,18.0,32.0,11.0,0.0,0.0,0.0,194.0,88.0,14.0,15.0,14.0,6.0,14.0,11.0,14.0,15.0,14.0,12.0,16.0,1.0,1.0,6.0,1.0,8.0,2.0,8.0,1.0,1.0,1.0,7.0,1.0,11.0,8.0,15.0,13.0,13.0,15.0,14.0,11.0,10.0,14.0,3.0,15.0,3.0,13.0,12.0,13.0,11.0,14.0,16.0,16.0,7.0,14.0,10.0,20.0,13.0,15.0,14.0,6.0,14.0,7.0,1.0,15.0,14.0,15.0,9.0,18.0,10.0,16.0,11.0,35.0,0.0,0.0,0.0,0.0,184.0,83.0,3.0,2.0,3.0,3.0,2.0,3.0,2.0,2.0,1.0,1.0,1.0,4.0,4.0,6.0,6.0,7.0,1.0,12.0,8.0,4.0,11.0,8.0,2.0,10.0,7.0,14.0,9.0,12.0,8.0,11.0,6.0,9.0,13.0,1.0,11.0,6.0,10.0,13.0,11.0,9.0,7.0,13.0,11.0,8.0,14.0,9.0,20.0,12.0,14.0,5.0,8.0,8.0,8.0,8.0,9.0,10.0,12.0,9.0,12.0,3.0,15.0,7.0,28.0,14.0,0.0,15.0,6.0,173.0,70.0,2.0,1.0,1.0,2.0,2.0,2.0,1.0,2.0,1.0,2.0,2.0,12.0,13.0,12.0,13.0,14.0,14.0,11.0,13.0,8.0,7.0,14.0,14.0,9.0,15.0,12.0,12.0,11.0,13.0,13.0,14.0,13.0,12.0,15.0,9.0,14.0,10.0,14.0,14.0,13.0,13.0,12.0,8.0,12.0,14.0,12.0,20.0,12.0,10.0,12.0,14.0,13.0,12.0,14.0,15.0,12.0,9.0,13.0,16.0,13.0,17.0,3.0,28.0,63.0,30.0,0.0,0.0,184.0,82.0,2.0,1.0,1.0,2.0,1.0,3.0,3.0,2.0,1.0,3.0,1.0,8.0,12.0,14.0,20.0,17.0,12.0,13.0,15.0,6.0,5.0,16.0,15.0,7.0,16.0,14.0,18.0,14.0,16.0,14.0,15.0,17.0,16.0,14.0,12.0,18.0,6.0,14.0,14.0,14.0,14.0,14.0,12.0,14.0,13.0,16.0,20.0,15.0,14.0,14.0,13.0,12.0,11.0,12.0,18.0,16.0,11.0,12.0,17.0,16.0,9.0,8.0,29.0,51.0,8.0,0.0,0.0,169.0,61.0,4.0,3.0,1.0,2.0,4.0,1.0,1.0,4.0,3.0,2.0,1.0,14.0,15.0,16.0,14.0,18.0,12.0,7.0,14.0,7.0,6.0,15.0,13.0,7.0,16.0,12.0,13.0,14.0,14.0,13.0,14.0,13.0,15.0,16.0,12.0,17.0,6.0,11.0,13.0,15.0,16.0,12.0,6.0,12.0,13.0,15.0,20.0,12.0,10.0,13.0,10.0,14.0,6.0,13.0,17.0,14.0,13.0,15.0,13.0,6.0,12.0,10.0,24.0,6.0,1.0,24.0,12.0,186.0,81.0,2.0,3.0,1.0,3.0,1.0,1.0,2.0,1.0,3.0,2.0,2.0,13.0,14.0,13.0,15.0,15.0,15.0,14.0,17.0,8.0,5.0,13.0,15.0,7.0,14.0,11.0,13.0,8.0,13.0,14.0,14.0,13.0,13.0,14.0,8.0,15.0,9.0,12.0,12.0,13.0,14.0,14.0,12.0,20.0,12.0,14.0,10.0,14.0,13.0,14.0,10.0,14.0,6.0,12.0,14.0,18.0,13.0,11.0,17.0,15.0,11.0,6.0,25.0,6.0,0.0,0.0,0.0,195.0,89.0,2.0,3.0,1.0,3.0,3.0,3.0,2.0,2.0,3.0,1.0,3.0,6.0,7.0,10.0,6.0,12.0,6.0,16.0,8.0,8.0,16.0,12.0,6.0,16.0,11.0,14.0,16.0,14.0,13.0,10.0,11.0,11.0,16.0,8.0,12.0,9.0,15.0,14.0,16.0,12.0,14.0,18.0,17.0,10.0,14.0,16.0,20.0,16.0,19.0,14.0,13.0,14.0,8.0,10.0,12.0,15.0,11.0,14.0,12.0,14.0,14.0,7.0,25.0,26.0,5.0,0.0,0.0,188.0,80.0,2.0,2.0,2.0,4.0,3.0,2.0,3.0,3.0,2.0,1.0,2.0,13.0,14.0,13.0,6.0,13.0,11.0,11.0,12.0,18.0,12.0,14.0,10.0,15.0,13.0,11.0,13.0,14.0,12.0,12.0,12.0,12.0,15.0,11.0,7.0,14.0,13.0,14.0,17.0,13.0,14.0,15.0,12.0,20.0,15.0,16.0,8.0,17.0,14.0,13.0,12.0,13.0,7.0,14.0,14.0,16.0,12.0,13.0,13.0,12.0,12.0,12.0,30.0,51.0,0.0,8.0,0.0,190.0,82.0,1.0,3.0,3.0,1.0,2.0,2.0,1.0,2.0,3.0,3.0,1.0,7.0,10.0,8.0,9.0,12.0,8.0,14.0,11.0,12.0,16.0,12.0,9.0,15.0,12.0,13.0,15.0,16.0,13.0,13.0,12.0,13.0,13.0,6.0,14.0,9.0,14.0,17.0,16.0,11.0,11.0,16.0,15.0,10.0,14.0,14.0,20.0,16.0,15.0,15.0,13.0,16.0,8.0,13.0,16.0,14.0,14.0,13.0,14.0,12.0,7.0,6.0,31.0,64.0,1.0,0.0,0.0,168.0,65.0,2.0,1.0,2.0,3.0,1.0,2.0,2.0,1.0,2.0,2.0,3.0,11.0,9.0,9.0,7.0,11.0,11.0,6.0,10.0,8.0,13.0,13.0,8.0,16.0,11.0,16.0,12.0,17.0,12.0,11.0,11.0,11.0,16.0,6.0,14.0,10.0,15.0,18.0,18.0,17.0,16.0,14.0,5.0,7.0,18.0,12.0,20.0,18.0,12.0,12.0,11.0,13.0,8.0,5.0,16.0,12.0,11.0,13.0,14.0,13.0,14.0,5.0,32.0,89.0,7.0,3.0,0.0,183.0,80.0,2.0,1.0,3.0,1.0,2.0,3.0,2.0,1.0,4.0,2.0,3.0,7.0,10.0,12.0,11.0,14.0,9.0,12.0,16.0,6.0,13.0,15.0,12.0,14.0,14.0,15.0,13.0,15.0,14.0,12.0,14.0,12.0,15.0,9.0,14.0,8.0,14.0,16.0,13.0,9.0,10.0,15.0,11.0,15.0,13.0,10.0,20.0,12.0,14.0,12.0,13.0,15.0,5.0,8.0,10.0,15.0,16.0,15.0,18.0,20.0,17.0,4.0
3,1,37.0,109.0,0.0,0.0,0.0,187.0,88.0,14.0,10.0,10.0,8.0,13.0,10.0,15.0,13.0,8.0,10.0,13.0,7.0,3.0,1.0,2.0,9.0,10.0,3.0,2.0,1.0,3.0,10.0,4.0,9.0,10.0,14.0,12.0,14.0,13.0,10.0,6.0,10.0,15.0,8.0,12.0,8.0,15.0,12.0,11.0,12.0,17.0,13.0,16.0,8.0,15.0,12.0,20.0,14.0,14.0,8.0,8.0,15.0,6.0,11.0,16.0,15.0,14.0,14.0,16.0,16.0,12.0,5.0,28.0,27.0,1.0,2.0,0.0,183.0,90.0,2.0,1.0,2.0,2.0,3.0,2.0,1.0,2.0,3.0,2.0,1.0,12.0,9.0,7.0,10.0,14.0,12.0,8.0,14.0,7.0,12.0,17.0,14.0,13.0,15.0,13.0,14.0,15.0,14.0,14.0,16.0,18.0,15.0,10.0,10.0,11.0,15.0,16.0,13.0,6.0,8.0,14.0,11.0,12.0,5.0,8.0,20.0,10.0,14.0,14.0,8.0,13.0,19.0,7.0,7.0,15.0,14.0,14.0,6.0,14.0,12.0,15.0,33.0,39.0,3.0,6.0,2.0,180.0,87.0,3.0,1.0,4.0,2.0,1.0,3.0,2.0,3.0,2.0,2.0,3.0,5.0,7.0,6.0,6.0,10.0,5.0,15.0,8.0,10.0,14.0,11.0,14.0,15.0,10.0,10.0,15.0,16.0,14.0,12.0,7.0,17.0,16.0,5.0,15.0,7.0,14.0,14.0,10.0,13.0,10.0,9.0,12.0,8.0,15.0,12.0,20.0,15.0,14.0,12.0,5.0,16.0,1.0,14.0,7.0,14.0,17.0,14.0,16.0,15.0,15.0,1.0,23.0,50.0,14.0,5.0,1.0,191.0,94.0,2.0,1.0,2.0,3.0,1.0,2.0,3.0,1.0,1.0,1.0,2.0,4.0,11.0,13.0,17.0,13.0,12.0,14.0,14.0,6.0,6.0,11.0,16.0,6.0,13.0,10.0,14.0,14.0,15.0,14.0,11.0,12.0,16.0,12.0,12.0,14.0,9.0,14.0,10.0,14.0,10.0,18.0,16.0,20.0,17.0,16.0,11.0,13.0,19.0,14.0,6.0,14.0,7.0,6.0,11.0,18.0,14.0,18.0,18.0,15.0,12.0,8.0,28.0,50.0,9.0,5.0,2.0,182.0,69.0,3.0,4.0,3.0,1.0,3.0,2.0,1.0,3.0,3.0,1.0,2.0,12.0,13.0,14.0,13.0,14.0,16.0,8.0,12.0,4.0,5.0,13.0,10.0,5.0,14.0,13.0,14.0,11.0,13.0,13.0,13.0,10.0,12.0,13.0,6.0,15.0,5.0,7.0,11.0,16.0,14.0,13.0,8.0,12.0,13.0,14.0,20.0,12.0,11.0,10.0,15.0,12.0,5.0,6.0,12.0,18.0,11.0,11.0,10.0,8.0,12.0,12.0,29.0,43.0,6.0,15.0,6.0,178.0,73.0,2.0,2.0,2.0,1.0,2.0,2.0,3.0,2.0,3.0,1.0,1.0,11.0,12.0,11.0,13.0,12.0,6.0,14.0,12.0,6.0,7.0,11.0,17.0,7.0,14.0,14.0,14.0,14.0,13.0,14.0,13.0,13.0,18.0,9.0,12.0,16.0,10.0,15.0,14.0,12.0,12.0,13.0,9.0,9.0,16.0,12.0,20.0,13.0,13.0,12.0,7.0,13.0,9.0,15.0,10.0,15.0,15.0,12.0,11.0,12.0,10.0,8.0,25.0,39.0,0.0,7.0,1.0,180.0,72.0,3.0,3.0,2.0,1.0,1.0,2.0,3.0,2.0,1.0,1.0,1.0,8.0,9.0,9.0,9.0,11.0,5.0,13.0,9.0,4.0,16.0,13.0,8.0,18.0,10.0,14.0,14.0,16.0,12.0,13.0,10.0,15.0,14.0,6.0,10.0,8.0,15.0,16.0,17.0,12.0,12.0,14.0,10.0,10.0,14.0,13.0,20.0,17.0,14.0,14.0,11.0,13.0,8.0,14.0,12.0,5.0,16.0,14.0,15.0,10.0,10.0,17.0,35.0,53.0,3.0,27.0,2.0,183.0,78.0,1.0,2.0,2.0,3.0,1.0,1.0,3.0,2.0,3.0,2.0,3.0,10.0,13.0,8.0,11.0,14.0,12.0,12.0,10.0,8.0,14.0,16.0,12.0,14.0,15.0,14.0,16.0,14.0,17.0,15.0,11.0,14.0,15.0,8.0,16.0,11.0,17.0,18.0,14.0,8.0,9.0,12.0,11.0,20.0,15.0,9.0,12.0,11.0,14.0,15.0,16.0,14.0,4.0,15.0,2.0,12.0,13.0,13.0,15.0,12.0,14.0,2.0,27.0,38.0,0.0,13.0,1.0,178.0,67.0,3.0,3.0,4.0,1.0,1.0,2.0,3.0,2.0,1.0,3.0,2.0,5.0,13.0,14.0,10.0,12.0,8.0,14.0,13.0,12.0,12.0,12.0,7.0,14.0,12.0,14.0,14.0,15.0,13.0,13.0,8.0,13.0,16.0,11.0,10.0,13.0,13.0,15.0,15.0,15.0,12.0,15.0,10.0,9.0,14.0,14.0,20.0,17.0,14.0,12.0,11.0,12.0,7.0,10.0,10.0,13.0,18.0,12.0,15.0,15.0,12.0,7.0,23.0,0.0,0.0,11.0,0.0,180.0,73.0,3.0,2.0,2.0,2.0,3.0,3.0,3.0,3.0,1.0,1.0,3.0,13.0,14.0,12.0,6.0,12.0,13.0,10.0,8.0,10.0,12.0,13.0,12.0,12.0,13.0,9.0,10.0,8.0,13.0,11.0,11.0,12.0,13.0,9.0,7.0,12.0,13.0,12.0,14.0,14.0,12.0,11.0,9.0,20.0,14.0,14.0,8.0,13.0,9.0,11.0,7.0,11.0,5.0,13.0,10.0,14.0,11.0,11.0,12.0,12.0,12.0,8.0,33.0,24.0,2.0,0.0,0.0,187.0,82.0,1.0,2.0,4.0,2.0,2.0,1.0,3.0,2.0,2.0,2.0,3.0,9.0,7.0,8.0,7.0,12.0,9.0,15.0,7.0,11.0,16.0,12.0,8.0,15.0,11.0,15.0,16.0,15.0,14.0,12.0,6.0,14.0,15.0,5.0,15.0,7.0,14.0,15.0,15.0,8.0,8.0,13.0,13.0,10.0,6.0,8.0,20.0,8.0,16.0,13.0,14.0,12.0,14.0,5.0,12.0,15.0,12.0,13.0,14.0,9.0,10.0,12.0,33.0,11.0,0.0,24.0,0.0,186.0,88.0,12.0,12.0,14.0,11.0,13.0,13.0,13.0,14.0,13.0,9.0,13.0,8.0,2.0,1.0,3.0,3.0,11.0,2.0,2.0,3.0,1.0,3.0,4.0,1.0,6.0,12.0,15.0,13.0,10.0,12.0,12.0,14.0,10.0,1.0,13.0,6.0,12.0,13.0,11.0,9.0,13.0,13.0,15.0,8.0,7.0,10.0,20.0,7.0,15.0,13.0,12.0,8.0,5.0,11.0,14.0,12.0,18.0,7.0,16.0,18.0,6.0,13.0,29.0,3.0,0.0,4.0,1.0,190.0,85.0,1.0,3.0,1.0,3.0,4.0,2.0,1.0,1.0,3.0,1.0,3.0,5.0,7.0,6.0,6.0,10.0,5.0,14.0,9.0,10.0,13.0,10.0,12.0,13.0,8.0,12.0,14.0,13.0,11.0,9.0,8.0,10.0,13.0,9.0,12.0,9.0,13.0,13.0,12.0,11.0,10.0,12.0,14.0,10.0,12.0,12.0,20.0,13.0,14.0,12.0,11.0,12.0,7.0,10.0,10.0,12.0,12.0,11.0,7.0,10.0,7.0,12.0,22.0,0.0,0.0,11.0,1.0,179.0,72.0,4.0,3.0,1.0,1.0,3.0,2.0,4.0,1.0,2.0,2.0,1.0,9.0,10.0,11.0,9.0,13.0,13.0,12.0,10.0,11.0,13.0,14.0,10.0,12.0,13.0,13.0,10.0,13.0,9.0,14.0,12.0,13.0,10.0,8.0,8.0,11.0,13.0,14.0,14.0,11.0,13.0,14.0,8.0,12.0,11.0,12.0,20.0,14.0,8.0,9.0,12.0,8.0,10.0,12.0,15.0,12.0,14.0,8.0,11.0,10.0,9.0,11.0,25.0,0.0,0.0,27.0,1.0,185.0,81.0,1.0,3.0,3.0,3.0,2.0,4.0,4.0,2.0,2.0,3.0,3.0,11.0,14.0,11.0,7.0,12.0,11.0,10.0,13.0,14.0,10.0,12.0,13.0,12.0,12.0,12.0,13.0,13.0,11.0,9.0,12.0,10.0,13.0,10.0,10.0,11.0,9.0,14.0,13.0,14.0,14.0,13.0,12.0,20.0,12.0,14.0,8.0,14.0,12.0,14.0,8.0,10.0,6.0,12.0,14.0,11.0,10.0,8.0,13.0,12.0,11.0,10.0,31.0,0.0,0.0,0.0,0.0,182.0,76.0,3.0,2.0,3.0,3.0,1.0,3.0,2.0,2.0,3.0,3.0,1.0,8.0,10.0,13.0,9.0,13.0,10.0,9.0,12.0,5.0,5.0,14.0,12.0,8.0,14.0,8.0,13.0,10.0,13.0,12.0,10.0,11.0,9.0,15.0,7.0,14.0,7.0,9.0,7.0,12.0,13.0,10.0,13.0,20.0,13.0,12.0,15.0,10.0,9.0,8.0,14.0,14.0,13.0,12.0,8.0,11.0,9.0,12.0,11.0,6.0,5.0,14.0,33.0,1.0,0.0,42.0,2.0,182.0,78.0,1.0,2.0,3.0,2.0,3.0,1.0,2.0,2.0,2.0,1.0,2.0,10.0,10.0,8.0,7.0,10.0,7.0,13.0,11.0,17.0,13.0,12.0,10.0,14.0,11.0,13.0,12.0,13.0,12.0,11.0,8.0,10.0,13.0,7.0,13.0,7.0,13.0,16.0,16.0,13.0,13.0,13.0,11.0,20.0,14.0,14.0,5.0,14.0,14.0,9.0,8.0,7.0,7.0,13.0,7.0,15.0,15.0,7.0,8.0,15.0,14.0,3.0,30.0,2.0,0.0,2.0,0.0,181.0,78.0,1.0,1.0,1.0,2.0,3.0,2.0,2.0,1.0,2.0,2.0,1.0,8.0,13.0,10.0,8.0,12.0,7.0,12.0,9.0,12.0,12.0,13.0,9.0,13.0,13.0,10.0,9.0,11.0,12.0,13.0,9.0,11.0,12.0,10.0,13.0,13.0,12.0,11.0,10.0,13.0,12.0,13.0,11.0,11.0,14.0,13.0,20.0,13.0,11.0,12.0,13.0,10.0,11.0,13.0,13.0,12.0,13.0,10.0,10.0,12.0,16.0,13.0,32.0,0.0,0.0,0.0,0.0,175.0,75.0,1.0,2.0,2.0,2.0,1.0,1.0,2.0,3.0,2.0,2.0,3.0,11.0,12.0,13.0,9.0,13.0,9.0,7.0,11.0,6.0,8.0,11.0,5.0,8.0,13.0,13.0,12.0,11.0,12.0,9.0,10.0,12.0,13.0,13.0,11.0,13.0,9.0,14.0,13.0,13.0,13.0,7.0,7.0,20.0,11.0,12.0,10.0,11.0,6.0,12.0,8.0,10.0,8.0,14.0,7.0,10.0,16.0,10.0,16.0,13.0,8.0,5.0,22.0,0.0,0.0,8.0,5.0,178.0,72.0,1.0,1.0,1.0,1.0,3.0,2.0,1.0,1.0,1.0,3.0,1.0,7.0,8.0,13.0,12.0,14.0,11.0,6.0,13.0,2.0,4.0,13.0,9.0,5.0,14.0,8.0,11.0,6.0,11.0,11.0,12.0,9.0,9.0,14.0,5.0,12.0,6.0,11.0,13.0,15.0,16.0,6.0,6.0,16.0,13.0,14.0,20.0,10.0,6.0,7.0,11.0,7.0,11.0,11.0,14.0,11.0,13.0,7.0,13.0,13.0,16.0,3.0,27.0,0.0,0.0,0.0,0.0,182.0,80.0,1.0,4.0,4.0,1.0,1.0,2.0,3.0,3.0,2.0,3.0,2.0,8.0,9.0,9.0,6.0,12.0,8.0,7.0,13.0,11.0,13.0,12.0,7.0,15.0,13.0,16.0,12.0,17.0,9.0,13.0,12.0,12.0,12.0,7.0,8.0,9.0,12.0,15.0,16.0,12.0,14.0,16.0,11.0,20.0,13.0,13.0,4.0,16.0,15.0,12.0,13.0,10.0,13.0,11.0,19.0,13.0,10.0,8.0,14.0,9.0,10.0,7.0,32.0,5.0,0.0,0.0,0.0,192.0,80.0,2.0,3.0,2.0,1.0,1.0,2.0,1.0,2.0,1.0,2.0,2.0,6.0,9.0,11.0,16.0,12.0,8.0,17.0,12.0,5.0,10.0,13.0,15.0,9.0,12.0,12.0,15.0,15.0,15.0,12.0,11.0,14.0,13.0,11.0,9.0,16.0,11.0,14.0,10.0,10.0,9.0,17.0,16.0,10.0,12.0,11.0,20.0,15.0,16.0,14.0,9.0,15.0,13.0,5.0,8.0,14.0,13.0,10.0,17.0,16.0,11.0,5.0
2,0,30.0,0.0,0.0,0.0,0.0,185.0,85.0,2.0,1.0,1.0,2.0,3.0,1.0,3.0,3.0,3.0,2.0,3.0,8.0,6.0,6.0,4.0,10.0,4.0,12.0,8.0,2.0,11.0,10.0,2.0,13.0,8.0,9.0,12.0,10.0,9.0,9.0,12.0,10.0,9.0,1.0,11.0,7.0,15.0,13.0,10.0,13.0,9.0,9.0,13.0,3.0,13.0,9.0,20.0,9.0,13.0,9.0,6.0,6.0,9.0,9.0,12.0,10.0,12.0,9.0,12.0,13.0,5.0,5.0,28.0,13.0,1.0,15.0,3.0,181.0,83.0,1.0,2.0,1.0,2.0,1.0,3.0,1.0,3.0,1.0,3.0,3.0,3.0,10.0,10.0,6.0,10.0,5.0,15.0,4.0,15.0,12.0,10.0,5.0,13.0,9.0,14.0,11.0,18.0,10.0,10.0,6.0,12.0,9.0,4.0,11.0,10.0,12.0,10.0,13.0,12.0,11.0,14.0,14.0,8.0,16.0,13.0,20.0,13.0,17.0,9.0,8.0,12.0,19.0,16.0,8.0,10.0,15.0,11.0,9.0,13.0,11.0,10.0,27.0,24.0,1.0,14.0,0.0,186.0,76.0,1.0,1.0,1.0,3.0,1.0,1.0,1.0,1.0,3.0,2.0,3.0,8.0,13.0,13.0,9.0,15.0,10.0,13.0,11.0,7.0,13.0,16.0,11.0,15.0,15.0,11.0,15.0,12.0,15.0,10.0,14.0,13.0,12.0,14.0,13.0,9.0,13.0,16.0,13.0,12.0,13.0,14.0,12.0,12.0,13.0,13.0,20.0,15.0,13.0,13.0,12.0,8.0,7.0,12.0,12.0,12.0,8.0,12.0,15.0,16.0,19.0,2.0,36.0,46.0,2.0,0.0,0.0,170.0,65.0,3.0,3.0,2.0,3.0,1.0,3.0,3.0,3.0,1.0,1.0,3.0,15.0,13.0,14.0,10.0,16.0,14.0,6.0,12.0,7.0,11.0,16.0,13.0,13.0,16.0,14.0,14.0,15.0,13.0,13.0,16.0,14.0,15.0,14.0,14.0,11.0,13.0,16.0,8.0,9.0,8.0,11.0,5.0,12.0,7.0,9.0,20.0,7.0,9.0,14.0,14.0,13.0,18.0,10.0,12.0,13.0,13.0,14.0,15.0,12.0,5.0,13.0,16.0,0.0,0.0,0.0,0.0,175.0,0.0,7.0,9.0,7.0,10.0,10.0,4.0,3.0,10.0,14.0,6.0,4.0,3.0,3.0,1.0,2.0,1.0,5.0,1.0,1.0,3.0,3.0,1.0,1.0,3.0,3.0,7.0,4.0,11.0,4.0,5.0,4.0,9.0,8.0,1.0,5.0,3.0,7.0,6.0,9.0,12.0,6.0,8.0,8.0,9.0,13.0,11.0,20.0,5.0,4.0,11.0,8.0,11.0,3.0,3.0,11.0,15.0,5.0,10.0,9.0,10.0,3.0,7.0,22.0,0.0,0.0,0.0,0.0,174.0,70.0,2.0,1.0,2.0,1.0,2.0,2.0,3.0,2.0,2.0,2.0,3.0,13.0,12.0,13.0,9.0,13.0,8.0,6.0,8.0,3.0,3.0,12.0,6.0,3.0,13.0,10.0,10.0,8.0,9.0,6.0,11.0,9.0,8.0,14.0,3.0,12.0,6.0,8.0,8.0,14.0,15.0,8.0,8.0,20.0,8.0,14.0,15.0,8.0,8.0,8.0,8.0,1.0,6.0,11.0,13.0,9.0,12.0,10.0,12.0,12.0,14.0,13.0,28.0,0.0,0.0,0.0,0.0,182.0,71.0,3.0,4.0,2.0,3.0,2.0,1.0,4.0,1.0,2.0,4.0,1.0,2.0,5.0,2.0,3.0,7.0,5.0,11.0,3.0,8.0,10.0,7.0,5.0,11.0,5.0,10.0,10.0,10.0,11.0,13.0,4.0,10.0,9.0,1.0,5.0,2.0,11.0,12.0,10.0,9.0,10.0,10.0,11.0,9.0,11.0,9.0,20.0,12.0,15.0,10.0,5.0,9.0,3.0,8.0,13.0,11.0,10.0,12.0,14.0,11.0,18.0,7.0,32.0,12.0,0.0,0.0,0.0,188.0,78.0,2.0,1.0,3.0,3.0,3.0,2.0,3.0,1.0,1.0,3.0,1.0,3.0,6.0,11.0,8.0,11.0,3.0,15.0,6.0,9.0,15.0,11.0,5.0,16.0,12.0,13.0,15.0,14.0,13.0,14.0,10.0,13.0,15.0,9.0,14.0,7.0,15.0,13.0,14.0,12.0,14.0,15.0,14.0,20.0,15.0,14.0,10.0,15.0,14.0,15.0,12.0,14.0,8.0,10.0,14.0,13.0,13.0,13.0,14.0,14.0,13.0,4.0,25.0,0.0,0.0,0.0,0.0,188.0,81.0,1.0,3.0,3.0,1.0,3.0,2.0,2.0,3.0,4.0,1.0,1.0,14.0,15.0,12.0,10.0,13.0,15.0,12.0,14.0,12.0,13.0,14.0,12.0,14.0,13.0,12.0,14.0,12.0,14.0,12.0,13.0,13.0,13.0,12.0,9.0,14.0,13.0,13.0,14.0,12.0,12.0,15.0,13.0,20.0,14.0,13.0,9.0,16.0,15.0,14.0,9.0,13.0,7.0,13.0,13.0,14.0,12.0,13.0,14.0,13.0,12.0,10.0,30.0,0.0,0.0,0.0,0.0,174.0,70.0,3.0,3.0,2.0,3.0,3.0,1.0,2.0,2.0,1.0,2.0,1.0,10.0,9.0,12.0,10.0,11.0,13.0,9.0,9.0,5.0,10.0,9.0,10.0,7.0,12.0,10.0,12.0,11.0,11.0,11.0,11.0,12.0,11.0,10.0,10.0,12.0,11.0,11.0,12.0,11.0,10.0,11.0,10.0,20.0,13.0,11.0,11.0,11.0,10.0,12.0,3.0,10.0,10.0,15.0,11.0,11.0,11.0,9.0,12.0,8.0,11.0,10.0,24.0,42.0,25.0,11.0,4.0,175.0,72.0,3.0,3.0,3.0,4.0,1.0,3.0,1.0,1.0,2.0,3.0,3.0,6.0,12.0,16.0,15.0,16.0,6.0,5.0,12.0,3.0,4.0,12.0,11.0,6.0,15.0,8.0,16.0,7.0,13.0,11.0,12.0,13.0,13.0,17.0,5.0,17.0,7.0,10.0,10.0,18.0,17.0,11.0,6.0,20.0,14.0,18.0,9.0,14.0,8.0,14.0,4.0,16.0,6.0,14.0,15.0,17.0,10.0,14.0,11.0,10.0,14.0,9.0,29.0,82.0,0.0,8.0,0.0,188.0,78.0,12.0,12.0,14.0,14.0,17.0,8.0,15.0,18.0,17.0,18.0,11.0,5.0,2.0,3.0,2.0,11.0,10.0,1.0,9.0,3.0,7.0,10.0,1.0,13.0,8.0,10.0,14.0,18.0,14.0,16.0,9.0,16.0,15.0,6.0,16.0,3.0,17.0,14.0,8.0,15.0,17.0,15.0,15.0,20.0,15.0,14.0,6.0,15.0,14.0,15.0,10.0,15.0,5.0,1.0,14.0,15.0,17.0,18.0,17.0,18.0,18.0,4.0,29.0,82.0,6.0,0.0,0.0,189.0,79.0,3.0,1.0,3.0,3.0,2.0,3.0,3.0,1.0,2.0,2.0,4.0,7.0,7.0,13.0,8.0,13.0,11.0,14.0,9.0,12.0,14.0,14.0,8.0,16.0,14.0,9.0,14.0,14.0,18.0,13.0,14.0,15.0,16.0,13.0,12.0,10.0,14.0,15.0,15.0,13.0,14.0,13.0,15.0,20.0,12.0,12.0,10.0,16.0,16.0,14.0,10.0,13.0,11.0,12.0,13.0,17.0,13.0,16.0,8.0,9.0,9.0,10.0,26.0,32.0,0.0,3.0,0.0,184.0,75.0,3.0,1.0,3.0,2.0,3.0,1.0,3.0,3.0,2.0,1.0,2.0,5.0,11.0,12.0,8.0,13.0,8.0,14.0,7.0,7.0,14.0,12.0,10.0,15.0,11.0,11.0,16.0,12.0,15.0,10.0,14.0,13.0,15.0,14.0,14.0,8.0,14.0,14.0,14.0,11.0,11.0,14.0,13.0,15.0,16.0,13.0,20.0,14.0,14.0,13.0,6.0,17.0,3.0,15.0,16.0,15.0,13.0,13.0,15.0,14.0,10.0,3.0,31.0,12.0,7.0,9.0,6.0,179.0,72.0,2.0,2.0,1.0,3.0,3.0,3.0,2.0,2.0,2.0,2.0,1.0,7.0,11.0,12.0,14.0,11.0,13.0,14.0,12.0,6.0,6.0,13.0,16.0,8.0,13.0,16.0,14.0,15.0,12.0,14.0,13.0,14.0,16.0,14.0,15.0,15.0,10.0,14.0,15.0,14.0,15.0,14.0,10.0,15.0,15.0,15.0,20.0,15.0,12.0,14.0,15.0,3.0,7.0,11.0,8.0,15.0,15.0,6.0,18.0,7.0,7.0,8.0,24.0,22.0,3.0,0.0,0.0,183.0,79.0,4.0,1.0,1.0,2.0,3.0,3.0,3.0,2.0,3.0,3.0,2.0,15.0,12.0,14.0,13.0,15.0,14.0,6.0,13.0,4.0,4.0,14.0,13.0,10.0,17.0,15.0,14.0,11.0,14.0,10.0,14.0,12.0,14.0,16.0,5.0,15.0,9.0,10.0,16.0,16.0,15.0,14.0,10.0,20.0,17.0,14.0,9.0,16.0,11.0,13.0,13.0,12.0,10.0,16.0,4.0,14.0,12.0,11.0,14.0,9.0,11.0,7.0,29.0,3.0,0.0,13.0,1.0,195.0,85.0,2.0,2.0,3.0,1.0,1.0,1.0,3.0,3.0,3.0,1.0,2.0,4.0,5.0,8.0,7.0,13.0,6.0,19.0,8.0,5.0,16.0,14.0,8.0,15.0,13.0,13.0,16.0,15.0,13.0,13.0,11.0,12.0,13.0,13.0,15.0,8.0,15.0,15.0,14.0,9.0,10.0,11.0,19.0,9.0,9.0,11.0,20.0,14.0,17.0,12.0,14.0,10.0,13.0,15.0,13.0,12.0,13.0,12.0,14.0,14.0,13.0,11.0,26.0,31.0,3.0,0.0,0.0,187.0,80.0,3.0,2.0,3.0,1.0,1.0,1.0,3.0,1.0,3.0,2.0,3.0,12.0,13.0,15.0,14.0,15.0,12.0,13.0,13.0,5.0,4.0,15.0,12.0,9.0,15.0,10.0,12.0,12.0,14.0,12.0,15.0,12.0,15.0,14.0,6.0,14.0,10.0,12.0,13.0,13.0,14.0,13.0,14.0,15.0,12.0,15.0,20.0,14.0,14.0,10.0,4.0,12.0,8.0,12.0,8.0,14.0,13.0,13.0,17.0,15.0,15.0,6.0,24.0,61.0,9.0,3.0,1.0,177.0,71.0,2.0,1.0,1.0,2.0,2.0,3.0,1.0,1.0,3.0,1.0,3.0,13.0,15.0,13.0,13.0,16.0,17.0,7.0,12.0,3.0,4.0,16.0,11.0,3.0,18.0,5.0,14.0,7.0,15.0,12.0,17.0,16.0,14.0,13.0,8.0,16.0,4.0,13.0,16.0,14.0,16.0,12.0,7.0,16.0,15.0,13.0,20.0,15.0,11.0,15.0,4.0,12.0,6.0,15.0,17.0,17.0,18.0,16.0,15.0,18.0,17.0,4.0,25.0,0.0,0.0,14.0,0.0,180.0,82.0,1.0,3.0,3.0,1.0,3.0,2.0,3.0,1.0,1.0,3.0,1.0,5.0,10.0,10.0,7.0,13.0,7.0,12.0,8.0,10.0,14.0,12.0,8.0,17.0,13.0,13.0,16.0,16.0,14.0,15.0,10.0,12.0,15.0,8.0,13.0,10.0,14.0,18.0,15.0,10.0,12.0,16.0,11.0,10.0,15.0,12.0,20.0,16.0,15.0,17.0,10.0,16.0,6.0,10.0,12.0,16.0,12.0,13.0,17.0,14.0,14.0,5.0,23.0,25.0,0.0,0.0,0.0,181.0,77.0,1.0,2.0,3.0,1.0,2.0,2.0,3.0,1.0,3.0,2.0,3.0,13.0,15.0,12.0,6.0,14.0,14.0,14.0,6.0,11.0,14.0,14.0,10.0,14.0,13.0,13.0,15.0,18.0,15.0,13.0,14.0,14.0,17.0,9.0,6.0,13.0,15.0,14.0,15.0,13.0,13.0,15.0,10.0,20.0,13.0,11.0,8.0,14.0,14.0,15.0,6.0,9.0,5.0,11.0,10.0,13.0,14.0,9.0,15.0,13.0,12.0,4.0,21.0,19.0,3.0,0.0,0.0,187.0,78.0,3.0,2.0,3.0,1.0,1.0,1.0,1.0,1.0,1.0,2.0,3.0,9.0,12.0,13.0,10.0,15.0,10.0,9.0,12.0,9.0,11.0,14.0,10.0,13.0,16.0,17.0,14.0,16.0,16.0,11.0,14.0,11.0,17.0,13.0,10.0,14.0,12.0,12.0,17.0,12.0,13.0,15.0,14.0,20.0,14.0,12.0,12.0,17.0,13.0,12.0,13.0,13.0,11.0,8.0,14.0,16.0,10.0,13.0,12.0,14.0,10.0,12.0
1,0,28.0,2.0,0.0,5.0,0.0,190.0,84.0,13.0,9.0,11.0,9.0,12.0,13.0,13.0,18.0,14.0,15.0,13.0,7.0,2.0,1.0,3.0,9.0,11.0,5.0,2.0,2.0,1.0,8.0,6.0,3.0,9.0,13.0,10.0,16.0,17.0,10.0,6.0,9.0,10.0,5.0,11.0,4.0,10.0,12.0,13.0,12.0,15.0,12.0,15.0,10.0,14.0,13.0,20.0,13.0,12.0,13.0,4.0,11.0,7.0,11.0,18.0,9.0,12.0,10.0,13.0,15.0,15.0,3.0,28.0,6.0,0.0,8.0,0.0,184.0,79.0,3.0,2.0,1.0,4.0,3.0,3.0,3.0,3.0,3.0,3.0,2.0,11.0,12.0,7.0,7.0,11.0,8.0,10.0,10.0,10.0,13.0,11.0,9.0,15.0,12.0,14.0,12.0,13.0,12.0,15.0,8.0,13.0,8.0,7.0,10.0,10.0,15.0,15.0,12.0,9.0,9.0,12.0,11.0,12.0,7.0,11.0,20.0,11.0,12.0,15.0,10.0,10.0,8.0,12.0,9.0,8.0,15.0,11.0,13.0,12.0,13.0,6.0,30.0,0.0,0.0,0.0,0.0,183.0,90.0,3.0,2.0,2.0,3.0,2.0,2.0,1.0,3.0,2.0,2.0,2.0,7.0,8.0,8.0,9.0,12.0,7.0,13.0,10.0,2.0,8.0,12.0,5.0,8.0,11.0,9.0,11.0,7.0,12.0,12.0,8.0,9.0,2.0,9.0,13.0,13.0,8.0,7.0,8.0,14.0,11.0,14.0,10.0,5.0,13.0,9.0,20.0,9.0,14.0,9.0,5.0,9.0,7.0,9.0,15.0,11.0,11.0,12.0,12.0,3.0,7.0,1.0,24.0,26.0,0.0,2.0,0.0,176.0,70.0,2.0,3.0,1.0,1.0,3.0,2.0,2.0,1.0,2.0,1.0,1.0,15.0,16.0,16.0,10.0,15.0,12.0,5.0,12.0,8.0,2.0,13.0,9.0,5.0,16.0,13.0,11.0,11.0,12.0,9.0,12.0,10.0,10.0,18.0,4.0,11.0,7.0,9.0,11.0,15.0,15.0,15.0,8.0,20.0,13.0,14.0,16.0,12.0,11.0,3.0,13.0,14.0,6.0,12.0,10.0,8.0,8.0,8.0,9.0,7.0,6.0,16.0,27.0,31.0,1.0,18.0,1.0,178.0,68.0,2.0,1.0,2.0,2.0,3.0,3.0,1.0,3.0,4.0,4.0,1.0,8.0,8.0,8.0,8.0,11.0,7.0,10.0,12.0,4.0,14.0,12.0,10.0,14.0,10.0,19.0,12.0,19.0,8.0,16.0,10.0,10.0,14.0,8.0,10.0,10.0,10.0,17.0,17.0,11.0,11.0,12.0,9.0,17.0,7.0,12.0,20.0,14.0,12.0,14.0,13.0,12.0,15.0,10.0,11.0,12.0,16.0,12.0,18.0,11.0,13.0,5.0,31.0,17.0,5.0,0.0,0.0,189.0,85.0,3.0,1.0,1.0,2.0,1.0,3.0,1.0,1.0,4.0,3.0,3.0,6.0,10.0,13.0,15.0,14.0,12.0,15.0,13.0,3.0,5.0,13.0,12.0,7.0,14.0,13.0,16.0,17.0,16.0,15.0,12.0,15.0,14.0,16.0,4.0,15.0,9.0,9.0,12.0,12.0,14.0,16.0,14.0,10.0,7.0,13.0,20.0,13.0,16.0,11.0,7.0,13.0,11.0,8.0,12.0,15.0,8.0,14.0,13.0,10.0,12.0,12.0,29.0,26.0,2.0,0.0,0.0,179.0,71.0,2.0,3.0,2.0,3.0,1.0,2.0,3.0,1.0,1.0,1.0,2.0,8.0,10.0,12.0,13.0,13.0,8.0,8.0,10.0,6.0,8.0,12.0,9.0,10.0,13.0,13.0,16.0,9.0,10.0,13.0,10.0,13.0,13.0,12.0,13.0,17.0,12.0,16.0,16.0,13.0,13.0,9.0,9.0,11.0,14.0,13.0,20.0,15.0,9.0,13.0,8.0,16.0,3.0,18.0,14.0,16.0,16.0,11.0,15.0,10.0,14.0,5.0,33.0,75.0,6.0,19.0,0.0,187.0,83.0,2.0,3.0,3.0,1.0,2.0,3.0,1.0,3.0,1.0,1.0,3.0,7.0,7.0,10.0,5.0,12.0,5.0,12.0,6.0,10.0,12.0,12.0,8.0,13.0,13.0,9.0,18.0,9.0,12.0,18.0,8.0,15.0,12.0,6.0,14.0,10.0,18.0,20.0,17.0,12.0,15.0,15.0,14.0,8.0,18.0,14.0,20.0,16.0,13.0,19.0,3.0,16.0,3.0,18.0,16.0,12.0,18.0,16.0,19.0,16.0,17.0,4.0,25.0,4.0,0.0,14.0,2.0,183.0,73.0,1.0,3.0,1.0,3.0,3.0,2.0,2.0,2.0,2.0,3.0,4.0,6.0,9.0,7.0,6.0,14.0,6.0,13.0,8.0,7.0,13.0,14.0,8.0,14.0,13.0,9.0,15.0,10.0,16.0,15.0,13.0,13.0,10.0,11.0,12.0,10.0,15.0,16.0,8.0,11.0,11.0,11.0,10.0,9.0,10.0,12.0,20.0,11.0,11.0,17.0,12.0,4.0,4.0,9.0,7.0,12.0,15.0,13.0,14.0,15.0,14.0,6.0,25.0,1.0,0.0,17.0,0.0,180.0,72.0,3.0,1.0,3.0,2.0,2.0,2.0,3.0,3.0,1.0,2.0,3.0,7.0,8.0,10.0,5.0,11.0,5.0,9.0,6.0,9.0,14.0,11.0,10.0,15.0,11.0,19.0,13.0,18.0,10.0,15.0,8.0,10.0,12.0,5.0,13.0,9.0,12.0,17.0,19.0,12.0,12.0,16.0,9.0,10.0,13.0,13.0,20.0,15.0,14.0,17.0,15.0,10.0,6.0,12.0,18.0,12.0,18.0,10.0,14.0,10.0,11.0,3.0,25.0,17.0,0.0,2.0,0.0,175.0,74.0,1.0,2.0,1.0,3.0,2.0,1.0,2.0,2.0,4.0,2.0,2.0,8.0,14.0,13.0,7.0,11.0,5.0,8.0,10.0,14.0,9.0,10.0,6.0,13.0,12.0,16.0,8.0,14.0,9.0,8.0,9.0,7.0,14.0,13.0,10.0,12.0,10.0,12.0,16.0,16.0,15.0,13.0,9.0,8.0,18.0,17.0,20.0,15.0,11.0,12.0,14.0,12.0,11.0,13.0,15.0,18.0,12.0,12.0,11.0,8.0,7.0,13.0,28.0,17.0,0.0,9.0,0.0,193.0,88.0,14.0,11.0,12.0,8.0,15.0,14.0,15.0,18.0,13.0,13.0,13.0,7.0,3.0,1.0,3.0,10.0,10.0,4.0,3.0,1.0,1.0,10.0,5.0,1.0,8.0,10.0,15.0,14.0,14.0,14.0,10.0,12.0,14.0,1.0,5.0,2.0,15.0,11.0,10.0,11.0,16.0,13.0,14.0,6.0,14.0,11.0,20.0,13.0,14.0,12.0,1.0,13.0,4.0,12.0,16.0,15.0,15.0,13.0,15.0,16.0,14.0,3.0,35.0,118.0,7.0,0.0,0.0,183.0,77.0,3.0,1.0,3.0,3.0,2.0,2.0,3.0,2.0,4.0,2.0,1.0,4.0,10.0,12.0,7.0,13.0,6.0,15.0,8.0,8.0,15.0,9.0,9.0,15.0,12.0,15.0,14.0,14.0,12.0,14.0,6.0,13.0,18.0,9.0,13.0,7.0,14.0,13.0,13.0,10.0,9.0,12.0,11.0,11.0,9.0,9.0,20.0,10.0,13.0,13.0,7.0,13.0,9.0,13.0,18.0,15.0,15.0,15.0,17.0,17.0,16.0,9.0,26.0,31.0,2.0,19.0,3.0,190.0,84.0,1.0,3.0,1.0,3.0,3.0,3.0,3.0,2.0,2.0,3.0,3.0,2.0,7.0,11.0,7.0,13.0,7.0,16.0,6.0,7.0,15.0,14.0,9.0,17.0,13.0,16.0,15.0,17.0,13.0,13.0,12.0,14.0,16.0,9.0,12.0,10.0,15.0,13.0,14.0,13.0,13.0,14.0,15.0,11.0,13.0,13.0,20.0,14.0,15.0,13.0,13.0,14.0,12.0,5.0,12.0,15.0,13.0,11.0,13.0,10.0,12.0,9.0,26.0,21.0,6.0,15.0,4.0,183.0,79.0,1.0,2.0,1.0,2.0,1.0,3.0,1.0,3.0,1.0,3.0,1.0,7.0,12.0,15.0,16.0,16.0,10.0,11.0,13.0,3.0,7.0,13.0,13.0,7.0,16.0,12.0,15.0,11.0,15.0,14.0,14.0,13.0,11.0,15.0,4.0,16.0,5.0,12.0,12.0,14.0,17.0,16.0,11.0,20.0,10.0,13.0,13.0,14.0,13.0,15.0,5.0,15.0,14.0,9.0,13.0,18.0,13.0,13.0,14.0,13.0,16.0,8.0,23.0,3.0,0.0,10.0,0.0,171.0,64.0,1.0,3.0,2.0,2.0,1.0,1.0,1.0,4.0,2.0,1.0,2.0,7.0,13.0,13.0,7.0,14.0,9.0,7.0,14.0,9.0,11.0,13.0,7.0,15.0,14.0,14.0,13.0,14.0,13.0,11.0,12.0,12.0,15.0,12.0,7.0,14.0,10.0,15.0,16.0,16.0,15.0,14.0,8.0,20.0,15.0,16.0,5.0,17.0,13.0,12.0,9.0,13.0,7.0,11.0,13.0,13.0,14.0,12.0,15.0,14.0,13.0,8.0,18.0,0.0,0.0,0.0,0.0,187.0,0.0,3.0,3.0,1.0,1.0,1.0,2.0,3.0,2.0,4.0,3.0,1.0,6.0,7.0,10.0,11.0,10.0,7.0,9.0,9.0,6.0,4.0,8.0,8.0,4.0,9.0,8.0,10.0,8.0,9.0,7.0,9.0,7.0,13.0,11.0,6.0,10.0,5.0,8.0,9.0,11.0,10.0,11.0,14.0,10.0,10.0,12.0,20.0,9.0,8.0,11.0,8.0,11.0,9.0,9.0,6.0,12.0,11.0,14.0,12.0,13.0,13.0,8.0,26.0,31.0,0.0,7.0,2.0,168.0,62.0,2.0,3.0,1.0,2.0,3.0,1.0,2.0,1.0,3.0,1.0,1.0,8.0,9.0,13.0,9.0,15.0,7.0,7.0,8.0,3.0,14.0,15.0,6.0,13.0,15.0,13.0,15.0,15.0,15.0,15.0,13.0,14.0,13.0,12.0,8.0,14.0,13.0,17.0,18.0,13.0,15.0,14.0,6.0,11.0,15.0,12.0,20.0,15.0,10.0,14.0,6.0,15.0,8.0,11.0,10.0,14.0,14.0,13.0,15.0,15.0,12.0,2.0,21.0,26.0,2.0,8.0,3.0,171.0,69.0,2.0,1.0,2.0,1.0,3.0,2.0,2.0,3.0,2.0,1.0,2.0,10.0,11.0,15.0,12.0,13.0,10.0,5.0,9.0,9.0,9.0,12.0,7.0,9.0,13.0,13.0,13.0,13.0,11.0,10.0,12.0,10.0,13.0,15.0,4.0,13.0,10.0,14.0,13.0,17.0,16.0,13.0,4.0,9.0,15.0,16.0,20.0,14.0,10.0,13.0,4.0,11.0,5.0,18.0,11.0,16.0,7.0,8.0,15.0,10.0,14.0,8.0,20.0,0.0,0.0,4.0,0.0,176.0,70.0,2.0,4.0,3.0,3.0,1.0,2.0,3.0,3.0,3.0,2.0,2.0,9.0,12.0,15.0,11.0,12.0,5.0,6.0,10.0,3.0,8.0,12.0,8.0,8.0,14.0,9.0,12.0,5.0,13.0,9.0,13.0,11.0,12.0,14.0,4.0,13.0,9.0,12.0,12.0,17.0,15.0,12.0,8.0,11.0,13.0,16.0,20.0,12.0,12.0,10.0,4.0,13.0,7.0,13.0,13.0,15.0,10.0,13.0,14.0,13.0,10.0,7.0,31.0,85.0,5.0,13.0,0.0,191.0,81.0,1.0,4.0,2.0,3.0,1.0,1.0,1.0,3.0,2.0,3.0,2.0,2.0,5.0,9.0,9.0,11.0,2.0,17.0,3.0,5.0,15.0,13.0,2.0,16.0,12.0,14.0,16.0,16.0,13.0,12.0,7.0,14.0,17.0,7.0,9.0,12.0,16.0,14.0,12.0,12.0,13.0,14.0,16.0,8.0,14.0,13.0,20.0,13.0,16.0,17.0,11.0,15.0,10.0,4.0,14.0,16.0,16.0,13.0,16.0,15.0,13.0,8.0,25.0,33.0,13.0,16.0,6.0,189.0,88.0,2.0,4.0,1.0,2.0,3.0,1.0,2.0,3.0,2.0,1.0,2.0,12.0,13.0,15.0,15.0,15.0,17.0,16.0,16.0,8.0,5.0,14.0,19.0,7.0,16.0,13.0,14.0,12.0,16.0,9.0,14.0,12.0,7.0,15.0,8.0,12.0,5.0,2.0,4.0,13.0,15.0,14.0,14.0,12.0,12.0,15.0,20.0,13.0,15.0,7.0,16.0,13.0,14.0,11.0,8.0,13.0,4.0,11.0,8.0,3.0,4.0,16.0
1,2,32.0,12.0,0.0,3.0,0.0,187.0,87.0,11.0,13.0,14.0,16.0,14.0,14.0,16.0,16.0,12.0,14.0,13.0,5.0,1.0,10.0,1.0,9.0,8.0,7.0,2.0,3.0,1.0,11.0,2.0,2.0,10.0,7.0,13.0,15.0,11.0,12.0,9.0,10.0,16.0,2.0,10.0,2.0,11.0,12.0,12.0,10.0,14.0,15.0,15.0,7.0,15.0,9.0,20.0,14.0,15.0,15.0,3.0,13.0,5.0,11.0,12.0,12.0,13.0,11.0,17.0,17.0,11.0,12.0,25.0,4.0,0.0,23.0,0.0,185.0,83.0,1.0,3.0,2.0,1.0,2.0,3.0,1.0,2.0,3.0,3.0,2.0,4.0,9.0,11.0,6.0,11.0,5.0,13.0,6.0,10.0,14.0,12.0,9.0,16.0,12.0,16.0,14.0,15.0,12.0,11.0,11.0,13.0,15.0,7.0,13.0,9.0,13.0,14.0,15.0,13.0,13.0,17.0,13.0,20.0,15.0,14.0,9.0,16.0,17.0,12.0,13.0,13.0,5.0,12.0,14.0,13.0,14.0,11.0,15.0,12.0,14.0,10.0,34.0,27.0,3.0,0.0,0.0,175.0,70.0,2.0,1.0,2.0,2.0,2.0,1.0,1.0,4.0,3.0,4.0,2.0,8.0,13.0,14.0,14.0,16.0,8.0,13.0,10.0,3.0,5.0,13.0,15.0,7.0,16.0,6.0,14.0,13.0,13.0,14.0,13.0,13.0,16.0,15.0,9.0,15.0,9.0,15.0,15.0,14.0,14.0,12.0,9.0,12.0,13.0,15.0,20.0,11.0,8.0,14.0,2.0,13.0,10.0,14.0,15.0,13.0,17.0,15.0,17.0,17.0,15.0,4.0,23.0,1.0,0.0,5.0,3.0,181.0,75.0,3.0,3.0,1.0,3.0,2.0,2.0,3.0,1.0,4.0,3.0,2.0,4.0,7.0,13.0,18.0,16.0,5.0,15.0,12.0,4.0,5.0,12.0,16.0,5.0,14.0,8.0,18.0,11.0,18.0,13.0,10.0,17.0,16.0,14.0,16.0,17.0,6.0,10.0,12.0,15.0,16.0,16.0,11.0,11.0,14.0,14.0,20.0,15.0,13.0,17.0,6.0,17.0,9.0,7.0,14.0,17.0,13.0,16.0,10.0,10.0,10.0,8.0,22.0,29.0,1.0,7.0,0.0,178.0,77.0,2.0,1.0,3.0,4.0,1.0,3.0,3.0,1.0,2.0,2.0,2.0,13.0,14.0,17.0,12.0,17.0,12.0,10.0,13.0,7.0,12.0,17.0,12.0,12.0,17.0,14.0,15.0,13.0,14.0,11.0,16.0,14.0,17.0,16.0,11.0,13.0,11.0,15.0,14.0,14.0,15.0,16.0,9.0,10.0,12.0,14.0,20.0,15.0,12.0,11.0,12.0,13.0,7.0,15.0,12.0,14.0,12.0,14.0,16.0,14.0,17.0,9.0,30.0,56.0,4.0,32.0,6.0,183.0,77.0,1.0,1.0,1.0,4.0,2.0,3.0,2.0,2.0,3.0,3.0,1.0,14.0,13.0,13.0,13.0,16.0,11.0,11.0,11.0,6.0,10.0,16.0,13.0,13.0,16.0,16.0,14.0,14.0,14.0,10.0,15.0,14.0,14.0,12.0,12.0,15.0,12.0,10.0,12.0,11.0,11.0,16.0,11.0,10.0,14.0,12.0,20.0,13.0,15.0,12.0,13.0,15.0,12.0,13.0,15.0,15.0,12.0,11.0,8.0,13.0,15.0,7.0,36.0,17.0,0.0,0.0,0.0,181.0,85.0,1.0,1.0,1.0,4.0,3.0,2.0,1.0,2.0,2.0,2.0,2.0,6.0,11.0,7.0,6.0,12.0,8.0,12.0,10.0,14.0,14.0,12.0,10.0,15.0,11.0,16.0,13.0,18.0,12.0,12.0,10.0,11.0,17.0,8.0,14.0,10.0,13.0,16.0,15.0,12.0,13.0,14.0,12.0,5.0,10.0,11.0,20.0,12.0,15.0,12.0,14.0,15.0,13.0,11.0,16.0,17.0,15.0,17.0,19.0,18.0,18.0,4.0,28.0,95.0,7.0,18.0,0.0,171.0,76.0,2.0,3.0,1.0,1.0,2.0,2.0,2.0,1.0,3.0,1.0,1.0,7.0,8.0,10.0,9.0,11.0,6.0,10.0,10.0,12.0,16.0,13.0,4.0,15.0,11.0,17.0,16.0,19.0,12.0,14.0,10.0,12.0,17.0,9.0,14.0,10.0,16.0,16.0,18.0,14.0,14.0,16.0,9.0,9.0,14.0,13.0,20.0,17.0,14.0,15.0,11.0,15.0,4.0,14.0,14.0,15.0,14.0,15.0,14.0,9.0,7.0,14.0,25.0,8.0,0.0,17.0,0.0,186.0,83.0,1.0,1.0,1.0,1.0,1.0,1.0,1.0,1.0,1.0,1.0,1.0,11.0,14.0,12.0,8.0,13.0,8.0,11.0,10.0,10.0,13.0,13.0,10.0,14.0,14.0,13.0,13.0,13.0,14.0,12.0,11.0,12.0,14.0,10.0,9.0,13.0,12.0,13.0,15.0,15.0,13.0,14.0,12.0,12.0,13.0,15.0,20.0,14.0,13.0,13.0,14.0,13.0,10.0,14.0,13.0,13.0,13.0,13.0,14.0,14.0,17.0,5.0,28.0,21.0,0.0,14.0,1.0,195.0,81.0,2.0,1.0,2.0,1.0,1.0,2.0,1.0,3.0,3.0,2.0,3.0,5.0,6.0,8.0,9.0,10.0,5.0,19.0,7.0,7.0,14.0,12.0,8.0,14.0,10.0,14.0,12.0,15.0,12.0,10.0,11.0,12.0,13.0,6.0,14.0,6.0,12.0,14.0,15.0,12.0,11.0,15.0,19.0,9.0,12.0,12.0,20.0,13.0,14.0,10.0,14.0,14.0,10.0,7.0,14.0,15.0,15.0,10.0,15.0,12.0,13.0,5.0,31.0,28.0,2.0,7.0,2.0,180.0,77.0,1.0,1.0,2.0,3.0,3.0,1.0,2.0,2.0,3.0,1.0,3.0,13.0,13.0,15.0,12.0,16.0,15.0,8.0,15.0,3.0,8.0,15.0,14.0,11.0,16.0,12.0,13.0,11.0,13.0,11.0,14.0,13.0,12.0,15.0,11.0,12.0,11.0,11.0,12.0,11.0,13.0,12.0,10.0,16.0,14.0,11.0,20.0,13.0,11.0,12.0,10.0,14.0,3.0,14.0,15.0,15.0,14.0,11.0,13.0,13.0,18.0,9.0,32.0,61.0,0.0,0.0,0.0,194.0,89.0,15.0,12.0,16.0,8.0,14.0,10.0,16.0,15.0,13.0,8.0,11.0,4.0,3.0,2.0,3.0,7.0,9.0,6.0,1.0,2.0,3.0,8.0,1.0,1.0,7.0,6.0,12.0,14.0,10.0,15.0,7.0,12.0,14.0,4.0,15.0,3.0,15.0,13.0,10.0,10.0,16.0,14.0,14.0,8.0,15.0,10.0,20.0,12.0,16.0,17.0,5.0,16.0,5.0,12.0,15.0,12.0,16.0,14.0,18.0,15.0,12.0,6.0,28.0,14.0,0.0,12.0,0.0,193.0,87.0,2.0,2.0,1.0,1.0,3.0,3.0,3.0,3.0,1.0,2.0,2.0,3.0,5.0,6.0,7.0,8.0,3.0,16.0,5.0,10.0,14.0,10.0,5.0,14.0,8.0,11.0,14.0,13.0,12.0,15.0,7.0,14.0,14.0,5.0,13.0,8.0,15.0,17.0,12.0,12.0,8.0,13.0,18.0,12.0,13.0,15.0,20.0,13.0,15.0,15.0,6.0,14.0,5.0,5.0,12.0,14.0,10.0,13.0,15.0,16.0,18.0,3.0,27.0,0.0,0.0,0.0,0.0,182.0,79.0,1.0,2.0,1.0,1.0,2.0,3.0,1.0,2.0,3.0,1.0,4.0,10.0,12.0,14.0,13.0,12.0,10.0,8.0,14.0,11.0,7.0,11.0,14.0,9.0,13.0,16.0,11.0,13.0,9.0,12.0,10.0,10.0,12.0,14.0,7.0,12.0,9.0,14.0,16.0,15.0,13.0,15.0,9.0,9.0,14.0,17.0,20.0,14.0,12.0,13.0,8.0,13.0,8.0,15.0,9.0,14.0,12.0,11.0,15.0,13.0,10.0,8.0,21.0,0.0,0.0,0.0,0.0,178.0,79.0,1.0,4.0,3.0,3.0,3.0,3.0,3.0,1.0,1.0,2.0,1.0,6.0,6.0,8.0,5.0,9.0,5.0,6.0,6.0,3.0,7.0,11.0,4.0,5.0,11.0,8.0,10.0,4.0,9.0,5.0,14.0,9.0,3.0,10.0,1.0,8.0,8.0,8.0,10.0,14.0,8.0,7.0,7.0,9.0,14.0,11.0,20.0,7.0,5.0,8.0,8.0,6.0,8.0,8.0,12.0,12.0,11.0,10.0,12.0,10.0,20.0,7.0,27.0,6.0,1.0,10.0,5.0,192.0,78.0,3.0,3.0,3.0,3.0,3.0,3.0,2.0,1.0,1.0,2.0,2.0,6.0,9.0,10.0,18.0,15.0,8.0,16.0,9.0,5.0,5.0,10.0,15.0,5.0,13.0,8.0,18.0,14.0,18.0,16.0,10.0,13.0,10.0,10.0,6.0,17.0,6.0,8.0,9.0,11.0,9.0,12.0,15.0,15.0,12.0,13.0,20.0,13.0,14.0,15.0,4.0,12.0,10.0,5.0,12.0,17.0,8.0,13.0,12.0,10.0,8.0,14.0,25.0,45.0,12.0,2.0,0.0,181.0,76.0,3.0,2.0,4.0,3.0,3.0,3.0,3.0,1.0,1.0,3.0,2.0,15.0,17.0,15.0,16.0,17.0,15.0,7.0,16.0,8.0,7.0,17.0,12.0,8.0,17.0,12.0,14.0,9.0,14.0,12.0,17.0,15.0,15.0,16.0,11.0,16.0,10.0,12.0,15.0,13.0,13.0,13.0,8.0,16.0,16.0,13.0,20.0,17.0,12.0,14.0,8.0,15.0,4.0,14.0,12.0,18.0,10.0,11.0,17.0,10.0,12.0,13.0,28.0,10.0,0.0,0.0,0.0,180.0,74.0,3.0,1.0,2.0,2.0,3.0,3.0,1.0,1.0,3.0,1.0,1.0,7.0,12.0,10.0,7.0,8.0,9.0,6.0,13.0,15.0,13.0,10.0,9.0,16.0,8.0,17.0,13.0,16.0,10.0,15.0,8.0,11.0,17.0,5.0,12.0,9.0,12.0,17.0,18.0,13.0,10.0,14.0,11.0,14.0,17.0,13.0,20.0,17.0,11.0,16.0,10.0,16.0,6.0,19.0,7.0,12.0,10.0,12.0,18.0,17.0,15.0,3.0,28.0,41.0,2.0,0.0,0.0,187.0,80.0,3.0,2.0,3.0,2.0,1.0,1.0,2.0,3.0,1.0,4.0,2.0,7.0,10.0,11.0,7.0,12.0,7.0,10.0,12.0,13.0,15.0,13.0,8.0,18.0,12.0,18.0,13.0,17.0,12.0,14.0,10.0,12.0,17.0,7.0,13.0,9.0,14.0,17.0,18.0,14.0,13.0,16.0,14.0,20.0,18.0,13.0,12.0,18.0,14.0,15.0,16.0,15.0,6.0,15.0,14.0,13.0,10.0,14.0,12.0,8.0,7.0,8.0,25.0,7.0,0.0,15.0,2.0,187.0,77.0,3.0,3.0,2.0,2.0,3.0,2.0,3.0,3.0,1.0,2.0,1.0,5.0,8.0,10.0,9.0,11.0,7.0,12.0,9.0,10.0,14.0,12.0,7.0,14.0,12.0,18.0,16.0,14.0,11.0,10.0,11.0,12.0,15.0,9.0,11.0,13.0,15.0,16.0,18.0,13.0,12.0,15.0,14.0,9.0,17.0,15.0,20.0,17.0,16.0,13.0,13.0,12.0,9.0,10.0,11.0,15.0,12.0,14.0,13.0,13.0,11.0,6.0,24.0,0.0,0.0,10.0,1.0,190.0,77.0,2.0,2.0,1.0,2.0,3.0,4.0,3.0,4.0,2.0,1.0,4.0,5.0,8.0,7.0,7.0,10.0,5.0,14.0,6.0,12.0,15.0,11.0,6.0,14.0,10.0,10.0,15.0,13.0,14.0,16.0,9.0,15.0,12.0,4.0,10.0,6.0,16.0,18.0,12.0,9.0,10.0,12.0,15.0,9.0,13.0,11.0,20.0,13.0,13.0,15.0,6.0,15.0,5.0,12.0,8.0,10.0,15.0,13.0,14.0,16.0,18.0,3.0,15.0,0.0,0.0,0.0,0.0,165.0,0.0,2.0,3.0,1.0,2.0,1.0,2.0,3.0,3.0,3.0,3.0,1.0,3.0,5.0,3.0,3.0,5.0,2.0,6.0,4.0,4.0,6.0,7.0,4.0,11.0,5.0,14.0,4.0,9.0,5.0,6.0,4.0,10.0,14.0,13.0,9.0,5.0,5.0,7.0,8.0,11.0,6.0,6.0,5.0,20.0,12.0,6.0,6.0,12.0,6.0,4.0,14.0,11.0,4.0,6.0,14.0,13.0,14.0,11.0,8.0,5.0,8.0,10.0
1,4,32.0,61.0,0.0,0.0,0.0,194.0,89.0,15.0,12.0,16.0,8.0,14.0,10.0,16.0,15.0,13.0,8.0,11.0,4.0,3.0,2.0,3.0,7.0,9.0,6.0,1.0,2.0,3.0,8.0,1.0,1.0,7.0,6.0,12.0,14.0,10.0,15.0,7.0,12.0,14.0,4.0,15.0,3.0,15.0,13.0,10.0,10.0,16.0,14.0,14.0,8.0,15.0,10.0,20.0,12.0,16.0,17.0,5.0,16.0,5.0,12.0,15.0,12.0,16.0,14.0,18.0,15.0,12.0,6.0,27.0,0.0,0.0,0.0,0.0,182.0,79.0,1.0,2.0,1.0,1.0,2.0,3.0,1.0,2.0,3.0,1.0,4.0,10.0,12.0,14.0,13.0,12.0,10.0,8.0,14.0,11.0,7.0,11.0,14.0,9.0,13.0,16.0,11.0,13.0,9.0,12.0,10.0,10.0,12.0,14.0,7.0,12.0,9.0,14.0,16.0,15.0,13.0,15.0,9.0,9.0,14.0,17.0,20.0,14.0,12.0,13.0,8.0,13.0,8.0,15.0,9.0,14.0,12.0,11.0,15.0,13.0,10.0,8.0,21.0,0.0,0.0,0.0,0.0,178.0,79.0,1.0,4.0,3.0,3.0,3.0,3.0,3.0,1.0,1.0,2.0,1.0,6.0,6.0,8.0,5.0,9.0,5.0,6.0,6.0,3.0,7.0,11.0,4.0,5.0,11.0,8.0,10.0,4.0,9.0,5.0,14.0,9.0,3.0,10.0,1.0,8.0,8.0,8.0,10.0,14.0,8.0,7.0,7.0,9.0,14.0,11.0,20.0,7.0,5.0,8.0,8.0,6.0,8.0,8.0,12.0,12.0,11.0,10.0,12.0,10.0,20.0,7.0,27.0,6.0,1.0,10.0,5.0,192.0,78.0,3.0,3.0,3.0,3.0,3.0,3.0,2.0,1.0,1.0,2.0,2.0,6.0,9.0,10.0,18.0,15.0,8.0,16.0,9.0,5.0,5.0,10.0,15.0,5.0,13.0,8.0,18.0,14.0,18.0,16.0,10.0,13.0,10.0,10.0,6.0,17.0,6.0,8.0,9.0,11.0,9.0,12.0,15.0,15.0,12.0,13.0,20.0,13.0,14.0,15.0,4.0,12.0,10.0,5.0,12.0,17.0,8.0,13.0,12.0,10.0,8.0,14.0,25.0,45.0,12.0,2.0,0.0,181.0,76.0,3.0,2.0,4.0,3.0,3.0,3.0,3.0,1.0,1.0,3.0,2.0,15.0,17.0,15.0,16.0,17.0,15.0,7.0,16.0,8.0,7.0,17.0,12.0,8.0,17.0,12.0,14.0,9.0,14.0,12.0,17.0,15.0,15.0,16.0,11.0,16.0,10.0,12.0,15.0,13.0,13.0,13.0,8.0,16.0,16.0,13.0,20.0,17.0,12.0,14.0,8.0,15.0,4.0,14.0,12.0,18.0,10.0,11.0,17.0,10.0,12.0,13.0,25.0,55.0,20.0,4.0,3.0,184.0,74.0,3.0,3.0,1.0,2.0,2.0,2.0,3.0,1.0,3.0,2.0,3.0,9.0,13.0,15.0,14.0,12.0,10.0,8.0,16.0,6.0,7.0,12.0,14.0,8.0,13.0,17.0,12.0,9.0,10.0,12.0,11.0,11.0,15.0,13.0,7.0,15.0,9.0,13.0,17.0,17.0,14.0,12.0,10.0,10.0,18.0,17.0,20.0,15.0,10.0,10.0,5.0,14.0,6.0,14.0,12.0,18.0,7.0,14.0,14.0,11.0,13.0,12.0,28.0,41.0,2.0,0.0,0.0,187.0,80.0,3.0,2.0,3.0,2.0,1.0,1.0,2.0,3.0,1.0,4.0,2.0,7.0,10.0,11.0,7.0,12.0,7.0,10.0,12.0,13.0,15.0,13.0,8.0,18.0,12.0,18.0,13.0,17.0,12.0,14.0,10.0,12.0,17.0,7.0,13.0,9.0,14.0,17.0,18.0,14.0,13.0,16.0,14.0,20.0,18.0,13.0,12.0,18.0,14.0,15.0,16.0,15.0,6.0,15.0,14.0,13.0,10.0,14.0,12.0,8.0,7.0,8.0,25.0,7.0,0.0,15.0,2.0,187.0,77.0,3.0,3.0,2.0,2.0,3.0,2.0,3.0,3.0,1.0,2.0,1.0,5.0,8.0,10.0,9.0,11.0,7.0,12.0,9.0,10.0,14.0,12.0,7.0,14.0,12.0,18.0,16.0,14.0,11.0,10.0,11.0,12.0,15.0,9.0,11.0,13.0,15.0,16.0,18.0,13.0,12.0,15.0,14.0,9.0,17.0,15.0,20.0,17.0,16.0,13.0,13.0,12.0,9.0,10.0,11.0,15.0,12.0,14.0,13.0,13.0,11.0,6.0,30.0,0.0,0.0,0.0,0.0,186.0,75.0,13.0,13.0,6.0,1.0,13.0,11.0,9.0,13.0,9.0,6.0,11.0,4.0,2.0,2.0,1.0,1.0,6.0,1.0,1.0,1.0,2.0,1.0,3.0,1.0,5.0,9.0,6.0,12.0,7.0,8.0,6.0,13.0,4.0,3.0,5.0,2.0,5.0,5.0,6.0,10.0,14.0,7.0,12.0,8.0,10.0,11.0,20.0,3.0,7.0,9.0,6.0,4.0,7.0,9.0,16.0,10.0,9.0,10.0,10.0,8.0,7.0,7.0,24.0,0.0,0.0,10.0,1.0,190.0,77.0,2.0,2.0,1.0,2.0,3.0,4.0,3.0,4.0,2.0,1.0,4.0,5.0,8.0,7.0,7.0,10.0,5.0,14.0,6.0,12.0,15.0,11.0,6.0,14.0,10.0,10.0,15.0,13.0,14.0,16.0,9.0,15.0,12.0,4.0,10.0,6.0,16.0,18.0,12.0,9.0,10.0,12.0,15.0,9.0,13.0,11.0,20.0,13.0,13.0,15.0,6.0,15.0,5.0,12.0,8.0,10.0,15.0,13.0,14.0,16.0,18.0,3.0,15.0,0.0,0.0,0.0,0.0,165.0,0.0,2.0,3.0,1.0,2.0,1.0,2.0,3.0,3.0,3.0,3.0,1.0,3.0,5.0,3.0,3.0,5.0,2.0,6.0,4.0,4.0,6.0,7.0,4.0,11.0,5.0,14.0,4.0,9.0,5.0,6.0,4.0,10.0,14.0,13.0,9.0,5.0,5.0,7.0,8.0,11.0,6.0,6.0,5.0,20.0,12.0,6.0,6.0,12.0,6.0,4.0,14.0,11.0,4.0,6.0,14.0,13.0,14.0,11.0,8.0,5.0,8.0,10.0,32.0,11.0,0.0,0.0,0.0,194.0,88.0,14.0,15.0,14.0,6.0,14.0,11.0,14.0,15.0,14.0,12.0,16.0,1.0,1.0,6.0,1.0,8.0,2.0,8.0,1.0,1.0,1.0,7.0,1.0,11.0,8.0,15.0,13.0,13.0,15.0,14.0,11.0,10.0,14.0,3.0,15.0,3.0,13.0,12.0,13.0,11.0,14.0,16.0,16.0,7.0,14.0,10.0,20.0,13.0,15.0,14.0,6.0,14.0,7.0,1.0,15.0,14.0,15.0,9.0,18.0,10.0,16.0,11.0,30.0,0.0,0.0,0.0,0.0,188.0,82.0,2.0,3.0,1.0,2.0,1.0,2.0,1.0,2.0,2.0,3.0,1.0,7.0,7.0,8.0,8.0,12.0,11.0,14.0,12.0,13.0,14.0,10.0,10.0,15.0,13.0,15.0,15.0,14.0,12.0,12.0,11.0,14.0,12.0,9.0,8.0,10.0,14.0,13.0,13.0,12.0,11.0,14.0,14.0,20.0,15.0,14.0,9.0,13.0,15.0,13.0,14.0,13.0,10.0,10.0,14.0,11.0,13.0,11.0,13.0,14.0,15.0,8.0,29.0,2.0,0.0,4.0,1.0,178.0,73.0,3.0,3.0,2.0,1.0,1.0,2.0,1.0,1.0,1.0,3.0,3.0,9.0,13.0,12.0,14.0,15.0,11.0,10.0,13.0,8.0,9.0,14.0,12.0,10.0,15.0,12.0,14.0,14.0,14.0,14.0,14.0,14.0,16.0,15.0,10.0,17.0,9.0,17.0,15.0,15.0,15.0,13.0,10.0,11.0,14.0,14.0,20.0,16.0,12.0,15.0,8.0,15.0,7.0,13.0,16.0,15.0,15.0,14.0,14.0,10.0,8.0,11.0,28.0,63.0,30.0,0.0,0.0,184.0,82.0,2.0,1.0,1.0,2.0,1.0,3.0,3.0,2.0,1.0,3.0,1.0,8.0,12.0,14.0,20.0,17.0,12.0,13.0,15.0,6.0,5.0,16.0,15.0,7.0,16.0,14.0,18.0,14.0,16.0,14.0,15.0,17.0,16.0,14.0,12.0,18.0,6.0,14.0,14.0,14.0,14.0,14.0,12.0,14.0,13.0,16.0,20.0,15.0,14.0,14.0,13.0,12.0,11.0,12.0,18.0,16.0,11.0,12.0,17.0,16.0,9.0,8.0,34.0,34.0,0.0,2.0,0.0,184.0,79.0,1.0,2.0,1.0,2.0,2.0,1.0,3.0,1.0,3.0,2.0,1.0,8.0,12.0,12.0,10.0,12.0,4.0,13.0,8.0,13.0,12.0,12.0,2.0,15.0,13.0,13.0,14.0,15.0,11.0,13.0,12.0,12.0,11.0,7.0,10.0,14.0,15.0,13.0,15.0,12.0,13.0,15.0,13.0,9.0,15.0,14.0,20.0,13.0,14.0,12.0,9.0,15.0,12.0,14.0,10.0,12.0,15.0,14.0,15.0,18.0,10.0,7.0,29.0,51.0,8.0,0.0,0.0,169.0,61.0,4.0,3.0,1.0,2.0,4.0,1.0,1.0,4.0,3.0,2.0,1.0,14.0,15.0,16.0,14.0,18.0,12.0,7.0,14.0,7.0,6.0,15.0,13.0,7.0,16.0,12.0,13.0,14.0,14.0,13.0,14.0,13.0,15.0,16.0,12.0,17.0,6.0,11.0,13.0,15.0,16.0,12.0,6.0,12.0,13.0,15.0,20.0,12.0,10.0,13.0,10.0,14.0,6.0,13.0,17.0,14.0,13.0,15.0,13.0,6.0,12.0,10.0,28.0,91.0,19.0,2.0,0.0,183.0,79.0,3.0,1.0,2.0,2.0,2.0,1.0,2.0,3.0,2.0,3.0,1.0,14.0,13.0,13.0,14.0,15.0,12.0,15.0,14.0,8.0,8.0,16.0,14.0,9.0,17.0,11.0,14.0,12.0,15.0,10.0,16.0,14.0,15.0,15.0,17.0,18.0,14.0,15.0,10.0,15.0,15.0,13.0,11.0,15.0,15.0,14.0,20.0,14.0,13.0,13.0,6.0,12.0,5.0,14.0,17.0,16.0,19.0,13.0,18.0,14.0,12.0,8.0,17.0,0.0,0.0,0.0,0.0,173.0,0.0,1.0,2.0,4.0,1.0,1.0,1.0,3.0,2.0,2.0,3.0,1.0,7.0,8.0,5.0,3.0,8.0,2.0,4.0,6.0,4.0,7.0,7.0,6.0,8.0,5.0,7.0,9.0,16.0,8.0,9.0,7.0,12.0,6.0,9.0,7.0,7.0,9.0,13.0,8.0,11.0,9.0,6.0,6.0,8.0,11.0,9.0,20.0,12.0,8.0,5.0,13.0,8.0,3.0,11.0,11.0,10.0,13.0,12.0,15.0,10.0,7.0,2.0,25.0,26.0,5.0,0.0,0.0,188.0,80.0,2.0,2.0,2.0,4.0,3.0,2.0,3.0,3.0,2.0,1.0,2.0,13.0,14.0,13.0,6.0,13.0,11.0,11.0,12.0,18.0,12.0,14.0,10.0,15.0,13.0,11.0,13.0,14.0,12.0,12.0,12.0,12.0,15.0,11.0,7.0,14.0,13.0,14.0,17.0,13.0,14.0,15.0,12.0,20.0,15.0,16.0,8.0,17.0,14.0,13.0,12.0,13.0,7.0,14.0,14.0,16.0,12.0,13.0,13.0,12.0,12.0,12.0,30.0,51.0,0.0,8.0,0.0,190.0,82.0,1.0,3.0,3.0,1.0,2.0,2.0,1.0,2.0,3.0,3.0,1.0,7.0,10.0,8.0,9.0,12.0,8.0,14.0,11.0,12.0,16.0,12.0,9.0,15.0,12.0,13.0,15.0,16.0,13.0,13.0,12.0,13.0,13.0,6.0,14.0,9.0,14.0,17.0,16.0,11.0,11.0,16.0,15.0,10.0,14.0,14.0,20.0,16.0,15.0,15.0,13.0,16.0,8.0,13.0,16.0,14.0,14.0,13.0,14.0,12.0,7.0,6.0,32.0,89.0,7.0,3.0,0.0,183.0,80.0,2.0,1.0,3.0,1.0,2.0,3.0,2.0,1.0,4.0,2.0,3.0,7.0,10.0,12.0,11.0,14.0,9.0,12.0,16.0,6.0,13.0,15.0,12.0,14.0,14.0,15.0,13.0,15.0,14.0,12.0,14.0,12.0,15.0,9.0,14.0,8.0,14.0,16.0,13.0,9.0,10.0,15.0,11.0,15.0,13.0,10.0,20.0,12.0,14.0,12.0,13.0,15.0,5.0,8.0,10.0,15.0,16.0,15.0,18.0,20.0,17.0,4.0
2,2,32.0,11.0,0.0,0.0,0.0,194.0,88.0,14.0,15.0,14.0,6.0,14.0,11.0,14.0,15.0,14.0,12.0,16.0,1.0,1.0,6.0,1.0,8.0,2.0,8.0,1.0,1.0,1.0,7.0,1.0,11.0,8.0,15.0,13.0,13.0,15.0,14.0,11.0,10.0,14.0,3.0,15.0,3.0,13.0,12.0,13.0,11.0,14.0,16.0,16.0,7.0,14.0,10.0,20.0,13.0,15.0,14.0,6.0,14.0,7.0,1.0,15.0,14.0,15.0,9.0,18.0,10.0,16.0,11.0,30.0,0.0,0.0,0.0,0.0,188.0,82.0,2.0,3.0,1.0,2.0,1.0,2.0,1.0,2.0,2.0,3.0,1.0,7.0,7.0,8.0,8.0,12.0,11.0,14.0,12.0,13.0,14.0,10.0,10.0,15.0,13.0,15.0,15.0,14.0,12.0,12.0,11.0,14.0,12.0,9.0,8.0,10.0,14.0,13.0,13.0,12.0,11.0,14.0,14.0,20.0,15.0,14.0,9.0,13.0,15.0,13.0,14.0,13.0,10.0,10.0,14.0,11.0,13.0,11.0,13.0,14.0,15.0,8.0,29.0,2.0,0.0,4.0,1.0,178.0,73.0,3.0,3.0,2.0,1.0,1.0,2.0,1.0,1.0,1.0,3.0,3.0,9.0,13.0,12.0,14.0,15.0,11.0,10.0,13.0,8.0,9.0,14.0,12.0,10.0,15.0,12.0,14.0,14.0,14.0,14.0,14.0,14.0,16.0,15.0,10.0,17.0,9.0,17.0,15.0,15.0,15.0,13.0,10.0,11.0,14.0,14.0,20.0,16.0,12.0,15.0,8.0,15.0,7.0,13.0,16.0,15.0,15.0,14.0,14.0,10.0,8.0,11.0,28.0,63.0,30.0,0.0,0.0,184.0,82.0,2.0,1.0,1.0,2.0,1.0,3.0,3.0,2.0,1.0,3.0,1.0,8.0,12.0,14.0,20.0,17.0,12.0,13.0,15.0,6.0,5.0,16.0,15.0,7.0,16.0,14.0,18.0,14.0,16.0,14.0,15.0,17.0,16.0,14.0,12.0,18.0,6.0,14.0,14.0,14.0,14.0,14.0,12.0,14.0,13.0,16.0,20.0,15.0,14.0,14.0,13.0,12.0,11.0,12.0,18.0,16.0,11.0,12.0,17.0,16.0,9.0,8.0,29.0,51.0,8.0,0.0,0.0,169.0,61.0,4.0,3.0,1.0,2.0,4.0,1.0,1.0,4.0,3.0,2.0,1.0,14.0,15.0,16.0,14.0,18.0,12.0,7.0,14.0,7.0,6.0,15.0,13.0,7.0,16.0,12.0,13.0,14.0,14.0,13.0,14.0,13.0,15.0,16.0,12.0,17.0,6.0,11.0,13.0,15.0,16.0,12.0,6.0,12.0,13.0,15.0,20.0,12.0,10.0,13.0,10.0,14.0,6.0,13.0,17.0,14.0,13.0,15.0,13.0,6.0,12.0,10.0,34.0,3.0,0.0,9.0,0.0,181.0,74.0,1.0,4.0,3.0,1.0,3.0,1.0,1.0,1.0,2.0,3.0,3.0,6.0,11.0,12.0,7.0,10.0,5.0,10.0,10.0,12.0,10.0,11.0,6.0,13.0,12.0,14.0,13.0,13.0,13.0,11.0,12.0,12.0,16.0,13.0,9.0,13.0,13.0,16.0,16.0,12.0,13.0,12.0,10.0,10.0,13.0,14.0,20.0,13.0,13.0,12.0,14.0,10.0,9.0,16.0,16.0,13.0,16.0,12.0,19.0,12.0,9.0,6.0,28.0,91.0,19.0,2.0,0.0,183.0,79.0,3.0,1.0,2.0,2.0,2.0,1.0,2.0,3.0,2.0,3.0,1.0,14.0,13.0,13.0,14.0,15.0,12.0,15.0,14.0,8.0,8.0,16.0,14.0,9.0,17.0,11.0,14.0,12.0,15.0,10.0,16.0,14.0,15.0,15.0,17.0,18.0,14.0,15.0,10.0,15.0,15.0,13.0,11.0,15.0,15.0,14.0,20.0,14.0,13.0,13.0,6.0,12.0,5.0,14.0,17.0,16.0,19.0,13.0,18.0,14.0,12.0,8.0,17.0,0.0,0.0,0.0,0.0,173.0,0.0,1.0,2.0,4.0,1.0,1.0,1.0,3.0,2.0,2.0,3.0,1.0,7.0,8.0,5.0,3.0,8.0,2.0,4.0,6.0,4.0,7.0,7.0,6.0,8.0,5.0,7.0,9.0,16.0,8.0,9.0,7.0,12.0,6.0,9.0,7.0,7.0,9.0,13.0,8.0,11.0,9.0,6.0,6.0,8.0,11.0,9.0,20.0,12.0,8.0,5.0,13.0,8.0,3.0,11.0,11.0,10.0,13.0,12.0,15.0,10.0,7.0,2.0,25.0,26.0,5.0,0.0,0.0,188.0,80.0,2.0,2.0,2.0,4.0,3.0,2.0,3.0,3.0,2.0,1.0,2.0,13.0,14.0,13.0,6.0,13.0,11.0,11.0,12.0,18.0,12.0,14.0,10.0,15.0,13.0,11.0,13.0,14.0,12.0,12.0,12.0,12.0,15.0,11.0,7.0,14.0,13.0,14.0,17.0,13.0,14.0,15.0,12.0,20.0,15.0,16.0,8.0,17.0,14.0,13.0,12.0,13.0,7.0,14.0,14.0,16.0,12.0,13.0,13.0,12.0,12.0,12.0,30.0,51.0,0.0,8.0,0.0,190.0,82.0,1.0,3.0,3.0,1.0,2.0,2.0,1.0,2.0,3.0,3.0,1.0,7.0,10.0,8.0,9.0,12.0,8.0,14.0,11.0,12.0,16.0,12.0,9.0,15.0,12.0,13.0,15.0,16.0,13.0,13.0,12.0,13.0,13.0,6.0,14.0,9.0,14.0,17.0,16.0,11.0,11.0,16.0,15.0,10.0,14.0,14.0,20.0,16.0,15.0,15.0,13.0,16.0,8.0,13.0,16.0,14.0,14.0,13.0,14.0,12.0,7.0,6.0,32.0,89.0,7.0,3.0,0.0,183.0,80.0,2.0,1.0,3.0,1.0,2.0,3.0,2.0,1.0,4.0,2.0,3.0,7.0,10.0,12.0,11.0,14.0,9.0,12.0,16.0,6.0,13.0,15.0,12.0,14.0,14.0,15.0,13.0,15.0,14.0,12.0,14.0,12.0,15.0,9.0,14.0,8.0,14.0,16.0,13.0,9.0,10.0,15.0,11.0,15.0,13.0,10.0,20.0,12.0,14.0,12.0,13.0,15.0,5.0,8.0,10.0,15.0,16.0,15.0,18.0,20.0,17.0,4.0,32.0,61.0,0.0,0.0,0.0,194.0,89.0,15.0,12.0,16.0,8.0,14.0,10.0,16.0,15.0,13.0,8.0,11.0,4.0,3.0,2.0,3.0,7.0,9.0,6.0,1.0,2.0,3.0,8.0,1.0,1.0,7.0,6.0,12.0,14.0,10.0,15.0,7.0,12.0,14.0,4.0,15.0,3.0,15.0,13.0,10.0,10.0,16.0,14.0,14.0,8.0,15.0,10.0,20.0,12.0,16.0,17.0,5.0,16.0,5.0,12.0,15.0,12.0,16.0,14.0,18.0,15.0,12.0,6.0,28.0,74.0,29.0,4.0,2.0,194.0,89.0,1.0,1.0,2.0,1.0,3.0,2.0,3.0,3.0,4.0,3.0,2.0,8.0,10.0,13.0,12.0,15.0,10.0,16.0,12.0,8.0,5.0,13.0,14.0,5.0,14.0,10.0,15.0,12.0,12.0,7.0,13.0,11.0,6.0,14.0,6.0,12.0,6.0,8.0,7.0,11.0,10.0,14.0,17.0,12.0,8.0,12.0,20.0,8.0,15.0,8.0,10.0,17.0,12.0,8.0,12.0,6.0,7.0,14.0,6.0,7.0,9.0,17.0,28.0,14.0,0.0,12.0,0.0,193.0,87.0,2.0,2.0,1.0,1.0,3.0,3.0,3.0,3.0,1.0,2.0,2.0,3.0,5.0,6.0,7.0,8.0,3.0,16.0,5.0,10.0,14.0,10.0,5.0,14.0,8.0,11.0,14.0,13.0,12.0,15.0,7.0,14.0,14.0,5.0,13.0,8.0,15.0,17.0,12.0,12.0,8.0,13.0,18.0,12.0,13.0,15.0,20.0,13.0,15.0,15.0,6.0,14.0,5.0,5.0,12.0,14.0,10.0,13.0,15.0,16.0,18.0,3.0,27.0,0.0,0.0,0.0,0.0,182.0,79.0,1.0,2.0,1.0,1.0,2.0,3.0,1.0,2.0,3.0,1.0,4.0,10.0,12.0,14.0,13.0,12.0,10.0,8.0,14.0,11.0,7.0,11.0,14.0,9.0,13.0,16.0,11.0,13.0,9.0,12.0,10.0,10.0,12.0,14.0,7.0,12.0,9.0,14.0,16.0,15.0,13.0,15.0,9.0,9.0,14.0,17.0,20.0,14.0,12.0,13.0,8.0,13.0,8.0,15.0,9.0,14.0,12.0,11.0,15.0,13.0,10.0,8.0,27.0,51.0,15.0,8.0,3.0,186.0,79.0,1.0,2.0,2.0,2.0,3.0,2.0,2.0,2.0,3.0,2.0,3.0,12.0,13.0,15.0,14.0,15.0,14.0,13.0,12.0,5.0,7.0,13.0,12.0,7.0,14.0,8.0,14.0,11.0,14.0,11.0,11.0,13.0,13.0,13.0,6.0,16.0,8.0,12.0,12.0,16.0,13.0,13.0,13.0,15.0,13.0,15.0,20.0,14.0,12.0,14.0,7.0,15.0,6.0,17.0,13.0,16.0,9.0,15.0,10.0,12.0,10.0,16.0,28.0,10.0,0.0,0.0,0.0,180.0,74.0,3.0,1.0,2.0,2.0,3.0,3.0,1.0,1.0,3.0,1.0,1.0,7.0,12.0,10.0,7.0,8.0,9.0,6.0,13.0,15.0,13.0,10.0,9.0,16.0,8.0,17.0,13.0,16.0,10.0,15.0,8.0,11.0,17.0,5.0,12.0,9.0,12.0,17.0,18.0,13.0,10.0,14.0,11.0,14.0,17.0,13.0,20.0,17.0,11.0,16.0,10.0,16.0,6.0,19.0,7.0,12.0,10.0,12.0,18.0,17.0,15.0,3.0,28.0,41.0,2.0,0.0,0.0,187.0,80.0,3.0,2.0,3.0,2.0,1.0,1.0,2.0,3.0,1.0,4.0,2.0,7.0,10.0,11.0,7.0,12.0,7.0,10.0,12.0,13.0,15.0,13.0,8.0,18.0,12.0,18.0,13.0,17.0,12.0,14.0,10.0,12.0,17.0,7.0,13.0,9.0,14.0,17.0,18.0,14.0,13.0,16.0,14.0,20.0,18.0,13.0,12.0,18.0,14.0,15.0,16.0,15.0,6.0,15.0,14.0,13.0,10.0,14.0,12.0,8.0,7.0,8.0,25.0,7.0,0.0,15.0,2.0,187.0,77.0,3.0,3.0,2.0,2.0,3.0,2.0,3.0,3.0,1.0,2.0,1.0,5.0,8.0,10.0,9.0,11.0,7.0,12.0,9.0,10.0,14.0,12.0,7.0,14.0,12.0,18.0,16.0,14.0,11.0,10.0,11.0,12.0,15.0,9.0,11.0,13.0,15.0,16.0,18.0,13.0,12.0,15.0,14.0,9.0,17.0,15.0,20.0,17.0,16.0,13.0,13.0,12.0,9.0,10.0,11.0,15.0,12.0,14.0,13.0,13.0,11.0,6.0,30.0,0.0,0.0,0.0,0.0,186.0,75.0,13.0,13.0,6.0,1.0,13.0,11.0,9.0,13.0,9.0,6.0,11.0,4.0,2.0,2.0,1.0,1.0,6.0,1.0,1.0,1.0,2.0,1.0,3.0,1.0,5.0,9.0,6.0,12.0,7.0,8.0,6.0,13.0,4.0,3.0,5.0,2.0,5.0,5.0,6.0,10.0,14.0,7.0,12.0,8.0,10.0,11.0,20.0,3.0,7.0,9.0,6.0,4.0,7.0,9.0,16.0,10.0,9.0,10.0,10.0,8.0,7.0,7.0,22.0,1.0,0.0,10.0,2.0,183.0,74.0,3.0,2.0,2.0,1.0,3.0,3.0,1.0,1.0,1.0,3.0,2.0,13.0,12.0,10.0,13.0,13.0,11.0,9.0,17.0,8.0,9.0,15.0,10.0,12.0,14.0,17.0,14.0,13.0,16.0,12.0,13.0,14.0,14.0,10.0,11.0,16.0,10.0,15.0,17.0,12.0,11.0,13.0,10.0,20.0,15.0,12.0,12.0,17.0,10.0,15.0,12.0,15.0,5.0,17.0,11.0,16.0,10.0,15.0,13.0,8.0,10.0,12.0,15.0,0.0,0.0,0.0,0.0,165.0,0.0,2.0,3.0,1.0,2.0,1.0,2.0,3.0,3.0,3.0,3.0,1.0,3.0,5.0,3.0,3.0,5.0,2.0,6.0,4.0,4.0,6.0,7.0,4.0,11.0,5.0,14.0,4.0,9.0,5.0,6.0,4.0,10.0,14.0,13.0,9.0,5.0,5.0,7.0,8.0,11.0,6.0,6.0,5.0,20.0,12.0,6.0,6.0,12.0,6.0,4.0,14.0,11.0,4.0,6.0,14.0,13.0,14.0,11.0,8.0,5.0,8.0,10.0
3,0,22.0,1.0,0.0,0.0,0.0,194.0,90.0,14.0,13.0,14.0,6.0,15.0,13.0,16.0,18.0,7.0,18.0,14.0,9.0,1.0,1.0,3.0,10.0,12.0,5.0,2.0,2.0,2.0,11.0,6.0,2.0,7.0,8.0,14.0,13.0,16.0,15.0,6.0,15.0,10.0,11.0,9.0,5.0,15.0,15.0,14.0,10.0,16.0,15.0,14.0,5.0,10.0,8.0,20.0,8.0,14.0,13.0,11.0,14.0,8.0,13.0,10.0,9.0,13.0,11.0,16.0,18.0,8.0,3.0,30.0,5.0,0.0,0.0,0.0,173.0,64.0,2.0,3.0,2.0,3.0,1.0,1.0,2.0,3.0,3.0,3.0,3.0,12.0,16.0,13.0,7.0,13.0,14.0,8.0,11.0,12.0,12.0,13.0,12.0,12.0,14.0,10.0,14.0,12.0,14.0,13.0,13.0,14.0,14.0,12.0,8.0,15.0,12.0,16.0,14.0,14.0,13.0,11.0,6.0,20.0,16.0,14.0,10.0,16.0,9.0,15.0,10.0,15.0,14.0,8.0,11.0,13.0,9.0,13.0,14.0,14.0,14.0,8.0,26.0,39.0,2.0,7.0,3.0,186.0,83.0,1.0,2.0,3.0,2.0,2.0,2.0,1.0,2.0,4.0,1.0,1.0,4.0,6.0,8.0,8.0,12.0,8.0,15.0,13.0,6.0,15.0,13.0,13.0,15.0,12.0,17.0,15.0,19.0,13.0,15.0,11.0,12.0,16.0,7.0,16.0,10.0,16.0,18.0,18.0,11.0,11.0,16.0,15.0,10.0,16.0,14.0,20.0,17.0,17.0,16.0,14.0,14.0,5.0,10.0,18.0,13.0,16.0,14.0,16.0,11.0,11.0,5.0,27.0,1.0,0.0,16.0,0.0,182.0,74.0,1.0,1.0,2.0,3.0,2.0,1.0,3.0,2.0,2.0,3.0,3.0,7.0,7.0,8.0,8.0,10.0,11.0,15.0,11.0,10.0,15.0,12.0,12.0,16.0,13.0,18.0,18.0,17.0,12.0,15.0,9.0,13.0,14.0,7.0,19.0,11.0,15.0,15.0,15.0,12.0,13.0,12.0,13.0,8.0,12.0,13.0,20.0,11.0,14.0,14.0,15.0,14.0,16.0,12.0,12.0,14.0,15.0,14.0,17.0,16.0,17.0,8.0,29.0,38.0,13.0,0.0,0.0,181.0,77.0,3.0,2.0,1.0,1.0,1.0,2.0,1.0,3.0,1.0,1.0,3.0,6.0,10.0,14.0,17.0,14.0,6.0,13.0,12.0,8.0,5.0,13.0,17.0,6.0,15.0,13.0,14.0,17.0,16.0,14.0,12.0,14.0,15.0,15.0,14.0,17.0,6.0,12.0,13.0,15.0,15.0,16.0,11.0,10.0,14.0,16.0,20.0,14.0,15.0,13.0,12.0,13.0,6.0,7.0,14.0,15.0,13.0,13.0,14.0,15.0,11.0,10.0,32.0,22.0,4.0,7.0,3.0,175.0,71.0,2.0,1.0,1.0,2.0,4.0,2.0,3.0,2.0,3.0,3.0,3.0,15.0,16.0,18.0,12.0,15.0,14.0,8.0,12.0,6.0,5.0,15.0,13.0,7.0,17.0,9.0,14.0,12.0,14.0,11.0,16.0,15.0,9.0,18.0,16.0,15.0,6.0,11.0,10.0,13.0,11.0,12.0,8.0,20.0,10.0,11.0,9.0,11.0,10.0,8.0,12.0,15.0,11.0,12.0,6.0,10.0,15.0,10.0,10.0,8.0,11.0,11.0,24.0,0.0,0.0,3.0,0.0,185.0,75.0,3.0,3.0,1.0,3.0,1.0,4.0,1.0,3.0,4.0,2.0,4.0,5.0,11.0,9.0,7.0,10.0,5.0,13.0,7.0,14.0,16.0,12.0,9.0,15.0,11.0,15.0,12.0,18.0,10.0,10.0,9.0,12.0,16.0,8.0,11.0,10.0,13.0,13.0,15.0,13.0,12.0,16.0,13.0,20.0,17.0,16.0,6.0,18.0,15.0,14.0,10.0,14.0,7.0,10.0,14.0,17.0,10.0,13.0,13.0,14.0,14.0,7.0,28.0,42.0,5.0,6.0,0.0,174.0,71.0,2.0,3.0,4.0,1.0,3.0,2.0,2.0,3.0,1.0,2.0,3.0,10.0,10.0,15.0,10.0,17.0,10.0,6.0,13.0,7.0,10.0,17.0,12.0,12.0,17.0,14.0,14.0,11.0,16.0,12.0,18.0,16.0,14.0,16.0,11.0,13.0,10.0,15.0,14.0,11.0,14.0,15.0,7.0,14.0,12.0,12.0,20.0,13.0,10.0,13.0,10.0,13.0,13.0,10.0,8.0,13.0,12.0,11.0,6.0,11.0,8.0,15.0,26.0,3.0,0.0,0.0,0.0,184.0,80.0,1.0,3.0,1.0,2.0,1.0,2.0,1.0,1.0,2.0,1.0,2.0,9.0,12.0,15.0,14.0,14.0,9.0,13.0,12.0,5.0,10.0,15.0,13.0,9.0,14.0,14.0,13.0,14.0,15.0,14.0,14.0,15.0,15.0,14.0,14.0,15.0,9.0,17.0,19.0,14.0,12.0,14.0,14.0,14.0,8.0,13.0,20.0,15.0,16.0,18.0,8.0,16.0,9.0,14.0,12.0,16.0,14.0,16.0,14.0,15.0,14.0,11.0,26.0,1.0,0.0,0.0,0.0,176.0,70.0,3.0,2.0,3.0,2.0,1.0,1.0,1.0,3.0,2.0,2.0,3.0,11.0,12.0,15.0,11.0,14.0,8.0,7.0,10.0,12.0,11.0,13.0,12.0,11.0,15.0,12.0,12.0,14.0,11.0,13.0,12.0,13.0,15.0,16.0,9.0,15.0,10.0,13.0,16.0,15.0,13.0,12.0,8.0,12.0,15.0,14.0,20.0,13.0,9.0,15.0,10.0,12.0,7.0,16.0,11.0,16.0,8.0,14.0,13.0,11.0,9.0,10.0,30.0,61.0,4.0,4.0,1.0,189.0,81.0,3.0,3.0,3.0,2.0,4.0,3.0,1.0,3.0,1.0,2.0,2.0,6.0,9.0,11.0,10.0,12.0,6.0,16.0,8.0,8.0,13.0,13.0,10.0,16.0,12.0,15.0,15.0,15.0,12.0,14.0,12.0,13.0,16.0,10.0,14.0,12.0,14.0,14.0,15.0,14.0,14.0,14.0,15.0,10.0,15.0,13.0,20.0,15.0,16.0,15.0,13.0,12.0,10.0,13.0,14.0,16.0,6.0,14.0,8.0,8.0,11.0,15.0,30.0,0.0,0.0,0.0,0.0,185.0,85.0,2.0,1.0,1.0,2.0,3.0,1.0,3.0,3.0,3.0,2.0,3.0,8.0,6.0,6.0,4.0,10.0,4.0,12.0,8.0,2.0,11.0,10.0,2.0,13.0,8.0,9.0,12.0,10.0,9.0,9.0,12.0,10.0,9.0,1.0,11.0,7.0,15.0,13.0,10.0,13.0,9.0,9.0,13.0,3.0,13.0,9.0,20.0,9.0,13.0,9.0,6.0,6.0,9.0,9.0,12.0,10.0,12.0,9.0,12.0,13.0,5.0,5.0,16.0,0.0,0.0,0.0,0.0,172.0,0.0,1.0,1.0,1.0,1.0,3.0,3.0,2.0,1.0,2.0,1.0,1.0,5.0,5.0,6.0,4.0,8.0,7.0,2.0,4.0,2.0,4.0,6.0,3.0,3.0,5.0,15.0,6.0,3.0,5.0,4.0,5.0,8.0,6.0,13.0,2.0,4.0,3.0,13.0,13.0,9.0,12.0,5.0,4.0,20.0,13.0,11.0,8.0,11.0,4.0,3.0,11.0,4.0,3.0,7.0,8.0,13.0,7.0,14.0,6.0,4.0,5.0,11.0,27.0,24.0,1.0,14.0,0.0,186.0,76.0,1.0,1.0,1.0,3.0,1.0,1.0,1.0,1.0,3.0,2.0,3.0,8.0,13.0,13.0,9.0,15.0,10.0,13.0,11.0,7.0,13.0,16.0,11.0,15.0,15.0,11.0,15.0,12.0,15.0,10.0,14.0,13.0,12.0,14.0,13.0,9.0,13.0,16.0,13.0,12.0,13.0,14.0,12.0,12.0,13.0,13.0,20.0,15.0,13.0,13.0,12.0,8.0,7.0,12.0,12.0,12.0,8.0,12.0,15.0,16.0,19.0,2.0,16.0,0.0,0.0,0.0,0.0,175.0,0.0,7.0,9.0,7.0,10.0,10.0,4.0,3.0,10.0,14.0,6.0,4.0,3.0,3.0,1.0,2.0,1.0,5.0,1.0,1.0,3.0,3.0,1.0,1.0,3.0,3.0,7.0,4.0,11.0,4.0,5.0,4.0,9.0,8.0,1.0,5.0,3.0,7.0,6.0,9.0,12.0,6.0,8.0,8.0,9.0,13.0,11.0,20.0,5.0,4.0,11.0,8.0,11.0,3.0,3.0,11.0,15.0,5.0,10.0,9.0,10.0,3.0,7.0,22.0,0.0,0.0,0.0,0.0,174.0,70.0,2.0,1.0,2.0,1.0,2.0,2.0,3.0,2.0,2.0,2.0,3.0,13.0,12.0,13.0,9.0,13.0,8.0,6.0,8.0,3.0,3.0,12.0,6.0,3.0,13.0,10.0,10.0,8.0,9.0,6.0,11.0,9.0,8.0,14.0,3.0,12.0,6.0,8.0,8.0,14.0,15.0,8.0,8.0,20.0,8.0,14.0,15.0,8.0,8.0,8.0,8.0,1.0,6.0,11.0,13.0,9.0,12.0,10.0,12.0,12.0,14.0,13.0,28.0,0.0,0.0,0.0,0.0,182.0,71.0,3.0,4.0,2.0,3.0,2.0,1.0,4.0,1.0,2.0,4.0,1.0,2.0,5.0,2.0,3.0,7.0,5.0,11.0,3.0,8.0,10.0,7.0,5.0,11.0,5.0,10.0,10.0,10.0,11.0,13.0,4.0,10.0,9.0,1.0,5.0,2.0,11.0,12.0,10.0,9.0,10.0,10.0,11.0,9.0,11.0,9.0,20.0,12.0,15.0,10.0,5.0,9.0,3.0,8.0,13.0,11.0,10.0,12.0,14.0,11.0,18.0,7.0,31.0,1.0,0.0,0.0,0.0,175.0,73.0,1.0,2.0,4.0,3.0,3.0,4.0,1.0,1.0,2.0,1.0,2.0,16.0,14.0,14.0,10.0,17.0,12.0,6.0,10.0,3.0,9.0,18.0,11.0,12.0,16.0,12.0,17.0,12.0,15.0,14.0,17.0,15.0,13.0,16.0,13.0,15.0,13.0,17.0,14.0,12.0,14.0,12.0,7.0,12.0,15.0,13.0,20.0,12.0,10.0,12.0,9.0,13.0,5.0,14.0,16.0,14.0,14.0,15.0,18.0,14.0,14.0,3.0,25.0,0.0,0.0,0.0,0.0,188.0,81.0,1.0,3.0,3.0,1.0,3.0,2.0,2.0,3.0,4.0,1.0,1.0,14.0,15.0,12.0,10.0,13.0,15.0,12.0,14.0,12.0,13.0,14.0,12.0,14.0,13.0,12.0,14.0,12.0,14.0,12.0,13.0,13.0,13.0,12.0,9.0,14.0,13.0,13.0,14.0,12.0,12.0,15.0,13.0,20.0,14.0,13.0,9.0,16.0,15.0,14.0,9.0,13.0,7.0,13.0,13.0,14.0,12.0,13.0,14.0,13.0,12.0,10.0,30.0,0.0,0.0,0.0,0.0,174.0,70.0,3.0,3.0,2.0,3.0,3.0,1.0,2.0,2.0,1.0,2.0,1.0,10.0,9.0,12.0,10.0,11.0,13.0,9.0,9.0,5.0,10.0,9.0,10.0,7.0,12.0,10.0,12.0,11.0,11.0,11.0,11.0,12.0,11.0,10.0,10.0,12.0,11.0,11.0,12.0,11.0,10.0,11.0,10.0,20.0,13.0,11.0,11.0,11.0,10.0,12.0,3.0,10.0,10.0,15.0,11.0,11.0,11.0,9.0,12.0,8.0,11.0,10.0,28.0,22.0,0.0,9.0,1.0,184.0,79.0,3.0,2.0,1.0,1.0,3.0,3.0,1.0,3.0,2.0,3.0,3.0,6.0,12.0,11.0,8.0,13.0,7.0,13.0,8.0,12.0,14.0,12.0,8.0,13.0,12.0,15.0,14.0,15.0,15.0,13.0,11.0,13.0,14.0,10.0,11.0,10.0,15.0,15.0,15.0,14.0,13.0,14.0,12.0,9.0,15.0,14.0,20.0,15.0,15.0,14.0,13.0,13.0,7.0,13.0,13.0,14.0,15.0,14.0,13.0,11.0,13.0,6.0,24.0,42.0,25.0,11.0,4.0,175.0,72.0,3.0,3.0,3.0,4.0,1.0,3.0,1.0,1.0,2.0,3.0,3.0,6.0,12.0,16.0,15.0,16.0,6.0,5.0,12.0,3.0,4.0,12.0,11.0,6.0,15.0,8.0,16.0,7.0,13.0,11.0,12.0,13.0,13.0,17.0,5.0,17.0,7.0,10.0,10.0,18.0,17.0,11.0,6.0,20.0,14.0,18.0,9.0,14.0,8.0,14.0,4.0,16.0,6.0,14.0,15.0,17.0,10.0,14.0,11.0,10.0,14.0,9.0
0,2,30.0,0.0,0.0,0.0,0.0,185.0,85.0,2.0,1.0,1.0,2.0,3.0,1.0,3.0,3.0,3.0,2.0,3.0,8.0,6.0,6.0,4.0,10.0,4.0,12.0,8.0,2.0,11.0,10.0,2.0,13.0,8.0,9.0,12.0,10.0,9.0,9.0,12.0,10.0,9.0,1.0,11.0,7.0,15.0,13.0,10.0,13.0,9.0,9.0,13.0,3.0,13.0,9.0,20.0,9.0,13.0,9.0,6.0,6.0,9.0,9.0,12.0,10.0,12.0,9.0,12.0,13.0,5.0,5.0,16.0,0.0,0.0,0.0,0.0,172.0,0.0,1.0,1.0,1.0,1.0,3.0,3.0,2.0,1.0,2.0,1.0,1.0,5.0,5.0,6.0,4.0,8.0,7.0,2.0,4.0,2.0,4.0,6.0,3.0,3.0,5.0,15.0,6.0,3.0,5.0,4.0,5.0,8.0,6.0,13.0,2.0,4.0,3.0,13.0,13.0,9.0,12.0,5.0,4.0,20.0,13.0,11.0,8.0,11.0,4.0,3.0,11.0,4.0,3.0,7.0,8.0,13.0,7.0,14.0,6.0,4.0,5.0,11.0,36.0,46.0,2.0,0.0,0.0,170.0,65.0,3.0,3.0,2.0,3.0,1.0,3.0,3.0,3.0,1.0,1.0,3.0,15.0,13.0,14.0,10.0,16.0,14.0,6.0,12.0,7.0,11.0,16.0,13.0,13.0,16.0,14.0,14.0,15.0,13.0,13.0,16.0,14.0,15.0,14.0,14.0,11.0,13.0,16.0,8.0,9.0,8.0,11.0,5.0,12.0,7.0,9.0,20.0,7.0,9.0,14.0,14.0,13.0,18.0,10.0,12.0,13.0,13.0,14.0,15.0,12.0,5.0,13.0,16.0,0.0,0.0,0.0,0.0,175.0,0.0,7.0,9.0,7.0,10.0,10.0,4.0,3.0,10.0,14.0,6.0,4.0,3.0,3.0,1.0,2.0,1.0,5.0,1.0,1.0,3.0,3.0,1.0,1.0,3.0,3.0,7.0,4.0,11.0,4.0,5.0,4.0,9.0,8.0,1.0,5.0,3.0,7.0,6.0,9.0,12.0,6.0,8.0,8.0,9.0,13.0,11.0,20.0,5.0,4.0,11.0,8.0,11.0,3.0,3.0,11.0,15.0,5.0,10.0,9.0,10.0,3.0,7.0,22.0,0.0,0.0,0.0,0.0,174.0,70.0,2.0,1.0,2.0,1.0,2.0,2.0,3.0,2.0,2.0,2.0,3.0,13.0,12.0,13.0,9.0,13.0,8.0,6.0,8.0,3.0,3.0,12.0,6.0,3.0,13.0,10.0,10.0,8.0,9.0,6.0,11.0,9.0,8.0,14.0,3.0,12.0,6.0,8.0,8.0,14.0,15.0,8.0,8.0,20.0,8.0,14.0,15.0,8.0,8.0,8.0,8.0,1.0,6.0,11.0,13.0,9.0,12.0,10.0,12.0,12.0,14.0,13.0,28.0,0.0,0.0,0.0,0.0,182.0,71.0,3.0,4.0,2.0,3.0,2.0,1.0,4.0,1.0,2.0,4.0,1.0,2.0,5.0,2.0,3.0,7.0,5.0,11.0,3.0,8.0,10.0,7.0,5.0,11.0,5.0,10.0,10.0,10.0,11.0,13.0,4.0,10.0,9.0,1.0,5.0,2.0,11.0,12.0,10.0,9.0,10.0,10.0,11.0,9.0,11.0,9.0,20.0,12.0,15.0,10.0,5.0,9.0,3.0,8.0,13.0,11.0,10.0,12.0,14.0,11.0,18.0,7.0,32.0,12.0,0.0,0.0,0.0,188.0,78.0,2.0,1.0,3.0,3.0,3.0,2.0,3.0,1.0,1.0,3.0,1.0,3.0,6.0,11.0,8.0,11.0,3.0,15.0,6.0,9.0,15.0,11.0,5.0,16.0,12.0,13.0,15.0,14.0,13.0,14.0,10.0,13.0,15.0,9.0,14.0,7.0,15.0,13.0,14.0,12.0,14.0,15.0,14.0,20.0,15.0,14.0,10.0,15.0,14.0,15.0,12.0,14.0,8.0,10.0,14.0,13.0,13.0,13.0,14.0,14.0,13.0,4.0,31.0,1.0,0.0,0.0,0.0,175.0,73.0,1.0,2.0,4.0,3.0,3.0,4.0,1.0,1.0,2.0,1.0,2.0,16.0,14.0,14.0,10.0,17.0,12.0,6.0,10.0,3.0,9.0,18.0,11.0,12.0,16.0,12.0,17.0,12.0,15.0,14.0,17.0,15.0,13.0,16.0,13.0,15.0,13.0,17.0,14.0,12.0,14.0,12.0,7.0,12.0,15.0,13.0,20.0,12.0,10.0,12.0,9.0,13.0,5.0,14.0,16.0,14.0,14.0,15.0,18.0,14.0,14.0,3.0,25.0,0.0,0.0,0.0,0.0,188.0,81.0,1.0,3.0,3.0,1.0,3.0,2.0,2.0,3.0,4.0,1.0,1.0,14.0,15.0,12.0,10.0,13.0,15.0,12.0,14.0,12.0,13.0,14.0,12.0,14.0,13.0,12.0,14.0,12.0,14.0,12.0,13.0,13.0,13.0,12.0,9.0,14.0,13.0,13.0,14.0,12.0,12.0,15.0,13.0,20.0,14.0,13.0,9.0,16.0,15.0,14.0,9.0,13.0,7.0,13.0,13.0,14.0,12.0,13.0,14.0,13.0,12.0,10.0,28.0,43.0,2.0,5.0,0.0,190.0,79.0,3.0,1.0,4.0,2.0,3.0,3.0,2.0,1.0,3.0,3.0,1.0,15.0,13.0,14.0,14.0,15.0,15.0,9.0,16.0,5.0,6.0,15.0,16.0,9.0,16.0,13.0,15.0,7.0,14.0,11.0,14.0,15.0,14.0,15.0,11.0,16.0,11.0,11.0,11.0,12.0,13.0,13.0,14.0,20.0,12.0,13.0,12.0,14.0,13.0,12.0,10.0,14.0,7.0,15.0,14.0,14.0,14.0,13.0,16.0,15.0,12.0,7.0,24.0,42.0,25.0,11.0,4.0,175.0,72.0,3.0,3.0,3.0,4.0,1.0,3.0,1.0,1.0,2.0,3.0,3.0,6.0,12.0,16.0,15.0,16.0,6.0,5.0,12.0,3.0,4.0,12.0,11.0,6.0,15.0,8.0,16.0,7.0,13.0,11.0,12.0,13.0,13.0,17.0,5.0,17.0,7.0,10.0,10.0,18.0,17.0,11.0,6.0,20.0,14.0,18.0,9.0,14.0,8.0,14.0,4.0,16.0,6.0,14.0,15.0,17.0,10.0,14.0,11.0,10.0,14.0,9.0,22.0,1.0,0.0,0.0,0.0,194.0,90.0,14.0,13.0,14.0,6.0,15.0,13.0,16.0,18.0,7.0,18.0,14.0,9.0,1.0,1.0,3.0,10.0,12.0,5.0,2.0,2.0,2.0,11.0,6.0,2.0,7.0,8.0,14.0,13.0,16.0,15.0,6.0,15.0,10.0,11.0,9.0,5.0,15.0,15.0,14.0,10.0,16.0,15.0,14.0,5.0,10.0,8.0,20.0,8.0,14.0,13.0,11.0,14.0,8.0,13.0,10.0,9.0,13.0,11.0,16.0,18.0,8.0,3.0,30.0,5.0,0.0,0.0,0.0,173.0,64.0,2.0,3.0,2.0,3.0,1.0,1.0,2.0,3.0,3.0,3.0,3.0,12.0,16.0,13.0,7.0,13.0,14.0,8.0,11.0,12.0,12.0,13.0,12.0,12.0,14.0,10.0,14.0,12.0,14.0,13.0,13.0,14.0,14.0,12.0,8.0,15.0,12.0,16.0,14.0,14.0,13.0,11.0,6.0,20.0,16.0,14.0,10.0,16.0,9.0,15.0,10.0,15.0,14.0,8.0,11.0,13.0,9.0,13.0,14.0,14.0,14.0,8.0,26.0,39.0,2.0,7.0,3.0,186.0,83.0,1.0,2.0,3.0,2.0,2.0,2.0,1.0,2.0,4.0,1.0,1.0,4.0,6.0,8.0,8.0,12.0,8.0,15.0,13.0,6.0,15.0,13.0,13.0,15.0,12.0,17.0,15.0,19.0,13.0,15.0,11.0,12.0,16.0,7.0,16.0,10.0,16.0,18.0,18.0,11.0,11.0,16.0,15.0,10.0,16.0,14.0,20.0,17.0,17.0,16.0,14.0,14.0,5.0,10.0,18.0,13.0,16.0,14.0,16.0,11.0,11.0,5.0,27.0,1.0,0.0,16.0,0.0,182.0,74.0,1.0,1.0,2.0,3.0,2.0,1.0,3.0,2.0,2.0,3.0,3.0,7.0,7.0,8.0,8.0,10.0,11.0,15.0,11.0,10.0,15.0,12.0,12.0,16.0,13.0,18.0,18.0,17.0,12.0,15.0,9.0,13.0,14.0,7.0,19.0,11.0,15.0,15.0,15.0,12.0,13.0,12.0,13.0,8.0,12.0,13.0,20.0,11.0,14.0,14.0,15.0,14.0,16.0,12.0,12.0,14.0,15.0,14.0,17.0,16.0,17.0,8.0,29.0,38.0,13.0,0.0,0.0,181.0,77.0,3.0,2.0,1.0,1.0,1.0,2.0,1.0,3.0,1.0,1.0,3.0,6.0,10.0,14.0,17.0,14.0,6.0,13.0,12.0,8.0,5.0,13.0,17.0,6.0,15.0,13.0,14.0,17.0,16.0,14.0,12.0,14.0,15.0,15.0,14.0,17.0,6.0,12.0,13.0,15.0,15.0,16.0,11.0,10.0,14.0,16.0,20.0,14.0,15.0,13.0,12.0,13.0,6.0,7.0,14.0,15.0,13.0,13.0,14.0,15.0,11.0,10.0,24.0,0.0,0.0,3.0,0.0,185.0,75.0,3.0,3.0,1.0,3.0,1.0,4.0,1.0,3.0,4.0,2.0,4.0,5.0,11.0,9.0,7.0,10.0,5.0,13.0,7.0,14.0,16.0,12.0,9.0,15.0,11.0,15.0,12.0,18.0,10.0,10.0,9.0,12.0,16.0,8.0,11.0,10.0,13.0,13.0,15.0,13.0,12.0,16.0,13.0,20.0,17.0,16.0,6.0,18.0,15.0,14.0,10.0,14.0,7.0,10.0,14.0,17.0,10.0,13.0,13.0,14.0,14.0,7.0,28.0,42.0,5.0,6.0,0.0,174.0,71.0,2.0,3.0,4.0,1.0,3.0,2.0,2.0,3.0,1.0,2.0,3.0,10.0,10.0,15.0,10.0,17.0,10.0,6.0,13.0,7.0,10.0,17.0,12.0,12.0,17.0,14.0,14.0,11.0,16.0,12.0,18.0,16.0,14.0,16.0,11.0,13.0,10.0,15.0,14.0,11.0,14.0,15.0,7.0,14.0,12.0,12.0,20.0,13.0,10.0,13.0,10.0,13.0,13.0,10.0,8.0,13.0,12.0,11.0,6.0,11.0,8.0,15.0,26.0,3.0,0.0,0.0,0.0,184.0,80.0,1.0,3.0,1.0,2.0,1.0,2.0,1.0,1.0,2.0,1.0,2.0,9.0,12.0,15.0,14.0,14.0,9.0,13.0,12.0,5.0,10.0,15.0,13.0,9.0,14.0,14.0,13.0,14.0,15.0,14.0,14.0,15.0,15.0,14.0,14.0,15.0,9.0,17.0,19.0,14.0,12.0,14.0,14.0,14.0,8.0,13.0,20.0,15.0,16.0,18.0,8.0,16.0,9.0,14.0,12.0,16.0,14.0,16.0,14.0,15.0,14.0,11.0,26.0,1.0,0.0,0.0,0.0,176.0,70.0,3.0,2.0,3.0,2.0,1.0,1.0,1.0,3.0,2.0,2.0,3.0,11.0,12.0,15.0,11.0,14.0,8.0,7.0,10.0,12.0,11.0,13.0,12.0,11.0,15.0,12.0,12.0,14.0,11.0,13.0,12.0,13.0,15.0,16.0,9.0,15.0,10.0,13.0,16.0,15.0,13.0,12.0,8.0,12.0,15.0,14.0,20.0,13.0,9.0,15.0,10.0,12.0,7.0,16.0,11.0,16.0,8.0,14.0,13.0,11.0,9.0,10.0,29.0,0.0,0.0,0.0,0.0,177.0,74.0,2.0,2.0,2.0,2.0,1.0,3.0,3.0,1.0,1.0,1.0,2.0,8.0,12.0,10.0,13.0,11.0,8.0,15.0,12.0,14.0,10.0,10.0,12.0,13.0,11.0,17.0,13.0,16.0,12.0,14.0,10.0,11.0,18.0,11.0,18.0,15.0,10.0,13.0,17.0,14.0,13.0,15.0,11.0,12.0,14.0,13.0,20.0,16.0,11.0,16.0,9.0,18.0,8.0,15.0,10.0,15.0,15.0,16.0,18.0,14.0,10.0,5.0,30.0,61.0,4.0,4.0,1.0,189.0,81.0,3.0,3.0,3.0,2.0,4.0,3.0,1.0,3.0,1.0,2.0,2.0,6.0,9.0,11.0,10.0,12.0,6.0,16.0,8.0,8.0,13.0,13.0,10.0,16.0,12.0,15.0,15.0,15.0,12.0,14.0,12.0,13.0,16.0,10.0,14.0,12.0,14.0,14.0,15.0,14.0,14.0,14.0,15.0,10.0,15.0,13.0,20.0,15.0,16.0,15.0,13.0,12.0,10.0,13.0,14.0,16.0,6.0,14.0,8.0,8.0,11.0,15.0
1,4,35.0,0.0,0.0,8.0,0.0,181.0,83.0,11.0,10.0,11.0,6.0,12.0,9.0,13.0,12.0,12.0,13.0,10.0,5.0,3.0,1.0,1.0,5.0,7.0,1.0,1.0,2.0,1.0,2.0,4.0,1.0,6.0,10.0,9.0,10.0,9.0,10.0,1.0,10.0,15.0,1.0,8.0,1.0,11.0,2.0,6.0,9.0,12.0,11.0,10.0,9.0,12.0,8.0,20.0,6.0,6.0,11.0,6.0,9.0,7.0,9.0,10.0,12.0,18.0,14.0,16.0,12.0,14.0,5.0,24.0,0.0,0.0,1.0,0.0,183.0,74.0,1.0,2.0,1.0,3.0,3.0,2.0,3.0,3.0,3.0,1.0,2.0,2.0,7.0,6.0,10.0,5.0,1.0,4.0,5.0,5.0,8.0,7.0,5.0,8.0,6.0,9.0,8.0,8.0,8.0,5.0,7.0,9.0,3.0,12.0,15.0,6.0,7.0,8.0,11.0,13.0,12.0,8.0,8.0,20.0,14.0,13.0,9.0,11.0,10.0,9.0,9.0,9.0,9.0,14.0,14.0,10.0,18.0,11.0,15.0,12.0,12.0,4.0,32.0,0.0,0.0,0.0,0.0,171.0,0.0,3.0,1.0,1.0,1.0,4.0,3.0,2.0,1.0,2.0,1.0,3.0,8.0,6.0,4.0,4.0,5.0,6.0,13.0,8.0,7.0,10.0,9.0,5.0,12.0,7.0,17.0,6.0,17.0,6.0,7.0,6.0,7.0,17.0,5.0,12.0,5.0,7.0,13.0,13.0,10.0,9.0,8.0,14.0,10.0,7.0,11.0,20.0,8.0,11.0,15.0,6.0,9.0,2.0,15.0,20.0,8.0,8.0,7.0,15.0,13.0,12.0,2.0,23.0,0.0,0.0,0.0,0.0,188.0,80.0,2.0,2.0,2.0,2.0,3.0,3.0,2.0,4.0,3.0,1.0,2.0,3.0,4.0,8.0,6.0,10.0,4.0,10.0,5.0,5.0,13.0,11.0,6.0,10.0,11.0,14.0,11.0,13.0,5.0,13.0,11.0,6.0,17.0,7.0,11.0,8.0,11.0,12.0,12.0,10.0,8.0,11.0,15.0,5.0,13.0,9.0,20.0,13.0,12.0,15.0,4.0,16.0,7.0,4.0,4.0,15.0,19.0,14.0,15.0,14.0,14.0,6.0,28.0,0.0,0.0,0.0,0.0,188.0,85.0,1.0,2.0,4.0,3.0,3.0,3.0,2.0,2.0,2.0,1.0,3.0,4.0,4.0,5.0,4.0,6.0,8.0,8.0,6.0,6.0,12.0,8.0,8.0,9.0,11.0,11.0,9.0,8.0,7.0,9.0,11.0,9.0,16.0,6.0,8.0,7.0,11.0,9.0,11.0,11.0,7.0,7.0,12.0,10.0,10.0,11.0,20.0,10.0,13.0,12.0,11.0,9.0,9.0,5.0,15.0,12.0,13.0,6.0,6.0,9.0,6.0,16.0,23.0,0.0,0.0,0.0,0.0,178.0,69.0,2.0,1.0,2.0,1.0,3.0,1.0,3.0,1.0,1.0,1.0,1.0,7.0,9.0,8.0,5.0,8.0,6.0,3.0,4.0,3.0,4.0,5.0,2.0,2.0,9.0,8.0,8.0,3.0,10.0,7.0,9.0,7.0,7.0,8.0,5.0,8.0,6.0,8.0,12.0,14.0,14.0,7.0,5.0,9.0,13.0,14.0,20.0,7.0,5.0,8.0,8.0,8.0,4.0,8.0,14.0,11.0,10.0,12.0,12.0,12.0,19.0,7.0,34.0,0.0,0.0,1.0,0.0,183.0,85.0,2.0,1.0,3.0,2.0,2.0,3.0,3.0,1.0,1.0,3.0,2.0,7.0,10.0,12.0,8.0,9.0,10.0,10.0,12.0,8.0,11.0,12.0,10.0,12.0,10.0,11.0,12.0,9.0,11.0,10.0,8.0,10.0,11.0,10.0,12.0,12.0,11.0,10.0,12.0,12.0,12.0,12.0,10.0,20.0,10.0,11.0,9.0,11.0,8.0,14.0,3.0,15.0,9.0,12.0,8.0,14.0,8.0,15.0,14.0,12.0,12.0,10.0,21.0,0.0,0.0,0.0,0.0,170.0,0.0,2.0,3.0,1.0,3.0,1.0,3.0,1.0,3.0,2.0,1.0,3.0,3.0,4.0,1.0,1.0,9.0,5.0,7.0,6.0,3.0,8.0,8.0,1.0,9.0,5.0,5.0,9.0,6.0,7.0,6.0,9.0,11.0,2.0,7.0,2.0,4.0,8.0,6.0,7.0,14.0,11.0,6.0,7.0,20.0,12.0,13.0,10.0,4.0,7.0,7.0,6.0,2.0,6.0,7.0,13.0,11.0,10.0,12.0,8.0,10.0,15.0,7.0,22.0,0.0,0.0,0.0,0.0,183.0,77.0,1.0,3.0,1.0,2.0,2.0,2.0,1.0,3.0,3.0,3.0,4.0,6.0,8.0,4.0,7.0,11.0,6.0,2.0,4.0,1.0,7.0,11.0,3.0,7.0,14.0,8.0,3.0,6.0,8.0,7.0,6.0,8.0,6.0,8.0,9.0,8.0,8.0,7.0,8.0,12.0,14.0,7.0,7.0,8.0,14.0,14.0,20.0,9.0,9.0,8.0,8.0,3.0,5.0,8.0,16.0,12.0,10.0,9.0,10.0,12.0,19.0,8.0,20.0,0.0,0.0,0.0,0.0,183.0,71.0,2.0,2.0,2.0,1.0,1.0,3.0,1.0,2.0,2.0,2.0,2.0,6.0,11.0,13.0,6.0,12.0,3.0,9.0,7.0,3.0,5.0,7.0,1.0,1.0,7.0,8.0,5.0,7.0,5.0,7.0,8.0,6.0,6.0,7.0,5.0,8.0,5.0,6.0,7.0,13.0,11.0,6.0,10.0,20.0,9.0,12.0,8.0,4.0,9.0,8.0,8.0,8.0,8.0,8.0,2.0,8.0,6.0,5.0,9.0,9.0,7.0,13.0,21.0,0.0,0.0,0.0,0.0,181.0,73.0,3.0,2.0,1.0,1.0,1.0,1.0,2.0,1.0,2.0,2.0,3.0,6.0,8.0,8.0,5.0,6.0,6.0,1.0,5.0,4.0,6.0,6.0,1.0,8.0,10.0,8.0,10.0,7.0,8.0,4.0,7.0,8.0,1.0,4.0,7.0,5.0,8.0,8.0,8.0,14.0,13.0,5.0,7.0,20.0,10.0,13.0,8.0,4.0,7.0,8.0,8.0,1.0,8.0,8.0,15.0,10.0,13.0,11.0,13.0,11.0,16.0,6.0,32.0,0.0,0.0,1.0,0.0,188.0,84.0,15.0,13.0,14.0,1.0,13.0,14.0,10.0,14.0,10.0,5.0,11.0,6.0,2.0,1.0,1.0,7.0,10.0,1.0,2.0,2.0,1.0,3.0,3.0,1.0,2.0,9.0,13.0,12.0,11.0,11.0,10.0,15.0,8.0,2.0,10.0,3.0,15.0,11.0,10.0,13.0,8.0,9.0,10.0,2.0,16.0,9.0,20.0,10.0,12.0,11.0,4.0,9.0,7.0,10.0,17.0,9.0,14.0,11.0,12.0,9.0,20.0,8.0,21.0,4.0,0.0,14.0,3.0,187.0,80.0,2.0,1.0,2.0,3.0,1.0,2.0,2.0,1.0,3.0,2.0,3.0,5.0,8.0,10.0,10.0,12.0,7.0,14.0,8.0,11.0,14.0,12.0,9.0,15.0,11.0,13.0,15.0,12.0,11.0,10.0,10.0,11.0,16.0,6.0,12.0,10.0,16.0,12.0,14.0,12.0,10.0,12.0,13.0,20.0,12.0,13.0,8.0,15.0,12.0,14.0,10.0,8.0,8.0,10.0,10.0,12.0,12.0,10.0,16.0,12.0,8.0,8.0,20.0,0.0,0.0,5.0,0.0,170.0,71.0,2.0,2.0,3.0,2.0,3.0,2.0,2.0,3.0,1.0,1.0,3.0,8.0,10.0,12.0,9.0,14.0,8.0,8.0,14.0,8.0,4.0,10.0,6.0,9.0,11.0,10.0,9.0,9.0,10.0,7.0,14.0,10.0,10.0,10.0,2.0,10.0,7.0,9.0,15.0,13.0,11.0,9.0,6.0,11.0,12.0,11.0,20.0,15.0,6.0,10.0,4.0,5.0,10.0,10.0,8.0,10.0,9.0,11.0,13.0,3.0,15.0,2.0,23.0,0.0,0.0,23.0,3.0,184.0,74.0,2.0,1.0,2.0,3.0,3.0,3.0,1.0,1.0,2.0,2.0,3.0,10.0,15.0,12.0,11.0,15.0,10.0,15.0,8.0,4.0,11.0,13.0,8.0,10.0,15.0,10.0,11.0,4.0,10.0,12.0,12.0,15.0,3.0,11.0,6.0,11.0,11.0,11.0,12.0,15.0,10.0,11.0,7.0,11.0,14.0,13.0,20.0,9.0,10.0,10.0,11.0,1.0,11.0,11.0,7.0,11.0,12.0,11.0,9.0,4.0,20.0,2.0,25.0,0.0,0.0,0.0,0.0,184.0,75.0,3.0,1.0,1.0,2.0,1.0,3.0,2.0,1.0,3.0,2.0,2.0,8.0,12.0,13.0,14.0,14.0,3.0,13.0,11.0,3.0,6.0,13.0,10.0,7.0,12.0,13.0,13.0,14.0,8.0,11.0,13.0,15.0,13.0,14.0,3.0,15.0,5.0,12.0,14.0,12.0,12.0,10.0,12.0,11.0,12.0,13.0,20.0,10.0,14.0,8.0,7.0,9.0,7.0,11.0,8.0,13.0,11.0,12.0,11.0,12.0,11.0,6.0,33.0,34.0,1.0,12.0,0.0,171.0,73.0,2.0,1.0,3.0,2.0,2.0,1.0,2.0,3.0,2.0,1.0,1.0,11.0,11.0,10.0,9.0,12.0,10.0,9.0,12.0,8.0,13.0,16.0,3.0,14.0,12.0,8.0,14.0,11.0,12.0,12.0,16.0,14.0,11.0,12.0,14.0,8.0,12.0,17.0,15.0,9.0,7.0,14.0,8.0,12.0,12.0,10.0,20.0,15.0,14.0,15.0,11.0,15.0,15.0,6.0,14.0,11.0,12.0,11.0,9.0,2.0,12.0,5.0,20.0,0.0,0.0,3.0,0.0,182.0,74.0,2.0,2.0,2.0,3.0,2.0,1.0,3.0,2.0,4.0,3.0,2.0,10.0,15.0,12.0,11.0,11.0,7.0,8.0,10.0,4.0,6.0,12.0,6.0,5.0,13.0,10.0,10.0,8.0,9.0,7.0,11.0,8.0,10.0,12.0,7.0,12.0,7.0,11.0,9.0,12.0,13.0,9.0,11.0,8.0,7.0,14.0,20.0,9.0,7.0,11.0,7.0,10.0,14.0,10.0,16.0,10.0,11.0,10.0,13.0,8.0,11.0,2.0,20.0,0.0,0.0,3.0,2.0,190.0,76.0,2.0,3.0,3.0,1.0,2.0,1.0,1.0,2.0,2.0,1.0,2.0,4.0,1.0,4.0,5.0,9.0,1.0,14.0,5.0,5.0,12.0,8.0,3.0,15.0,4.0,10.0,11.0,10.0,7.0,6.0,7.0,14.0,10.0,1.0,3.0,8.0,15.0,8.0,9.0,13.0,12.0,9.0,16.0,11.0,12.0,12.0,20.0,6.0,9.0,10.0,8.0,7.0,10.0,10.0,13.0,12.0,11.0,12.0,10.0,12.0,12.0,4.0,23.0,0.0,0.0,4.0,0.0,184.0,78.0,1.0,3.0,2.0,2.0,1.0,3.0,2.0,3.0,2.0,1.0,3.0,8.0,10.0,11.0,5.0,12.0,3.0,10.0,7.0,6.0,12.0,11.0,7.0,16.0,12.0,10.0,10.0,10.0,11.0,11.0,10.0,12.0,2.0,10.0,6.0,11.0,9.0,11.0,11.0,11.0,12.0,12.0,13.0,20.0,12.0,11.0,10.0,10.0,10.0,10.0,5.0,10.0,6.0,10.0,11.0,10.0,9.0,10.0,11.0,10.0,19.0,7.0,18.0,0.0,0.0,1.0,0.0,181.0,72.0,2.0,1.0,3.0,3.0,1.0,2.0,3.0,3.0,1.0,4.0,1.0,16.0,16.0,10.0,12.0,13.0,14.0,8.0,13.0,5.0,7.0,15.0,12.0,7.0,15.0,14.0,11.0,10.0,13.0,8.0,16.0,11.0,10.0,15.0,7.0,10.0,8.0,12.0,14.0,12.0,13.0,9.0,10.0,20.0,15.0,10.0,8.0,12.0,7.0,10.0,10.0,10.0,8.0,13.0,12.0,15.0,8.0,12.0,13.0,10.0,15.0,7.0,28.0,0.0,0.0,0.0,0.0,176.0,81.0,2.0,2.0,2.0,1.0,2.0,1.0,1.0,2.0,1.0,1.0,2.0,9.0,12.0,10.0,9.0,10.0,6.0,11.0,13.0,11.0,14.0,12.0,4.0,13.0,11.0,6.0,10.0,11.0,11.0,12.0,8.0,13.0,14.0,12.0,10.0,6.0,13.0,12.0,12.0,14.0,11.0,9.0,8.0,11.0,9.0,13.0,20.0,13.0,9.0,14.0,11.0,5.0,6.0,11.0,8.0,12.0,19.0,11.0,9.0,11.0,16.0,6.0
0,4,30.0,6.0,0.0,10.0,0.0,195.0,91.0,15.0,16.0,15.0,10.0,15.0,16.0,16.0,16.0,13.0,8.0,16.0,5.0,3.0,3.0,2.0,10.0,10.0,10.0,1.0,1.0,1.0,8.0,2.0,1.0,4.0,8.0,13.0,14.0,11.0,11.0,8.0,11.0,15.0,8.0,15.0,14.0,12.0,12.0,14.0,7.0,14.0,16.0,15.0,20.0,12.0,12.0,6.0,13.0,11.0,14.0,2.0,16.0,5.0,12.0,15.0,12.0,11.0,11.0,15.0,7.0,11.0,15.0,20.0,0.0,0.0,0.0,0.0,172.0,0.0,2.0,2.0,1.0,3.0,1.0,3.0,3.0,2.0,3.0,1.0,3.0,5.0,5.0,9.0,6.0,12.0,4.0,5.0,6.0,2.0,3.0,5.0,3.0,4.0,7.0,8.0,6.0,3.0,5.0,4.0,3.0,11.0,4.0,8.0,8.0,6.0,5.0,6.0,6.0,13.0,13.0,6.0,2.0,8.0,10.0,12.0,20.0,7.0,3.0,8.0,8.0,5.0,8.0,8.0,19.0,12.0,13.0,13.0,8.0,12.0,13.0,3.0,16.0,0.0,0.0,0.0,0.0,188.0,0.0,1.0,3.0,1.0,1.0,1.0,2.0,3.0,2.0,1.0,3.0,1.0,4.0,4.0,4.0,4.0,7.0,4.0,3.0,2.0,4.0,6.0,5.0,2.0,9.0,5.0,9.0,8.0,8.0,4.0,6.0,4.0,8.0,6.0,2.0,8.0,4.0,7.0,18.0,15.0,8.0,7.0,11.0,14.0,20.0,11.0,7.0,6.0,10.0,9.0,4.0,13.0,12.0,5.0,8.0,9.0,20.0,13.0,13.0,13.0,14.0,13.0,10.0,31.0,61.0,3.0,15.0,3.0,182.0,78.0,2.0,2.0,1.0,2.0,3.0,3.0,3.0,2.0,3.0,1.0,2.0,10.0,11.0,12.0,10.0,13.0,12.0,11.0,12.0,5.0,12.0,12.0,12.0,14.0,13.0,16.0,14.0,15.0,13.0,14.0,12.0,13.0,16.0,11.0,16.0,12.0,13.0,16.0,16.0,11.0,10.0,12.0,11.0,12.0,14.0,10.0,20.0,16.0,11.0,16.0,12.0,15.0,9.0,13.0,17.0,12.0,10.0,15.0,14.0,15.0,18.0,3.0,34.0,22.0,0.0,18.0,0.0,177.0,77.0,1.0,1.0,1.0,1.0,1.0,1.0,1.0,1.0,2.0,3.0,4.0,8.0,8.0,9.0,7.0,10.0,12.0,11.0,12.0,8.0,15.0,14.0,10.0,13.0,12.0,16.0,15.0,16.0,13.0,14.0,13.0,13.0,18.0,7.0,19.0,10.0,16.0,19.0,19.0,9.0,8.0,16.0,8.0,9.0,20.0,11.0,20.0,11.0,9.0,14.0,7.0,14.0,3.0,12.0,8.0,13.0,19.0,14.0,19.0,18.0,18.0,8.0,25.0,3.0,0.0,6.0,0.0,182.0,75.0,1.0,4.0,1.0,2.0,1.0,1.0,3.0,3.0,1.0,1.0,1.0,12.0,12.0,12.0,10.0,13.0,12.0,8.0,11.0,5.0,12.0,14.0,8.0,14.0,12.0,14.0,14.0,12.0,12.0,12.0,13.0,13.0,11.0,12.0,11.0,11.0,13.0,14.0,14.0,12.0,12.0,10.0,10.0,20.0,14.0,12.0,10.0,13.0,13.0,10.0,13.0,13.0,7.0,8.0,13.0,13.0,15.0,12.0,13.0,13.0,15.0,8.0,25.0,8.0,0.0,14.0,2.0,182.0,76.0,3.0,1.0,1.0,1.0,2.0,1.0,2.0,3.0,1.0,1.0,2.0,11.0,11.0,14.0,12.0,14.0,10.0,9.0,13.0,5.0,9.0,15.0,9.0,10.0,16.0,10.0,14.0,13.0,13.0,13.0,15.0,14.0,13.0,14.0,10.0,14.0,13.0,14.0,14.0,14.0,14.0,13.0,10.0,12.0,12.0,13.0,20.0,14.0,13.0,13.0,12.0,12.0,7.0,12.0,16.0,14.0,12.0,13.0,10.0,12.0,10.0,8.0,26.0,0.0,0.0,0.0,0.0,171.0,69.0,2.0,3.0,4.0,3.0,1.0,1.0,1.0,2.0,1.0,2.0,1.0,7.0,7.0,12.0,14.0,14.0,7.0,7.0,9.0,6.0,8.0,8.0,5.0,6.0,11.0,9.0,11.0,8.0,10.0,8.0,9.0,12.0,11.0,15.0,7.0,13.0,8.0,7.0,9.0,12.0,12.0,12.0,10.0,10.0,10.0,14.0,20.0,8.0,8.0,14.0,9.0,11.0,4.0,9.0,13.0,12.0,10.0,12.0,10.0,3.0,7.0,8.0,25.0,9.0,1.0,8.0,4.0,178.0,79.0,4.0,3.0,1.0,1.0,2.0,2.0,2.0,3.0,1.0,2.0,3.0,10.0,10.0,14.0,14.0,14.0,10.0,11.0,12.0,7.0,5.0,12.0,14.0,5.0,16.0,12.0,13.0,10.0,11.0,10.0,13.0,12.0,8.0,16.0,8.0,14.0,10.0,10.0,12.0,17.0,14.0,12.0,9.0,10.0,12.0,17.0,20.0,12.0,14.0,12.0,13.0,8.0,13.0,12.0,11.0,16.0,10.0,9.0,10.0,11.0,8.0,5.0,31.0,0.0,0.0,0.0,0.0,185.0,78.0,3.0,1.0,1.0,1.0,2.0,1.0,2.0,3.0,3.0,1.0,2.0,6.0,7.0,6.0,8.0,11.0,8.0,14.0,6.0,11.0,14.0,12.0,7.0,14.0,11.0,13.0,12.0,16.0,11.0,9.0,10.0,12.0,14.0,5.0,14.0,7.0,15.0,14.0,15.0,12.0,13.0,14.0,13.0,8.0,13.0,13.0,20.0,16.0,16.0,12.0,10.0,11.0,12.0,12.0,15.0,12.0,15.0,8.0,16.0,14.0,13.0,7.0,29.0,16.0,0.0,0.0,0.0,190.0,85.0,1.0,4.0,2.0,3.0,3.0,3.0,1.0,2.0,1.0,3.0,1.0,9.0,11.0,9.0,8.0,10.0,13.0,16.0,12.0,13.0,15.0,13.0,9.0,15.0,10.0,5.0,14.0,14.0,13.0,12.0,10.0,13.0,16.0,9.0,13.0,9.0,14.0,16.0,16.0,9.0,9.0,15.0,16.0,20.0,14.0,13.0,8.0,14.0,15.0,16.0,8.0,10.0,4.0,5.0,14.0,12.0,12.0,14.0,14.0,12.0,14.0,4.0,37.0,0.0,0.0,0.0,0.0,191.0,83.0,11.0,12.0,12.0,12.0,12.0,8.0,12.0,10.0,12.0,14.0,10.0,3.0,10.0,8.0,3.0,8.0,6.0,6.0,6.0,10.0,7.0,7.0,12.0,10.0,10.0,9.0,10.0,12.0,10.0,11.0,2.0,12.0,12.0,7.0,15.0,4.0,11.0,11.0,11.0,8.0,10.0,10.0,13.0,20.0,12.0,8.0,8.0,8.0,11.0,10.0,7.0,9.0,7.0,10.0,11.0,11.0,14.0,8.0,12.0,13.0,12.0,6.0,25.0,0.0,0.0,0.0,0.0,184.0,70.0,3.0,4.0,1.0,3.0,3.0,1.0,1.0,1.0,1.0,3.0,3.0,11.0,12.0,10.0,9.0,9.0,6.0,10.0,4.0,11.0,12.0,12.0,9.0,13.0,10.0,15.0,11.0,13.0,11.0,13.0,7.0,10.0,11.0,12.0,17.0,10.0,12.0,11.0,11.0,12.0,11.0,10.0,12.0,8.0,12.0,12.0,20.0,13.0,13.0,15.0,17.0,11.0,6.0,9.0,11.0,11.0,12.0,10.0,7.0,5.0,7.0,9.0,22.0,0.0,0.0,1.0,0.0,182.0,70.0,1.0,4.0,2.0,1.0,1.0,1.0,4.0,2.0,1.0,1.0,1.0,10.0,11.0,13.0,12.0,12.0,9.0,8.0,13.0,7.0,7.0,14.0,10.0,9.0,13.0,10.0,12.0,13.0,12.0,11.0,13.0,11.0,12.0,15.0,11.0,11.0,9.0,12.0,12.0,11.0,12.0,10.0,8.0,8.0,11.0,12.0,20.0,11.0,10.0,14.0,9.0,13.0,9.0,10.0,12.0,13.0,14.0,12.0,13.0,13.0,12.0,9.0,27.0,0.0,0.0,0.0,0.0,181.0,73.0,3.0,3.0,1.0,2.0,2.0,2.0,3.0,1.0,2.0,1.0,2.0,14.0,13.0,14.0,12.0,13.0,15.0,8.0,14.0,6.0,7.0,13.0,14.0,8.0,14.0,8.0,12.0,10.0,11.0,9.0,13.0,10.0,10.0,14.0,7.0,12.0,7.0,13.0,10.0,12.0,12.0,11.0,8.0,20.0,11.0,12.0,8.0,12.0,11.0,10.0,6.0,13.0,7.0,9.0,9.0,13.0,9.0,13.0,14.0,12.0,11.0,8.0,30.0,0.0,0.0,0.0,0.0,183.0,77.0,2.0,1.0,3.0,2.0,3.0,2.0,3.0,3.0,4.0,3.0,3.0,11.0,11.0,10.0,9.0,11.0,12.0,11.0,10.0,9.0,10.0,9.0,11.0,10.0,10.0,14.0,11.0,12.0,11.0,11.0,10.0,11.0,14.0,12.0,11.0,9.0,11.0,12.0,11.0,11.0,10.0,11.0,11.0,8.0,12.0,11.0,20.0,11.0,9.0,13.0,17.0,11.0,7.0,18.0,13.0,13.0,12.0,11.0,10.0,9.0,8.0,6.0,20.0,0.0,0.0,0.0,0.0,185.0,83.0,3.0,1.0,3.0,2.0,3.0,2.0,3.0,2.0,3.0,1.0,1.0,9.0,9.0,8.0,5.0,10.0,7.0,14.0,8.0,10.0,13.0,9.0,10.0,13.0,9.0,12.0,12.0,14.0,11.0,9.0,7.0,12.0,13.0,6.0,10.0,10.0,12.0,12.0,13.0,12.0,12.0,12.0,12.0,8.0,13.0,12.0,20.0,12.0,13.0,14.0,10.0,13.0,9.0,16.0,11.0,13.0,14.0,11.0,13.0,14.0,11.0,8.0,21.0,0.0,0.0,1.0,0.0,182.0,75.0,4.0,1.0,2.0,3.0,1.0,2.0,1.0,3.0,1.0,1.0,1.0,9.0,10.0,10.0,7.0,11.0,9.0,12.0,14.0,11.0,13.0,10.0,10.0,13.0,11.0,11.0,11.0,12.0,11.0,12.0,9.0,13.0,13.0,7.0,11.0,10.0,13.0,12.0,13.0,12.0,11.0,12.0,11.0,20.0,12.0,13.0,10.0,13.0,13.0,13.0,8.0,11.0,9.0,9.0,10.0,10.0,14.0,10.0,11.0,11.0,10.0,9.0,27.0,0.0,0.0,4.0,1.0,181.0,77.0,1.0,1.0,3.0,4.0,3.0,2.0,3.0,3.0,4.0,2.0,2.0,3.0,6.0,5.0,3.0,8.0,3.0,13.0,4.0,11.0,13.0,9.0,5.0,13.0,9.0,8.0,13.0,14.0,9.0,13.0,9.0,11.0,4.0,8.0,10.0,9.0,12.0,10.0,9.0,12.0,12.0,12.0,10.0,8.0,12.0,12.0,20.0,13.0,14.0,11.0,6.0,13.0,3.0,5.0,13.0,18.0,11.0,13.0,11.0,11.0,11.0,8.0,26.0,0.0,0.0,0.0,0.0,181.0,75.0,2.0,1.0,3.0,2.0,2.0,2.0,2.0,1.0,1.0,1.0,1.0,8.0,8.0,10.0,10.0,11.0,10.0,11.0,10.0,8.0,11.0,13.0,9.0,13.0,11.0,13.0,11.0,11.0,12.0,11.0,12.0,11.0,11.0,8.0,9.0,11.0,13.0,14.0,14.0,12.0,12.0,12.0,10.0,10.0,11.0,12.0,20.0,13.0,12.0,12.0,7.0,9.0,6.0,15.0,10.0,12.0,14.0,12.0,10.0,12.0,12.0,7.0,28.0,0.0,0.0,0.0,0.0,186.0,72.0,3.0,1.0,1.0,3.0,1.0,3.0,1.0,2.0,1.0,3.0,1.0,10.0,7.0,11.0,8.0,11.0,11.0,12.0,12.0,10.0,11.0,13.0,12.0,12.0,11.0,13.0,12.0,13.0,12.0,13.0,9.0,12.0,13.0,8.0,15.0,12.0,13.0,14.0,13.0,12.0,10.0,12.0,11.0,13.0,12.0,12.0,20.0,13.0,13.0,14.0,9.0,10.0,7.0,17.0,12.0,12.0,12.0,10.0,11.0,11.0,12.0,9.0,22.0,0.0,0.0,8.0,5.0,180.0,69.0,3.0,3.0,2.0,2.0,3.0,3.0,3.0,1.0,1.0,1.0,2.0,6.0,10.0,13.0,12.0,12.0,8.0,12.0,12.0,5.0,3.0,10.0,12.0,6.0,12.0,13.0,12.0,13.0,13.0,13.0,10.0,13.0,14.0,15.0,10.0,13.0,9.0,11.0,13.0,13.0,14.0,12.0,11.0,10.0,13.0,13.0,20.0,13.0,14.0,11.0,12.0,13.0,8.0,9.0,13.0,13.0,13.0,12.0,10.0,9.0,10.0,9.0
0,2,37.0,0.0,0.0,0.0,0.0,191.0,83.0,11.0,12.0,12.0,12.0,12.0,8.0,12.0,10.0,12.0,14.0,10.0,3.0,10.0,8.0,3.0,8.0,6.0,6.0,6.0,10.0,7.0,7.0,12.0,10.0,10.0,9.0,10.0,12.0,10.0,11.0,2.0,12.0,12.0,7.0,15.0,4.0,11.0,11.0,11.0,8.0,10.0,10.0,13.0,20.0,12.0,8.0,8.0,8.0,11.0,10.0,7.0,9.0,7.0,10.0,11.0,11.0,14.0,8.0,12.0,13.0,12.0,6.0,25.0,0.0,0.0,0.0,0.0,184.0,70.0,3.0,4.0,1.0,3.0,3.0,1.0,1.0,1.0,1.0,3.0,3.0,11.0,12.0,10.0,9.0,9.0,6.0,10.0,4.0,11.0,12.0,12.0,9.0,13.0,10.0,15.0,11.0,13.0,11.0,13.0,7.0,10.0,11.0,12.0,17.0,10.0,12.0,11.0,11.0,12.0,11.0,10.0,12.0,8.0,12.0,12.0,20.0,13.0,13.0,15.0,17.0,11.0,6.0,9.0,11.0,11.0,12.0,10.0,7.0,5.0,7.0,9.0,22.0,0.0,0.0,1.0,0.0,182.0,70.0,1.0,4.0,2.0,1.0,1.0,1.0,4.0,2.0,1.0,1.0,1.0,10.0,11.0,13.0,12.0,12.0,9.0,8.0,13.0,7.0,7.0,14.0,10.0,9.0,13.0,10.0,12.0,13.0,12.0,11.0,13.0,11.0,12.0,15.0,11.0,11.0,9.0,12.0,12.0,11.0,12.0,10.0,8.0,8.0,11.0,12.0,20.0,11.0,10.0,14.0,9.0,13.0,9.0,10.0,12.0,13.0,14.0,12.0,13.0,13.0,12.0,9.0,27.0,0.0,0.0,0.0,0.0,181.0,73.0,3.0,3.0,1.0,2.0,2.0,2.0,3.0,1.0,2.0,1.0,2.0,14.0,13.0,14.0,12.0,13.0,15.0,8.0,14.0,6.0,7.0,13.0,14.0,8.0,14.0,8.0,12.0,10.0,11.0,9.0,13.0,10.0,10.0,14.0,7.0,12.0,7.0,13.0,10.0,12.0,12.0,11.0,8.0,20.0,11.0,12.0,8.0,12.0,11.0,10.0,6.0,13.0,7.0,9.0,9.0,13.0,9.0,13.0,14.0,12.0,11.0,8.0,30.0,0.0,0.0,0.0,0.0,183.0,77.0,2.0,1.0,3.0,2.0,3.0,2.0,3.0,3.0,4.0,3.0,3.0,11.0,11.0,10.0,9.0,11.0,12.0,11.0,10.0,9.0,10.0,9.0,11.0,10.0,10.0,14.0,11.0,12.0,11.0,11.0,10.0,11.0,14.0,12.0,11.0,9.0,11.0,12.0,11.0,11.0,10.0,11.0,11.0,8.0,12.0,11.0,20.0,11.0,9.0,13.0,17.0,11.0,7.0,18.0,13.0,13.0,12.0,11.0,10.0,9.0,8.0,6.0,20.0,0.0,0.0,0.0,0.0,185.0,83.0,3.0,1.0,3.0,2.0,3.0,2.0,3.0,2.0,3.0,1.0,1.0,9.0,9.0,8.0,5.0,10.0,7.0,14.0,8.0,10.0,13.0,9.0,10.0,13.0,9.0,12.0,12.0,14.0,11.0,9.0,7.0,12.0,13.0,6.0,10.0,10.0,12.0,12.0,13.0,12.0,12.0,12.0,12.0,8.0,13.0,12.0,20.0,12.0,13.0,14.0,10.0,13.0,9.0,16.0,11.0,13.0,14.0,11.0,13.0,14.0,11.0,8.0,21.0,0.0,0.0,1.0,0.0,182.0,75.0,4.0,1.0,2.0,3.0,1.0,2.0,1.0,3.0,1.0,1.0,1.0,9.0,10.0,10.0,7.0,11.0,9.0,12.0,14.0,11.0,13.0,10.0,10.0,13.0,11.0,11.0,11.0,12.0,11.0,12.0,9.0,13.0,13.0,7.0,11.0,10.0,13.0,12.0,13.0,12.0,11.0,12.0,11.0,20.0,12.0,13.0,10.0,13.0,13.0,13.0,8.0,11.0,9.0,9.0,10.0,10.0,14.0,10.0,11.0,11.0,10.0,9.0,27.0,0.0,0.0,4.0,1.0,181.0,77.0,1.0,1.0,3.0,4.0,3.0,2.0,3.0,3.0,4.0,2.0,2.0,3.0,6.0,5.0,3.0,8.0,3.0,13.0,4.0,11.0,13.0,9.0,5.0,13.0,9.0,8.0,13.0,14.0,9.0,13.0,9.0,11.0,4.0,8.0,10.0,9.0,12.0,10.0,9.0,12.0,12.0,12.0,10.0,8.0,12.0,12.0,20.0,13.0,14.0,11.0,6.0,13.0,3.0,5.0,13.0,18.0,11.0,13.0,11.0,11.0,11.0,8.0,26.0,0.0,0.0,0.0,0.0,181.0,75.0,2.0,1.0,3.0,2.0,2.0,2.0,2.0,1.0,1.0,1.0,1.0,8.0,8.0,10.0,10.0,11.0,10.0,11.0,10.0,8.0,11.0,13.0,9.0,13.0,11.0,13.0,11.0,11.0,12.0,11.0,12.0,11.0,11.0,8.0,9.0,11.0,13.0,14.0,14.0,12.0,12.0,12.0,10.0,10.0,11.0,12.0,20.0,13.0,12.0,12.0,7.0,9.0,6.0,15.0,10.0,12.0,14.0,12.0,10.0,12.0,12.0,7.0,28.0,0.0,0.0,0.0,0.0,186.0,72.0,3.0,1.0,1.0,3.0,1.0,3.0,1.0,2.0,1.0,3.0,1.0,10.0,7.0,11.0,8.0,11.0,11.0,12.0,12.0,10.0,11.0,13.0,12.0,12.0,11.0,13.0,12.0,13.0,12.0,13.0,9.0,12.0,13.0,8.0,15.0,12.0,13.0,14.0,13.0,12.0,10.0,12.0,11.0,13.0,12.0,12.0,20.0,13.0,13.0,14.0,9.0,10.0,7.0,17.0,12.0,12.0,12.0,10.0,11.0,11.0,12.0,9.0,22.0,0.0,0.0,8.0,5.0,180.0,69.0,3.0,3.0,2.0,2.0,3.0,3.0,3.0,1.0,1.0,1.0,2.0,6.0,10.0,13.0,12.0,12.0,8.0,12.0,12.0,5.0,3.0,10.0,12.0,6.0,12.0,13.0,12.0,13.0,13.0,13.0,10.0,13.0,14.0,15.0,10.0,13.0,9.0,11.0,13.0,13.0,14.0,12.0,11.0,10.0,13.0,13.0,20.0,13.0,14.0,11.0,12.0,13.0,8.0,9.0,13.0,13.0,13.0,12.0,10.0,9.0,10.0,9.0,30.0,6.0,0.0,10.0,0.0,195.0,91.0,15.0,16.0,15.0,10.0,15.0,16.0,16.0,16.0,13.0,8.0,16.0,5.0,3.0,3.0,2.0,10.0,10.0,10.0,1.0,1.0,1.0,8.0,2.0,1.0,4.0,8.0,13.0,14.0,11.0,11.0,8.0,11.0,15.0,8.0,15.0,14.0,12.0,12.0,14.0,7.0,14.0,16.0,15.0,20.0,12.0,12.0,6.0,13.0,11.0,14.0,2.0,16.0,5.0,12.0,15.0,12.0,11.0,11.0,15.0,7.0,11.0,15.0,20.0,0.0,0.0,0.0,0.0,172.0,0.0,2.0,2.0,1.0,3.0,1.0,3.0,3.0,2.0,3.0,1.0,3.0,5.0,5.0,9.0,6.0,12.0,4.0,5.0,6.0,2.0,3.0,5.0,3.0,4.0,7.0,8.0,6.0,3.0,5.0,4.0,3.0,11.0,4.0,8.0,8.0,6.0,5.0,6.0,6.0,13.0,13.0,6.0,2.0,8.0,10.0,12.0,20.0,7.0,3.0,8.0,8.0,5.0,8.0,8.0,19.0,12.0,13.0,13.0,8.0,12.0,13.0,3.0,31.0,0.0,0.0,14.0,0.0,188.0,86.0,1.0,2.0,1.0,1.0,3.0,3.0,3.0,1.0,3.0,1.0,3.0,3.0,4.0,5.0,7.0,8.0,3.0,14.0,10.0,3.0,13.0,12.0,6.0,12.0,10.0,11.0,11.0,14.0,11.0,10.0,10.0,13.0,14.0,3.0,10.0,8.0,14.0,13.0,11.0,11.0,10.0,16.0,14.0,7.0,11.0,12.0,20.0,12.0,15.0,13.0,12.0,14.0,10.0,6.0,10.0,11.0,16.0,13.0,17.0,15.0,13.0,2.0,16.0,0.0,0.0,0.0,0.0,188.0,0.0,1.0,3.0,1.0,1.0,1.0,2.0,3.0,2.0,1.0,3.0,1.0,4.0,4.0,4.0,4.0,7.0,4.0,3.0,2.0,4.0,6.0,5.0,2.0,9.0,5.0,9.0,8.0,8.0,4.0,6.0,4.0,8.0,6.0,2.0,8.0,4.0,7.0,18.0,15.0,8.0,7.0,11.0,14.0,20.0,11.0,7.0,6.0,10.0,9.0,4.0,13.0,12.0,5.0,8.0,9.0,20.0,13.0,13.0,13.0,14.0,13.0,10.0,31.0,61.0,3.0,15.0,3.0,182.0,78.0,2.0,2.0,1.0,2.0,3.0,3.0,3.0,2.0,3.0,1.0,2.0,10.0,11.0,12.0,10.0,13.0,12.0,11.0,12.0,5.0,12.0,12.0,12.0,14.0,13.0,16.0,14.0,15.0,13.0,14.0,12.0,13.0,16.0,11.0,16.0,12.0,13.0,16.0,16.0,11.0,10.0,12.0,11.0,12.0,14.0,10.0,20.0,16.0,11.0,16.0,12.0,15.0,9.0,13.0,17.0,12.0,10.0,15.0,14.0,15.0,18.0,3.0,25.0,3.0,0.0,6.0,0.0,182.0,75.0,1.0,4.0,1.0,2.0,1.0,1.0,3.0,3.0,1.0,1.0,1.0,12.0,12.0,12.0,10.0,13.0,12.0,8.0,11.0,5.0,12.0,14.0,8.0,14.0,12.0,14.0,14.0,12.0,12.0,12.0,13.0,13.0,11.0,12.0,11.0,11.0,13.0,14.0,14.0,12.0,12.0,10.0,10.0,20.0,14.0,12.0,10.0,13.0,13.0,10.0,13.0,13.0,7.0,8.0,13.0,13.0,15.0,12.0,13.0,13.0,15.0,8.0,25.0,8.0,0.0,14.0,2.0,182.0,76.0,3.0,1.0,1.0,1.0,2.0,1.0,2.0,3.0,1.0,1.0,2.0,11.0,11.0,14.0,12.0,14.0,10.0,9.0,13.0,5.0,9.0,15.0,9.0,10.0,16.0,10.0,14.0,13.0,13.0,13.0,15.0,14.0,13.0,14.0,10.0,14.0,13.0,14.0,14.0,14.0,14.0,13.0,10.0,12.0,12.0,13.0,20.0,14.0,13.0,13.0,12.0,12.0,7.0,12.0,16.0,14.0,12.0,13.0,10.0,12.0,10.0,8.0,26.0,0.0,0.0,0.0,0.0,171.0,69.0,2.0,3.0,4.0,3.0,1.0,1.0,1.0,2.0,1.0,2.0,1.0,7.0,7.0,12.0,14.0,14.0,7.0,7.0,9.0,6.0,8.0,8.0,5.0,6.0,11.0,9.0,11.0,8.0,10.0,8.0,9.0,12.0,11.0,15.0,7.0,13.0,8.0,7.0,9.0,12.0,12.0,12.0,10.0,10.0,10.0,14.0,20.0,8.0,8.0,14.0,9.0,11.0,4.0,9.0,13.0,12.0,10.0,12.0,10.0,3.0,7.0,8.0,25.0,9.0,1.0,8.0,4.0,178.0,79.0,4.0,3.0,1.0,1.0,2.0,2.0,2.0,3.0,1.0,2.0,3.0,10.0,10.0,14.0,14.0,14.0,10.0,11.0,12.0,7.0,5.0,12.0,14.0,5.0,16.0,12.0,13.0,10.0,11.0,10.0,13.0,12.0,8.0,16.0,8.0,14.0,10.0,10.0,12.0,17.0,14.0,12.0,9.0,10.0,12.0,17.0,20.0,12.0,14.0,12.0,13.0,8.0,13.0,12.0,11.0,16.0,10.0,9.0,10.0,11.0,8.0,5.0,31.0,0.0,0.0,0.0,0.0,185.0,78.0,3.0,1.0,1.0,1.0,2.0,1.0,2.0,3.0,3.0,1.0,2.0,6.0,7.0,6.0,8.0,11.0,8.0,14.0,6.0,11.0,14.0,12.0,7.0,14.0,11.0,13.0,12.0,16.0,11.0,9.0,10.0,12.0,14.0,5.0,14.0,7.0,15.0,14.0,15.0,12.0,13.0,14.0,13.0,8.0,13.0,13.0,20.0,16.0,16.0,12.0,10.0,11.0,12.0,12.0,15.0,12.0,15.0,8.0,16.0,14.0,13.0,7.0,29.0,16.0,0.0,0.0,0.0,190.0,85.0,1.0,4.0,2.0,3.0,3.0,3.0,1.0,2.0,1.0,3.0,1.0,9.0,11.0,9.0,8.0,10.0,13.0,16.0,12.0,13.0,15.0,13.0,9.0,15.0,10.0,5.0,14.0,14.0,13.0,12.0,10.0,13.0,16.0,9.0,13.0,9.0,14.0,16.0,16.0,9.0,9.0,15.0,16.0,20.0,14.0,13.0,8.0,14.0,15.0,16.0,8.0,10.0,4.0,5.0,14.0,12.0,12.0,14.0,14.0,12.0,14.0,4.0
3,0,32.0,21.0,0.0,12.0,0.0,193.0,94.0,12.0,17.0,8.0,7.0,17.0,14.0,14.0,14.0,14.0,5.0,13.0,3.0,4.0,5.0,3.0,7.0,5.0,4.0,3.0,6.0,5.0,12.0,8.0,6.0,7.0,8.0,14.0,13.0,9.0,9.0,8.0,13.0,18.0,3.0,11.0,3.0,16.0,16.0,3.0,11.0,9.0,16.0,14.0,7.0,12.0,9.0,20.0,14.0,15.0,16.0,9.0,14.0,10.0,2.0,16.0,14.0,12.0,18.0,16.0,12.0,16.0,8.0,32.0,24.0,2.0,23.0,1.0,192.0,84.0,1.0,2.0,3.0,2.0,3.0,1.0,2.0,1.0,3.0,3.0,3.0,8.0,6.0,5.0,4.0,7.0,4.0,16.0,6.0,8.0,14.0,8.0,4.0,12.0,7.0,13.0,15.0,16.0,12.0,13.0,8.0,14.0,14.0,14.0,15.0,10.0,15.0,19.0,8.0,9.0,9.0,14.0,16.0,9.0,19.0,11.0,20.0,13.0,17.0,15.0,14.0,15.0,12.0,14.0,8.0,8.0,16.0,14.0,10.0,12.0,12.0,4.0,32.0,29.0,0.0,11.0,1.0,179.0,79.0,3.0,2.0,3.0,3.0,1.0,2.0,1.0,3.0,3.0,1.0,1.0,12.0,14.0,15.0,10.0,13.0,12.0,7.0,15.0,8.0,13.0,13.0,13.0,15.0,14.0,12.0,12.0,15.0,13.0,9.0,10.0,13.0,16.0,14.0,12.0,7.0,12.0,10.0,16.0,13.0,16.0,13.0,8.0,10.0,14.0,16.0,20.0,18.0,7.0,15.0,12.0,15.0,10.0,17.0,4.0,12.0,20.0,8.0,14.0,10.0,10.0,15.0,25.0,8.0,0.0,4.0,1.0,179.0,72.0,1.0,1.0,1.0,1.0,1.0,2.0,1.0,3.0,2.0,2.0,2.0,11.0,11.0,11.0,11.0,14.0,13.0,10.0,13.0,10.0,11.0,12.0,14.0,9.0,14.0,13.0,13.0,13.0,15.0,12.0,11.0,13.0,13.0,14.0,14.0,11.0,9.0,9.0,13.0,13.0,12.0,13.0,10.0,10.0,12.0,13.0,20.0,14.0,9.0,13.0,14.0,17.0,10.0,13.0,4.0,12.0,10.0,12.0,12.0,12.0,10.0,8.0,26.0,2.0,1.0,11.0,0.0,177.0,73.0,1.0,3.0,3.0,1.0,3.0,2.0,1.0,1.0,2.0,3.0,2.0,12.0,11.0,14.0,13.0,13.0,10.0,8.0,14.0,9.0,8.0,13.0,13.0,10.0,13.0,15.0,11.0,14.0,11.0,10.0,11.0,11.0,10.0,16.0,7.0,12.0,8.0,8.0,11.0,14.0,14.0,12.0,8.0,10.0,8.0,16.0,20.0,12.0,8.0,11.0,13.0,11.0,9.0,7.0,10.0,13.0,19.0,9.0,11.0,8.0,6.0,12.0,28.0,29.0,4.0,10.0,4.0,183.0,75.0,2.0,2.0,1.0,2.0,1.0,1.0,1.0,1.0,1.0,1.0,2.0,10.0,11.0,15.0,14.0,13.0,12.0,12.0,13.0,8.0,7.0,12.0,14.0,9.0,10.0,13.0,11.0,12.0,10.0,14.0,7.0,11.0,16.0,14.0,7.0,11.0,5.0,9.0,11.0,16.0,12.0,15.0,11.0,12.0,14.0,15.0,20.0,14.0,10.0,10.0,14.0,17.0,6.0,11.0,13.0,11.0,17.0,13.0,14.0,10.0,7.0,5.0,24.0,14.0,0.0,21.0,1.0,177.0,67.0,2.0,3.0,3.0,2.0,2.0,3.0,2.0,3.0,2.0,1.0,4.0,11.0,11.0,13.0,13.0,13.0,12.0,5.0,13.0,6.0,9.0,14.0,13.0,5.0,14.0,12.0,13.0,13.0,14.0,14.0,12.0,14.0,11.0,15.0,8.0,11.0,13.0,11.0,14.0,13.0,14.0,13.0,7.0,12.0,6.0,14.0,20.0,16.0,12.0,11.0,12.0,10.0,12.0,14.0,9.0,9.0,12.0,12.0,9.0,7.0,11.0,6.0,28.0,0.0,0.0,13.0,2.0,185.0,75.0,2.0,1.0,3.0,2.0,1.0,1.0,2.0,2.0,2.0,2.0,3.0,15.0,19.0,12.0,12.0,14.0,15.0,8.0,9.0,9.0,10.0,15.0,13.0,12.0,14.0,9.0,11.0,10.0,11.0,10.0,9.0,11.0,12.0,13.0,9.0,11.0,14.0,11.0,12.0,13.0,11.0,11.0,10.0,20.0,11.0,12.0,8.0,13.0,11.0,15.0,12.0,14.0,9.0,13.0,7.0,10.0,12.0,13.0,12.0,10.0,10.0,8.0,32.0,15.0,0.0,3.0,0.0,185.0,79.0,1.0,2.0,1.0,3.0,1.0,4.0,1.0,1.0,3.0,3.0,2.0,8.0,6.0,9.0,2.0,9.0,5.0,15.0,6.0,6.0,14.0,13.0,2.0,14.0,9.0,11.0,13.0,14.0,6.0,12.0,10.0,12.0,16.0,12.0,10.0,8.0,15.0,8.0,11.0,10.0,9.0,10.0,14.0,15.0,16.0,12.0,20.0,12.0,14.0,14.0,12.0,13.0,12.0,17.0,6.0,12.0,12.0,10.0,12.0,12.0,10.0,10.0,30.0,29.0,2.0,10.0,2.0,180.0,77.0,3.0,3.0,3.0,2.0,2.0,3.0,1.0,1.0,2.0,2.0,2.0,9.0,11.0,13.0,14.0,13.0,7.0,10.0,14.0,7.0,10.0,15.0,13.0,8.0,14.0,14.0,18.0,17.0,14.0,10.0,9.0,15.0,16.0,12.0,11.0,14.0,10.0,8.0,12.0,13.0,8.0,13.0,8.0,20.0,9.0,13.0,13.0,10.0,10.0,11.0,15.0,15.0,8.0,9.0,8.0,18.0,14.0,8.0,10.0,10.0,8.0,9.0,30.0,14.0,0.0,15.0,1.0,179.0,77.0,2.0,3.0,2.0,3.0,3.0,4.0,2.0,3.0,1.0,2.0,3.0,8.0,12.0,12.0,11.0,11.0,8.0,9.0,11.0,12.0,13.0,10.0,9.0,13.0,10.0,12.0,13.0,14.0,12.0,15.0,10.0,13.0,14.0,12.0,11.0,13.0,11.0,16.0,14.0,13.0,11.0,12.0,7.0,10.0,16.0,13.0,20.0,14.0,11.0,13.0,8.0,14.0,5.0,16.0,8.0,12.0,13.0,10.0,14.0,14.0,17.0,8.0,37.0,0.0,0.0,0.0,0.0,191.0,83.0,11.0,12.0,12.0,12.0,12.0,8.0,12.0,10.0,12.0,14.0,10.0,3.0,10.0,8.0,3.0,8.0,6.0,6.0,6.0,10.0,7.0,7.0,12.0,10.0,10.0,9.0,10.0,12.0,10.0,11.0,2.0,12.0,12.0,7.0,15.0,4.0,11.0,11.0,11.0,8.0,10.0,10.0,13.0,20.0,12.0,8.0,8.0,8.0,11.0,10.0,7.0,9.0,7.0,10.0,11.0,11.0,14.0,8.0,12.0,13.0,12.0,6.0,25.0,0.0,0.0,0.0,0.0,184.0,70.0,3.0,4.0,1.0,3.0,3.0,1.0,1.0,1.0,1.0,3.0,3.0,11.0,12.0,10.0,9.0,9.0,6.0,10.0,4.0,11.0,12.0,12.0,9.0,13.0,10.0,15.0,11.0,13.0,11.0,13.0,7.0,10.0,11.0,12.0,17.0,10.0,12.0,11.0,11.0,12.0,11.0,10.0,12.0,8.0,12.0,12.0,20.0,13.0,13.0,15.0,17.0,11.0,6.0,9.0,11.0,11.0,12.0,10.0,7.0,5.0,7.0,9.0,22.0,0.0,0.0,1.0,0.0,182.0,70.0,1.0,4.0,2.0,1.0,1.0,1.0,4.0,2.0,1.0,1.0,1.0,10.0,11.0,13.0,12.0,12.0,9.0,8.0,13.0,7.0,7.0,14.0,10.0,9.0,13.0,10.0,12.0,13.0,12.0,11.0,13.0,11.0,12.0,15.0,11.0,11.0,9.0,12.0,12.0,11.0,12.0,10.0,8.0,8.0,11.0,12.0,20.0,11.0,10.0,14.0,9.0,13.0,9.0,10.0,12.0,13.0,14.0,12.0,13.0,13.0,12.0,9.0,27.0,0.0,0.0,0.0,0.0,181.0,73.0,3.0,3.0,1.0,2.0,2.0,2.0,3.0,1.0,2.0,1.0,2.0,14.0,13.0,14.0,12.0,13.0,15.0,8.0,14.0,6.0,7.0,13.0,14.0,8.0,14.0,8.0,12.0,10.0,11.0,9.0,13.0,10.0,10.0,14.0,7.0,12.0,7.0,13.0,10.0,12.0,12.0,11.0,8.0,20.0,11.0,12.0,8.0,12.0,11.0,10.0,6.0,13.0,7.0,9.0,9.0,13.0,9.0,13.0,14.0,12.0,11.0,8.0,30.0,0.0,0.0,0.0,0.0,183.0,77.0,2.0,1.0,3.0,2.0,3.0,2.0,3.0,3.0,4.0,3.0,3.0,11.0,11.0,10.0,9.0,11.0,12.0,11.0,10.0,9.0,10.0,9.0,11.0,10.0,10.0,14.0,11.0,12.0,11.0,11.0,10.0,11.0,14.0,12.0,11.0,9.0,11.0,12.0,11.0,11.0,10.0,11.0,11.0,8.0,12.0,11.0,20.0,11.0,9.0,13.0,17.0,11.0,7.0,18.0,13.0,13.0,12.0,11.0,10.0,9.0,8.0,6.0,20.0,0.0,0.0,0.0,0.0,185.0,83.0,3.0,1.0,3.0,2.0,3.0,2.0,3.0,2.0,3.0,1.0,1.0,9.0,9.0,8.0,5.0,10.0,7.0,14.0,8.0,10.0,13.0,9.0,10.0,13.0,9.0,12.0,12.0,14.0,11.0,9.0,7.0,12.0,13.0,6.0,10.0,10.0,12.0,12.0,13.0,12.0,12.0,12.0,12.0,8.0,13.0,12.0,20.0,12.0,13.0,14.0,10.0,13.0,9.0,16.0,11.0,13.0,14.0,11.0,13.0,14.0,11.0,8.0,21.0,0.0,0.0,1.0,0.0,182.0,75.0,4.0,1.0,2.0,3.0,1.0,2.0,1.0,3.0,1.0,1.0,1.0,9.0,10.0,10.0,7.0,11.0,9.0,12.0,14.0,11.0,13.0,10.0,10.0,13.0,11.0,11.0,11.0,12.0,11.0,12.0,9.0,13.0,13.0,7.0,11.0,10.0,13.0,12.0,13.0,12.0,11.0,12.0,11.0,20.0,12.0,13.0,10.0,13.0,13.0,13.0,8.0,11.0,9.0,9.0,10.0,10.0,14.0,10.0,11.0,11.0,10.0,9.0,27.0,0.0,0.0,4.0,1.0,181.0,77.0,1.0,1.0,3.0,4.0,3.0,2.0,3.0,3.0,4.0,2.0,2.0,3.0,6.0,5.0,3.0,8.0,3.0,13.0,4.0,11.0,13.0,9.0,5.0,13.0,9.0,8.0,13.0,14.0,9.0,13.0,9.0,11.0,4.0,8.0,10.0,9.0,12.0,10.0,9.0,12.0,12.0,12.0,10.0,8.0,12.0,12.0,20.0,13.0,14.0,11.0,6.0,13.0,3.0,5.0,13.0,18.0,11.0,13.0,11.0,11.0,11.0,8.0,26.0,0.0,0.0,0.0,0.0,181.0,75.0,2.0,1.0,3.0,2.0,2.0,2.0,2.0,1.0,1.0,1.0,1.0,8.0,8.0,10.0,10.0,11.0,10.0,11.0,10.0,8.0,11.0,13.0,9.0,13.0,11.0,13.0,11.0,11.0,12.0,11.0,12.0,11.0,11.0,8.0,9.0,11.0,13.0,14.0,14.0,12.0,12.0,12.0,10.0,10.0,11.0,12.0,20.0,13.0,12.0,12.0,7.0,9.0,6.0,15.0,10.0,12.0,14.0,12.0,10.0,12.0,12.0,7.0,28.0,0.0,0.0,0.0,0.0,186.0,72.0,3.0,1.0,1.0,3.0,1.0,3.0,1.0,2.0,1.0,3.0,1.0,10.0,7.0,11.0,8.0,11.0,11.0,12.0,12.0,10.0,11.0,13.0,12.0,12.0,11.0,13.0,12.0,13.0,12.0,13.0,9.0,12.0,13.0,8.0,15.0,12.0,13.0,14.0,13.0,12.0,10.0,12.0,11.0,13.0,12.0,12.0,20.0,13.0,13.0,14.0,9.0,10.0,7.0,17.0,12.0,12.0,12.0,10.0,11.0,11.0,12.0,9.0,22.0,0.0,0.0,8.0,5.0,180.0,69.0,3.0,3.0,2.0,2.0,3.0,3.0,3.0,1.0,1.0,1.0,2.0,6.0,10.0,13.0,12.0,12.0,8.0,12.0,12.0,5.0,3.0,10.0,12.0,6.0,12.0,13.0,12.0,13.0,13.0,13.0,10.0,13.0,14.0,15.0,10.0,13.0,9.0,11.0,13.0,13.0,14.0,12.0,11.0,10.0,13.0,13.0,20.0,13.0,14.0,11.0,12.0,13.0,8.0,9.0,13.0,13.0,13.0,12.0,10.0,9.0,10.0,9.0
1,0,17.0,0.0,0.0,0.0,0.0,163.0,59.0,2.0,3.0,3.0,1.0,2.0,3.0,3.0,1.0,2.0,3.0,3.0,8.0,12.0,13.0,7.0,13.0,7.0,5.0,7.0,7.0,7.0,12.0,5.0,8.0,12.0,9.0,12.0,16.0,10.0,8.0,7.0,10.0,11.0,14.0,7.0,12.0,8.0,7.0,7.0,14.0,11.0,4.0,4.0,20.0,10.0,14.0,6.0,6.0,4.0,8.0,4.0,9.0,9.0,9.0,16.0,7.0,11.0,9.0,8.0,2.0,10.0,10.0,25.0,0.0,0.0,0.0,0.0,195.0,90.0,2.0,3.0,3.0,1.0,2.0,2.0,1.0,1.0,3.0,1.0,1.0,2.0,4.0,7.0,6.0,8.0,3.0,16.0,8.0,5.0,14.0,13.0,6.0,14.0,12.0,17.0,14.0,15.0,11.0,14.0,11.0,13.0,10.0,7.0,12.0,7.0,15.0,13.0,13.0,10.0,10.0,16.0,17.0,9.0,14.0,11.0,20.0,13.0,17.0,14.0,15.0,13.0,5.0,6.0,19.0,14.0,9.0,10.0,9.0,12.0,14.0,8.0,30.0,0.0,0.0,0.0,0.0,175.0,65.0,3.0,1.0,3.0,4.0,3.0,1.0,4.0,1.0,1.0,2.0,3.0,8.0,9.0,11.0,8.0,14.0,8.0,9.0,13.0,8.0,10.0,14.0,12.0,12.0,14.0,13.0,14.0,15.0,14.0,15.0,14.0,14.0,15.0,11.0,10.0,13.0,15.0,15.0,15.0,12.0,12.0,14.0,9.0,8.0,15.0,12.0,20.0,15.0,12.0,13.0,3.0,13.0,8.0,12.0,13.0,12.0,13.0,14.0,14.0,14.0,9.0,7.0,28.0,0.0,0.0,0.0,0.0,184.0,78.0,1.0,3.0,1.0,3.0,1.0,1.0,3.0,3.0,2.0,2.0,2.0,12.0,13.0,13.0,9.0,13.0,10.0,9.0,10.0,12.0,9.0,12.0,10.0,12.0,13.0,11.0,13.0,12.0,11.0,11.0,9.0,10.0,13.0,14.0,9.0,14.0,10.0,14.0,15.0,14.0,14.0,14.0,13.0,20.0,15.0,15.0,6.0,14.0,13.0,13.0,7.0,10.0,5.0,11.0,11.0,13.0,13.0,13.0,15.0,12.0,12.0,5.0,26.0,0.0,0.0,22.0,8.0,180.0,75.0,1.0,2.0,3.0,4.0,3.0,2.0,3.0,3.0,2.0,3.0,1.0,6.0,8.0,13.0,14.0,14.0,13.0,14.0,8.0,6.0,6.0,14.0,13.0,7.0,15.0,11.0,11.0,10.0,14.0,13.0,14.0,14.0,14.0,14.0,8.0,15.0,8.0,12.0,13.0,14.0,14.0,13.0,12.0,12.0,12.0,14.0,20.0,12.0,12.0,13.0,6.0,14.0,16.0,10.0,16.0,14.0,15.0,11.0,11.0,10.0,16.0,1.0,23.0,8.0,0.0,13.0,3.0,170.0,63.0,2.0,2.0,3.0,2.0,3.0,2.0,1.0,3.0,4.0,1.0,2.0,12.0,13.0,15.0,8.0,15.0,12.0,5.0,13.0,5.0,6.0,14.0,13.0,8.0,16.0,12.0,13.0,11.0,14.0,11.0,14.0,14.0,14.0,18.0,10.0,15.0,9.0,9.0,14.0,17.0,16.0,13.0,5.0,8.0,14.0,17.0,20.0,12.0,6.0,12.0,6.0,16.0,9.0,10.0,15.0,14.0,14.0,13.0,16.0,12.0,14.0,8.0,20.0,0.0,0.0,0.0,0.0,183.0,0.0,2.0,3.0,2.0,1.0,2.0,2.0,3.0,1.0,2.0,3.0,3.0,7.0,12.0,13.0,12.0,12.0,5.0,7.0,8.0,5.0,6.0,6.0,3.0,4.0,13.0,9.0,9.0,8.0,8.0,5.0,8.0,9.0,7.0,13.0,1.0,8.0,6.0,7.0,8.0,13.0,11.0,7.0,9.0,8.0,13.0,11.0,20.0,8.0,6.0,9.0,6.0,6.0,9.0,8.0,15.0,12.0,14.0,11.0,11.0,10.0,13.0,3.0,26.0,0.0,0.0,5.0,1.0,184.0,75.0,3.0,1.0,2.0,1.0,1.0,3.0,2.0,4.0,3.0,2.0,1.0,6.0,10.0,15.0,16.0,16.0,9.0,14.0,12.0,6.0,5.0,13.0,12.0,7.0,16.0,14.0,13.0,11.0,12.0,12.0,12.0,13.0,13.0,16.0,9.0,13.0,2.0,11.0,12.0,14.0,16.0,12.0,11.0,12.0,14.0,14.0,20.0,13.0,10.0,12.0,6.0,10.0,12.0,4.0,5.0,10.0,10.0,12.0,11.0,8.0,18.0,11.0,28.0,0.0,0.0,0.0,0.0,189.0,83.0,4.0,3.0,3.0,3.0,4.0,2.0,3.0,2.0,3.0,2.0,2.0,10.0,8.0,7.0,6.0,8.0,8.0,14.0,8.0,9.0,13.0,12.0,9.0,13.0,6.0,16.0,9.0,12.0,11.0,14.0,9.0,10.0,13.0,10.0,10.0,13.0,13.0,14.0,13.0,12.0,10.0,12.0,14.0,20.0,14.0,13.0,5.0,13.0,13.0,11.0,16.0,15.0,8.0,9.0,13.0,14.0,14.0,11.0,12.0,12.0,5.0,15.0,24.0,16.0,0.0,5.0,0.0,184.0,78.0,3.0,1.0,2.0,2.0,1.0,2.0,2.0,1.0,3.0,3.0,1.0,12.0,12.0,12.0,8.0,14.0,8.0,13.0,13.0,7.0,12.0,15.0,10.0,14.0,15.0,15.0,13.0,13.0,14.0,15.0,14.0,14.0,13.0,6.0,15.0,13.0,14.0,14.0,13.0,11.0,12.0,15.0,13.0,20.0,14.0,12.0,8.0,14.0,13.0,14.0,7.0,11.0,5.0,9.0,9.0,12.0,11.0,13.0,15.0,15.0,12.0,8.0,28.0,0.0,0.0,0.0,0.0,176.0,69.0,1.0,3.0,1.0,4.0,2.0,3.0,2.0,1.0,2.0,3.0,2.0,8.0,14.0,12.0,6.0,13.0,12.0,7.0,13.0,11.0,11.0,13.0,12.0,13.0,14.0,11.0,13.0,12.0,12.0,14.0,10.0,13.0,14.0,11.0,8.0,15.0,11.0,12.0,14.0,15.0,14.0,10.0,7.0,12.0,14.0,14.0,20.0,15.0,8.0,15.0,8.0,13.0,6.0,14.0,14.0,10.0,13.0,14.0,15.0,12.0,15.0,5.0,26.0,0.0,0.0,3.0,0.0,197.0,85.0,14.0,12.0,14.0,9.0,14.0,14.0,11.0,15.0,8.0,11.0,14.0,1.0,3.0,3.0,1.0,13.0,3.0,1.0,2.0,8.0,2.0,15.0,3.0,3.0,12.0,8.0,12.0,12.0,15.0,14.0,12.0,12.0,12.0,6.0,12.0,2.0,14.0,12.0,14.0,11.0,9.0,12.0,17.0,6.0,7.0,10.0,20.0,14.0,11.0,15.0,5.0,11.0,11.0,11.0,10.0,12.0,12.0,12.0,12.0,13.0,11.0,5.0,25.0,0.0,0.0,14.0,0.0,180.0,70.0,1.0,1.0,3.0,3.0,2.0,1.0,2.0,3.0,4.0,2.0,2.0,7.0,9.0,9.0,6.0,10.0,8.0,13.0,8.0,12.0,14.0,10.0,8.0,14.0,12.0,8.0,10.0,13.0,11.0,10.0,12.0,11.0,11.0,12.0,8.0,14.0,12.0,14.0,13.0,14.0,13.0,11.0,15.0,8.0,12.0,14.0,20.0,13.0,12.0,11.0,7.0,12.0,11.0,11.0,18.0,10.0,14.0,13.0,9.0,11.0,10.0,6.0,29.0,0.0,0.0,0.0,0.0,190.0,85.0,3.0,3.0,3.0,3.0,1.0,3.0,2.0,3.0,3.0,3.0,2.0,5.0,9.0,10.0,4.0,12.0,8.0,12.0,9.0,9.0,13.0,12.0,6.0,12.0,12.0,13.0,13.0,13.0,14.0,13.0,11.0,12.0,10.0,8.0,12.0,11.0,13.0,13.0,14.0,13.0,12.0,12.0,15.0,6.0,14.0,11.0,20.0,13.0,13.0,13.0,8.0,11.0,9.0,11.0,8.0,11.0,9.0,13.0,14.0,12.0,8.0,1.0,29.0,0.0,0.0,0.0,0.0,175.0,70.0,3.0,3.0,2.0,2.0,3.0,1.0,1.0,3.0,3.0,3.0,2.0,9.0,9.0,12.0,14.0,14.0,10.0,15.0,7.0,10.0,5.0,12.0,14.0,4.0,10.0,11.0,15.0,13.0,14.0,13.0,13.0,13.0,15.0,13.0,14.0,17.0,6.0,15.0,16.0,12.0,13.0,13.0,11.0,10.0,14.0,13.0,20.0,11.0,10.0,12.0,9.0,15.0,10.0,12.0,9.0,14.0,12.0,11.0,8.0,11.0,16.0,7.0,21.0,0.0,0.0,8.0,3.0,180.0,66.0,2.0,1.0,2.0,3.0,3.0,3.0,3.0,2.0,3.0,2.0,3.0,7.0,11.0,14.0,12.0,13.0,11.0,7.0,11.0,5.0,5.0,11.0,13.0,5.0,14.0,13.0,12.0,10.0,10.0,9.0,12.0,11.0,11.0,13.0,4.0,12.0,5.0,10.0,10.0,14.0,15.0,13.0,9.0,14.0,14.0,13.0,20.0,13.0,9.0,12.0,11.0,11.0,4.0,11.0,12.0,13.0,11.0,12.0,13.0,12.0,11.0,6.0,25.0,0.0,0.0,0.0,0.0,170.0,64.0,4.0,2.0,3.0,3.0,1.0,3.0,3.0,3.0,1.0,3.0,2.0,14.0,12.0,12.0,13.0,13.0,12.0,9.0,11.0,4.0,5.0,13.0,12.0,7.0,14.0,14.0,13.0,14.0,11.0,10.0,13.0,12.0,18.0,12.0,12.0,15.0,6.0,13.0,12.0,14.0,12.0,12.0,7.0,10.0,12.0,13.0,20.0,12.0,12.0,8.0,9.0,13.0,7.0,14.0,12.0,16.0,11.0,9.0,14.0,14.0,15.0,8.0,22.0,0.0,0.0,0.0,0.0,174.0,69.0,1.0,2.0,1.0,1.0,3.0,2.0,2.0,1.0,3.0,1.0,3.0,9.0,11.0,15.0,11.0,12.0,9.0,5.0,8.0,4.0,3.0,13.0,12.0,4.0,16.0,12.0,9.0,14.0,11.0,11.0,12.0,9.0,14.0,14.0,3.0,14.0,3.0,12.0,12.0,14.0,15.0,12.0,4.0,12.0,11.0,14.0,20.0,12.0,9.0,11.0,8.0,4.0,11.0,11.0,10.0,13.0,12.0,9.0,10.0,9.0,10.0,5.0,21.0,0.0,0.0,40.0,4.0,171.0,67.0,3.0,2.0,2.0,1.0,4.0,2.0,1.0,3.0,3.0,1.0,1.0,9.0,11.0,14.0,6.0,15.0,9.0,7.0,8.0,6.0,6.0,15.0,8.0,6.0,15.0,12.0,14.0,11.0,13.0,13.0,13.0,11.0,14.0,11.0,13.0,13.0,9.0,13.0,14.0,13.0,14.0,14.0,7.0,12.0,14.0,12.0,20.0,13.0,8.0,14.0,5.0,13.0,6.0,14.0,13.0,16.0,17.0,12.0,17.0,18.0,18.0,2.0,31.0,18.0,0.0,0.0,0.0,184.0,79.0,3.0,2.0,1.0,1.0,2.0,3.0,1.0,3.0,2.0,3.0,2.0,6.0,8.0,9.0,9.0,13.0,10.0,14.0,12.0,10.0,12.0,13.0,13.0,13.0,12.0,13.0,13.0,14.0,12.0,13.0,10.0,11.0,12.0,8.0,14.0,9.0,13.0,15.0,13.0,9.0,10.0,12.0,13.0,8.0,10.0,8.0,20.0,10.0,12.0,12.0,12.0,11.0,16.0,10.0,10.0,6.0,15.0,14.0,16.0,15.0,16.0,14.0,25.0,1.0,0.0,0.0,0.0,184.0,77.0,3.0,1.0,2.0,2.0,2.0,2.0,3.0,1.0,2.0,3.0,4.0,7.0,7.0,10.0,6.0,11.0,6.0,9.0,5.0,7.0,13.0,9.0,7.0,14.0,11.0,12.0,10.0,13.0,12.0,11.0,8.0,12.0,4.0,7.0,10.0,10.0,13.0,12.0,14.0,12.0,12.0,11.0,10.0,8.0,11.0,12.0,20.0,13.0,11.0,8.0,7.0,9.0,15.0,11.0,7.0,12.0,12.0,11.0,11.0,11.0,12.0,7.0,22.0,0.0,0.0,0.0,0.0,187.0,81.0,2.0,3.0,2.0,1.0,3.0,1.0,3.0,3.0,1.0,4.0,1.0,8.0,11.0,9.0,4.0,12.0,7.0,12.0,5.0,11.0,12.0,13.0,7.0,13.0,12.0,16.0,13.0,13.0,13.0,13.0,9.0,12.0,16.0,10.0,10.0,13.0,12.0,14.0,14.0,12.0,13.0,14.0,11.0,6.0,13.0,13.0,20.0,13.0,15.0,12.0,7.0,11.0,11.0,11.0,19.0,14.0,13.0,12.0,13.0,11.0,12.0,6.0
1,1,28.0,17.0,0.0,9.0,0.0,193.0,88.0,14.0,11.0,12.0,8.0,15.0,14.0,15.0,18.0,13.0,13.0,13.0,7.0,3.0,1.0,3.0,10.0,10.0,4.0,3.0,1.0,1.0,10.0,5.0,1.0,8.0,10.0,15.0,14.0,14.0,14.0,10.0,12.0,14.0,1.0,5.0,2.0,15.0,11.0,10.0,11.0,16.0,13.0,14.0,6.0,14.0,11.0,20.0,13.0,14.0,12.0,1.0,13.0,4.0,12.0,16.0,15.0,15.0,13.0,15.0,16.0,14.0,3.0,25.0,13.0,0.0,8.0,0.0,176.0,67.0,1.0,3.0,1.0,2.0,1.0,3.0,3.0,1.0,1.0,2.0,2.0,3.0,12.0,13.0,8.0,14.0,3.0,8.0,8.0,9.0,14.0,14.0,5.0,16.0,13.0,13.0,13.0,14.0,12.0,13.0,11.0,14.0,15.0,10.0,9.0,15.0,14.0,17.0,16.0,16.0,15.0,14.0,8.0,8.0,18.0,16.0,20.0,17.0,12.0,17.0,8.0,15.0,5.0,12.0,16.0,15.0,15.0,15.0,15.0,13.0,15.0,7.0,35.0,118.0,7.0,0.0,0.0,183.0,77.0,3.0,1.0,3.0,3.0,2.0,2.0,3.0,2.0,4.0,2.0,1.0,4.0,10.0,12.0,7.0,13.0,6.0,15.0,8.0,8.0,15.0,9.0,9.0,15.0,12.0,15.0,14.0,14.0,12.0,14.0,6.0,13.0,18.0,9.0,13.0,7.0,14.0,13.0,13.0,10.0,9.0,12.0,11.0,11.0,9.0,9.0,20.0,10.0,13.0,13.0,7.0,13.0,9.0,13.0,18.0,15.0,15.0,15.0,17.0,17.0,16.0,9.0,19.0,0.0,0.0,3.0,0.0,188.0,87.0,4.0,2.0,1.0,2.0,1.0,4.0,3.0,4.0,3.0,3.0,2.0,8.0,11.0,13.0,8.0,14.0,6.0,14.0,8.0,12.0,14.0,12.0,5.0,14.0,14.0,12.0,13.0,12.0,14.0,10.0,9.0,11.0,5.0,9.0,9.0,8.0,14.0,13.0,15.0,13.0,13.0,13.0,13.0,9.0,16.0,15.0,20.0,16.0,13.0,13.0,4.0,12.0,12.0,14.0,12.0,16.0,10.0,15.0,11.0,9.0,10.0,8.0,28.0,26.0,0.0,1.0,0.0,173.0,73.0,2.0,1.0,4.0,2.0,1.0,3.0,3.0,2.0,1.0,2.0,3.0,11.0,13.0,17.0,13.0,17.0,10.0,6.0,11.0,2.0,10.0,15.0,9.0,10.0,18.0,9.0,15.0,11.0,15.0,12.0,15.0,14.0,15.0,17.0,12.0,16.0,13.0,15.0,17.0,13.0,16.0,15.0,6.0,16.0,15.0,10.0,20.0,15.0,10.0,15.0,7.0,14.0,11.0,12.0,13.0,14.0,16.0,13.0,15.0,12.0,13.0,9.0,18.0,0.0,0.0,0.0,0.0,187.0,0.0,3.0,3.0,1.0,1.0,1.0,2.0,3.0,2.0,4.0,3.0,1.0,6.0,7.0,10.0,11.0,10.0,7.0,9.0,9.0,6.0,4.0,8.0,8.0,4.0,9.0,8.0,10.0,8.0,9.0,7.0,9.0,7.0,13.0,11.0,6.0,10.0,5.0,8.0,9.0,11.0,10.0,11.0,14.0,10.0,10.0,12.0,20.0,9.0,8.0,11.0,8.0,11.0,9.0,9.0,6.0,12.0,11.0,14.0,12.0,13.0,13.0,8.0,26.0,31.0,0.0,7.0,2.0,168.0,62.0,2.0,3.0,1.0,2.0,3.0,1.0,2.0,1.0,3.0,1.0,1.0,8.0,9.0,13.0,9.0,15.0,7.0,7.0,8.0,3.0,14.0,15.0,6.0,13.0,15.0,13.0,15.0,15.0,15.0,15.0,13.0,14.0,13.0,12.0,8.0,14.0,13.0,17.0,18.0,13.0,15.0,14.0,6.0,11.0,15.0,12.0,20.0,15.0,10.0,14.0,6.0,15.0,8.0,11.0,10.0,14.0,14.0,13.0,15.0,15.0,12.0,2.0,21.0,21.0,3.0,2.0,0.0,185.0,75.0,1.0,1.0,3.0,2.0,1.0,1.0,2.0,2.0,1.0,2.0,2.0,4.0,11.0,16.0,14.0,16.0,7.0,12.0,14.0,4.0,4.0,11.0,14.0,7.0,16.0,11.0,13.0,11.0,14.0,12.0,11.0,12.0,15.0,15.0,5.0,14.0,9.0,13.0,13.0,15.0,16.0,14.0,11.0,13.0,13.0,16.0,20.0,12.0,14.0,12.0,5.0,12.0,9.0,10.0,14.0,15.0,15.0,13.0,14.0,12.0,14.0,5.0,23.0,1.0,0.0,13.0,4.0,178.0,74.0,3.0,1.0,2.0,2.0,4.0,1.0,1.0,1.0,1.0,2.0,3.0,4.0,10.0,14.0,15.0,15.0,9.0,13.0,12.0,3.0,7.0,12.0,12.0,9.0,14.0,13.0,14.0,14.0,14.0,14.0,13.0,13.0,17.0,12.0,10.0,15.0,8.0,15.0,16.0,14.0,14.0,14.0,10.0,10.0,13.0,13.0,20.0,15.0,13.0,12.0,2.0,10.0,12.0,10.0,12.0,15.0,15.0,9.0,12.0,11.0,13.0,6.0,20.0,0.0,0.0,4.0,0.0,176.0,70.0,2.0,4.0,3.0,3.0,1.0,2.0,3.0,3.0,3.0,2.0,2.0,9.0,12.0,15.0,11.0,12.0,5.0,6.0,10.0,3.0,8.0,12.0,8.0,8.0,14.0,9.0,12.0,5.0,13.0,9.0,13.0,11.0,12.0,14.0,4.0,13.0,9.0,12.0,12.0,17.0,15.0,12.0,8.0,11.0,13.0,16.0,20.0,12.0,12.0,10.0,4.0,13.0,7.0,13.0,13.0,15.0,10.0,13.0,14.0,13.0,10.0,7.0,19.0,0.0,0.0,0.0,0.0,176.0,58.0,3.0,2.0,2.0,3.0,3.0,3.0,3.0,1.0,2.0,2.0,3.0,9.0,8.0,10.0,10.0,13.0,9.0,8.0,11.0,4.0,13.0,13.0,9.0,14.0,12.0,14.0,13.0,14.0,13.0,12.0,12.0,13.0,15.0,10.0,14.0,12.0,12.0,15.0,14.0,9.0,12.0,12.0,7.0,9.0,13.0,11.0,20.0,14.0,11.0,13.0,12.0,10.0,16.0,8.0,16.0,10.0,12.0,11.0,13.0,12.0,16.0,5.0,36.0,63.0,0.0,0.0,0.0,185.0,78.0,12.0,10.0,14.0,4.0,14.0,11.0,12.0,14.0,14.0,9.0,12.0,5.0,1.0,2.0,3.0,8.0,7.0,1.0,1.0,3.0,3.0,9.0,6.0,1.0,8.0,7.0,12.0,12.0,13.0,10.0,9.0,11.0,14.0,4.0,12.0,2.0,15.0,10.0,8.0,8.0,13.0,15.0,13.0,10.0,15.0,9.0,20.0,9.0,11.0,14.0,6.0,13.0,7.0,11.0,13.0,13.0,15.0,14.0,17.0,11.0,13.0,3.0,30.0,35.0,1.0,30.0,3.0,183.0,80.0,1.0,3.0,2.0,1.0,2.0,4.0,4.0,2.0,3.0,3.0,1.0,10.0,12.0,10.0,9.0,12.0,14.0,13.0,9.0,9.0,13.0,12.0,15.0,14.0,12.0,9.0,11.0,10.0,14.0,12.0,10.0,12.0,11.0,10.0,15.0,12.0,14.0,12.0,12.0,12.0,12.0,12.0,11.0,20.0,15.0,13.0,14.0,14.0,12.0,10.0,8.0,12.0,7.0,14.0,20.0,11.0,16.0,9.0,17.0,17.0,10.0,10.0,24.0,0.0,0.0,5.0,0.0,197.0,95.0,3.0,2.0,2.0,2.0,3.0,3.0,3.0,3.0,1.0,3.0,2.0,4.0,5.0,5.0,6.0,7.0,5.0,17.0,7.0,10.0,15.0,8.0,5.0,14.0,9.0,12.0,9.0,16.0,9.0,13.0,5.0,12.0,9.0,4.0,7.0,8.0,12.0,13.0,12.0,9.0,9.0,17.0,18.0,10.0,11.0,11.0,20.0,15.0,17.0,12.0,12.0,12.0,14.0,6.0,15.0,11.0,16.0,8.0,13.0,9.0,14.0,7.0,26.0,1.0,0.0,7.0,1.0,174.0,69.0,1.0,1.0,1.0,1.0,3.0,2.0,1.0,2.0,1.0,1.0,1.0,7.0,9.0,11.0,8.0,11.0,10.0,8.0,10.0,12.0,10.0,12.0,10.0,12.0,11.0,15.0,11.0,16.0,10.0,12.0,12.0,11.0,13.0,7.0,14.0,8.0,12.0,13.0,14.0,14.0,15.0,16.0,15.0,13.0,12.0,13.0,20.0,15.0,12.0,10.0,14.0,12.0,10.0,10.0,10.0,10.0,12.0,8.0,13.0,8.0,8.0,8.0,20.0,0.0,0.0,1.0,0.0,190.0,70.0,3.0,1.0,2.0,1.0,4.0,3.0,2.0,2.0,3.0,2.0,3.0,10.0,12.0,13.0,7.0,14.0,8.0,11.0,12.0,7.0,7.0,14.0,4.0,8.0,15.0,8.0,9.0,9.0,12.0,13.0,13.0,9.0,10.0,13.0,7.0,13.0,8.0,13.0,10.0,13.0,12.0,14.0,14.0,12.0,11.0,13.0,20.0,14.0,11.0,10.0,7.0,13.0,3.0,11.0,9.0,12.0,13.0,9.0,10.0,9.0,13.0,9.0,30.0,0.0,0.0,25.0,2.0,185.0,86.0,3.0,2.0,3.0,2.0,2.0,3.0,3.0,1.0,1.0,3.0,2.0,8.0,8.0,9.0,8.0,11.0,11.0,15.0,8.0,5.0,13.0,12.0,10.0,14.0,13.0,13.0,13.0,12.0,14.0,14.0,10.0,14.0,13.0,13.0,15.0,11.0,14.0,15.0,12.0,11.0,8.0,15.0,13.0,10.0,14.0,11.0,20.0,17.0,15.0,13.0,12.0,15.0,11.0,10.0,12.0,11.0,8.0,12.0,10.0,9.0,12.0,16.0,31.0,0.0,0.0,0.0,0.0,175.0,64.0,1.0,2.0,1.0,3.0,3.0,4.0,1.0,3.0,1.0,4.0,2.0,7.0,9.0,12.0,7.0,14.0,7.0,7.0,5.0,1.0,7.0,9.0,1.0,8.0,13.0,8.0,11.0,5.0,7.0,8.0,12.0,13.0,3.0,12.0,11.0,9.0,7.0,8.0,10.0,12.0,12.0,8.0,6.0,20.0,11.0,13.0,10.0,7.0,6.0,9.0,9.0,7.0,9.0,9.0,8.0,11.0,9.0,11.0,11.0,9.0,12.0,3.0,23.0,16.0,7.0,4.0,0.0,183.0,79.0,4.0,3.0,3.0,4.0,3.0,2.0,2.0,1.0,2.0,3.0,3.0,11.0,11.0,13.0,14.0,14.0,8.0,13.0,12.0,4.0,4.0,11.0,12.0,7.0,13.0,13.0,12.0,9.0,12.0,12.0,8.0,12.0,13.0,13.0,8.0,14.0,7.0,8.0,11.0,14.0,13.0,11.0,12.0,12.0,14.0,13.0,20.0,14.0,13.0,11.0,13.0,12.0,5.0,13.0,13.0,13.0,11.0,8.0,11.0,6.0,10.0,5.0,26.0,13.0,0.0,10.0,0.0,178.0,77.0,3.0,1.0,3.0,3.0,1.0,3.0,1.0,1.0,1.0,1.0,2.0,9.0,13.0,11.0,8.0,12.0,6.0,12.0,8.0,12.0,11.0,12.0,9.0,13.0,12.0,12.0,10.0,13.0,9.0,9.0,9.0,11.0,4.0,12.0,7.0,12.0,10.0,12.0,14.0,14.0,11.0,14.0,11.0,20.0,13.0,13.0,12.0,15.0,13.0,10.0,5.0,7.0,9.0,14.0,11.0,10.0,11.0,14.0,14.0,14.0,12.0,6.0,22.0,1.0,0.0,12.0,9.0,176.0,72.0,2.0,1.0,3.0,1.0,2.0,1.0,1.0,4.0,3.0,2.0,2.0,8.0,12.0,13.0,12.0,13.0,6.0,5.0,10.0,5.0,4.0,11.0,9.0,5.0,14.0,9.0,9.0,7.0,11.0,9.0,9.0,8.0,20.0,14.0,7.0,13.0,4.0,11.0,12.0,16.0,14.0,8.0,6.0,14.0,12.0,15.0,20.0,12.0,7.0,9.0,7.0,10.0,8.0,7.0,12.0,12.0,9.0,9.0,11.0,8.0,13.0,5.0,29.0,58.0,5.0,6.0,1.0,179.0,81.0,3.0,2.0,2.0,2.0,3.0,3.0,1.0,1.0,1.0,3.0,4.0,9.0,12.0,9.0,8.0,11.0,7.0,12.0,12.0,12.0,12.0,11.0,7.0,12.0,11.0,13.0,12.0,15.0,12.0,13.0,9.0,12.0,10.0,7.0,10.0,11.0,12.0,14.0,13.0,12.0,12.0,12.0,8.0,10.0,12.0,12.0,20.0,13.0,12.0,10.0,4.0,11.0,4.0,12.0,9.0,11.0,11.0,12.0,12.0,6.0,19.0,5.0
2,2,33.0,44.0,0.0,5.0,0.0,193.0,78.0,17.0,15.0,14.0,2.0,13.0,12.0,13.0,17.0,12.0,8.0,12.0,10.0,2.0,1.0,1.0,7.0,12.0,9.0,3.0,3.0,1.0,7.0,2.0,1.0,8.0,8.0,15.0,10.0,14.0,14.0,5.0,14.0,15.0,2.0,10.0,4.0,16.0,10.0,9.0,6.0,13.0,15.0,16.0,20.0,10.0,6.0,8.0,9.0,12.0,15.0,3.0,17.0,11.0,12.0,11.0,15.0,17.0,19.0,19.0,14.0,20.0,7.0,27.0,46.0,2.0,15.0,0.0,190.0,82.0,3.0,2.0,2.0,3.0,1.0,3.0,2.0,3.0,2.0,1.0,4.0,8.0,5.0,13.0,6.0,13.0,11.0,15.0,8.0,13.0,14.0,14.0,11.0,14.0,14.0,19.0,12.0,14.0,9.0,4.0,12.0,3.0,14.0,13.0,8.0,11.0,13.0,12.0,14.0,13.0,13.0,15.0,17.0,10.0,16.0,14.0,20.0,15.0,14.0,11.0,9.0,16.0,7.0,12.0,14.0,16.0,15.0,16.0,18.0,18.0,19.0,5.0,24.0,18.0,2.0,21.0,2.0,194.0,77.0,3.0,1.0,1.0,3.0,1.0,3.0,1.0,1.0,2.0,1.0,2.0,7.0,12.0,11.0,13.0,15.0,10.0,11.0,13.0,7.0,13.0,16.0,15.0,13.0,14.0,9.0,14.0,8.0,16.0,12.0,15.0,16.0,9.0,14.0,11.0,12.0,15.0,14.0,11.0,8.0,9.0,10.0,14.0,13.0,9.0,9.0,20.0,12.0,10.0,14.0,6.0,13.0,9.0,8.0,17.0,10.0,18.0,14.0,18.0,12.0,10.0,1.0,17.0,0.0,0.0,0.0,0.0,187.0,0.0,3.0,2.0,3.0,1.0,2.0,1.0,1.0,3.0,1.0,3.0,3.0,6.0,5.0,4.0,5.0,7.0,4.0,8.0,6.0,5.0,10.0,6.0,5.0,12.0,6.0,12.0,8.0,11.0,7.0,8.0,4.0,10.0,8.0,10.0,1.0,8.0,9.0,14.0,10.0,13.0,11.0,13.0,14.0,8.0,14.0,11.0,20.0,11.0,8.0,12.0,14.0,7.0,6.0,7.0,7.0,6.0,15.0,8.0,11.0,5.0,7.0,10.0,25.0,7.0,0.0,11.0,3.0,175.0,64.0,1.0,1.0,2.0,2.0,1.0,2.0,2.0,1.0,2.0,2.0,3.0,8.0,13.0,12.0,16.0,14.0,10.0,13.0,17.0,2.0,2.0,12.0,15.0,4.0,15.0,16.0,17.0,11.0,13.0,8.0,10.0,12.0,15.0,14.0,5.0,16.0,8.0,7.0,14.0,16.0,11.0,13.0,7.0,20.0,11.0,14.0,12.0,15.0,9.0,15.0,15.0,14.0,2.0,9.0,10.0,7.0,15.0,17.0,6.0,6.0,7.0,13.0,32.0,12.0,2.0,0.0,0.0,174.0,75.0,3.0,1.0,3.0,1.0,3.0,1.0,3.0,1.0,2.0,1.0,2.0,14.0,14.0,13.0,15.0,15.0,11.0,7.0,16.0,9.0,9.0,14.0,15.0,7.0,14.0,6.0,15.0,13.0,15.0,12.0,14.0,14.0,13.0,12.0,9.0,15.0,10.0,9.0,13.0,6.0,10.0,15.0,5.0,20.0,8.0,8.0,12.0,13.0,13.0,7.0,10.0,14.0,8.0,12.0,10.0,13.0,16.0,14.0,14.0,7.0,15.0,3.0,25.0,2.0,0.0,10.0,0.0,188.0,85.0,1.0,2.0,1.0,1.0,2.0,1.0,1.0,2.0,3.0,1.0,3.0,5.0,6.0,8.0,9.0,7.0,6.0,15.0,6.0,11.0,13.0,6.0,6.0,15.0,6.0,16.0,11.0,15.0,8.0,11.0,4.0,13.0,16.0,6.0,11.0,9.0,15.0,11.0,11.0,13.0,11.0,13.0,14.0,7.0,13.0,13.0,20.0,13.0,15.0,12.0,6.0,10.0,4.0,10.0,16.0,17.0,15.0,18.0,18.0,17.0,17.0,5.0,29.0,53.0,3.0,11.0,0.0,189.0,77.0,4.0,2.0,2.0,1.0,2.0,2.0,4.0,2.0,2.0,2.0,4.0,7.0,13.0,12.0,5.0,13.0,6.0,11.0,5.0,9.0,14.0,13.0,7.0,15.0,11.0,12.0,14.0,10.0,15.0,17.0,12.0,15.0,14.0,8.0,7.0,14.0,14.0,15.0,14.0,14.0,11.0,13.0,12.0,10.0,7.0,14.0,20.0,10.0,12.0,15.0,7.0,11.0,13.0,9.0,17.0,16.0,16.0,17.0,17.0,15.0,14.0,7.0,25.0,29.0,3.0,6.0,0.0,180.0,70.0,3.0,1.0,2.0,2.0,1.0,2.0,3.0,2.0,3.0,4.0,1.0,11.0,14.0,11.0,10.0,13.0,13.0,11.0,12.0,6.0,10.0,10.0,6.0,10.0,13.0,16.0,8.0,13.0,9.0,8.0,10.0,10.0,19.0,11.0,10.0,11.0,10.0,17.0,19.0,15.0,14.0,16.0,10.0,20.0,16.0,15.0,9.0,18.0,12.0,11.0,11.0,12.0,3.0,14.0,15.0,17.0,9.0,11.0,15.0,10.0,9.0,6.0,24.0,13.0,0.0,4.0,0.0,173.0,64.0,1.0,1.0,1.0,1.0,2.0,4.0,4.0,2.0,2.0,3.0,4.0,9.0,11.0,10.0,12.0,10.0,8.0,5.0,15.0,8.0,10.0,10.0,12.0,10.0,11.0,10.0,11.0,7.0,10.0,8.0,10.0,10.0,12.0,12.0,8.0,16.0,12.0,8.0,12.0,17.0,15.0,10.0,6.0,7.0,6.0,17.0,20.0,10.0,10.0,10.0,5.0,11.0,19.0,3.0,20.0,14.0,18.0,14.0,13.0,11.0,8.0,8.0,19.0,1.0,0.0,0.0,0.0,176.0,71.0,3.0,2.0,2.0,3.0,3.0,3.0,3.0,2.0,3.0,1.0,2.0,13.0,12.0,13.0,8.0,12.0,8.0,8.0,9.0,11.0,7.0,12.0,8.0,14.0,12.0,15.0,14.0,17.0,12.0,12.0,9.0,13.0,19.0,13.0,7.0,12.0,13.0,14.0,16.0,16.0,13.0,14.0,8.0,20.0,13.0,15.0,8.0,14.0,12.0,15.0,5.0,15.0,9.0,11.0,7.0,13.0,17.0,14.0,13.0,11.0,10.0,7.0,38.0,0.0,0.0,0.0,0.0,186.0,86.0,11.0,12.0,13.0,6.0,13.0,12.0,13.0,12.0,11.0,14.0,14.0,3.0,2.0,2.0,1.0,1.0,5.0,1.0,3.0,3.0,3.0,5.0,2.0,1.0,6.0,10.0,11.0,11.0,12.0,12.0,4.0,11.0,12.0,2.0,17.0,6.0,11.0,8.0,10.0,9.0,12.0,12.0,13.0,3.0,12.0,11.0,20.0,12.0,13.0,13.0,6.0,12.0,7.0,10.0,11.0,11.0,11.0,12.0,15.0,14.0,14.0,10.0,26.0,16.0,0.0,7.0,1.0,183.0,75.0,1.0,1.0,3.0,1.0,1.0,2.0,3.0,2.0,2.0,1.0,1.0,7.0,13.0,9.0,4.0,12.0,4.0,9.0,4.0,13.0,12.0,10.0,8.0,14.0,12.0,11.0,12.0,10.0,13.0,12.0,8.0,12.0,12.0,8.0,6.0,10.0,13.0,13.0,16.0,15.0,15.0,10.0,11.0,20.0,16.0,14.0,8.0,16.0,10.0,10.0,13.0,12.0,3.0,8.0,14.0,11.0,16.0,10.0,14.0,12.0,15.0,5.0,27.0,60.0,3.0,2.0,0.0,189.0,90.0,1.0,2.0,2.0,1.0,1.0,1.0,2.0,3.0,1.0,3.0,2.0,3.0,7.0,6.0,7.0,8.0,14.0,13.0,10.0,12.0,18.0,10.0,5.0,16.0,8.0,17.0,15.0,18.0,8.0,16.0,7.0,14.0,18.0,5.0,16.0,7.0,15.0,14.0,13.0,11.0,9.0,16.0,16.0,8.0,15.0,13.0,20.0,13.0,17.0,17.0,13.0,15.0,8.0,12.0,14.0,16.0,12.0,13.0,16.0,14.0,14.0,10.0,30.0,62.0,1.0,13.0,1.0,187.0,82.0,2.0,3.0,2.0,1.0,1.0,3.0,3.0,1.0,3.0,1.0,2.0,3.0,10.0,10.0,5.0,13.0,7.0,11.0,13.0,6.0,13.0,13.0,10.0,16.0,12.0,13.0,16.0,14.0,13.0,14.0,10.0,14.0,14.0,7.0,13.0,8.0,15.0,18.0,15.0,12.0,10.0,14.0,14.0,17.0,14.0,14.0,20.0,17.0,14.0,17.0,8.0,16.0,5.0,10.0,6.0,13.0,17.0,14.0,16.0,17.0,18.0,2.0,21.0,27.0,2.0,0.0,0.0,179.0,72.0,3.0,1.0,4.0,1.0,2.0,1.0,1.0,1.0,3.0,1.0,3.0,7.0,12.0,12.0,11.0,13.0,5.0,13.0,13.0,9.0,12.0,13.0,10.0,13.0,13.0,13.0,12.0,15.0,12.0,14.0,12.0,12.0,12.0,11.0,8.0,12.0,12.0,15.0,16.0,13.0,12.0,14.0,9.0,10.0,12.0,13.0,20.0,16.0,13.0,14.0,7.0,15.0,7.0,18.0,11.0,10.0,12.0,10.0,14.0,12.0,9.0,7.0,32.0,101.0,50.0,12.0,1.0,183.0,71.0,1.0,3.0,3.0,2.0,2.0,1.0,3.0,3.0,3.0,2.0,1.0,15.0,14.0,14.0,19.0,19.0,14.0,13.0,15.0,5.0,3.0,15.0,17.0,3.0,19.0,12.0,16.0,12.0,15.0,8.0,15.0,14.0,17.0,17.0,16.0,16.0,7.0,13.0,5.0,9.0,11.0,12.0,12.0,20.0,6.0,11.0,15.0,8.0,13.0,14.0,15.0,17.0,14.0,10.0,17.0,18.0,10.0,17.0,16.0,7.0,13.0,10.0,33.0,76.0,10.0,26.0,1.0,180.0,78.0,1.0,3.0,3.0,1.0,1.0,2.0,1.0,1.0,3.0,3.0,2.0,14.0,14.0,8.0,12.0,14.0,14.0,12.0,15.0,11.0,12.0,14.0,12.0,13.0,14.0,12.0,15.0,10.0,13.0,13.0,12.0,15.0,13.0,11.0,12.0,12.0,15.0,15.0,12.0,9.0,11.0,11.0,9.0,12.0,8.0,9.0,20.0,7.0,11.0,14.0,12.0,14.0,15.0,14.0,15.0,15.0,12.0,15.0,14.0,10.0,9.0,15.0,26.0,0.0,0.0,0.0,0.0,173.0,63.0,3.0,2.0,1.0,2.0,2.0,1.0,1.0,2.0,3.0,2.0,3.0,6.0,4.0,3.0,6.0,14.0,4.0,6.0,6.0,1.0,7.0,9.0,1.0,7.0,12.0,8.0,8.0,4.0,9.0,7.0,10.0,14.0,8.0,8.0,8.0,9.0,5.0,8.0,12.0,14.0,14.0,7.0,6.0,5.0,8.0,14.0,20.0,11.0,8.0,8.0,8.0,8.0,5.0,8.0,12.0,8.0,10.0,10.0,14.0,13.0,18.0,2.0,26.0,8.0,0.0,0.0,0.0,171.0,78.0,3.0,1.0,3.0,2.0,3.0,1.0,2.0,2.0,3.0,1.0,1.0,7.0,16.0,14.0,5.0,14.0,8.0,11.0,13.0,9.0,9.0,13.0,7.0,13.0,14.0,10.0,10.0,13.0,13.0,12.0,9.0,9.0,11.0,12.0,7.0,12.0,9.0,15.0,18.0,15.0,15.0,14.0,6.0,8.0,12.0,15.0,20.0,15.0,13.0,17.0,7.0,10.0,7.0,8.0,12.0,12.0,13.0,7.0,12.0,8.0,11.0,8.0,28.0,19.0,0.0,4.0,0.0,175.0,72.0,3.0,1.0,3.0,1.0,2.0,2.0,2.0,3.0,3.0,2.0,1.0,14.0,13.0,18.0,7.0,13.0,11.0,8.0,7.0,5.0,3.0,8.0,11.0,6.0,16.0,15.0,8.0,9.0,11.0,7.0,10.0,7.0,15.0,16.0,10.0,10.0,5.0,5.0,14.0,17.0,17.0,7.0,8.0,16.0,9.0,16.0,20.0,13.0,8.0,10.0,14.0,10.0,7.0,16.0,8.0,14.0,9.0,7.0,11.0,7.0,6.0,14.0,25.0,0.0,0.0,0.0,0.0,184.0,81.0,2.0,1.0,1.0,1.0,3.0,1.0,2.0,3.0,1.0,3.0,3.0,7.0,9.0,10.0,9.0,10.0,7.0,12.0,7.0,9.0,12.0,9.0,7.0,13.0,9.0,12.0,12.0,14.0,11.0,13.0,8.0,11.0,13.0,11.0,10.0,9.0,12.0,14.0,13.0,13.0,12.0,10.0,13.0,8.0,14.0,12.0,20.0,15.0,12.0,12.0,12.0,11.0,5.0,8.0,11.0,13.0,9.0,13.0,11.0,7.0,9.0,1.0
3,2,17.0,0.0,0.0,0.0,0.0,163.0,59.0,2.0,3.0,3.0,1.0,2.0,3.0,3.0,1.0,2.0,3.0,3.0,8.0,12.0,13.0,7.0,13.0,7.0,5.0,7.0,7.0,7.0,12.0,5.0,8.0,12.0,9.0,12.0,16.0,10.0,8.0,7.0,10.0,11.0,14.0,7.0,12.0,8.0,7.0,7.0,14.0,11.0,4.0,4.0,20.0,10.0,14.0,6.0,6.0,4.0,8.0,4.0,9.0,9.0,9.0,16.0,7.0,11.0,9.0,8.0,2.0,10.0,10.0,25.0,0.0,0.0,0.0,0.0,195.0,90.0,2.0,3.0,3.0,1.0,2.0,2.0,1.0,1.0,3.0,1.0,1.0,2.0,4.0,7.0,6.0,8.0,3.0,16.0,8.0,5.0,14.0,13.0,6.0,14.0,12.0,17.0,14.0,15.0,11.0,14.0,11.0,13.0,10.0,7.0,12.0,7.0,15.0,13.0,13.0,10.0,10.0,16.0,17.0,9.0,14.0,11.0,20.0,13.0,17.0,14.0,15.0,13.0,5.0,6.0,19.0,14.0,9.0,10.0,9.0,12.0,14.0,8.0,28.0,0.0,0.0,0.0,0.0,184.0,78.0,1.0,3.0,1.0,3.0,1.0,1.0,3.0,3.0,2.0,2.0,2.0,12.0,13.0,13.0,9.0,13.0,10.0,9.0,10.0,12.0,9.0,12.0,10.0,12.0,13.0,11.0,13.0,12.0,11.0,11.0,9.0,10.0,13.0,14.0,9.0,14.0,10.0,14.0,15.0,14.0,14.0,14.0,13.0,20.0,15.0,15.0,6.0,14.0,13.0,13.0,7.0,10.0,5.0,11.0,11.0,13.0,13.0,13.0,15.0,12.0,12.0,5.0,26.0,0.0,0.0,22.0,8.0,180.0,75.0,1.0,2.0,3.0,4.0,3.0,2.0,3.0,3.0,2.0,3.0,1.0,6.0,8.0,13.0,14.0,14.0,13.0,14.0,8.0,6.0,6.0,14.0,13.0,7.0,15.0,11.0,11.0,10.0,14.0,13.0,14.0,14.0,14.0,14.0,8.0,15.0,8.0,12.0,13.0,14.0,14.0,13.0,12.0,12.0,12.0,14.0,20.0,12.0,12.0,13.0,6.0,14.0,16.0,10.0,16.0,14.0,15.0,11.0,11.0,10.0,16.0,1.0,23.0,8.0,0.0,13.0,3.0,170.0,63.0,2.0,2.0,3.0,2.0,3.0,2.0,1.0,3.0,4.0,1.0,2.0,12.0,13.0,15.0,8.0,15.0,12.0,5.0,13.0,5.0,6.0,14.0,13.0,8.0,16.0,12.0,13.0,11.0,14.0,11.0,14.0,14.0,14.0,18.0,10.0,15.0,9.0,9.0,14.0,17.0,16.0,13.0,5.0,8.0,14.0,17.0,20.0,12.0,6.0,12.0,6.0,16.0,9.0,10.0,15.0,14.0,14.0,13.0,16.0,12.0,14.0,8.0,20.0,0.0,0.0,0.0,0.0,183.0,0.0,2.0,3.0,2.0,1.0,2.0,2.0,3.0,1.0,2.0,3.0,3.0,7.0,12.0,13.0,12.0,12.0,5.0,7.0,8.0,5.0,6.0,6.0,3.0,4.0,13.0,9.0,9.0,8.0,8.0,5.0,8.0,9.0,7.0,13.0,1.0,8.0,6.0,7.0,8.0,13.0,11.0,7.0,9.0,8.0,13.0,11.0,20.0,8.0,6.0,9.0,6.0,6.0,9.0,8.0,15.0,12.0,14.0,11.0,11.0,10.0,13.0,3.0,26.0,0.0,0.0,1.0,0.0,188.0,84.0,13.0,12.0,10.0,4.0,15.0,15.0,10.0,15.0,16.0,12.0,10.0,8.0,1.0,3.0,1.0,10.0,11.0,7.0,2.0,3.0,1.0,12.0,10.0,2.0,10.0,6.0,10.0,8.0,11.0,14.0,10.0,13.0,13.0,2.0,8.0,3.0,15.0,10.0,14.0,7.0,14.0,13.0,13.0,10.0,12.0,10.0,20.0,12.0,12.0,15.0,11.0,11.0,11.0,11.0,13.0,16.0,14.0,8.0,19.0,15.0,11.0,2.0,26.0,0.0,0.0,5.0,1.0,184.0,75.0,3.0,1.0,2.0,1.0,1.0,3.0,2.0,4.0,3.0,2.0,1.0,6.0,10.0,15.0,16.0,16.0,9.0,14.0,12.0,6.0,5.0,13.0,12.0,7.0,16.0,14.0,13.0,11.0,12.0,12.0,12.0,13.0,13.0,16.0,9.0,13.0,2.0,11.0,12.0,14.0,16.0,12.0,11.0,12.0,14.0,14.0,20.0,13.0,10.0,12.0,6.0,10.0,12.0,4.0,5.0,10.0,10.0,12.0,11.0,8.0,18.0,11.0,24.0,16.0,0.0,5.0,0.0,184.0,78.0,3.0,1.0,2.0,2.0,1.0,2.0,2.0,1.0,3.0,3.0,1.0,12.0,12.0,12.0,8.0,14.0,8.0,13.0,13.0,7.0,12.0,15.0,10.0,14.0,15.0,15.0,13.0,13.0,14.0,15.0,14.0,14.0,13.0,6.0,15.0,13.0,14.0,14.0,13.0,11.0,12.0,15.0,13.0,20.0,14.0,12.0,8.0,14.0,13.0,14.0,7.0,11.0,5.0,9.0,9.0,12.0,11.0,13.0,15.0,15.0,12.0,8.0,32.0,0.0,0.0,0.0,0.0,190.0,82.0,3.0,1.0,2.0,3.0,3.0,2.0,1.0,2.0,1.0,2.0,1.0,5.0,1.0,1.0,3.0,8.0,3.0,13.0,5.0,7.0,13.0,8.0,3.0,13.0,7.0,10.0,13.0,10.0,8.0,10.0,3.0,13.0,12.0,4.0,6.0,7.0,13.0,7.0,8.0,12.0,10.0,8.0,14.0,1.0,13.0,9.0,20.0,13.0,11.0,12.0,8.0,10.0,10.0,10.0,8.0,12.0,13.0,14.0,9.0,2.0,15.0,2.0,28.0,0.0,0.0,0.0,0.0,176.0,69.0,1.0,3.0,1.0,4.0,2.0,3.0,2.0,1.0,2.0,3.0,2.0,8.0,14.0,12.0,6.0,13.0,12.0,7.0,13.0,11.0,11.0,13.0,12.0,13.0,14.0,11.0,13.0,12.0,12.0,14.0,10.0,13.0,14.0,11.0,8.0,15.0,11.0,12.0,14.0,15.0,14.0,10.0,7.0,12.0,14.0,14.0,20.0,15.0,8.0,15.0,8.0,13.0,6.0,14.0,14.0,10.0,13.0,14.0,15.0,12.0,15.0,5.0,31.0,22.0,0.0,17.0,0.0,185.0,82.0,12.0,12.0,13.0,6.0,14.0,11.0,15.0,18.0,14.0,10.0,13.0,7.0,3.0,8.0,5.0,9.0,10.0,8.0,12.0,2.0,2.0,9.0,6.0,3.0,10.0,6.0,12.0,15.0,16.0,12.0,8.0,12.0,14.0,8.0,15.0,3.0,13.0,13.0,8.0,13.0,17.0,14.0,13.0,7.0,12.0,11.0,20.0,15.0,14.0,13.0,6.0,16.0,3.0,1.0,8.0,16.0,12.0,13.0,16.0,16.0,16.0,7.0,21.0,1.0,0.0,10.0,1.0,186.0,79.0,3.0,2.0,1.0,3.0,4.0,1.0,1.0,2.0,3.0,1.0,2.0,5.0,8.0,11.0,7.0,13.0,5.0,15.0,6.0,7.0,14.0,13.0,8.0,14.0,12.0,15.0,13.0,14.0,11.0,13.0,8.0,12.0,11.0,9.0,7.0,13.0,10.0,11.0,11.0,12.0,13.0,13.0,14.0,20.0,15.0,13.0,8.0,14.0,16.0,13.0,4.0,1.0,4.0,7.0,16.0,12.0,12.0,12.0,9.0,13.0,13.0,1.0,23.0,0.0,0.0,4.0,1.0,182.0,80.0,1.0,2.0,1.0,1.0,1.0,3.0,1.0,2.0,3.0,2.0,2.0,12.0,11.0,12.0,9.0,14.0,12.0,10.0,16.0,8.0,13.0,15.0,13.0,14.0,13.0,12.0,15.0,13.0,14.0,14.0,13.0,13.0,13.0,11.0,13.0,12.0,13.0,15.0,15.0,11.0,12.0,11.0,11.0,10.0,13.0,12.0,20.0,15.0,12.0,12.0,9.0,12.0,5.0,15.0,5.0,11.0,12.0,12.0,13.0,12.0,11.0,4.0,31.0,28.0,0.0,18.0,0.0,173.0,73.0,4.0,3.0,3.0,2.0,3.0,2.0,2.0,2.0,2.0,3.0,3.0,11.0,10.0,10.0,6.0,13.0,9.0,9.0,10.0,12.0,13.0,13.0,6.0,15.0,12.0,17.0,15.0,16.0,13.0,14.0,11.0,13.0,19.0,10.0,14.0,9.0,14.0,16.0,16.0,12.0,14.0,15.0,8.0,12.0,18.0,12.0,20.0,15.0,12.0,15.0,14.0,15.0,11.0,13.0,17.0,15.0,8.0,17.0,10.0,14.0,15.0,14.0,27.0,0.0,0.0,0.0,0.0,173.0,70.0,2.0,1.0,2.0,2.0,3.0,2.0,2.0,1.0,1.0,2.0,4.0,9.0,12.0,14.0,11.0,14.0,12.0,8.0,13.0,7.0,3.0,13.0,11.0,4.0,14.0,13.0,13.0,12.0,12.0,10.0,13.0,11.0,13.0,14.0,6.0,12.0,7.0,8.0,11.0,15.0,16.0,12.0,8.0,20.0,14.0,14.0,10.0,13.0,11.0,11.0,11.0,12.0,12.0,10.0,10.0,15.0,10.0,12.0,13.0,12.0,9.0,12.0,21.0,0.0,0.0,0.0,0.0,186.0,82.0,1.0,3.0,3.0,1.0,1.0,4.0,1.0,2.0,2.0,1.0,2.0,5.0,6.0,9.0,6.0,11.0,6.0,12.0,6.0,5.0,14.0,11.0,7.0,14.0,12.0,15.0,13.0,13.0,11.0,13.0,8.0,12.0,14.0,8.0,13.0,7.0,11.0,13.0,13.0,14.0,13.0,13.0,12.0,6.0,13.0,14.0,20.0,13.0,15.0,13.0,11.0,12.0,8.0,9.0,13.0,14.0,10.0,13.0,12.0,8.0,7.0,1.0,28.0,79.0,3.0,7.0,2.0,175.0,72.0,1.0,2.0,3.0,3.0,1.0,2.0,2.0,2.0,1.0,3.0,2.0,11.0,12.0,12.0,10.0,13.0,8.0,8.0,9.0,12.0,12.0,12.0,10.0,13.0,13.0,14.0,13.0,13.0,8.0,12.0,14.0,9.0,13.0,10.0,11.0,14.0,14.0,14.0,15.0,14.0,15.0,13.0,8.0,10.0,14.0,14.0,20.0,16.0,12.0,13.0,11.0,13.0,13.0,18.0,17.0,13.0,7.0,10.0,12.0,12.0,9.0,14.0,27.0,25.0,4.0,11.0,3.0,179.0,73.0,1.0,3.0,2.0,2.0,3.0,3.0,1.0,2.0,1.0,1.0,2.0,14.0,13.0,14.0,12.0,13.0,16.0,8.0,13.0,7.0,5.0,14.0,9.0,6.0,14.0,8.0,13.0,11.0,15.0,12.0,16.0,11.0,14.0,15.0,11.0,14.0,7.0,13.0,12.0,12.0,14.0,13.0,8.0,10.0,12.0,14.0,20.0,13.0,11.0,14.0,8.0,13.0,13.0,14.0,15.0,15.0,13.0,8.0,14.0,14.0,14.0,7.0,22.0,7.0,3.0,13.0,7.0,185.0,85.0,1.0,3.0,3.0,1.0,2.0,3.0,3.0,3.0,2.0,3.0,1.0,11.0,11.0,14.0,14.0,15.0,12.0,11.0,13.0,5.0,4.0,12.0,12.0,3.0,14.0,12.0,12.0,14.0,14.0,12.0,11.0,12.0,12.0,14.0,4.0,15.0,8.0,12.0,11.0,15.0,15.0,14.0,13.0,9.0,12.0,16.0,20.0,13.0,15.0,14.0,11.0,15.0,8.0,10.0,11.0,15.0,14.0,12.0,5.0,8.0,9.0,11.0,21.0,0.0,0.0,9.0,0.0,185.0,75.0,1.0,1.0,2.0,2.0,2.0,1.0,1.0,4.0,2.0,3.0,2.0,11.0,15.0,14.0,7.0,13.0,9.0,11.0,11.0,14.0,13.0,13.0,10.0,14.0,13.0,15.0,12.0,13.0,10.0,11.0,11.0,12.0,14.0,11.0,10.0,14.0,12.0,13.0,15.0,15.0,13.0,14.0,13.0,20.0,14.0,16.0,8.0,15.0,15.0,13.0,13.0,12.0,9.0,10.0,14.0,14.0,13.0,12.0,12.0,13.0,9.0,9.0,25.0,7.0,0.0,1.0,0.0,175.0,71.0,3.0,3.0,1.0,4.0,2.0,3.0,2.0,4.0,1.0,2.0,1.0,7.0,11.0,11.0,7.0,11.0,7.0,10.0,9.0,5.0,12.0,9.0,11.0,13.0,12.0,14.0,12.0,16.0,12.0,13.0,9.0,11.0,15.0,9.0,7.0,11.0,12.0,14.0,16.0,15.0,13.0,14.0,10.0,8.0,17.0,15.0,20.0,16.0,13.0,13.0,14.0,14.0,11.0,10.0,17.0,12.0,14.0,13.0,14.0,13.0,13.0,6.0
3,2,32.0,3.0,0.0,0.0,0.0,199.0,99.0,17.0,11.0,11.0,5.0,10.0,11.0,13.0,14.0,13.0,17.0,15.0,7.0,1.0,1.0,2.0,6.0,11.0,3.0,2.0,3.0,3.0,4.0,1.0,1.0,9.0,5.0,12.0,14.0,9.0,12.0,11.0,11.0,12.0,4.0,4.0,1.0,14.0,13.0,13.0,11.0,11.0,13.0,18.0,6.0,14.0,11.0,20.0,15.0,16.0,14.0,5.0,11.0,6.0,11.0,13.0,10.0,12.0,10.0,12.0,13.0,15.0,4.0,25.0,4.0,0.0,5.0,2.0,184.0,80.0,2.0,1.0,4.0,4.0,3.0,3.0,2.0,3.0,1.0,3.0,2.0,8.0,10.0,9.0,9.0,12.0,14.0,10.0,14.0,12.0,11.0,13.0,8.0,12.0,13.0,11.0,13.0,15.0,13.0,14.0,12.0,12.0,15.0,9.0,13.0,8.0,12.0,16.0,14.0,11.0,10.0,15.0,11.0,10.0,14.0,12.0,20.0,15.0,14.0,15.0,10.0,14.0,6.0,17.0,11.0,14.0,12.0,13.0,14.0,12.0,10.0,10.0,25.0,0.0,0.0,17.0,0.0,185.0,78.0,2.0,1.0,2.0,2.0,3.0,2.0,1.0,1.0,4.0,2.0,3.0,13.0,6.0,13.0,11.0,13.0,12.0,16.0,13.0,2.0,9.0,13.0,13.0,8.0,14.0,6.0,12.0,15.0,12.0,10.0,13.0,12.0,13.0,15.0,14.0,12.0,12.0,12.0,13.0,12.0,14.0,14.0,13.0,20.0,14.0,12.0,9.0,15.0,15.0,12.0,6.0,11.0,10.0,11.0,20.0,13.0,13.0,14.0,13.0,14.0,8.0,6.0,21.0,0.0,0.0,16.0,3.0,177.0,74.0,2.0,1.0,3.0,3.0,1.0,2.0,1.0,3.0,2.0,1.0,2.0,14.0,14.0,15.0,12.0,13.0,11.0,9.0,10.0,6.0,6.0,14.0,13.0,6.0,16.0,6.0,12.0,13.0,12.0,13.0,14.0,13.0,15.0,14.0,9.0,13.0,11.0,13.0,13.0,12.0,14.0,10.0,11.0,20.0,12.0,13.0,8.0,12.0,13.0,11.0,5.0,12.0,10.0,12.0,8.0,12.0,14.0,9.0,15.0,14.0,8.0,5.0,35.0,3.0,0.0,0.0,0.0,173.0,70.0,1.0,3.0,3.0,1.0,1.0,1.0,2.0,3.0,3.0,1.0,1.0,17.0,15.0,14.0,13.0,17.0,17.0,6.0,15.0,8.0,4.0,14.0,16.0,9.0,15.0,9.0,13.0,11.0,13.0,14.0,14.0,14.0,14.0,16.0,18.0,11.0,6.0,15.0,14.0,12.0,10.0,10.0,9.0,10.0,10.0,12.0,20.0,8.0,11.0,14.0,11.0,18.0,13.0,12.0,12.0,16.0,18.0,11.0,17.0,13.0,13.0,9.0,23.0,1.0,0.0,17.0,1.0,176.0,71.0,1.0,2.0,3.0,2.0,1.0,2.0,2.0,3.0,3.0,3.0,2.0,15.0,14.0,14.0,12.0,12.0,11.0,7.0,15.0,8.0,6.0,13.0,10.0,9.0,13.0,14.0,11.0,9.0,12.0,10.0,15.0,11.0,10.0,16.0,7.0,12.0,9.0,12.0,14.0,14.0,15.0,8.0,8.0,12.0,13.0,13.0,20.0,14.0,7.0,13.0,4.0,11.0,5.0,12.0,8.0,15.0,12.0,13.0,12.0,10.0,10.0,12.0,25.0,1.0,1.0,20.0,2.0,181.0,73.0,2.0,4.0,2.0,1.0,2.0,2.0,2.0,2.0,4.0,3.0,2.0,3.0,6.0,8.0,7.0,12.0,7.0,14.0,6.0,6.0,13.0,12.0,6.0,16.0,10.0,5.0,12.0,15.0,12.0,12.0,8.0,8.0,15.0,5.0,15.0,12.0,14.0,14.0,15.0,13.0,12.0,13.0,14.0,9.0,13.0,13.0,20.0,13.0,13.0,12.0,1.0,13.0,13.0,8.0,17.0,13.0,16.0,14.0,17.0,18.0,13.0,7.0,22.0,0.0,0.0,2.0,0.0,183.0,75.0,2.0,1.0,3.0,1.0,3.0,2.0,1.0,1.0,2.0,2.0,1.0,5.0,8.0,9.0,6.0,11.0,8.0,14.0,9.0,9.0,14.0,11.0,8.0,13.0,9.0,12.0,11.0,13.0,10.0,11.0,8.0,10.0,12.0,5.0,12.0,10.0,14.0,14.0,14.0,12.0,12.0,12.0,14.0,10.0,13.0,12.0,20.0,13.0,12.0,8.0,8.0,11.0,9.0,9.0,12.0,13.0,13.0,9.0,13.0,13.0,14.0,9.0,22.0,0.0,0.0,0.0,0.0,180.0,68.0,2.0,2.0,2.0,2.0,2.0,2.0,1.0,2.0,1.0,1.0,2.0,11.0,13.0,13.0,5.0,11.0,10.0,12.0,14.0,9.0,12.0,11.0,5.0,13.0,12.0,13.0,10.0,13.0,10.0,11.0,8.0,11.0,13.0,10.0,7.0,13.0,12.0,14.0,13.0,13.0,11.0,12.0,13.0,10.0,14.0,13.0,20.0,13.0,12.0,9.0,9.0,12.0,11.0,11.0,11.0,12.0,15.0,9.0,13.0,13.0,15.0,4.0,24.0,0.0,0.0,0.0,0.0,185.0,73.0,2.0,4.0,4.0,3.0,1.0,2.0,3.0,3.0,2.0,1.0,2.0,10.0,13.0,10.0,6.0,12.0,10.0,14.0,9.0,10.0,12.0,11.0,12.0,13.0,10.0,10.0,12.0,14.0,12.0,12.0,13.0,10.0,11.0,5.0,8.0,13.0,12.0,15.0,15.0,13.0,12.0,13.0,15.0,20.0,14.0,13.0,11.0,13.0,13.0,13.0,5.0,12.0,13.0,12.0,12.0,12.0,4.0,8.0,12.0,13.0,14.0,8.0,23.0,0.0,0.0,3.0,0.0,188.0,80.0,2.0,1.0,2.0,1.0,3.0,2.0,2.0,1.0,2.0,2.0,2.0,5.0,6.0,8.0,12.0,12.0,8.0,16.0,6.0,8.0,9.0,9.0,13.0,6.0,10.0,12.0,14.0,12.0,13.0,12.0,9.0,11.0,14.0,7.0,10.0,11.0,12.0,11.0,13.0,11.0,10.0,14.0,16.0,14.0,13.0,13.0,20.0,12.0,14.0,9.0,11.0,10.0,12.0,2.0,13.0,18.0,12.0,16.0,14.0,10.0,7.0,12.0,32.0,21.0,0.0,12.0,0.0,193.0,94.0,12.0,17.0,8.0,7.0,17.0,14.0,14.0,14.0,14.0,5.0,13.0,3.0,4.0,5.0,3.0,7.0,5.0,4.0,3.0,6.0,5.0,12.0,8.0,6.0,7.0,8.0,14.0,13.0,9.0,9.0,8.0,13.0,18.0,3.0,11.0,3.0,16.0,16.0,3.0,11.0,9.0,16.0,14.0,7.0,12.0,9.0,20.0,14.0,15.0,16.0,9.0,14.0,10.0,2.0,16.0,14.0,12.0,18.0,16.0,12.0,16.0,8.0,26.0,1.0,0.0,6.0,0.0,188.0,83.0,3.0,3.0,1.0,3.0,2.0,2.0,1.0,3.0,2.0,3.0,1.0,7.0,6.0,9.0,5.0,8.0,5.0,17.0,6.0,9.0,14.0,9.0,8.0,13.0,8.0,9.0,9.0,12.0,9.0,12.0,7.0,8.0,15.0,12.0,8.0,12.0,12.0,11.0,10.0,16.0,9.0,17.0,16.0,8.0,18.0,15.0,20.0,18.0,16.0,14.0,10.0,9.0,10.0,17.0,8.0,12.0,12.0,15.0,12.0,12.0,10.0,4.0,28.0,5.0,3.0,17.0,1.0,180.0,68.0,3.0,2.0,2.0,3.0,3.0,3.0,3.0,2.0,3.0,2.0,4.0,4.0,9.0,16.0,12.0,17.0,11.0,6.0,13.0,7.0,9.0,16.0,13.0,13.0,16.0,9.0,15.0,12.0,12.0,9.0,14.0,14.0,11.0,16.0,5.0,11.0,11.0,11.0,10.0,12.0,12.0,9.0,8.0,15.0,11.0,10.0,20.0,9.0,9.0,14.0,13.0,14.0,7.0,7.0,11.0,9.0,15.0,11.0,17.0,17.0,11.0,4.0,32.0,29.0,0.0,11.0,1.0,179.0,79.0,3.0,2.0,3.0,3.0,1.0,2.0,1.0,3.0,3.0,1.0,1.0,12.0,14.0,15.0,10.0,13.0,12.0,7.0,15.0,8.0,13.0,13.0,13.0,15.0,14.0,12.0,12.0,15.0,13.0,9.0,10.0,13.0,16.0,14.0,12.0,7.0,12.0,10.0,16.0,13.0,16.0,13.0,8.0,10.0,14.0,16.0,20.0,18.0,7.0,15.0,12.0,15.0,10.0,17.0,4.0,12.0,20.0,8.0,14.0,10.0,10.0,15.0,25.0,8.0,0.0,4.0,1.0,179.0,72.0,1.0,1.0,1.0,1.0,1.0,2.0,1.0,3.0,2.0,2.0,2.0,11.0,11.0,11.0,11.0,14.0,13.0,10.0,13.0,10.0,11.0,12.0,14.0,9.0,14.0,13.0,13.0,13.0,15.0,12.0,11.0,13.0,13.0,14.0,14.0,11.0,9.0,9.0,13.0,13.0,12.0,13.0,10.0,10.0,12.0,13.0,20.0,14.0,9.0,13.0,14.0,17.0,10.0,13.0,4.0,12.0,10.0,12.0,12.0,12.0,10.0,8.0,26.0,2.0,1.0,11.0,0.0,177.0,73.0,1.0,3.0,3.0,1.0,3.0,2.0,1.0,1.0,2.0,3.0,2.0,12.0,11.0,14.0,13.0,13.0,10.0,8.0,14.0,9.0,8.0,13.0,13.0,10.0,13.0,15.0,11.0,14.0,11.0,10.0,11.0,11.0,10.0,16.0,7.0,12.0,8.0,8.0,11.0,14.0,14.0,12.0,8.0,10.0,8.0,16.0,20.0,12.0,8.0,11.0,13.0,11.0,9.0,7.0,10.0,13.0,19.0,9.0,11.0,8.0,6.0,12.0,28.0,29.0,4.0,10.0,4.0,183.0,75.0,2.0,2.0,1.0,2.0,1.0,1.0,1.0,1.0,1.0,1.0,2.0,10.0,11.0,15.0,14.0,13.0,12.0,12.0,13.0,8.0,7.0,12.0,14.0,9.0,10.0,13.0,11.0,12.0,10.0,14.0,7.0,11.0,16.0,14.0,7.0,11.0,5.0,9.0,11.0,16.0,12.0,15.0,11.0,12.0,14.0,15.0,20.0,14.0,10.0,10.0,14.0,17.0,6.0,11.0,13.0,11.0,17.0,13.0,14.0,10.0,7.0,5.0,24.0,14.0,0.0,21.0,1.0,177.0,67.0,2.0,3.0,3.0,2.0,2.0,3.0,2.0,3.0,2.0,1.0,4.0,11.0,11.0,13.0,13.0,13.0,12.0,5.0,13.0,6.0,9.0,14.0,13.0,5.0,14.0,12.0,13.0,13.0,14.0,14.0,12.0,14.0,11.0,15.0,8.0,11.0,13.0,11.0,14.0,13.0,14.0,13.0,7.0,12.0,6.0,14.0,20.0,16.0,12.0,11.0,12.0,10.0,12.0,14.0,9.0,9.0,12.0,12.0,9.0,7.0,11.0,6.0,28.0,0.0,0.0,13.0,2.0,185.0,75.0,2.0,1.0,3.0,2.0,1.0,1.0,2.0,2.0,2.0,2.0,3.0,15.0,19.0,12.0,12.0,14.0,15.0,8.0,9.0,9.0,10.0,15.0,13.0,12.0,14.0,9.0,11.0,10.0,11.0,10.0,9.0,11.0,12.0,13.0,9.0,11.0,14.0,11.0,12.0,13.0,11.0,11.0,10.0,20.0,11.0,12.0,8.0,13.0,11.0,15.0,12.0,14.0,9.0,13.0,7.0,10.0,12.0,13.0,12.0,10.0,10.0,8.0,23.0,0.0,0.0,4.0,0.0,192.0,86.0,3.0,3.0,2.0,1.0,2.0,2.0,3.0,4.0,2.0,1.0,2.0,6.0,6.0,9.0,11.0,10.0,8.0,16.0,8.0,8.0,14.0,11.0,9.0,12.0,10.0,14.0,12.0,16.0,12.0,13.0,10.0,12.0,14.0,13.0,12.0,14.0,14.0,12.0,12.0,15.0,9.0,15.0,14.0,7.0,13.0,11.0,20.0,15.0,15.0,14.0,11.0,12.0,6.0,9.0,12.0,11.0,12.0,12.0,12.0,10.0,10.0,8.0,30.0,14.0,0.0,15.0,1.0,179.0,77.0,2.0,3.0,2.0,3.0,3.0,4.0,2.0,3.0,1.0,2.0,3.0,8.0,12.0,12.0,11.0,11.0,8.0,9.0,11.0,12.0,13.0,10.0,9.0,13.0,10.0,12.0,13.0,14.0,12.0,15.0,10.0,13.0,14.0,12.0,11.0,13.0,11.0,16.0,14.0,13.0,11.0,12.0,7.0,10.0,16.0,13.0,20.0,14.0,11.0,13.0,8.0,14.0,5.0,16.0,8.0,12.0,13.0,10.0,14.0,14.0,17.0,8.0
1,4,27.0,0.0,0.0,3.0,0.0,196.0,91.0,17.0,10.0,13.0,8.0,11.0,10.0,15.0,15.0,10.0,10.0,13.0,5.0,3.0,2.0,3.0,7.0,7.0,7.0,1.0,2.0,3.0,9.0,3.0,2.0,8.0,12.0,11.0,12.0,12.0,9.0,10.0,10.0,15.0,3.0,11.0,3.0,10.0,13.0,12.0,9.0,10.0,12.0,18.0,6.0,8.0,10.0,20.0,9.0,15.0,10.0,7.0,14.0,10.0,11.0,13.0,18.0,16.0,9.0,13.0,12.0,8.0,5.0,27.0,2.0,0.0,0.0,0.0,184.0,73.0,3.0,2.0,1.0,4.0,3.0,3.0,2.0,2.0,1.0,2.0,2.0,6.0,11.0,8.0,4.0,12.0,7.0,11.0,6.0,16.0,14.0,13.0,6.0,14.0,11.0,14.0,15.0,14.0,13.0,12.0,12.0,13.0,13.0,6.0,11.0,5.0,14.0,16.0,14.0,12.0,11.0,12.0,13.0,8.0,13.0,13.0,20.0,12.0,13.0,12.0,9.0,14.0,13.0,15.0,7.0,14.0,14.0,14.0,13.0,13.0,12.0,4.0,29.0,54.0,1.0,19.0,6.0,194.0,86.0,3.0,3.0,1.0,1.0,1.0,1.0,1.0,1.0,3.0,1.0,2.0,8.0,11.0,8.0,8.0,13.0,13.0,13.0,13.0,10.0,12.0,15.0,12.0,14.0,12.0,12.0,15.0,13.0,14.0,13.0,12.0,14.0,18.0,7.0,15.0,10.0,15.0,16.0,16.0,6.0,10.0,15.0,16.0,20.0,17.0,12.0,7.0,16.0,14.0,13.0,7.0,15.0,3.0,14.0,15.0,17.0,17.0,16.0,17.0,14.0,13.0,3.0,24.0,5.0,1.0,8.0,2.0,185.0,82.0,3.0,3.0,3.0,1.0,1.0,3.0,1.0,3.0,3.0,3.0,2.0,6.0,7.0,8.0,7.0,12.0,6.0,15.0,7.0,10.0,15.0,10.0,7.0,15.0,9.0,16.0,14.0,15.0,14.0,12.0,9.0,15.0,14.0,9.0,15.0,9.0,14.0,14.0,15.0,9.0,8.0,13.0,14.0,10.0,16.0,14.0,20.0,15.0,14.0,13.0,11.0,15.0,11.0,11.0,14.0,17.0,14.0,13.0,14.0,13.0,13.0,6.0,32.0,35.0,2.0,16.0,1.0,181.0,74.0,2.0,1.0,1.0,2.0,1.0,3.0,1.0,1.0,2.0,2.0,1.0,14.0,14.0,11.0,12.0,13.0,15.0,7.0,14.0,12.0,10.0,16.0,16.0,8.0,14.0,10.0,13.0,10.0,14.0,13.0,15.0,14.0,12.0,11.0,14.0,15.0,12.0,17.0,14.0,7.0,8.0,10.0,9.0,14.0,12.0,8.0,20.0,14.0,10.0,13.0,5.0,13.0,1.0,15.0,8.0,14.0,15.0,11.0,13.0,15.0,14.0,10.0,31.0,13.0,4.0,21.0,9.0,185.0,87.0,2.0,3.0,2.0,3.0,2.0,1.0,1.0,2.0,3.0,1.0,1.0,5.0,6.0,7.0,14.0,9.0,7.0,16.0,10.0,12.0,8.0,11.0,14.0,9.0,8.0,17.0,17.0,17.0,15.0,13.0,12.0,13.0,16.0,8.0,14.0,15.0,6.0,16.0,13.0,8.0,7.0,13.0,16.0,11.0,7.0,10.0,20.0,11.0,15.0,13.0,13.0,15.0,14.0,2.0,11.0,12.0,15.0,14.0,14.0,7.0,7.0,7.0,28.0,0.0,0.0,0.0,0.0,182.0,72.0,3.0,3.0,3.0,1.0,1.0,2.0,2.0,2.0,3.0,2.0,4.0,7.0,8.0,12.0,14.0,13.0,11.0,14.0,12.0,4.0,6.0,11.0,14.0,6.0,13.0,18.0,14.0,16.0,11.0,6.0,11.0,8.0,17.0,10.0,6.0,15.0,5.0,4.0,16.0,11.0,12.0,13.0,13.0,20.0,11.0,14.0,8.0,14.0,14.0,10.0,15.0,15.0,10.0,12.0,11.0,20.0,8.0,12.0,15.0,6.0,8.0,13.0,19.0,0.0,0.0,0.0,0.0,180.0,73.0,3.0,1.0,2.0,3.0,2.0,2.0,1.0,3.0,3.0,1.0,1.0,13.0,12.0,14.0,11.0,14.0,14.0,6.0,13.0,5.0,5.0,14.0,12.0,4.0,14.0,9.0,12.0,7.0,9.0,7.0,14.0,7.0,13.0,14.0,7.0,13.0,6.0,7.0,7.0,14.0,12.0,12.0,8.0,16.0,13.0,12.0,20.0,12.0,8.0,6.0,7.0,12.0,6.0,12.0,9.0,13.0,10.0,9.0,7.0,7.0,8.0,14.0,22.0,0.0,0.0,0.0,0.0,186.0,78.0,1.0,1.0,2.0,1.0,3.0,1.0,3.0,3.0,4.0,2.0,1.0,7.0,11.0,10.0,6.0,12.0,9.0,12.0,8.0,13.0,12.0,13.0,9.0,13.0,11.0,14.0,12.0,14.0,12.0,10.0,12.0,10.0,10.0,8.0,12.0,12.0,13.0,15.0,15.0,10.0,11.0,12.0,12.0,11.0,15.0,12.0,20.0,13.0,9.0,11.0,11.0,14.0,3.0,18.0,8.0,12.0,14.0,10.0,12.0,11.0,10.0,8.0,26.0,2.0,0.0,6.0,1.0,183.0,79.0,2.0,2.0,1.0,3.0,1.0,1.0,2.0,3.0,1.0,4.0,3.0,14.0,12.0,13.0,12.0,12.0,14.0,15.0,12.0,14.0,12.0,12.0,11.0,12.0,12.0,11.0,14.0,14.0,10.0,10.0,12.0,11.0,15.0,14.0,9.0,15.0,11.0,12.0,13.0,13.0,12.0,13.0,11.0,20.0,12.0,14.0,9.0,15.0,12.0,14.0,12.0,12.0,7.0,14.0,12.0,15.0,15.0,14.0,14.0,10.0,8.0,6.0,26.0,6.0,0.0,9.0,3.0,177.0,76.0,2.0,1.0,1.0,4.0,3.0,1.0,1.0,2.0,3.0,3.0,2.0,10.0,11.0,13.0,12.0,11.0,11.0,9.0,13.0,4.0,9.0,10.0,11.0,10.0,13.0,8.0,11.0,12.0,8.0,7.0,9.0,6.0,10.0,14.0,8.0,12.0,9.0,11.0,15.0,14.0,11.0,10.0,10.0,12.0,14.0,17.0,20.0,13.0,10.0,6.0,6.0,11.0,5.0,11.0,13.0,12.0,11.0,9.0,15.0,10.0,11.0,6.0,33.0,33.0,0.0,20.0,0.0,188.0,92.0,11.0,11.0,17.0,15.0,13.0,18.0,13.0,14.0,18.0,13.0,17.0,9.0,1.0,2.0,2.0,12.0,11.0,10.0,1.0,3.0,1.0,13.0,6.0,2.0,12.0,10.0,17.0,14.0,18.0,12.0,12.0,11.0,15.0,3.0,15.0,1.0,15.0,13.0,10.0,11.0,15.0,12.0,13.0,10.0,12.0,10.0,20.0,12.0,17.0,14.0,9.0,13.0,6.0,12.0,17.0,12.0,14.0,13.0,17.0,16.0,10.0,9.0,25.0,0.0,0.0,5.0,0.0,173.0,73.0,1.0,4.0,2.0,3.0,3.0,3.0,2.0,3.0,3.0,2.0,1.0,6.0,11.0,15.0,10.0,14.0,8.0,10.0,12.0,8.0,16.0,14.0,10.0,17.0,14.0,16.0,13.0,16.0,14.0,15.0,13.0,14.0,16.0,13.0,11.0,13.0,14.0,16.0,15.0,14.0,14.0,13.0,9.0,8.0,14.0,14.0,20.0,16.0,15.0,14.0,12.0,13.0,12.0,15.0,13.0,13.0,12.0,14.0,14.0,12.0,13.0,9.0,30.0,1.0,0.0,0.0,0.0,176.0,70.0,4.0,1.0,2.0,2.0,2.0,3.0,1.0,2.0,1.0,3.0,3.0,14.0,9.0,11.0,6.0,15.0,13.0,7.0,11.0,6.0,12.0,16.0,7.0,12.0,15.0,9.0,12.0,12.0,12.0,14.0,16.0,14.0,14.0,14.0,14.0,9.0,13.0,15.0,13.0,12.0,13.0,13.0,7.0,10.0,13.0,13.0,20.0,13.0,14.0,14.0,8.0,14.0,9.0,10.0,14.0,14.0,13.0,9.0,14.0,14.0,15.0,2.0,29.0,2.0,0.0,4.0,1.0,178.0,73.0,3.0,3.0,2.0,1.0,1.0,2.0,1.0,1.0,1.0,3.0,3.0,9.0,13.0,12.0,14.0,15.0,11.0,10.0,13.0,8.0,9.0,14.0,12.0,10.0,15.0,12.0,14.0,14.0,14.0,14.0,14.0,14.0,16.0,15.0,10.0,17.0,9.0,17.0,15.0,15.0,15.0,13.0,10.0,11.0,14.0,14.0,20.0,16.0,12.0,15.0,8.0,15.0,7.0,13.0,16.0,15.0,15.0,14.0,14.0,10.0,8.0,11.0,34.0,34.0,0.0,2.0,0.0,184.0,79.0,1.0,2.0,1.0,2.0,2.0,1.0,3.0,1.0,3.0,2.0,1.0,8.0,12.0,12.0,10.0,12.0,4.0,13.0,8.0,13.0,12.0,12.0,2.0,15.0,13.0,13.0,14.0,15.0,11.0,13.0,12.0,12.0,11.0,7.0,10.0,14.0,15.0,13.0,15.0,12.0,13.0,15.0,13.0,9.0,15.0,14.0,20.0,13.0,14.0,12.0,9.0,15.0,12.0,14.0,10.0,12.0,15.0,14.0,15.0,18.0,10.0,7.0,17.0,0.0,0.0,0.0,0.0,173.0,0.0,1.0,2.0,4.0,1.0,1.0,1.0,3.0,2.0,2.0,3.0,1.0,7.0,8.0,5.0,3.0,8.0,2.0,4.0,6.0,4.0,7.0,7.0,6.0,8.0,5.0,7.0,9.0,16.0,8.0,9.0,7.0,12.0,6.0,9.0,7.0,7.0,9.0,13.0,8.0,11.0,9.0,6.0,6.0,8.0,11.0,9.0,20.0,12.0,8.0,5.0,13.0,8.0,3.0,11.0,11.0,10.0,13.0,12.0,15.0,10.0,7.0,2.0,26.0,32.0,0.0,3.0,0.0,184.0,75.0,3.0,1.0,3.0,2.0,3.0,1.0,3.0,3.0,2.0,1.0,2.0,5.0,11.0,12.0,8.0,13.0,8.0,14.0,7.0,7.0,14.0,12.0,10.0,15.0,11.0,11.0,16.0,12.0,15.0,10.0,14.0,13.0,15.0,14.0,14.0,8.0,14.0,14.0,14.0,11.0,11.0,14.0,13.0,15.0,16.0,13.0,20.0,14.0,14.0,13.0,6.0,17.0,3.0,15.0,16.0,15.0,13.0,13.0,15.0,14.0,10.0,3.0,24.0,6.0,1.0,24.0,12.0,186.0,81.0,2.0,3.0,1.0,3.0,1.0,1.0,2.0,1.0,3.0,2.0,2.0,13.0,14.0,13.0,15.0,15.0,15.0,14.0,17.0,8.0,5.0,13.0,15.0,7.0,14.0,11.0,13.0,8.0,13.0,14.0,14.0,13.0,13.0,14.0,8.0,15.0,9.0,12.0,12.0,13.0,14.0,14.0,12.0,20.0,12.0,14.0,10.0,14.0,13.0,14.0,10.0,14.0,6.0,12.0,14.0,18.0,13.0,11.0,17.0,15.0,11.0,6.0,25.0,6.0,0.0,0.0,0.0,195.0,89.0,2.0,3.0,1.0,3.0,3.0,3.0,2.0,2.0,3.0,1.0,3.0,6.0,7.0,10.0,6.0,12.0,6.0,16.0,8.0,8.0,16.0,12.0,6.0,16.0,11.0,14.0,16.0,14.0,13.0,10.0,11.0,11.0,16.0,8.0,12.0,9.0,15.0,14.0,16.0,12.0,14.0,18.0,17.0,10.0,14.0,16.0,20.0,16.0,19.0,14.0,13.0,14.0,8.0,10.0,12.0,15.0,11.0,14.0,12.0,14.0,14.0,7.0,25.0,26.0,5.0,0.0,0.0,188.0,80.0,2.0,2.0,2.0,4.0,3.0,2.0,3.0,3.0,2.0,1.0,2.0,13.0,14.0,13.0,6.0,13.0,11.0,11.0,12.0,18.0,12.0,14.0,10.0,15.0,13.0,11.0,13.0,14.0,12.0,12.0,12.0,12.0,15.0,11.0,7.0,14.0,13.0,14.0,17.0,13.0,14.0,15.0,12.0,20.0,15.0,16.0,8.0,17.0,14.0,13.0,12.0,13.0,7.0,14.0,14.0,16.0,12.0,13.0,13.0,12.0,12.0,12.0,25.0,18.0,5.0,2.0,0.0,187.0,80.0,2.0,2.0,1.0,3.0,4.0,3.0,1.0,4.0,3.0,2.0,2.0,12.0,14.0,13.0,13.0,14.0,9.0,12.0,13.0,9.0,8.0,14.0,11.0,10.0,14.0,10.0,11.0,8.0,13.0,13.0,15.0,14.0,10.0,12.0,9.0,14.0,14.0,12.0,13.0,13.0,14.0,15.0,14.0,10.0,14.0,14.0,20.0,14.0,13.0,10.0,5.0,12.0,10.0,10.0,12.0,14.0,13.0,13.0,11.0,10.0,12.0,9.0
0,2,28.0,0.0,0.0,13.0,0.0,184.0,78.0,13.0,11.0,13.0,8.0,15.0,11.0,12.0,14.0,14.0,13.0,13.0,3.0,1.0,2.0,1.0,7.0,6.0,8.0,3.0,3.0,1.0,11.0,4.0,2.0,12.0,11.0,11.0,12.0,12.0,11.0,10.0,9.0,12.0,3.0,11.0,1.0,14.0,12.0,12.0,12.0,13.0,13.0,13.0,6.0,11.0,13.0,20.0,7.0,13.0,11.0,6.0,6.0,11.0,10.0,12.0,5.0,15.0,13.0,17.0,14.0,15.0,5.0,24.0,0.0,0.0,5.0,0.0,182.0,75.0,3.0,2.0,3.0,4.0,3.0,3.0,3.0,3.0,2.0,1.0,1.0,12.0,11.0,12.0,7.0,14.0,10.0,5.0,10.0,5.0,8.0,14.0,11.0,7.0,13.0,11.0,9.0,8.0,14.0,14.0,15.0,14.0,11.0,15.0,8.0,12.0,9.0,12.0,8.0,11.0,12.0,12.0,8.0,6.0,14.0,11.0,20.0,12.0,8.0,14.0,9.0,14.0,15.0,10.0,19.0,15.0,14.0,12.0,9.0,9.0,13.0,7.0,24.0,0.0,0.0,3.0,0.0,181.0,71.0,2.0,2.0,1.0,2.0,3.0,3.0,2.0,3.0,2.0,2.0,3.0,12.0,12.0,11.0,8.0,13.0,13.0,8.0,13.0,7.0,11.0,13.0,11.0,12.0,13.0,12.0,13.0,12.0,13.0,12.0,13.0,12.0,14.0,8.0,12.0,13.0,13.0,14.0,14.0,12.0,12.0,13.0,10.0,12.0,13.0,12.0,20.0,12.0,11.0,13.0,7.0,11.0,11.0,13.0,19.0,12.0,16.0,14.0,16.0,14.0,14.0,8.0,24.0,0.0,0.0,0.0,0.0,179.0,0.0,3.0,3.0,3.0,1.0,2.0,4.0,1.0,3.0,2.0,2.0,1.0,6.0,3.0,8.0,7.0,13.0,6.0,6.0,13.0,3.0,7.0,10.0,4.0,7.0,9.0,9.0,10.0,3.0,7.0,5.0,8.0,13.0,9.0,9.0,4.0,11.0,8.0,8.0,12.0,13.0,13.0,8.0,4.0,5.0,13.0,13.0,20.0,7.0,5.0,9.0,7.0,9.0,6.0,9.0,7.0,9.0,11.0,9.0,14.0,3.0,5.0,7.0,22.0,0.0,0.0,0.0,0.0,186.0,0.0,1.0,4.0,1.0,3.0,2.0,1.0,1.0,1.0,1.0,2.0,3.0,6.0,2.0,10.0,13.0,10.0,3.0,13.0,7.0,6.0,5.0,7.0,8.0,1.0,13.0,6.0,10.0,6.0,10.0,6.0,6.0,9.0,8.0,13.0,5.0,12.0,5.0,6.0,7.0,12.0,10.0,7.0,8.0,12.0,15.0,9.0,20.0,7.0,10.0,9.0,6.0,9.0,9.0,9.0,9.0,11.0,13.0,9.0,11.0,8.0,12.0,7.0,26.0,12.0,1.0,0.0,0.0,181.0,70.0,2.0,1.0,2.0,2.0,2.0,1.0,4.0,1.0,1.0,4.0,2.0,13.0,11.0,14.0,12.0,14.0,10.0,8.0,10.0,6.0,6.0,11.0,12.0,7.0,14.0,8.0,12.0,11.0,12.0,9.0,12.0,10.0,9.0,15.0,9.0,14.0,8.0,11.0,12.0,13.0,13.0,10.0,11.0,12.0,13.0,13.0,20.0,12.0,8.0,9.0,7.0,10.0,9.0,13.0,7.0,14.0,7.0,11.0,11.0,14.0,14.0,5.0,22.0,0.0,0.0,1.0,0.0,183.0,76.0,3.0,3.0,3.0,3.0,1.0,3.0,2.0,3.0,3.0,1.0,1.0,8.0,12.0,12.0,10.0,11.0,10.0,9.0,10.0,7.0,7.0,11.0,12.0,7.0,14.0,12.0,13.0,14.0,9.0,10.0,12.0,9.0,11.0,13.0,9.0,14.0,11.0,13.0,15.0,14.0,14.0,13.0,12.0,11.0,11.0,14.0,20.0,12.0,10.0,11.0,7.0,9.0,9.0,13.0,8.0,13.0,14.0,13.0,12.0,10.0,18.0,3.0,25.0,0.0,0.0,2.0,0.0,178.0,72.0,2.0,2.0,2.0,1.0,3.0,3.0,4.0,3.0,4.0,1.0,3.0,11.0,12.0,12.0,7.0,12.0,10.0,8.0,12.0,12.0,7.0,12.0,12.0,12.0,14.0,13.0,12.0,12.0,13.0,11.0,10.0,13.0,13.0,10.0,7.0,13.0,10.0,12.0,12.0,14.0,12.0,11.0,8.0,20.0,12.0,14.0,5.0,12.0,10.0,11.0,10.0,10.0,7.0,13.0,8.0,12.0,13.0,13.0,13.0,11.0,11.0,8.0,29.0,2.0,0.0,8.0,0.0,182.0,78.0,2.0,1.0,3.0,1.0,2.0,2.0,2.0,2.0,4.0,1.0,1.0,12.0,11.0,9.0,5.0,11.0,12.0,13.0,8.0,10.0,14.0,12.0,10.0,13.0,13.0,11.0,14.0,12.0,13.0,14.0,8.0,11.0,13.0,6.0,16.0,9.0,14.0,15.0,12.0,11.0,11.0,13.0,14.0,20.0,12.0,12.0,4.0,14.0,12.0,14.0,6.0,12.0,11.0,11.0,10.0,14.0,17.0,9.0,12.0,12.0,15.0,5.0,25.0,0.0,0.0,1.0,0.0,186.0,80.0,2.0,1.0,2.0,2.0,2.0,4.0,3.0,2.0,1.0,2.0,1.0,6.0,7.0,10.0,6.0,12.0,6.0,11.0,5.0,6.0,14.0,12.0,7.0,12.0,12.0,11.0,16.0,15.0,8.0,14.0,7.0,10.0,12.0,6.0,8.0,8.0,12.0,13.0,14.0,14.0,13.0,13.0,13.0,12.0,12.0,14.0,20.0,14.0,12.0,12.0,8.0,3.0,8.0,8.0,7.0,14.0,11.0,12.0,12.0,10.0,14.0,2.0,29.0,4.0,2.0,0.0,0.0,176.0,75.0,3.0,3.0,1.0,3.0,2.0,3.0,1.0,1.0,1.0,2.0,1.0,9.0,9.0,11.0,13.0,11.0,12.0,10.0,12.0,7.0,6.0,11.0,12.0,7.0,12.0,10.0,12.0,10.0,9.0,10.0,9.0,8.0,12.0,13.0,6.0,13.0,7.0,11.0,11.0,15.0,12.0,13.0,10.0,10.0,14.0,14.0,20.0,13.0,12.0,10.0,6.0,10.0,7.0,13.0,13.0,11.0,12.0,11.0,9.0,14.0,14.0,5.0,27.0,6.0,0.0,17.0,0.0,188.0,82.0,11.0,13.0,14.0,9.0,15.0,12.0,15.0,15.0,14.0,10.0,12.0,5.0,5.0,5.0,3.0,10.0,5.0,2.0,2.0,2.0,2.0,10.0,9.0,9.0,10.0,6.0,12.0,16.0,15.0,15.0,6.0,13.0,16.0,8.0,12.0,5.0,14.0,10.0,10.0,12.0,15.0,13.0,15.0,9.0,9.0,8.0,20.0,12.0,13.0,16.0,10.0,13.0,8.0,1.0,13.0,11.0,18.0,15.0,14.0,12.0,12.0,4.0,25.0,19.0,2.0,0.0,0.0,185.0,79.0,3.0,3.0,2.0,3.0,1.0,1.0,1.0,3.0,2.0,3.0,1.0,8.0,12.0,9.0,11.0,12.0,8.0,14.0,9.0,13.0,13.0,13.0,6.0,14.0,12.0,14.0,13.0,15.0,13.0,12.0,11.0,13.0,12.0,8.0,12.0,14.0,13.0,16.0,15.0,11.0,11.0,15.0,13.0,10.0,16.0,13.0,20.0,17.0,13.0,14.0,10.0,13.0,7.0,13.0,8.0,11.0,10.0,11.0,14.0,12.0,5.0,5.0,26.0,4.0,0.0,0.0,0.0,180.0,70.0,2.0,3.0,3.0,1.0,3.0,1.0,2.0,1.0,1.0,2.0,3.0,16.0,14.0,11.0,10.0,14.0,16.0,11.0,13.0,5.0,9.0,16.0,10.0,11.0,14.0,9.0,13.0,10.0,13.0,14.0,15.0,14.0,12.0,12.0,12.0,12.0,11.0,18.0,12.0,11.0,12.0,12.0,10.0,20.0,18.0,11.0,9.0,17.0,9.0,12.0,6.0,11.0,12.0,12.0,20.0,12.0,12.0,14.0,16.0,14.0,16.0,4.0,28.0,52.0,8.0,25.0,3.0,182.0,75.0,2.0,3.0,2.0,3.0,2.0,3.0,3.0,3.0,4.0,2.0,3.0,9.0,11.0,9.0,13.0,11.0,8.0,15.0,12.0,10.0,9.0,12.0,13.0,12.0,11.0,13.0,13.0,14.0,12.0,13.0,11.0,13.0,14.0,9.0,13.0,16.0,11.0,14.0,14.0,12.0,12.0,18.0,13.0,9.0,16.0,13.0,20.0,16.0,16.0,13.0,7.0,12.0,4.0,15.0,16.0,15.0,12.0,13.0,14.0,15.0,16.0,1.0,20.0,0.0,0.0,6.0,0.0,187.0,84.0,1.0,3.0,1.0,2.0,1.0,3.0,3.0,2.0,1.0,1.0,1.0,4.0,5.0,7.0,6.0,11.0,4.0,13.0,7.0,7.0,12.0,8.0,6.0,13.0,11.0,11.0,11.0,13.0,12.0,14.0,8.0,11.0,14.0,8.0,6.0,5.0,13.0,13.0,12.0,12.0,14.0,13.0,16.0,8.0,12.0,11.0,20.0,13.0,13.0,12.0,5.0,10.0,3.0,9.0,13.0,15.0,11.0,12.0,18.0,17.0,17.0,6.0,28.0,29.0,1.0,23.0,0.0,183.0,76.0,3.0,1.0,1.0,2.0,3.0,1.0,1.0,1.0,2.0,2.0,1.0,4.0,4.0,6.0,7.0,10.0,6.0,16.0,7.0,8.0,16.0,9.0,6.0,15.0,12.0,13.0,15.0,18.0,14.0,12.0,5.0,14.0,14.0,4.0,14.0,8.0,16.0,14.0,13.0,10.0,9.0,16.0,12.0,9.0,13.0,11.0,20.0,16.0,15.0,13.0,12.0,13.0,7.0,9.0,14.0,15.0,16.0,12.0,16.0,13.0,12.0,7.0,31.0,31.0,0.0,0.0,0.0,184.0,73.0,1.0,1.0,3.0,3.0,3.0,2.0,1.0,3.0,2.0,1.0,1.0,10.0,12.0,11.0,5.0,12.0,8.0,11.0,10.0,13.0,12.0,12.0,6.0,13.0,12.0,13.0,14.0,13.0,12.0,13.0,11.0,13.0,11.0,8.0,12.0,13.0,12.0,14.0,14.0,11.0,12.0,14.0,11.0,20.0,14.0,12.0,6.0,15.0,11.0,12.0,8.0,11.0,5.0,13.0,18.0,11.0,11.0,15.0,13.0,15.0,15.0,6.0,33.0,56.0,26.0,3.0,2.0,196.0,93.0,1.0,3.0,4.0,2.0,3.0,1.0,2.0,3.0,4.0,3.0,2.0,5.0,7.0,7.0,17.0,15.0,7.0,17.0,9.0,4.0,5.0,12.0,14.0,5.0,14.0,7.0,15.0,10.0,14.0,10.0,12.0,13.0,13.0,10.0,11.0,16.0,5.0,13.0,9.0,8.0,9.0,14.0,15.0,20.0,8.0,11.0,14.0,11.0,15.0,9.0,5.0,12.0,15.0,10.0,14.0,12.0,10.0,9.0,12.0,12.0,10.0,11.0,23.0,37.0,2.0,5.0,1.0,180.0,77.0,2.0,2.0,3.0,3.0,4.0,2.0,1.0,3.0,4.0,2.0,3.0,8.0,7.0,11.0,6.0,14.0,8.0,12.0,14.0,8.0,13.0,14.0,14.0,15.0,15.0,12.0,14.0,14.0,16.0,15.0,13.0,14.0,14.0,8.0,11.0,10.0,13.0,17.0,18.0,12.0,12.0,15.0,13.0,8.0,18.0,13.0,20.0,18.0,15.0,13.0,8.0,12.0,6.0,8.0,14.0,14.0,14.0,15.0,15.0,14.0,18.0,4.0,25.0,13.0,0.0,0.0,0.0,172.0,72.0,1.0,1.0,3.0,2.0,2.0,2.0,1.0,1.0,1.0,1.0,1.0,11.0,10.0,8.0,5.0,12.0,8.0,11.0,8.0,12.0,13.0,12.0,5.0,16.0,12.0,17.0,12.0,19.0,11.0,13.0,10.0,12.0,16.0,8.0,11.0,9.0,13.0,16.0,18.0,11.0,13.0,13.0,6.0,8.0,14.0,12.0,20.0,17.0,12.0,12.0,15.0,12.0,5.0,17.0,20.0,9.0,16.0,13.0,14.0,4.0,3.0,15.0,19.0,14.0,1.0,4.0,0.0,184.0,84.0,3.0,3.0,1.0,1.0,2.0,3.0,1.0,1.0,1.0,1.0,3.0,8.0,10.0,13.0,13.0,14.0,8.0,11.0,10.0,8.0,7.0,12.0,13.0,9.0,12.0,16.0,11.0,17.0,12.0,8.0,13.0,10.0,15.0,15.0,7.0,14.0,8.0,15.0,17.0,14.0,13.0,17.0,12.0,9.0,14.0,17.0,20.0,13.0,15.0,10.0,5.0,11.0,8.0,14.0,12.0,16.0,13.0,13.0,14.0,18.0,15.0,4.0
1,0,25.0,0.0,0.0,0.0,0.0,191.0,90.0,13.0,13.0,13.0,10.0,15.0,14.0,13.0,16.0,12.0,13.0,12.0,7.0,3.0,3.0,3.0,10.0,11.0,8.0,3.0,3.0,1.0,8.0,3.0,1.0,9.0,13.0,12.0,11.0,10.0,11.0,10.0,12.0,14.0,4.0,9.0,3.0,13.0,10.0,11.0,12.0,13.0,12.0,12.0,20.0,12.0,11.0,7.0,11.0,13.0,12.0,8.0,9.0,4.0,11.0,12.0,15.0,13.0,13.0,9.0,14.0,13.0,13.0,32.0,0.0,0.0,0.0,0.0,173.0,71.0,3.0,3.0,2.0,4.0,2.0,1.0,3.0,2.0,2.0,4.0,3.0,8.0,10.0,13.0,12.0,14.0,7.0,8.0,8.0,5.0,5.0,12.0,8.0,5.0,14.0,13.0,14.0,11.0,13.0,11.0,11.0,13.0,11.0,15.0,6.0,14.0,5.0,10.0,14.0,15.0,15.0,11.0,8.0,10.0,12.0,14.0,20.0,9.0,11.0,12.0,2.0,10.0,3.0,10.0,14.0,12.0,13.0,13.0,13.0,14.0,14.0,7.0,28.0,22.0,0.0,9.0,1.0,184.0,79.0,3.0,2.0,1.0,1.0,3.0,3.0,1.0,3.0,2.0,3.0,3.0,6.0,12.0,11.0,8.0,13.0,7.0,13.0,8.0,12.0,14.0,12.0,8.0,13.0,12.0,15.0,14.0,15.0,15.0,13.0,11.0,13.0,14.0,10.0,11.0,10.0,15.0,15.0,15.0,14.0,13.0,14.0,12.0,9.0,15.0,14.0,20.0,15.0,15.0,14.0,13.0,13.0,7.0,13.0,13.0,14.0,15.0,14.0,13.0,11.0,13.0,6.0,27.0,24.0,1.0,14.0,0.0,186.0,76.0,1.0,1.0,1.0,3.0,1.0,1.0,1.0,1.0,3.0,2.0,3.0,8.0,13.0,13.0,9.0,15.0,10.0,13.0,11.0,7.0,13.0,16.0,11.0,15.0,15.0,11.0,15.0,12.0,15.0,10.0,14.0,13.0,12.0,14.0,13.0,9.0,13.0,16.0,13.0,12.0,13.0,14.0,12.0,12.0,13.0,13.0,20.0,15.0,13.0,13.0,12.0,8.0,7.0,12.0,12.0,12.0,8.0,12.0,15.0,16.0,19.0,2.0,29.0,11.0,1.0,0.0,0.0,188.0,80.0,2.0,2.0,1.0,2.0,3.0,1.0,2.0,3.0,1.0,3.0,1.0,6.0,8.0,9.0,8.0,11.0,7.0,13.0,5.0,13.0,15.0,12.0,5.0,14.0,11.0,14.0,16.0,15.0,13.0,12.0,12.0,12.0,14.0,8.0,12.0,8.0,16.0,15.0,14.0,13.0,13.0,15.0,15.0,20.0,12.0,14.0,8.0,16.0,15.0,14.0,12.0,13.0,9.0,11.0,12.0,14.0,13.0,12.0,14.0,14.0,13.0,6.0,31.0,1.0,0.0,0.0,0.0,175.0,73.0,1.0,2.0,4.0,3.0,3.0,4.0,1.0,1.0,2.0,1.0,2.0,16.0,14.0,14.0,10.0,17.0,12.0,6.0,10.0,3.0,9.0,18.0,11.0,12.0,16.0,12.0,17.0,12.0,15.0,14.0,17.0,15.0,13.0,16.0,13.0,15.0,13.0,17.0,14.0,12.0,14.0,12.0,7.0,12.0,15.0,13.0,20.0,12.0,10.0,12.0,9.0,13.0,5.0,14.0,16.0,14.0,14.0,15.0,18.0,14.0,14.0,3.0,33.0,0.0,0.0,0.0,0.0,176.0,70.0,1.0,3.0,1.0,2.0,3.0,1.0,3.0,4.0,4.0,2.0,3.0,10.0,12.0,10.0,10.0,16.0,13.0,9.0,13.0,9.0,8.0,14.0,13.0,9.0,15.0,8.0,10.0,9.0,11.0,13.0,16.0,12.0,12.0,9.0,9.0,11.0,11.0,14.0,12.0,12.0,15.0,10.0,8.0,11.0,10.0,12.0,20.0,12.0,9.0,9.0,4.0,7.0,7.0,14.0,13.0,8.0,13.0,14.0,8.0,13.0,16.0,4.0,29.0,30.0,7.0,22.0,11.0,173.0,72.0,2.0,2.0,2.0,3.0,1.0,2.0,3.0,3.0,2.0,3.0,3.0,13.0,15.0,15.0,16.0,17.0,14.0,9.0,15.0,4.0,5.0,14.0,16.0,7.0,17.0,8.0,13.0,11.0,17.0,14.0,15.0,15.0,16.0,15.0,13.0,15.0,8.0,13.0,14.0,15.0,14.0,10.0,8.0,20.0,5.0,14.0,9.0,11.0,7.0,14.0,12.0,12.0,19.0,12.0,17.0,15.0,13.0,15.0,15.0,14.0,12.0,3.0,34.0,11.0,0.0,0.0,0.0,178.0,71.0,4.0,1.0,1.0,1.0,3.0,4.0,3.0,2.0,2.0,2.0,2.0,15.0,17.0,11.0,9.0,13.0,15.0,12.0,13.0,11.0,12.0,15.0,8.0,14.0,13.0,13.0,12.0,13.0,13.0,14.0,13.0,14.0,14.0,10.0,16.0,13.0,13.0,14.0,14.0,13.0,12.0,14.0,9.0,20.0,16.0,14.0,7.0,12.0,12.0,15.0,10.0,13.0,6.0,14.0,11.0,12.0,18.0,15.0,18.0,15.0,14.0,12.0,25.0,0.0,0.0,0.0,0.0,188.0,81.0,1.0,3.0,3.0,1.0,3.0,2.0,2.0,3.0,4.0,1.0,1.0,14.0,15.0,12.0,10.0,13.0,15.0,12.0,14.0,12.0,13.0,14.0,12.0,14.0,13.0,12.0,14.0,12.0,14.0,12.0,13.0,13.0,13.0,12.0,9.0,14.0,13.0,13.0,14.0,12.0,12.0,15.0,13.0,20.0,14.0,13.0,9.0,16.0,15.0,14.0,9.0,13.0,7.0,13.0,13.0,14.0,12.0,13.0,14.0,13.0,12.0,10.0,23.0,0.0,0.0,6.0,1.0,184.0,68.0,3.0,1.0,1.0,2.0,3.0,2.0,2.0,2.0,2.0,1.0,2.0,4.0,7.0,13.0,14.0,14.0,6.0,13.0,15.0,8.0,5.0,12.0,12.0,5.0,14.0,11.0,14.0,14.0,14.0,12.0,10.0,13.0,13.0,14.0,9.0,15.0,6.0,12.0,12.0,15.0,14.0,16.0,14.0,9.0,12.0,13.0,20.0,14.0,16.0,11.0,11.0,14.0,7.0,10.0,12.0,13.0,13.0,12.0,14.0,14.0,11.0,3.0,28.0,0.0,0.0,13.0,0.0,184.0,78.0,13.0,11.0,13.0,8.0,15.0,11.0,12.0,14.0,14.0,13.0,13.0,3.0,1.0,2.0,1.0,7.0,6.0,8.0,3.0,3.0,1.0,11.0,4.0,2.0,12.0,11.0,11.0,12.0,12.0,11.0,10.0,9.0,12.0,3.0,11.0,1.0,14.0,12.0,12.0,12.0,13.0,13.0,13.0,6.0,11.0,13.0,20.0,7.0,13.0,11.0,6.0,6.0,11.0,10.0,12.0,5.0,15.0,13.0,17.0,14.0,15.0,5.0,24.0,0.0,0.0,5.0,0.0,182.0,75.0,3.0,2.0,3.0,4.0,3.0,3.0,3.0,3.0,2.0,1.0,1.0,12.0,11.0,12.0,7.0,14.0,10.0,5.0,10.0,5.0,8.0,14.0,11.0,7.0,13.0,11.0,9.0,8.0,14.0,14.0,15.0,14.0,11.0,15.0,8.0,12.0,9.0,12.0,8.0,11.0,12.0,12.0,8.0,6.0,14.0,11.0,20.0,12.0,8.0,14.0,9.0,14.0,15.0,10.0,19.0,15.0,14.0,12.0,9.0,9.0,13.0,7.0,24.0,0.0,0.0,3.0,0.0,181.0,71.0,2.0,2.0,1.0,2.0,3.0,3.0,2.0,3.0,2.0,2.0,3.0,12.0,12.0,11.0,8.0,13.0,13.0,8.0,13.0,7.0,11.0,13.0,11.0,12.0,13.0,12.0,13.0,12.0,13.0,12.0,13.0,12.0,14.0,8.0,12.0,13.0,13.0,14.0,14.0,12.0,12.0,13.0,10.0,12.0,13.0,12.0,20.0,12.0,11.0,13.0,7.0,11.0,11.0,13.0,19.0,12.0,16.0,14.0,16.0,14.0,14.0,8.0,24.0,0.0,0.0,0.0,0.0,179.0,0.0,3.0,3.0,3.0,1.0,2.0,4.0,1.0,3.0,2.0,2.0,1.0,6.0,3.0,8.0,7.0,13.0,6.0,6.0,13.0,3.0,7.0,10.0,4.0,7.0,9.0,9.0,10.0,3.0,7.0,5.0,8.0,13.0,9.0,9.0,4.0,11.0,8.0,8.0,12.0,13.0,13.0,8.0,4.0,5.0,13.0,13.0,20.0,7.0,5.0,9.0,7.0,9.0,6.0,9.0,7.0,9.0,11.0,9.0,14.0,3.0,5.0,7.0,21.0,0.0,0.0,0.0,0.0,181.0,81.0,2.0,3.0,2.0,2.0,3.0,2.0,4.0,2.0,3.0,2.0,2.0,6.0,9.0,9.0,7.0,11.0,6.0,11.0,7.0,9.0,12.0,11.0,8.0,12.0,10.0,14.0,12.0,12.0,11.0,12.0,8.0,10.0,15.0,6.0,8.0,6.0,13.0,13.0,12.0,13.0,12.0,9.0,11.0,8.0,10.0,12.0,20.0,14.0,14.0,11.0,15.0,4.0,8.0,7.0,10.0,13.0,10.0,9.0,15.0,9.0,14.0,5.0,22.0,0.0,0.0,1.0,0.0,183.0,76.0,3.0,3.0,3.0,3.0,1.0,3.0,2.0,3.0,3.0,1.0,1.0,8.0,12.0,12.0,10.0,11.0,10.0,9.0,10.0,7.0,7.0,11.0,12.0,7.0,14.0,12.0,13.0,14.0,9.0,10.0,12.0,9.0,11.0,13.0,9.0,14.0,11.0,13.0,15.0,14.0,14.0,13.0,12.0,11.0,11.0,14.0,20.0,12.0,10.0,11.0,7.0,9.0,9.0,13.0,8.0,13.0,14.0,13.0,12.0,10.0,18.0,3.0,18.0,0.0,0.0,0.0,0.0,175.0,71.0,2.0,3.0,1.0,3.0,2.0,1.0,1.0,2.0,1.0,3.0,1.0,1.0,5.0,2.0,5.0,12.0,5.0,5.0,8.0,2.0,4.0,7.0,1.0,7.0,9.0,7.0,4.0,3.0,4.0,3.0,13.0,11.0,4.0,2.0,8.0,8.0,4.0,7.0,11.0,14.0,11.0,6.0,5.0,5.0,11.0,12.0,20.0,7.0,7.0,3.0,7.0,4.0,7.0,7.0,19.0,12.0,10.0,9.0,10.0,12.0,16.0,4.0,25.0,0.0,0.0,2.0,0.0,178.0,72.0,2.0,2.0,2.0,1.0,3.0,3.0,4.0,3.0,4.0,1.0,3.0,11.0,12.0,12.0,7.0,12.0,10.0,8.0,12.0,12.0,7.0,12.0,12.0,12.0,14.0,13.0,12.0,12.0,13.0,11.0,10.0,13.0,13.0,10.0,7.0,13.0,10.0,12.0,12.0,14.0,12.0,11.0,8.0,20.0,12.0,14.0,5.0,12.0,10.0,11.0,10.0,10.0,7.0,13.0,8.0,12.0,13.0,13.0,13.0,11.0,11.0,8.0,34.0,17.0,2.0,14.0,7.0,172.0,68.0,2.0,2.0,1.0,1.0,3.0,3.0,2.0,3.0,1.0,2.0,2.0,15.0,16.0,12.0,12.0,15.0,16.0,8.0,16.0,5.0,9.0,16.0,14.0,9.0,15.0,15.0,14.0,14.0,15.0,11.0,15.0,14.0,15.0,15.0,13.0,16.0,10.0,14.0,12.0,9.0,12.0,13.0,7.0,13.0,9.0,9.0,20.0,10.0,11.0,12.0,15.0,15.0,17.0,11.0,9.0,15.0,10.0,10.0,10.0,7.0,6.0,12.0,25.0,0.0,0.0,1.0,0.0,186.0,80.0,2.0,1.0,2.0,2.0,2.0,4.0,3.0,2.0,1.0,2.0,1.0,6.0,7.0,10.0,6.0,12.0,6.0,11.0,5.0,6.0,14.0,12.0,7.0,12.0,12.0,11.0,16.0,15.0,8.0,14.0,7.0,10.0,12.0,6.0,8.0,8.0,12.0,13.0,14.0,14.0,13.0,13.0,13.0,12.0,12.0,14.0,20.0,14.0,12.0,12.0,8.0,3.0,8.0,8.0,7.0,14.0,11.0,12.0,12.0,10.0,14.0,2.0,29.0,4.0,2.0,0.0,0.0,176.0,75.0,3.0,3.0,1.0,3.0,2.0,3.0,1.0,1.0,1.0,2.0,1.0,9.0,9.0,11.0,13.0,11.0,12.0,10.0,12.0,7.0,6.0,11.0,12.0,7.0,12.0,10.0,12.0,10.0,9.0,10.0,9.0,8.0,12.0,13.0,6.0,13.0,7.0,11.0,11.0,15.0,12.0,13.0,10.0,10.0,14.0,14.0,20.0,13.0,12.0,10.0,6.0,10.0,7.0,13.0,13.0,11.0,12.0,11.0,9.0,14.0,14.0,5.0
3,1,28.0,42.0,0.0,12.0,0.0,190.0,84.0,16.0,14.0,16.0,5.0,16.0,14.0,17.0,18.0,15.0,12.0,14.0,6.0,3.0,5.0,2.0,7.0,8.0,8.0,3.0,12.0,3.0,8.0,1.0,1.0,11.0,12.0,12.0,13.0,14.0,14.0,10.0,13.0,15.0,11.0,16.0,11.0,16.0,13.0,14.0,11.0,14.0,16.0,16.0,20.0,13.0,10.0,5.0,12.0,15.0,14.0,7.0,15.0,8.0,13.0,19.0,8.0,20.0,15.0,17.0,18.0,17.0,4.0,28.0,0.0,0.0,0.0,0.0,189.0,74.0,3.0,1.0,3.0,4.0,3.0,1.0,2.0,1.0,1.0,1.0,3.0,7.0,8.0,12.0,12.0,9.0,10.0,13.0,7.0,4.0,5.0,12.0,13.0,4.0,12.0,9.0,12.0,10.0,11.0,9.0,12.0,12.0,11.0,9.0,11.0,13.0,11.0,12.0,13.0,10.0,11.0,12.0,15.0,9.0,15.0,11.0,20.0,13.0,13.0,12.0,7.0,9.0,8.0,6.0,5.0,14.0,9.0,12.0,13.0,12.0,12.0,8.0,28.0,44.0,24.0,0.0,0.0,188.0,84.0,2.0,1.0,2.0,1.0,3.0,4.0,2.0,2.0,1.0,1.0,3.0,7.0,8.0,11.0,16.0,13.0,11.0,17.0,6.0,6.0,7.0,12.0,12.0,8.0,11.0,17.0,17.0,17.0,15.0,16.0,9.0,14.0,16.0,11.0,13.0,15.0,8.0,12.0,15.0,12.0,13.0,16.0,16.0,11.0,14.0,13.0,20.0,14.0,15.0,15.0,20.0,13.0,8.0,8.0,12.0,14.0,14.0,13.0,13.0,7.0,12.0,11.0,28.0,4.0,0.0,0.0,0.0,176.0,73.0,2.0,2.0,1.0,1.0,3.0,3.0,3.0,3.0,3.0,1.0,2.0,11.0,11.0,15.0,15.0,14.0,13.0,12.0,15.0,8.0,6.0,14.0,14.0,5.0,16.0,13.0,13.0,12.0,14.0,13.0,15.0,12.0,14.0,14.0,10.0,11.0,8.0,14.0,11.0,12.0,14.0,14.0,9.0,13.0,12.0,13.0,20.0,13.0,12.0,10.0,10.0,14.0,10.0,7.0,14.0,15.0,14.0,16.0,15.0,12.0,14.0,8.0,24.0,15.0,0.0,15.0,2.0,187.0,83.0,2.0,3.0,2.0,2.0,3.0,3.0,3.0,2.0,1.0,3.0,4.0,8.0,9.0,12.0,9.0,15.0,10.0,7.0,10.0,11.0,13.0,15.0,12.0,16.0,14.0,13.0,15.0,14.0,16.0,18.0,14.0,15.0,12.0,5.0,15.0,10.0,16.0,17.0,13.0,9.0,10.0,19.0,14.0,13.0,16.0,11.0,20.0,16.0,18.0,17.0,8.0,14.0,6.0,6.0,14.0,10.0,18.0,15.0,19.0,16.0,15.0,5.0,24.0,1.0,0.0,23.0,1.0,187.0,82.0,2.0,3.0,3.0,2.0,1.0,2.0,3.0,3.0,4.0,4.0,1.0,6.0,6.0,8.0,7.0,11.0,10.0,12.0,7.0,8.0,14.0,9.0,11.0,15.0,9.0,10.0,15.0,12.0,10.0,15.0,8.0,14.0,16.0,5.0,13.0,8.0,15.0,14.0,14.0,13.0,14.0,14.0,15.0,9.0,14.0,14.0,20.0,14.0,13.0,14.0,6.0,12.0,6.0,11.0,13.0,14.0,12.0,12.0,17.0,10.0,14.0,10.0,23.0,22.0,0.0,13.0,3.0,179.0,73.0,3.0,3.0,2.0,3.0,1.0,3.0,1.0,2.0,2.0,2.0,2.0,14.0,14.0,15.0,12.0,15.0,12.0,7.0,12.0,6.0,9.0,18.0,15.0,10.0,17.0,12.0,13.0,12.0,17.0,16.0,16.0,16.0,14.0,13.0,13.0,14.0,13.0,15.0,13.0,13.0,15.0,14.0,9.0,14.0,14.0,13.0,20.0,14.0,11.0,16.0,6.0,16.0,6.0,12.0,15.0,11.0,10.0,13.0,18.0,18.0,14.0,6.0,30.0,91.0,21.0,0.0,0.0,188.0,81.0,3.0,2.0,2.0,1.0,4.0,3.0,3.0,3.0,2.0,1.0,2.0,15.0,16.0,16.0,12.0,17.0,15.0,11.0,13.0,3.0,6.0,16.0,16.0,8.0,17.0,7.0,11.0,9.0,17.0,11.0,17.0,16.0,11.0,16.0,10.0,16.0,9.0,12.0,11.0,11.0,16.0,13.0,11.0,20.0,14.0,11.0,13.0,11.0,9.0,13.0,5.0,10.0,11.0,12.0,13.0,13.0,13.0,13.0,14.0,15.0,10.0,1.0,26.0,0.0,0.0,14.0,1.0,183.0,79.0,2.0,2.0,1.0,3.0,3.0,1.0,2.0,4.0,1.0,2.0,3.0,8.0,9.0,10.0,6.0,10.0,12.0,12.0,9.0,11.0,13.0,10.0,5.0,13.0,12.0,15.0,11.0,13.0,10.0,11.0,8.0,11.0,13.0,5.0,11.0,6.0,12.0,13.0,12.0,10.0,11.0,14.0,12.0,20.0,11.0,12.0,7.0,13.0,12.0,12.0,10.0,10.0,9.0,15.0,9.0,11.0,13.0,13.0,13.0,14.0,14.0,6.0,27.0,14.0,0.0,13.0,1.0,175.0,73.0,2.0,1.0,1.0,2.0,3.0,2.0,2.0,3.0,2.0,3.0,3.0,15.0,12.0,12.0,12.0,15.0,12.0,9.0,15.0,8.0,15.0,15.0,18.0,16.0,14.0,17.0,15.0,16.0,15.0,17.0,14.0,15.0,18.0,11.0,17.0,13.0,16.0,18.0,18.0,11.0,12.0,14.0,10.0,11.0,15.0,11.0,20.0,17.0,12.0,18.0,13.0,14.0,7.0,14.0,12.0,12.0,19.0,15.0,18.0,13.0,11.0,5.0,30.0,0.0,0.0,0.0,0.0,186.0,75.0,13.0,13.0,6.0,1.0,13.0,11.0,9.0,13.0,9.0,6.0,11.0,4.0,2.0,2.0,1.0,1.0,6.0,1.0,1.0,1.0,2.0,1.0,3.0,1.0,5.0,9.0,6.0,12.0,7.0,8.0,6.0,13.0,4.0,3.0,5.0,2.0,5.0,5.0,6.0,10.0,14.0,7.0,12.0,8.0,10.0,11.0,20.0,3.0,7.0,9.0,6.0,4.0,7.0,9.0,16.0,10.0,9.0,10.0,10.0,8.0,7.0,7.0,32.0,9.0,0.0,4.0,0.0,192.0,90.0,13.0,12.0,14.0,7.0,14.0,8.0,15.0,15.0,10.0,8.0,12.0,3.0,3.0,2.0,2.0,9.0,8.0,5.0,1.0,2.0,3.0,7.0,3.0,1.0,6.0,11.0,15.0,16.0,10.0,13.0,8.0,12.0,10.0,5.0,15.0,4.0,15.0,12.0,12.0,11.0,15.0,12.0,16.0,5.0,13.0,9.0,20.0,12.0,12.0,14.0,8.0,13.0,10.0,12.0,4.0,12.0,18.0,7.0,15.0,16.0,12.0,8.0,26.0,20.0,0.0,6.0,0.0,178.0,75.0,3.0,3.0,3.0,2.0,1.0,1.0,1.0,1.0,1.0,2.0,2.0,12.0,12.0,12.0,12.0,13.0,12.0,6.0,12.0,8.0,9.0,12.0,8.0,12.0,13.0,15.0,10.0,12.0,12.0,13.0,8.0,10.0,10.0,10.0,5.0,12.0,10.0,15.0,15.0,15.0,14.0,10.0,8.0,20.0,13.0,15.0,10.0,14.0,10.0,12.0,6.0,10.0,7.0,12.0,10.0,5.0,11.0,7.0,14.0,13.0,13.0,2.0,30.0,0.0,0.0,0.0,0.0,183.0,90.0,3.0,2.0,2.0,3.0,2.0,2.0,1.0,3.0,2.0,2.0,2.0,7.0,8.0,8.0,9.0,12.0,7.0,13.0,10.0,2.0,8.0,12.0,5.0,8.0,11.0,9.0,11.0,7.0,12.0,12.0,8.0,9.0,2.0,9.0,13.0,13.0,8.0,7.0,8.0,14.0,11.0,14.0,10.0,5.0,13.0,9.0,20.0,9.0,14.0,9.0,5.0,9.0,7.0,9.0,15.0,11.0,11.0,12.0,12.0,3.0,7.0,1.0,31.0,17.0,1.0,23.0,0.0,185.0,85.0,1.0,1.0,3.0,2.0,2.0,1.0,1.0,3.0,3.0,1.0,1.0,9.0,11.0,11.0,7.0,11.0,6.0,14.0,9.0,10.0,12.0,12.0,5.0,15.0,11.0,16.0,14.0,18.0,13.0,12.0,9.0,13.0,8.0,7.0,14.0,11.0,13.0,14.0,14.0,9.0,9.0,15.0,12.0,20.0,15.0,12.0,12.0,14.0,15.0,19.0,12.0,12.0,7.0,12.0,7.0,12.0,8.0,13.0,14.0,12.0,10.0,7.0,29.0,26.0,2.0,0.0,0.0,179.0,71.0,2.0,3.0,2.0,3.0,1.0,2.0,3.0,1.0,1.0,1.0,2.0,8.0,10.0,12.0,13.0,13.0,8.0,8.0,10.0,6.0,8.0,12.0,9.0,10.0,13.0,13.0,16.0,9.0,10.0,13.0,10.0,13.0,13.0,12.0,13.0,17.0,12.0,16.0,16.0,13.0,13.0,9.0,9.0,11.0,14.0,13.0,20.0,15.0,9.0,13.0,8.0,16.0,3.0,18.0,14.0,16.0,16.0,11.0,15.0,10.0,14.0,5.0,33.0,75.0,6.0,19.0,0.0,187.0,83.0,2.0,3.0,3.0,1.0,2.0,3.0,1.0,3.0,1.0,1.0,3.0,7.0,7.0,10.0,5.0,12.0,5.0,12.0,6.0,10.0,12.0,12.0,8.0,13.0,13.0,9.0,18.0,9.0,12.0,18.0,8.0,15.0,12.0,6.0,14.0,10.0,18.0,20.0,17.0,12.0,15.0,15.0,14.0,8.0,18.0,14.0,20.0,16.0,13.0,19.0,3.0,16.0,3.0,18.0,16.0,12.0,18.0,16.0,19.0,16.0,17.0,4.0,23.0,23.0,1.0,7.0,3.0,180.0,75.0,3.0,3.0,1.0,2.0,1.0,2.0,3.0,2.0,1.0,2.0,2.0,13.0,13.0,15.0,11.0,17.0,15.0,5.0,12.0,5.0,5.0,15.0,14.0,8.0,17.0,7.0,13.0,8.0,16.0,12.0,17.0,14.0,11.0,15.0,7.0,13.0,7.0,12.0,10.0,14.0,16.0,9.0,8.0,13.0,12.0,12.0,20.0,13.0,8.0,8.0,12.0,10.0,8.0,13.0,13.0,15.0,11.0,11.0,11.0,7.0,8.0,13.0,32.0,56.0,8.0,28.0,6.0,175.0,67.0,2.0,1.0,3.0,2.0,1.0,4.0,2.0,1.0,1.0,2.0,1.0,17.0,19.0,17.0,9.0,15.0,13.0,7.0,15.0,7.0,2.0,12.0,15.0,2.0,17.0,14.0,10.0,10.0,12.0,12.0,12.0,10.0,10.0,20.0,5.0,8.0,5.0,6.0,7.0,15.0,15.0,13.0,8.0,11.0,12.0,14.0,20.0,12.0,12.0,10.0,17.0,17.0,6.0,12.0,7.0,5.0,7.0,7.0,12.0,6.0,6.0,16.0,29.0,9.0,0.0,27.0,2.0,180.0,74.0,1.0,3.0,3.0,1.0,2.0,3.0,2.0,3.0,3.0,3.0,2.0,6.0,11.0,9.0,5.0,12.0,5.0,8.0,8.0,13.0,12.0,12.0,7.0,14.0,12.0,13.0,14.0,12.0,11.0,14.0,9.0,14.0,12.0,6.0,13.0,10.0,13.0,17.0,14.0,14.0,14.0,11.0,9.0,11.0,16.0,13.0,20.0,16.0,9.0,14.0,8.0,11.0,6.0,15.0,13.0,12.0,15.0,10.0,16.0,15.0,17.0,8.0,30.0,0.0,0.0,0.0,0.0,174.0,70.0,3.0,3.0,2.0,3.0,3.0,1.0,2.0,2.0,1.0,2.0,1.0,10.0,9.0,12.0,10.0,11.0,13.0,9.0,9.0,5.0,10.0,9.0,10.0,7.0,12.0,10.0,12.0,11.0,11.0,11.0,11.0,12.0,11.0,10.0,10.0,12.0,11.0,11.0,12.0,11.0,10.0,11.0,10.0,20.0,13.0,11.0,11.0,11.0,10.0,12.0,3.0,10.0,10.0,15.0,11.0,11.0,11.0,9.0,12.0,8.0,11.0,10.0,29.0,0.0,0.0,0.0,0.0,193.0,84.0,3.0,2.0,3.0,2.0,1.0,1.0,2.0,1.0,1.0,2.0,1.0,2.0,7.0,8.0,8.0,8.0,11.0,16.0,10.0,10.0,15.0,10.0,10.0,15.0,8.0,13.0,13.0,13.0,10.0,13.0,7.0,13.0,15.0,7.0,15.0,8.0,15.0,12.0,10.0,7.0,7.0,15.0,17.0,10.0,15.0,9.0,20.0,12.0,16.0,14.0,11.0,14.0,9.0,10.0,7.0,12.0,13.0,13.0,15.0,13.0,12.0,9.0
2,1,27.0,0.0,0.0,3.0,0.0,196.0,91.0,17.0,10.0,13.0,8.0,11.0,10.0,15.0,15.0,10.0,10.0,13.0,5.0,3.0,2.0,3.0,7.0,7.0,7.0,1.0,2.0,3.0,9.0,3.0,2.0,8.0,12.0,11.0,12.0,12.0,9.0,10.0,10.0,15.0,3.0,11.0,3.0,10.0,13.0,12.0,9.0,10.0,12.0,18.0,6.0,8.0,10.0,20.0,9.0,15.0,10.0,7.0,14.0,10.0,11.0,13.0,18.0,16.0,9.0,13.0,12.0,8.0,5.0,27.0,2.0,0.0,0.0,0.0,184.0,73.0,3.0,2.0,1.0,4.0,3.0,3.0,2.0,2.0,1.0,2.0,2.0,6.0,11.0,8.0,4.0,12.0,7.0,11.0,6.0,16.0,14.0,13.0,6.0,14.0,11.0,14.0,15.0,14.0,13.0,12.0,12.0,13.0,13.0,6.0,11.0,5.0,14.0,16.0,14.0,12.0,11.0,12.0,13.0,8.0,13.0,13.0,20.0,12.0,13.0,12.0,9.0,14.0,13.0,15.0,7.0,14.0,14.0,14.0,13.0,13.0,12.0,4.0,29.0,54.0,1.0,19.0,6.0,194.0,86.0,3.0,3.0,1.0,1.0,1.0,1.0,1.0,1.0,3.0,1.0,2.0,8.0,11.0,8.0,8.0,13.0,13.0,13.0,13.0,10.0,12.0,15.0,12.0,14.0,12.0,12.0,15.0,13.0,14.0,13.0,12.0,14.0,18.0,7.0,15.0,10.0,15.0,16.0,16.0,6.0,10.0,15.0,16.0,20.0,17.0,12.0,7.0,16.0,14.0,13.0,7.0,15.0,3.0,14.0,15.0,17.0,17.0,16.0,17.0,14.0,13.0,3.0,30.0,35.0,1.0,0.0,0.0,182.0,72.0,3.0,1.0,1.0,1.0,3.0,3.0,3.0,4.0,1.0,3.0,1.0,7.0,9.0,10.0,7.0,11.0,7.0,14.0,8.0,9.0,15.0,11.0,10.0,14.0,12.0,16.0,13.0,16.0,12.0,12.0,11.0,11.0,15.0,8.0,13.0,10.0,13.0,13.0,13.0,10.0,12.0,15.0,11.0,10.0,14.0,11.0,20.0,13.0,14.0,13.0,13.0,14.0,8.0,14.0,8.0,13.0,12.0,11.0,12.0,11.0,6.0,15.0,28.0,0.0,0.0,0.0,0.0,182.0,72.0,3.0,3.0,3.0,1.0,1.0,2.0,2.0,2.0,3.0,2.0,4.0,7.0,8.0,12.0,14.0,13.0,11.0,14.0,12.0,4.0,6.0,11.0,14.0,6.0,13.0,18.0,14.0,16.0,11.0,6.0,11.0,8.0,17.0,10.0,6.0,15.0,5.0,4.0,16.0,11.0,12.0,13.0,13.0,20.0,11.0,14.0,8.0,14.0,14.0,10.0,15.0,15.0,10.0,12.0,11.0,20.0,8.0,12.0,15.0,6.0,8.0,13.0,24.0,11.0,2.0,14.0,7.0,181.0,74.0,3.0,3.0,4.0,2.0,2.0,1.0,2.0,3.0,1.0,2.0,1.0,7.0,10.0,13.0,15.0,12.0,11.0,13.0,12.0,5.0,6.0,12.0,14.0,6.0,14.0,12.0,15.0,12.0,9.0,10.0,13.0,9.0,13.0,13.0,6.0,14.0,7.0,11.0,12.0,15.0,14.0,13.0,8.0,14.0,12.0,14.0,20.0,12.0,9.0,8.0,8.0,13.0,6.0,13.0,6.0,14.0,7.0,10.0,13.0,14.0,10.0,8.0,21.0,0.0,0.0,17.0,5.0,178.0,67.0,1.0,3.0,3.0,1.0,3.0,4.0,1.0,1.0,3.0,3.0,2.0,12.0,12.0,13.0,9.0,14.0,12.0,8.0,9.0,11.0,6.0,15.0,10.0,6.0,15.0,14.0,14.0,8.0,12.0,12.0,14.0,11.0,12.0,11.0,11.0,12.0,7.0,12.0,12.0,9.0,13.0,13.0,8.0,11.0,13.0,14.0,20.0,12.0,7.0,8.0,6.0,13.0,7.0,11.0,10.0,15.0,7.0,13.0,13.0,11.0,10.0,10.0,21.0,2.0,0.0,4.0,1.0,171.0,64.0,3.0,2.0,4.0,3.0,1.0,2.0,4.0,1.0,3.0,1.0,3.0,11.0,12.0,16.0,12.0,14.0,15.0,7.0,14.0,5.0,6.0,13.0,14.0,5.0,17.0,12.0,14.0,7.0,10.0,8.0,12.0,8.0,15.0,17.0,7.0,13.0,7.0,11.0,14.0,16.0,14.0,14.0,7.0,13.0,14.0,14.0,20.0,13.0,9.0,9.0,3.0,13.0,2.0,14.0,8.0,16.0,17.0,9.0,16.0,16.0,15.0,3.0,22.0,0.0,0.0,0.0,0.0,186.0,78.0,1.0,1.0,2.0,1.0,3.0,1.0,3.0,3.0,4.0,2.0,1.0,7.0,11.0,10.0,6.0,12.0,9.0,12.0,8.0,13.0,12.0,13.0,9.0,13.0,11.0,14.0,12.0,14.0,12.0,10.0,12.0,10.0,10.0,8.0,12.0,12.0,13.0,15.0,15.0,10.0,11.0,12.0,12.0,11.0,15.0,12.0,20.0,13.0,9.0,11.0,11.0,14.0,3.0,18.0,8.0,12.0,14.0,10.0,12.0,11.0,10.0,8.0,25.0,0.0,0.0,0.0,0.0,172.0,64.0,1.0,1.0,3.0,1.0,2.0,1.0,3.0,3.0,1.0,2.0,1.0,5.0,11.0,15.0,8.0,12.0,6.0,7.0,8.0,4.0,4.0,12.0,8.0,5.0,14.0,8.0,12.0,6.0,8.0,8.0,12.0,7.0,11.0,14.0,6.0,15.0,5.0,13.0,12.0,16.0,15.0,12.0,5.0,10.0,16.0,15.0,20.0,13.0,5.0,7.0,12.0,17.0,13.0,13.0,7.0,12.0,14.0,10.0,13.0,14.0,9.0,4.0,26.0,2.0,0.0,6.0,1.0,183.0,79.0,2.0,2.0,1.0,3.0,1.0,1.0,2.0,3.0,1.0,4.0,3.0,14.0,12.0,13.0,12.0,12.0,14.0,15.0,12.0,14.0,12.0,12.0,11.0,12.0,12.0,11.0,14.0,14.0,10.0,10.0,12.0,11.0,15.0,14.0,9.0,15.0,11.0,12.0,13.0,13.0,12.0,13.0,11.0,20.0,12.0,14.0,9.0,15.0,12.0,14.0,12.0,12.0,7.0,14.0,12.0,15.0,15.0,14.0,14.0,10.0,8.0,6.0,16.0,0.0,0.0,0.0,0.0,179.0,0.0,1.0,3.0,1.0,2.0,3.0,2.0,3.0,1.0,2.0,3.0,1.0,1.0,1.0,2.0,1.0,2.0,1.0,3.0,1.0,1.0,5.0,1.0,1.0,10.0,4.0,11.0,3.0,4.0,1.0,6.0,1.0,10.0,14.0,7.0,10.0,1.0,9.0,11.0,11.0,9.0,5.0,8.0,6.0,20.0,12.0,8.0,8.0,6.0,4.0,6.0,8.0,12.0,8.0,5.0,8.0,7.0,8.0,19.0,16.0,5.0,8.0,2.0,22.0,24.0,3.0,7.0,0.0,177.0,78.0,2.0,1.0,2.0,3.0,2.0,2.0,4.0,3.0,3.0,2.0,1.0,10.0,13.0,16.0,14.0,16.0,16.0,8.0,16.0,4.0,4.0,15.0,12.0,4.0,16.0,12.0,11.0,12.0,13.0,10.0,11.0,8.0,13.0,17.0,5.0,14.0,5.0,10.0,12.0,15.0,14.0,13.0,9.0,10.0,17.0,16.0,20.0,15.0,14.0,12.0,11.0,15.0,4.0,12.0,19.0,16.0,14.0,14.0,11.0,13.0,10.0,12.0,28.0,39.0,11.0,25.0,8.0,171.0,65.0,4.0,3.0,2.0,1.0,1.0,3.0,3.0,2.0,2.0,1.0,3.0,14.0,14.0,16.0,16.0,19.0,16.0,4.0,12.0,3.0,2.0,18.0,15.0,4.0,19.0,11.0,18.0,8.0,16.0,14.0,18.0,16.0,15.0,17.0,6.0,17.0,4.0,16.0,13.0,13.0,16.0,13.0,6.0,20.0,13.0,12.0,12.0,15.0,8.0,16.0,10.0,16.0,7.0,12.0,18.0,18.0,12.0,15.0,17.0,13.0,19.0,2.0,20.0,12.0,0.0,12.0,4.0,181.0,76.0,4.0,4.0,3.0,2.0,2.0,3.0,3.0,3.0,3.0,3.0,4.0,5.0,10.0,17.0,15.0,15.0,7.0,10.0,11.0,2.0,2.0,12.0,14.0,3.0,15.0,8.0,12.0,12.0,13.0,11.0,10.0,12.0,15.0,14.0,5.0,15.0,5.0,12.0,14.0,18.0,16.0,14.0,10.0,11.0,14.0,17.0,20.0,14.0,14.0,12.0,8.0,13.0,8.0,11.0,12.0,18.0,12.0,15.0,16.0,15.0,18.0,7.0,26.0,29.0,1.0,14.0,1.0,194.0,90.0,1.0,2.0,3.0,4.0,1.0,2.0,3.0,3.0,3.0,2.0,2.0,4.0,4.0,7.0,7.0,11.0,2.0,17.0,2.0,8.0,15.0,8.0,4.0,16.0,12.0,14.0,16.0,15.0,11.0,13.0,3.0,14.0,14.0,5.0,12.0,4.0,16.0,15.0,14.0,13.0,12.0,14.0,16.0,9.0,12.0,14.0,20.0,16.0,17.0,14.0,8.0,13.0,11.0,8.0,17.0,14.0,13.0,13.0,15.0,16.0,17.0,6.0,34.0,34.0,0.0,14.0,2.0,188.0,74.0,2.0,1.0,1.0,1.0,3.0,1.0,1.0,3.0,2.0,2.0,4.0,13.0,13.0,5.0,8.0,16.0,10.0,12.0,9.0,8.0,14.0,18.0,14.0,14.0,17.0,8.0,18.0,8.0,18.0,18.0,14.0,19.0,16.0,6.0,12.0,10.0,18.0,18.0,11.0,7.0,8.0,14.0,13.0,16.0,14.0,9.0,20.0,11.0,13.0,17.0,7.0,12.0,13.0,8.0,8.0,15.0,14.0,15.0,18.0,18.0,19.0,1.0,26.0,36.0,2.0,23.0,0.0,180.0,72.0,3.0,2.0,2.0,1.0,2.0,3.0,2.0,1.0,4.0,2.0,2.0,11.0,11.0,8.0,6.0,15.0,8.0,12.0,8.0,10.0,14.0,16.0,9.0,14.0,14.0,12.0,16.0,14.0,16.0,15.0,14.0,16.0,17.0,10.0,13.0,11.0,14.0,17.0,16.0,9.0,11.0,13.0,11.0,20.0,17.0,11.0,8.0,17.0,12.0,17.0,12.0,15.0,4.0,20.0,16.0,14.0,16.0,18.0,18.0,16.0,15.0,8.0,26.0,0.0,0.0,15.0,4.0,182.0,73.0,1.0,2.0,2.0,4.0,1.0,3.0,3.0,3.0,3.0,3.0,3.0,10.0,11.0,12.0,11.0,17.0,11.0,5.0,12.0,3.0,7.0,16.0,14.0,13.0,17.0,14.0,16.0,14.0,14.0,15.0,15.0,14.0,16.0,14.0,15.0,15.0,14.0,16.0,17.0,14.0,16.0,12.0,9.0,11.0,15.0,13.0,20.0,16.0,11.0,15.0,15.0,15.0,6.0,13.0,14.0,16.0,15.0,13.0,18.0,10.0,12.0,8.0,21.0,11.0,0.0,2.0,0.0,186.0,72.0,3.0,2.0,2.0,1.0,1.0,3.0,3.0,1.0,2.0,1.0,1.0,5.0,7.0,9.0,10.0,14.0,9.0,13.0,13.0,8.0,11.0,14.0,4.0,12.0,15.0,10.0,14.0,9.0,13.0,12.0,11.0,11.0,15.0,12.0,5.0,8.0,11.0,14.0,12.0,12.0,10.0,12.0,13.0,14.0,11.0,13.0,20.0,14.0,12.0,14.0,4.0,9.0,9.0,11.0,7.0,11.0,9.0,12.0,11.0,12.0,11.0,5.0,23.0,0.0,0.0,11.0,2.0,168.0,65.0,3.0,1.0,2.0,1.0,3.0,1.0,1.0,1.0,1.0,1.0,2.0,11.0,13.0,13.0,13.0,14.0,8.0,6.0,10.0,4.0,6.0,14.0,11.0,6.0,14.0,15.0,13.0,13.0,10.0,12.0,12.0,11.0,14.0,16.0,5.0,16.0,9.0,16.0,17.0,15.0,15.0,13.0,5.0,10.0,16.0,15.0,20.0,16.0,9.0,12.0,4.0,7.0,3.0,9.0,20.0,14.0,11.0,15.0,18.0,7.0,12.0,7.0,21.0,0.0,0.0,5.0,0.0,178.0,72.0,2.0,1.0,2.0,1.0,1.0,1.0,3.0,3.0,3.0,3.0,3.0,7.0,11.0,9.0,6.0,11.0,5.0,9.0,7.0,8.0,11.0,10.0,6.0,12.0,11.0,14.0,10.0,11.0,11.0,11.0,7.0,11.0,16.0,5.0,8.0,10.0,13.0,12.0,14.0,14.0,13.0,9.0,9.0,9.0,12.0,14.0,20.0,14.0,10.0,9.0,2.0,4.0,9.0,10.0,14.0,12.0,10.0,12.0,12.0,8.0,13.0,7.0
1,0,34.0,63.0,0.0,17.0,0.0,191.0,90.0,14.0,16.0,10.0,13.0,17.0,17.0,12.0,13.0,16.0,12.0,14.0,7.0,1.0,2.0,2.0,9.0,12.0,11.0,3.0,2.0,1.0,8.0,5.0,1.0,7.0,12.0,16.0,16.0,14.0,9.0,9.0,15.0,16.0,7.0,14.0,4.0,16.0,13.0,12.0,7.0,11.0,16.0,15.0,7.0,15.0,7.0,20.0,10.0,18.0,13.0,10.0,19.0,4.0,12.0,14.0,10.0,20.0,17.0,14.0,2.0,5.0,18.0,27.0,60.0,3.0,2.0,0.0,189.0,90.0,1.0,2.0,2.0,1.0,1.0,1.0,2.0,3.0,1.0,3.0,2.0,3.0,7.0,6.0,7.0,8.0,14.0,13.0,10.0,12.0,18.0,10.0,5.0,16.0,8.0,17.0,15.0,18.0,8.0,16.0,7.0,14.0,18.0,5.0,16.0,7.0,15.0,14.0,13.0,11.0,9.0,16.0,16.0,8.0,15.0,13.0,20.0,13.0,17.0,17.0,13.0,15.0,8.0,12.0,14.0,16.0,12.0,13.0,16.0,14.0,14.0,10.0,30.0,62.0,1.0,13.0,1.0,187.0,82.0,2.0,3.0,2.0,1.0,1.0,3.0,3.0,1.0,3.0,1.0,2.0,3.0,10.0,10.0,5.0,13.0,7.0,11.0,13.0,6.0,13.0,13.0,10.0,16.0,12.0,13.0,16.0,14.0,13.0,14.0,10.0,14.0,14.0,7.0,13.0,8.0,15.0,18.0,15.0,12.0,10.0,14.0,14.0,17.0,14.0,14.0,20.0,17.0,14.0,17.0,8.0,16.0,5.0,10.0,6.0,13.0,17.0,14.0,16.0,17.0,18.0,2.0,27.0,3.0,0.0,5.0,0.0,188.0,82.0,3.0,1.0,1.0,3.0,1.0,1.0,4.0,3.0,1.0,1.0,2.0,12.0,11.0,12.0,11.0,12.0,10.0,12.0,13.0,6.0,14.0,12.0,12.0,14.0,13.0,14.0,14.0,12.0,13.0,14.0,10.0,12.0,12.0,12.0,11.0,12.0,12.0,16.0,15.0,13.0,11.0,13.0,14.0,13.0,13.0,13.0,20.0,16.0,13.0,12.0,8.0,12.0,7.0,12.0,8.0,11.0,10.0,12.0,12.0,5.0,12.0,11.0,21.0,27.0,2.0,0.0,0.0,179.0,72.0,3.0,1.0,4.0,1.0,2.0,1.0,1.0,1.0,3.0,1.0,3.0,7.0,12.0,12.0,11.0,13.0,5.0,13.0,13.0,9.0,12.0,13.0,10.0,13.0,13.0,13.0,12.0,15.0,12.0,14.0,12.0,12.0,12.0,11.0,8.0,12.0,12.0,15.0,16.0,13.0,12.0,14.0,9.0,10.0,12.0,13.0,20.0,16.0,13.0,14.0,7.0,15.0,7.0,18.0,11.0,10.0,12.0,10.0,14.0,12.0,9.0,7.0,32.0,101.0,50.0,12.0,1.0,183.0,71.0,1.0,3.0,3.0,2.0,2.0,1.0,3.0,3.0,3.0,2.0,1.0,15.0,14.0,14.0,19.0,19.0,14.0,13.0,15.0,5.0,3.0,15.0,17.0,3.0,19.0,12.0,16.0,12.0,15.0,8.0,15.0,14.0,17.0,17.0,16.0,16.0,7.0,13.0,5.0,9.0,11.0,12.0,12.0,20.0,6.0,11.0,15.0,8.0,13.0,14.0,15.0,17.0,14.0,10.0,17.0,18.0,10.0,17.0,16.0,7.0,13.0,10.0,26.0,8.0,0.0,0.0,0.0,171.0,78.0,3.0,1.0,3.0,2.0,3.0,1.0,2.0,2.0,3.0,1.0,1.0,7.0,16.0,14.0,5.0,14.0,8.0,11.0,13.0,9.0,9.0,13.0,7.0,13.0,14.0,10.0,10.0,13.0,13.0,12.0,9.0,9.0,11.0,12.0,7.0,12.0,9.0,15.0,18.0,15.0,15.0,14.0,6.0,8.0,12.0,15.0,20.0,15.0,13.0,17.0,7.0,10.0,7.0,8.0,12.0,12.0,13.0,7.0,12.0,8.0,11.0,8.0,28.0,19.0,0.0,4.0,0.0,175.0,72.0,3.0,1.0,3.0,1.0,2.0,2.0,2.0,3.0,3.0,2.0,1.0,14.0,13.0,18.0,7.0,13.0,11.0,8.0,7.0,5.0,3.0,8.0,11.0,6.0,16.0,15.0,8.0,9.0,11.0,7.0,10.0,7.0,15.0,16.0,10.0,10.0,5.0,5.0,14.0,17.0,17.0,7.0,8.0,16.0,9.0,16.0,20.0,13.0,8.0,10.0,14.0,10.0,7.0,16.0,8.0,14.0,9.0,7.0,11.0,7.0,6.0,14.0,25.0,0.0,0.0,0.0,0.0,184.0,81.0,2.0,1.0,1.0,1.0,3.0,1.0,2.0,3.0,1.0,3.0,3.0,7.0,9.0,10.0,9.0,10.0,7.0,12.0,7.0,9.0,12.0,9.0,7.0,13.0,9.0,12.0,12.0,14.0,11.0,13.0,8.0,11.0,13.0,11.0,10.0,9.0,12.0,14.0,13.0,13.0,12.0,10.0,13.0,8.0,14.0,12.0,20.0,15.0,12.0,12.0,12.0,11.0,5.0,8.0,11.0,13.0,9.0,13.0,11.0,7.0,9.0,1.0,25.0,15.0,0.0,11.0,1.0,177.0,71.0,3.0,1.0,1.0,3.0,3.0,2.0,2.0,1.0,3.0,3.0,1.0,8.0,12.0,16.0,8.0,13.0,8.0,10.0,8.0,5.0,8.0,13.0,10.0,9.0,15.0,14.0,10.0,12.0,12.0,13.0,10.0,9.0,11.0,14.0,8.0,12.0,8.0,14.0,16.0,15.0,15.0,8.0,9.0,10.0,14.0,14.0,20.0,16.0,8.0,13.0,13.0,14.0,7.0,12.0,11.0,14.0,14.0,8.0,12.0,5.0,12.0,5.0,27.0,49.0,2.0,14.0,2.0,179.0,76.0,2.0,2.0,3.0,1.0,4.0,3.0,4.0,2.0,2.0,3.0,4.0,16.0,17.0,14.0,13.0,14.0,15.0,9.0,13.0,6.0,9.0,15.0,12.0,9.0,14.0,16.0,12.0,14.0,12.0,14.0,10.0,9.0,16.0,14.0,4.0,12.0,7.0,12.0,15.0,15.0,14.0,12.0,10.0,20.0,15.0,14.0,10.0,15.0,11.0,14.0,14.0,11.0,6.0,13.0,15.0,16.0,10.0,8.0,14.0,5.0,3.0,17.0,17.0,0.0,0.0,0.0,0.0,163.0,59.0,2.0,3.0,3.0,1.0,2.0,3.0,3.0,1.0,2.0,3.0,3.0,8.0,12.0,13.0,7.0,13.0,7.0,5.0,7.0,7.0,7.0,12.0,5.0,8.0,12.0,9.0,12.0,16.0,10.0,8.0,7.0,10.0,11.0,14.0,7.0,12.0,8.0,7.0,7.0,14.0,11.0,4.0,4.0,20.0,10.0,14.0,6.0,6.0,4.0,8.0,4.0,9.0,9.0,9.0,16.0,7.0,11.0,9.0,8.0,2.0,10.0,10.0,17.0,0.0,0.0,0.0,0.0,174.0,69.0,3.0,1.0,3.0,4.0,4.0,2.0,2.0,3.0,2.0,1.0,3.0,2.0,4.0,6.0,5.0,10.0,1.0,1.0,8.0,1.0,2.0,9.0,1.0,3.0,13.0,7.0,4.0,2.0,3.0,2.0,5.0,13.0,7.0,13.0,11.0,3.0,1.0,6.0,11.0,13.0,10.0,5.0,5.0,5.0,8.0,12.0,20.0,6.0,3.0,4.0,7.0,7.0,7.0,5.0,17.0,9.0,12.0,11.0,11.0,9.0,12.0,5.0,25.0,0.0,0.0,13.0,6.0,179.0,73.0,3.0,1.0,1.0,4.0,2.0,1.0,1.0,1.0,2.0,3.0,2.0,12.0,13.0,14.0,13.0,12.0,11.0,7.0,13.0,7.0,5.0,12.0,13.0,5.0,14.0,11.0,13.0,11.0,12.0,12.0,12.0,12.0,12.0,14.0,9.0,15.0,8.0,10.0,13.0,15.0,15.0,13.0,9.0,6.0,14.0,15.0,20.0,13.0,12.0,13.0,6.0,10.0,5.0,14.0,7.0,10.0,13.0,10.0,14.0,11.0,15.0,5.0,30.0,0.0,0.0,0.0,0.0,175.0,65.0,3.0,1.0,3.0,4.0,3.0,1.0,4.0,1.0,1.0,2.0,3.0,8.0,9.0,11.0,8.0,14.0,8.0,9.0,13.0,8.0,10.0,14.0,12.0,12.0,14.0,13.0,14.0,15.0,14.0,15.0,14.0,14.0,15.0,11.0,10.0,13.0,15.0,15.0,15.0,12.0,12.0,14.0,9.0,8.0,15.0,12.0,20.0,15.0,12.0,13.0,3.0,13.0,8.0,12.0,13.0,12.0,13.0,14.0,14.0,14.0,9.0,7.0,29.0,0.0,0.0,0.0,0.0,184.0,79.0,4.0,1.0,3.0,3.0,2.0,1.0,2.0,2.0,4.0,3.0,1.0,5.0,7.0,5.0,9.0,12.0,8.0,8.0,9.0,5.0,10.0,14.0,2.0,13.0,8.0,3.0,13.0,9.0,8.0,9.0,11.0,13.0,10.0,9.0,8.0,8.0,10.0,9.0,12.0,14.0,14.0,8.0,6.0,9.0,12.0,14.0,20.0,8.0,10.0,10.0,9.0,10.0,10.0,10.0,20.0,10.0,12.0,12.0,11.0,3.0,9.0,2.0,23.0,8.0,0.0,13.0,3.0,170.0,63.0,2.0,2.0,3.0,2.0,3.0,2.0,1.0,3.0,4.0,1.0,2.0,12.0,13.0,15.0,8.0,15.0,12.0,5.0,13.0,5.0,6.0,14.0,13.0,8.0,16.0,12.0,13.0,11.0,14.0,11.0,14.0,14.0,14.0,18.0,10.0,15.0,9.0,9.0,14.0,17.0,16.0,13.0,5.0,8.0,14.0,17.0,20.0,12.0,6.0,12.0,6.0,16.0,9.0,10.0,15.0,14.0,14.0,13.0,16.0,12.0,14.0,8.0,20.0,0.0,0.0,0.0,0.0,183.0,0.0,2.0,3.0,2.0,1.0,2.0,2.0,3.0,1.0,2.0,3.0,3.0,7.0,12.0,13.0,12.0,12.0,5.0,7.0,8.0,5.0,6.0,6.0,3.0,4.0,13.0,9.0,9.0,8.0,8.0,5.0,8.0,9.0,7.0,13.0,1.0,8.0,6.0,7.0,8.0,13.0,11.0,7.0,9.0,8.0,13.0,11.0,20.0,8.0,6.0,9.0,6.0,6.0,9.0,8.0,15.0,12.0,14.0,11.0,11.0,10.0,13.0,3.0,26.0,0.0,0.0,1.0,0.0,188.0,84.0,13.0,12.0,10.0,4.0,15.0,15.0,10.0,15.0,16.0,12.0,10.0,8.0,1.0,3.0,1.0,10.0,11.0,7.0,2.0,3.0,1.0,12.0,10.0,2.0,10.0,6.0,10.0,8.0,11.0,14.0,10.0,13.0,13.0,2.0,8.0,3.0,15.0,10.0,14.0,7.0,14.0,13.0,13.0,10.0,12.0,10.0,20.0,12.0,12.0,15.0,11.0,11.0,11.0,11.0,13.0,16.0,14.0,8.0,19.0,15.0,11.0,2.0,22.0,0.0,0.0,0.0,0.0,188.0,80.0,4.0,1.0,1.0,3.0,1.0,1.0,3.0,2.0,1.0,1.0,2.0,3.0,8.0,9.0,8.0,9.0,4.0,13.0,8.0,4.0,13.0,9.0,9.0,13.0,11.0,14.0,11.0,14.0,11.0,11.0,5.0,12.0,13.0,9.0,6.0,12.0,12.0,13.0,13.0,13.0,12.0,9.0,13.0,8.0,14.0,13.0,20.0,13.0,13.0,12.0,13.0,13.0,4.0,8.0,9.0,11.0,14.0,11.0,10.0,13.0,1.0,3.0,24.0,16.0,0.0,5.0,0.0,184.0,78.0,3.0,1.0,2.0,2.0,1.0,2.0,2.0,1.0,3.0,3.0,1.0,12.0,12.0,12.0,8.0,14.0,8.0,13.0,13.0,7.0,12.0,15.0,10.0,14.0,15.0,15.0,13.0,13.0,14.0,15.0,14.0,14.0,13.0,6.0,15.0,13.0,14.0,14.0,13.0,11.0,12.0,15.0,13.0,20.0,14.0,12.0,8.0,14.0,13.0,14.0,7.0,11.0,5.0,9.0,9.0,12.0,11.0,13.0,15.0,15.0,12.0,8.0,28.0,0.0,0.0,0.0,0.0,176.0,69.0,1.0,3.0,1.0,4.0,2.0,3.0,2.0,1.0,2.0,3.0,2.0,8.0,14.0,12.0,6.0,13.0,12.0,7.0,13.0,11.0,11.0,13.0,12.0,13.0,14.0,11.0,13.0,12.0,12.0,14.0,10.0,13.0,14.0,11.0,8.0,15.0,11.0,12.0,14.0,15.0,14.0,10.0,7.0,12.0,14.0,14.0,20.0,15.0,8.0,15.0,8.0,13.0,6.0,14.0,14.0,10.0,13.0,14.0,15.0,12.0,15.0,5.0
2,1,25.0,0.0,0.0,0.0,0.0,180.0,88.0,4.0,3.0,1.0,3.0,1.0,1.0,1.0,2.0,2.0,1.0,3.0,5.0,12.0,12.0,13.0,12.0,7.0,11.0,11.0,5.0,1.0,10.0,10.0,6.0,12.0,5.0,11.0,7.0,11.0,9.0,10.0,11.0,11.0,14.0,4.0,13.0,5.0,14.0,14.0,14.0,10.0,12.0,10.0,20.0,13.0,14.0,8.0,14.0,14.0,11.0,6.0,13.0,14.0,16.0,11.0,13.0,11.0,13.0,14.0,13.0,13.0,3.0,26.0,73.0,0.0,8.0,0.0,181.0,71.0,1.0,1.0,2.0,2.0,2.0,2.0,3.0,1.0,3.0,4.0,3.0,9.0,10.0,9.0,6.0,12.0,8.0,11.0,7.0,10.0,11.0,11.0,10.0,12.0,10.0,10.0,12.0,13.0,12.0,11.0,9.0,10.0,13.0,5.0,14.0,13.0,11.0,15.0,19.0,13.0,12.0,13.0,9.0,20.0,20.0,13.0,15.0,20.0,12.0,15.0,5.0,15.0,5.0,13.0,14.0,12.0,15.0,12.0,16.0,9.0,10.0,3.0,27.0,34.0,1.0,13.0,0.0,175.0,64.0,3.0,1.0,1.0,2.0,2.0,3.0,4.0,1.0,4.0,3.0,3.0,7.0,9.0,8.0,3.0,13.0,6.0,12.0,4.0,2.0,13.0,10.0,3.0,14.0,8.0,15.0,13.0,12.0,10.0,13.0,9.0,12.0,14.0,8.0,9.0,11.0,13.0,14.0,16.0,15.0,14.0,12.0,9.0,20.0,14.0,16.0,5.0,17.0,12.0,15.0,11.0,12.0,4.0,10.0,11.0,16.0,10.0,13.0,10.0,8.0,10.0,15.0,23.0,25.0,0.0,0.0,0.0,181.0,77.0,1.0,2.0,3.0,1.0,2.0,2.0,3.0,1.0,3.0,2.0,3.0,13.0,15.0,12.0,6.0,14.0,14.0,14.0,6.0,11.0,14.0,14.0,10.0,14.0,13.0,13.0,15.0,18.0,15.0,13.0,14.0,14.0,17.0,9.0,6.0,13.0,15.0,14.0,15.0,13.0,13.0,15.0,10.0,20.0,13.0,11.0,8.0,14.0,14.0,15.0,6.0,9.0,5.0,11.0,10.0,13.0,14.0,9.0,15.0,13.0,12.0,4.0,27.0,17.0,0.0,0.0,0.0,181.0,81.0,1.0,3.0,1.0,2.0,2.0,2.0,2.0,2.0,2.0,1.0,3.0,4.0,5.0,10.0,6.0,12.0,4.0,14.0,4.0,8.0,13.0,11.0,10.0,15.0,11.0,13.0,15.0,14.0,15.0,12.0,9.0,12.0,14.0,2.0,14.0,9.0,14.0,15.0,13.0,13.0,12.0,12.0,12.0,11.0,19.0,13.0,20.0,16.0,12.0,15.0,8.0,14.0,8.0,15.0,10.0,11.0,12.0,13.0,14.0,14.0,15.0,3.0,31.0,65.0,2.0,0.0,0.0,182.0,91.0,2.0,2.0,1.0,2.0,1.0,2.0,2.0,3.0,3.0,1.0,2.0,3.0,4.0,7.0,4.0,10.0,3.0,15.0,4.0,6.0,13.0,12.0,4.0,15.0,10.0,16.0,16.0,18.0,11.0,14.0,9.0,12.0,15.0,8.0,18.0,7.0,17.0,13.0,10.0,10.0,11.0,9.0,12.0,14.0,13.0,11.0,20.0,16.0,17.0,15.0,14.0,16.0,1.0,6.0,10.0,16.0,16.0,14.0,14.0,8.0,8.0,16.0,26.0,31.0,0.0,7.0,2.0,168.0,62.0,2.0,3.0,1.0,2.0,3.0,1.0,2.0,1.0,3.0,1.0,1.0,8.0,9.0,13.0,9.0,15.0,7.0,7.0,8.0,3.0,14.0,15.0,6.0,13.0,15.0,13.0,15.0,15.0,15.0,15.0,13.0,14.0,13.0,12.0,8.0,14.0,13.0,17.0,18.0,13.0,15.0,14.0,6.0,11.0,15.0,12.0,20.0,15.0,10.0,14.0,6.0,15.0,8.0,11.0,10.0,14.0,14.0,13.0,15.0,15.0,12.0,2.0,25.0,44.0,11.0,12.0,2.0,178.0,67.0,3.0,2.0,2.0,4.0,1.0,1.0,3.0,2.0,2.0,1.0,2.0,9.0,13.0,15.0,12.0,15.0,8.0,5.0,12.0,3.0,9.0,15.0,12.0,12.0,17.0,10.0,14.0,13.0,16.0,14.0,17.0,14.0,15.0,14.0,12.0,17.0,11.0,16.0,16.0,13.0,16.0,14.0,8.0,12.0,16.0,12.0,20.0,16.0,12.0,14.0,6.0,15.0,12.0,16.0,14.0,14.0,16.0,14.0,17.0,16.0,14.0,6.0,26.0,61.0,22.0,13.0,3.0,186.0,82.0,2.0,2.0,2.0,1.0,3.0,2.0,1.0,1.0,2.0,1.0,3.0,14.0,16.0,16.0,17.0,15.0,17.0,19.0,19.0,15.0,6.0,14.0,13.0,9.0,16.0,10.0,14.0,11.0,13.0,11.0,13.0,13.0,16.0,17.0,9.0,18.0,7.0,10.0,10.0,15.0,14.0,14.0,15.0,20.0,13.0,19.0,11.0,18.0,17.0,13.0,10.0,13.0,15.0,16.0,8.0,14.0,11.0,14.0,14.0,17.0,14.0,12.0,30.0,35.0,3.0,9.0,1.0,186.0,71.0,1.0,1.0,2.0,3.0,4.0,1.0,1.0,3.0,3.0,2.0,3.0,8.0,10.0,12.0,14.0,12.0,8.0,15.0,8.0,2.0,8.0,12.0,11.0,11.0,10.0,10.0,10.0,13.0,13.0,13.0,10.0,13.0,13.0,11.0,12.0,15.0,12.0,17.0,16.0,12.0,10.0,12.0,13.0,10.0,15.0,13.0,20.0,16.0,12.0,13.0,3.0,14.0,13.0,12.0,10.0,10.0,15.0,10.0,15.0,15.0,13.0,1.0,22.0,16.0,0.0,8.0,2.0,168.0,64.0,1.0,2.0,4.0,3.0,3.0,3.0,1.0,2.0,1.0,1.0,3.0,9.0,12.0,14.0,11.0,13.0,9.0,7.0,11.0,4.0,8.0,14.0,4.0,9.0,15.0,6.0,14.0,15.0,13.0,13.0,13.0,12.0,11.0,12.0,4.0,13.0,8.0,13.0,8.0,13.0,13.0,14.0,6.0,15.0,15.0,12.0,20.0,14.0,9.0,8.0,1.0,9.0,20.0,7.0,13.0,12.0,11.0,12.0,13.0,13.0,12.0,5.0,32.0,21.0,0.0,12.0,0.0,193.0,94.0,12.0,17.0,8.0,7.0,17.0,14.0,14.0,14.0,14.0,5.0,13.0,3.0,4.0,5.0,3.0,7.0,5.0,4.0,3.0,6.0,5.0,12.0,8.0,6.0,7.0,8.0,14.0,13.0,9.0,9.0,8.0,13.0,18.0,3.0,11.0,3.0,16.0,16.0,3.0,11.0,9.0,16.0,14.0,7.0,12.0,9.0,20.0,14.0,15.0,16.0,9.0,14.0,10.0,2.0,16.0,14.0,12.0,18.0,16.0,12.0,16.0,8.0,29.0,71.0,2.0,7.0,0.0,176.0,72.0,2.0,3.0,3.0,1.0,2.0,1.0,3.0,2.0,3.0,1.0,3.0,8.0,14.0,10.0,5.0,11.0,5.0,10.0,6.0,13.0,12.0,12.0,6.0,14.0,11.0,12.0,16.0,10.0,13.0,16.0,9.0,13.0,12.0,6.0,12.0,10.0,14.0,18.0,13.0,14.0,15.0,10.0,8.0,10.0,15.0,13.0,20.0,16.0,8.0,18.0,8.0,17.0,5.0,10.0,14.0,14.0,16.0,13.0,15.0,17.0,18.0,3.0,31.0,85.0,5.0,13.0,0.0,191.0,81.0,1.0,4.0,2.0,3.0,1.0,1.0,1.0,3.0,2.0,3.0,2.0,2.0,5.0,9.0,9.0,11.0,2.0,17.0,3.0,5.0,15.0,13.0,2.0,16.0,12.0,14.0,16.0,16.0,13.0,12.0,7.0,14.0,17.0,7.0,9.0,12.0,16.0,14.0,12.0,12.0,13.0,14.0,16.0,8.0,14.0,13.0,20.0,13.0,16.0,17.0,11.0,15.0,10.0,4.0,14.0,16.0,16.0,13.0,16.0,15.0,13.0,8.0,34.0,83.0,4.0,0.0,0.0,188.0,86.0,1.0,2.0,3.0,3.0,1.0,1.0,1.0,1.0,3.0,3.0,3.0,6.0,9.0,12.0,7.0,12.0,5.0,16.0,9.0,14.0,14.0,12.0,7.0,14.0,10.0,15.0,13.0,18.0,13.0,14.0,8.0,12.0,15.0,9.0,11.0,5.0,14.0,14.0,16.0,10.0,10.0,10.0,13.0,20.0,15.0,10.0,10.0,12.0,14.0,17.0,11.0,15.0,3.0,12.0,15.0,13.0,13.0,12.0,15.0,12.0,10.0,5.0,26.0,56.0,5.0,8.0,0.0,173.0,71.0,3.0,1.0,2.0,2.0,1.0,2.0,3.0,1.0,3.0,1.0,3.0,13.0,13.0,16.0,11.0,15.0,12.0,7.0,13.0,5.0,5.0,13.0,13.0,5.0,15.0,12.0,12.0,8.0,7.0,8.0,13.0,8.0,12.0,14.0,7.0,14.0,5.0,7.0,11.0,16.0,17.0,12.0,6.0,6.0,12.0,16.0,20.0,12.0,11.0,9.0,14.0,13.0,5.0,12.0,15.0,15.0,11.0,10.0,12.0,7.0,8.0,12.0,24.0,14.0,0.0,21.0,1.0,177.0,67.0,2.0,3.0,3.0,2.0,2.0,3.0,2.0,3.0,2.0,1.0,4.0,11.0,11.0,13.0,13.0,13.0,12.0,5.0,13.0,6.0,9.0,14.0,13.0,5.0,14.0,12.0,13.0,13.0,14.0,14.0,12.0,14.0,11.0,15.0,8.0,11.0,13.0,11.0,14.0,13.0,14.0,13.0,7.0,12.0,6.0,14.0,20.0,16.0,12.0,11.0,12.0,10.0,12.0,14.0,9.0,9.0,12.0,12.0,9.0,7.0,11.0,6.0,28.0,91.0,19.0,2.0,0.0,183.0,79.0,3.0,1.0,2.0,2.0,2.0,1.0,2.0,3.0,2.0,3.0,1.0,14.0,13.0,13.0,14.0,15.0,12.0,15.0,14.0,8.0,8.0,16.0,14.0,9.0,17.0,11.0,14.0,12.0,15.0,10.0,16.0,14.0,15.0,15.0,17.0,18.0,14.0,15.0,10.0,15.0,15.0,13.0,11.0,15.0,15.0,14.0,20.0,14.0,13.0,13.0,6.0,12.0,5.0,14.0,17.0,16.0,19.0,13.0,18.0,14.0,12.0,8.0,30.0,42.0,1.0,3.0,0.0,178.0,63.0,3.0,1.0,4.0,1.0,2.0,1.0,2.0,2.0,3.0,3.0,1.0,13.0,13.0,11.0,11.0,13.0,9.0,10.0,11.0,11.0,8.0,12.0,8.0,10.0,13.0,12.0,10.0,11.0,11.0,10.0,12.0,9.0,12.0,12.0,7.0,15.0,8.0,12.0,15.0,14.0,14.0,9.0,8.0,20.0,10.0,14.0,12.0,12.0,7.0,8.0,5.0,9.0,10.0,17.0,16.0,13.0,16.0,14.0,16.0,16.0,14.0,2.0,29.0,54.0,6.0,11.0,0.0,186.0,84.0,1.0,2.0,2.0,2.0,1.0,1.0,3.0,4.0,2.0,3.0,2.0,6.0,8.0,12.0,8.0,12.0,9.0,12.0,13.0,8.0,13.0,13.0,11.0,15.0,13.0,14.0,15.0,17.0,14.0,12.0,11.0,13.0,14.0,12.0,13.0,14.0,14.0,16.0,15.0,12.0,13.0,17.0,13.0,12.0,16.0,14.0,20.0,16.0,17.0,14.0,16.0,12.0,12.0,13.0,14.0,12.0,18.0,14.0,14.0,12.0,10.0,2.0,25.0,30.0,7.0,20.0,2.0,179.0,75.0,1.0,3.0,1.0,1.0,1.0,1.0,3.0,3.0,2.0,2.0,1.0,9.0,12.0,12.0,10.0,13.0,8.0,5.0,11.0,6.0,5.0,13.0,12.0,7.0,12.0,9.0,9.0,11.0,10.0,9.0,12.0,10.0,9.0,12.0,6.0,12.0,6.0,10.0,10.0,17.0,16.0,13.0,10.0,13.0,14.0,16.0,20.0,12.0,10.0,14.0,4.0,11.0,7.0,11.0,16.0,15.0,10.0,9.0,12.0,10.0,12.0,14.0,28.0,29.0,4.0,10.0,4.0,183.0,75.0,2.0,2.0,1.0,2.0,1.0,1.0,1.0,1.0,1.0,1.0,2.0,10.0,11.0,15.0,14.0,13.0,12.0,12.0,13.0,8.0,7.0,12.0,14.0,9.0,10.0,13.0,11.0,12.0,10.0,14.0,7.0,11.0,16.0,14.0,7.0,11.0,5.0,9.0,11.0,16.0,12.0,15.0,11.0,12.0,14.0,15.0,20.0,14.0,10.0,10.0,14.0,17.0,6.0,11.0,13.0,11.0,17.0,13.0,14.0,10.0,7.0,5.0
0,1,27.0,20.0,0.0,19.0,0.0,192.0,83.0,14.0,14.0,15.0,5.0,14.0,16.0,12.0,15.0,8.0,13.0,14.0,8.0,2.0,3.0,3.0,8.0,12.0,11.0,1.0,1.0,1.0,9.0,4.0,2.0,7.0,9.0,14.0,13.0,13.0,14.0,5.0,12.0,10.0,6.0,12.0,4.0,14.0,12.0,11.0,9.0,12.0,12.0,16.0,10.0,10.0,10.0,20.0,11.0,14.0,16.0,11.0,14.0,5.0,12.0,8.0,10.0,16.0,12.0,12.0,12.0,15.0,9.0,33.0,49.0,2.0,0.0,0.0,184.0,80.0,1.0,1.0,3.0,1.0,1.0,1.0,1.0,1.0,1.0,1.0,2.0,8.0,13.0,8.0,9.0,13.0,8.0,13.0,11.0,11.0,13.0,12.0,10.0,13.0,13.0,9.0,17.0,10.0,15.0,13.0,11.0,15.0,10.0,5.0,13.0,10.0,17.0,15.0,9.0,6.0,9.0,14.0,10.0,20.0,10.0,9.0,12.0,9.0,13.0,16.0,5.0,16.0,8.0,15.0,12.0,9.0,18.0,15.0,17.0,17.0,18.0,6.0,22.0,21.0,6.0,2.0,0.0,178.0,69.0,3.0,3.0,3.0,3.0,1.0,2.0,3.0,2.0,1.0,2.0,3.0,18.0,16.0,12.0,13.0,17.0,18.0,7.0,17.0,5.0,7.0,14.0,15.0,10.0,17.0,10.0,12.0,8.0,14.0,9.0,15.0,11.0,9.0,17.0,6.0,12.0,8.0,10.0,14.0,12.0,15.0,9.0,6.0,14.0,13.0,12.0,20.0,15.0,8.0,10.0,6.0,13.0,5.0,14.0,11.0,18.0,5.0,14.0,10.0,7.0,11.0,16.0,31.0,60.0,1.0,0.0,0.0,175.0,73.0,1.0,3.0,1.0,2.0,2.0,3.0,1.0,1.0,1.0,3.0,2.0,7.0,12.0,12.0,8.0,12.0,4.0,10.0,8.0,15.0,13.0,13.0,10.0,16.0,13.0,15.0,14.0,17.0,13.0,14.0,10.0,14.0,15.0,14.0,12.0,14.0,12.0,15.0,15.0,15.0,14.0,11.0,9.0,11.0,18.0,14.0,20.0,15.0,9.0,18.0,7.0,16.0,16.0,12.0,8.0,10.0,15.0,14.0,11.0,15.0,15.0,14.0,31.0,55.0,8.0,8.0,0.0,182.0,74.0,1.0,3.0,3.0,2.0,1.0,3.0,3.0,3.0,2.0,1.0,3.0,17.0,16.0,9.0,13.0,14.0,17.0,10.0,14.0,7.0,9.0,17.0,18.0,10.0,14.0,12.0,15.0,9.0,17.0,15.0,15.0,16.0,12.0,9.0,16.0,12.0,13.0,17.0,12.0,7.0,8.0,9.0,10.0,12.0,10.0,11.0,20.0,14.0,9.0,16.0,10.0,16.0,3.0,7.0,17.0,12.0,16.0,14.0,15.0,17.0,16.0,7.0,25.0,11.0,3.0,2.0,0.0,183.0,78.0,1.0,1.0,2.0,2.0,3.0,1.0,3.0,2.0,1.0,1.0,2.0,7.0,9.0,11.0,18.0,13.0,10.0,14.0,12.0,7.0,8.0,9.0,13.0,4.0,12.0,13.0,14.0,13.0,14.0,12.0,8.0,10.0,12.0,10.0,5.0,12.0,7.0,10.0,10.0,11.0,12.0,12.0,12.0,16.0,14.0,12.0,20.0,13.0,13.0,15.0,12.0,10.0,6.0,10.0,14.0,16.0,15.0,10.0,13.0,6.0,9.0,7.0,29.0,94.0,17.0,2.0,0.0,176.0,72.0,1.0,1.0,3.0,2.0,3.0,2.0,1.0,3.0,1.0,1.0,1.0,14.0,16.0,17.0,13.0,16.0,14.0,13.0,13.0,6.0,6.0,16.0,13.0,10.0,18.0,11.0,15.0,12.0,17.0,13.0,17.0,17.0,12.0,17.0,14.0,14.0,8.0,11.0,12.0,14.0,15.0,14.0,8.0,13.0,9.0,12.0,20.0,12.0,11.0,13.0,10.0,16.0,10.0,16.0,11.0,16.0,13.0,14.0,12.0,12.0,9.0,13.0,23.0,23.0,1.0,7.0,3.0,180.0,75.0,3.0,3.0,1.0,2.0,1.0,2.0,3.0,2.0,1.0,2.0,2.0,13.0,13.0,15.0,11.0,17.0,15.0,5.0,12.0,5.0,5.0,15.0,14.0,8.0,17.0,7.0,13.0,8.0,16.0,12.0,17.0,14.0,11.0,15.0,7.0,13.0,7.0,12.0,10.0,14.0,16.0,9.0,8.0,13.0,12.0,12.0,20.0,13.0,8.0,8.0,12.0,10.0,8.0,13.0,13.0,15.0,11.0,11.0,11.0,7.0,8.0,13.0,30.0,62.0,1.0,13.0,1.0,187.0,82.0,2.0,3.0,2.0,1.0,1.0,3.0,3.0,1.0,3.0,1.0,2.0,3.0,10.0,10.0,5.0,13.0,7.0,11.0,13.0,6.0,13.0,13.0,10.0,16.0,12.0,13.0,16.0,14.0,13.0,14.0,10.0,14.0,14.0,7.0,13.0,8.0,15.0,18.0,15.0,12.0,10.0,14.0,14.0,17.0,14.0,14.0,20.0,17.0,14.0,17.0,8.0,16.0,5.0,10.0,6.0,13.0,17.0,14.0,16.0,17.0,18.0,2.0,21.0,27.0,2.0,0.0,0.0,179.0,72.0,3.0,1.0,4.0,1.0,2.0,1.0,1.0,1.0,3.0,1.0,3.0,7.0,12.0,12.0,11.0,13.0,5.0,13.0,13.0,9.0,12.0,13.0,10.0,13.0,13.0,13.0,12.0,15.0,12.0,14.0,12.0,12.0,12.0,11.0,8.0,12.0,12.0,15.0,16.0,13.0,12.0,14.0,9.0,10.0,12.0,13.0,20.0,16.0,13.0,14.0,7.0,15.0,7.0,18.0,11.0,10.0,12.0,10.0,14.0,12.0,9.0,7.0,27.0,49.0,2.0,14.0,2.0,179.0,76.0,2.0,2.0,3.0,1.0,4.0,3.0,4.0,2.0,2.0,3.0,4.0,16.0,17.0,14.0,13.0,14.0,15.0,9.0,13.0,6.0,9.0,15.0,12.0,9.0,14.0,16.0,12.0,14.0,12.0,14.0,10.0,9.0,16.0,14.0,4.0,12.0,7.0,12.0,15.0,15.0,14.0,12.0,10.0,20.0,15.0,14.0,10.0,15.0,11.0,14.0,14.0,11.0,6.0,13.0,15.0,16.0,10.0,8.0,14.0,5.0,3.0,17.0,31.0,25.0,0.0,6.0,0.0,191.0,84.0,11.0,14.0,13.0,12.0,15.0,14.0,15.0,16.0,13.0,14.0,14.0,8.0,2.0,10.0,5.0,11.0,11.0,7.0,10.0,2.0,5.0,10.0,11.0,11.0,9.0,12.0,13.0,15.0,13.0,13.0,8.0,13.0,16.0,12.0,14.0,1.0,16.0,13.0,11.0,12.0,13.0,16.0,16.0,8.0,16.0,13.0,20.0,15.0,15.0,17.0,8.0,15.0,7.0,2.0,15.0,15.0,17.0,15.0,17.0,16.0,15.0,6.0,28.0,38.0,0.0,2.0,0.0,186.0,78.0,3.0,3.0,1.0,3.0,2.0,1.0,1.0,2.0,4.0,1.0,2.0,8.0,13.0,12.0,5.0,13.0,6.0,11.0,15.0,14.0,13.0,12.0,8.0,14.0,13.0,15.0,12.0,14.0,13.0,13.0,13.0,13.0,17.0,12.0,10.0,13.0,13.0,15.0,17.0,14.0,14.0,14.0,13.0,20.0,10.0,14.0,8.0,14.0,14.0,14.0,13.0,14.0,7.0,11.0,12.0,14.0,14.0,11.0,16.0,7.0,12.0,4.0,27.0,51.0,15.0,8.0,3.0,186.0,79.0,1.0,2.0,2.0,2.0,3.0,2.0,2.0,2.0,3.0,2.0,3.0,12.0,13.0,15.0,14.0,15.0,14.0,13.0,12.0,5.0,7.0,13.0,12.0,7.0,14.0,8.0,14.0,11.0,14.0,11.0,11.0,13.0,13.0,13.0,6.0,16.0,8.0,12.0,12.0,16.0,13.0,13.0,13.0,15.0,13.0,15.0,20.0,14.0,12.0,14.0,7.0,15.0,6.0,17.0,13.0,16.0,9.0,15.0,10.0,12.0,10.0,16.0,30.0,92.0,4.0,9.0,0.0,192.0,84.0,2.0,2.0,2.0,1.0,2.0,3.0,3.0,1.0,2.0,3.0,2.0,7.0,9.0,10.0,9.0,12.0,10.0,13.0,7.0,12.0,14.0,13.0,6.0,15.0,12.0,15.0,16.0,13.0,14.0,13.0,10.0,15.0,17.0,7.0,14.0,10.0,14.0,12.0,10.0,10.0,11.0,13.0,15.0,14.0,14.0,11.0,20.0,14.0,14.0,15.0,4.0,14.0,12.0,11.0,13.0,14.0,15.0,13.0,13.0,17.0,15.0,8.0,28.0,80.0,12.0,4.0,2.0,184.0,78.0,2.0,3.0,3.0,3.0,3.0,3.0,3.0,4.0,3.0,3.0,3.0,18.0,15.0,14.0,13.0,17.0,16.0,8.0,18.0,10.0,9.0,18.0,16.0,10.0,17.0,11.0,14.0,11.0,14.0,14.0,17.0,15.0,12.0,12.0,14.0,14.0,12.0,14.0,13.0,12.0,11.0,11.0,12.0,14.0,12.0,14.0,20.0,15.0,14.0,14.0,12.0,13.0,6.0,12.0,14.0,14.0,13.0,11.0,13.0,14.0,18.0,12.0,30.0,93.0,11.0,15.0,2.0,173.0,65.0,3.0,2.0,2.0,3.0,3.0,3.0,4.0,1.0,1.0,1.0,1.0,16.0,16.0,17.0,9.0,19.0,13.0,8.0,12.0,7.0,8.0,19.0,14.0,11.0,18.0,12.0,17.0,13.0,15.0,16.0,18.0,18.0,16.0,13.0,13.0,12.0,12.0,16.0,17.0,14.0,17.0,13.0,7.0,13.0,13.0,13.0,20.0,17.0,8.0,15.0,12.0,14.0,11.0,16.0,10.0,15.0,13.0,17.0,16.0,16.0,17.0,5.0,34.0,124.0,21.0,10.0,4.0,182.0,78.0,2.0,3.0,3.0,1.0,1.0,2.0,1.0,2.0,3.0,2.0,3.0,15.0,18.0,11.0,8.0,14.0,17.0,10.0,13.0,10.0,13.0,13.0,16.0,15.0,12.0,19.0,15.0,19.0,16.0,13.0,15.0,15.0,18.0,14.0,19.0,13.0,14.0,17.0,16.0,10.0,10.0,13.0,9.0,10.0,14.0,10.0,20.0,11.0,14.0,15.0,18.0,14.0,5.0,17.0,20.0,13.0,20.0,12.0,20.0,4.0,7.0,5.0,23.0,20.0,4.0,13.0,7.0,181.0,68.0,2.0,4.0,2.0,3.0,3.0,1.0,1.0,3.0,1.0,4.0,3.0,6.0,14.0,14.0,11.0,15.0,10.0,9.0,13.0,3.0,11.0,15.0,9.0,13.0,15.0,12.0,14.0,13.0,14.0,13.0,14.0,13.0,14.0,12.0,7.0,14.0,13.0,14.0,17.0,13.0,13.0,14.0,10.0,15.0,18.0,14.0,20.0,16.0,13.0,14.0,11.0,11.0,5.0,13.0,15.0,15.0,12.0,17.0,14.0,12.0,9.0,11.0,30.0,69.0,24.0,9.0,1.0,190.0,85.0,3.0,2.0,3.0,2.0,2.0,2.0,1.0,3.0,2.0,3.0,2.0,6.0,10.0,10.0,16.0,13.0,6.0,19.0,8.0,7.0,6.0,13.0,15.0,9.0,14.0,18.0,16.0,18.0,14.0,15.0,11.0,15.0,18.0,13.0,11.0,14.0,9.0,18.0,19.0,11.0,12.0,17.0,17.0,15.0,18.0,14.0,20.0,18.0,17.0,15.0,17.0,16.0,4.0,10.0,15.0,15.0,6.0,18.0,15.0,7.0,9.0,14.0,27.0,24.0,1.0,14.0,0.0,186.0,76.0,1.0,1.0,1.0,3.0,1.0,1.0,1.0,1.0,3.0,2.0,3.0,8.0,13.0,13.0,9.0,15.0,10.0,13.0,11.0,7.0,13.0,16.0,11.0,15.0,15.0,11.0,15.0,12.0,15.0,10.0,14.0,13.0,12.0,14.0,13.0,9.0,13.0,16.0,13.0,12.0,13.0,14.0,12.0,12.0,13.0,13.0,20.0,15.0,13.0,13.0,12.0,8.0,7.0,12.0,12.0,12.0,8.0,12.0,15.0,16.0,19.0,2.0,27.0,41.0,1.0,19.0,2.0,184.0,73.0,3.0,1.0,1.0,1.0,1.0,1.0,3.0,3.0,3.0,3.0,3.0,2.0,10.0,12.0,11.0,11.0,3.0,16.0,10.0,14.0,14.0,13.0,7.0,18.0,12.0,14.0,11.0,18.0,12.0,9.0,10.0,10.0,18.0,4.0,14.0,15.0,12.0,16.0,18.0,14.0,12.0,14.0,16.0,9.0,15.0,17.0,20.0,17.0,13.0,12.0,12.0,14.0,6.0,16.0,7.0,18.0,15.0,11.0,12.0,10.0,8.0,10.0
0,2,24.0,42.0,0.0,4.0,0.0,199.0,94.0,18.0,13.0,12.0,5.0,17.0,15.0,17.0,16.0,10.0,5.0,15.0,7.0,1.0,10.0,2.0,10.0,10.0,10.0,1.0,3.0,2.0,13.0,3.0,2.0,13.0,8.0,15.0,14.0,14.0,15.0,10.0,15.0,15.0,14.0,11.0,3.0,13.0,14.0,10.0,11.0,14.0,12.0,19.0,20.0,12.0,10.0,10.0,9.0,13.0,14.0,5.0,18.0,5.0,12.0,14.0,14.0,15.0,16.0,15.0,14.0,14.0,8.0,27.0,60.0,2.0,5.0,0.0,186.0,81.0,1.0,1.0,3.0,3.0,1.0,3.0,1.0,1.0,3.0,3.0,2.0,6.0,7.0,9.0,6.0,13.0,11.0,16.0,15.0,12.0,16.0,15.0,6.0,16.0,15.0,11.0,17.0,15.0,15.0,14.0,11.0,15.0,12.0,8.0,16.0,8.0,17.0,15.0,15.0,13.0,13.0,13.0,14.0,12.0,16.0,12.0,20.0,14.0,15.0,16.0,5.0,14.0,4.0,12.0,11.0,13.0,15.0,12.0,18.0,15.0,9.0,9.0,30.0,57.0,1.0,12.0,1.0,183.0,80.0,2.0,2.0,1.0,2.0,1.0,3.0,1.0,1.0,1.0,2.0,2.0,7.0,8.0,10.0,9.0,13.0,10.0,17.0,13.0,13.0,15.0,13.0,11.0,16.0,14.0,15.0,15.0,14.0,15.0,13.0,11.0,14.0,18.0,7.0,14.0,13.0,14.0,15.0,16.0,11.0,11.0,13.0,16.0,20.0,9.0,13.0,10.0,14.0,14.0,14.0,11.0,14.0,15.0,13.0,18.0,14.0,15.0,13.0,16.0,13.0,11.0,3.0,28.0,24.0,6.0,13.0,1.0,176.0,65.0,1.0,2.0,1.0,2.0,2.0,3.0,2.0,1.0,1.0,1.0,1.0,7.0,10.0,13.0,14.0,15.0,8.0,8.0,15.0,8.0,14.0,14.0,10.0,19.0,15.0,19.0,13.0,20.0,13.0,13.0,13.0,14.0,18.0,13.0,14.0,16.0,12.0,15.0,20.0,16.0,15.0,17.0,8.0,11.0,16.0,13.0,20.0,17.0,15.0,15.0,17.0,14.0,6.0,16.0,16.0,14.0,16.0,16.0,10.0,11.0,10.0,17.0,29.0,82.0,6.0,0.0,0.0,189.0,79.0,3.0,1.0,3.0,3.0,2.0,3.0,3.0,1.0,2.0,2.0,4.0,7.0,7.0,13.0,8.0,13.0,11.0,14.0,9.0,12.0,14.0,14.0,8.0,16.0,14.0,9.0,14.0,14.0,18.0,13.0,14.0,15.0,16.0,13.0,12.0,10.0,14.0,15.0,15.0,13.0,14.0,13.0,15.0,20.0,12.0,12.0,10.0,16.0,16.0,14.0,10.0,13.0,11.0,12.0,13.0,17.0,13.0,16.0,8.0,9.0,9.0,10.0,27.0,73.0,7.0,12.0,0.0,186.0,73.0,2.0,2.0,1.0,2.0,1.0,3.0,2.0,1.0,3.0,1.0,1.0,11.0,10.0,13.0,11.0,14.0,11.0,14.0,13.0,8.0,8.0,15.0,17.0,12.0,14.0,12.0,18.0,13.0,13.0,18.0,12.0,13.0,13.0,12.0,11.0,14.0,14.0,15.0,16.0,13.0,12.0,14.0,13.0,13.0,16.0,13.0,20.0,15.0,12.0,18.0,13.0,13.0,9.0,16.0,15.0,15.0,11.0,13.0,18.0,12.0,15.0,6.0,25.0,45.0,12.0,2.0,0.0,181.0,76.0,3.0,2.0,4.0,3.0,3.0,3.0,3.0,1.0,1.0,3.0,2.0,15.0,17.0,15.0,16.0,17.0,15.0,7.0,16.0,8.0,7.0,17.0,12.0,8.0,17.0,12.0,14.0,9.0,14.0,12.0,17.0,15.0,15.0,16.0,11.0,16.0,10.0,12.0,15.0,13.0,13.0,13.0,8.0,16.0,16.0,13.0,20.0,17.0,12.0,14.0,8.0,15.0,4.0,14.0,12.0,18.0,10.0,11.0,17.0,10.0,12.0,13.0,28.0,72.0,15.0,7.0,0.0,194.0,85.0,1.0,3.0,3.0,3.0,2.0,3.0,1.0,3.0,3.0,1.0,2.0,9.0,9.0,9.0,13.0,14.0,8.0,17.0,10.0,13.0,12.0,13.0,12.0,15.0,15.0,17.0,14.0,16.0,11.0,13.0,10.0,14.0,15.0,12.0,7.0,15.0,13.0,18.0,16.0,9.0,12.0,19.0,17.0,12.0,16.0,13.0,20.0,17.0,17.0,14.0,19.0,12.0,5.0,12.0,14.0,16.0,11.0,12.0,14.0,5.0,8.0,9.0,23.0,50.0,14.0,5.0,1.0,191.0,94.0,2.0,1.0,2.0,3.0,1.0,2.0,3.0,1.0,1.0,1.0,2.0,4.0,11.0,13.0,17.0,13.0,12.0,14.0,14.0,6.0,6.0,11.0,16.0,6.0,13.0,10.0,14.0,14.0,15.0,14.0,11.0,12.0,16.0,12.0,12.0,14.0,9.0,14.0,10.0,14.0,10.0,18.0,16.0,20.0,17.0,16.0,11.0,13.0,19.0,14.0,6.0,14.0,7.0,6.0,11.0,18.0,14.0,18.0,18.0,15.0,12.0,8.0,25.0,70.0,14.0,0.0,0.0,173.0,76.0,1.0,3.0,1.0,3.0,3.0,2.0,2.0,3.0,3.0,1.0,4.0,13.0,12.0,20.0,13.0,17.0,13.0,7.0,13.0,5.0,3.0,15.0,19.0,4.0,18.0,8.0,12.0,17.0,15.0,13.0,16.0,13.0,16.0,18.0,6.0,14.0,7.0,11.0,13.0,17.0,20.0,16.0,8.0,16.0,16.0,16.0,20.0,17.0,9.0,15.0,8.0,15.0,3.0,8.0,15.0,18.0,14.0,15.0,14.0,17.0,14.0,9.0,30.0,8.0,0.0,12.0,1.0,182.0,69.0,2.0,1.0,3.0,2.0,2.0,3.0,3.0,3.0,3.0,2.0,3.0,9.0,12.0,10.0,8.0,10.0,12.0,15.0,12.0,8.0,15.0,11.0,14.0,13.0,10.0,15.0,15.0,15.0,11.0,11.0,8.0,9.0,17.0,5.0,16.0,12.0,12.0,16.0,16.0,14.0,12.0,17.0,10.0,10.0,14.0,14.0,20.0,14.0,5.0,16.0,12.0,9.0,11.0,15.0,16.0,11.0,12.0,15.0,14.0,16.0,15.0,5.0,38.0,161.0,0.0,11.0,0.0,192.0,91.0,14.0,20.0,20.0,16.0,14.0,12.0,17.0,19.0,18.0,16.0,13.0,1.0,1.0,1.0,1.0,9.0,1.0,1.0,1.0,1.0,1.0,8.0,4.0,1.0,8.0,5.0,17.0,17.0,17.0,16.0,7.0,17.0,18.0,12.0,20.0,1.0,20.0,6.0,10.0,8.0,14.0,14.0,14.0,7.0,12.0,8.0,20.0,10.0,15.0,19.0,5.0,17.0,12.0,1.0,12.0,16.0,20.0,18.0,16.0,15.0,14.0,4.0,31.0,88.0,7.0,26.0,6.0,187.0,86.0,2.0,1.0,4.0,2.0,3.0,3.0,3.0,1.0,1.0,1.0,2.0,2.0,10.0,8.0,8.0,10.0,2.0,16.0,11.0,20.0,17.0,12.0,4.0,18.0,8.0,17.0,16.0,20.0,15.0,15.0,10.0,13.0,18.0,8.0,14.0,13.0,17.0,16.0,19.0,12.0,10.0,17.0,14.0,20.0,17.0,15.0,7.0,16.0,18.0,16.0,15.0,16.0,14.0,14.0,12.0,15.0,17.0,14.0,14.0,16.0,18.0,11.0,26.0,26.0,1.0,1.0,0.0,183.0,70.0,3.0,2.0,3.0,2.0,1.0,1.0,1.0,2.0,3.0,3.0,2.0,4.0,10.0,10.0,7.0,13.0,4.0,14.0,4.0,10.0,14.0,13.0,4.0,17.0,13.0,12.0,13.0,14.0,13.0,13.0,9.0,13.0,13.0,5.0,10.0,10.0,13.0,14.0,15.0,13.0,14.0,14.0,11.0,11.0,17.0,14.0,20.0,15.0,14.0,15.0,13.0,13.0,7.0,18.0,10.0,14.0,15.0,15.0,15.0,18.0,18.0,8.0,29.0,44.0,6.0,13.0,0.0,181.0,72.0,2.0,2.0,3.0,3.0,1.0,3.0,3.0,2.0,1.0,1.0,2.0,16.0,15.0,14.0,13.0,16.0,15.0,6.0,15.0,6.0,7.0,15.0,16.0,6.0,16.0,10.0,14.0,14.0,14.0,12.0,14.0,14.0,17.0,16.0,15.0,16.0,8.0,11.0,12.0,14.0,15.0,12.0,10.0,12.0,15.0,15.0,20.0,15.0,12.0,13.0,7.0,16.0,8.0,17.0,13.0,15.0,14.0,15.0,17.0,9.0,13.0,9.0,30.0,17.0,7.0,16.0,4.0,193.0,86.0,1.0,1.0,1.0,1.0,1.0,1.0,1.0,1.0,1.0,1.0,1.0,4.0,6.0,9.0,16.0,16.0,8.0,17.0,13.0,5.0,9.0,14.0,12.0,7.0,14.0,14.0,15.0,13.0,15.0,13.0,13.0,14.0,18.0,16.0,12.0,16.0,9.0,12.0,11.0,9.0,14.0,17.0,16.0,10.0,13.0,9.0,20.0,14.0,17.0,13.0,15.0,16.0,9.0,8.0,14.0,16.0,14.0,17.0,16.0,7.0,3.0,13.0,35.0,61.0,0.0,15.0,0.0,187.0,87.0,1.0,3.0,2.0,2.0,3.0,1.0,3.0,1.0,4.0,1.0,2.0,2.0,2.0,8.0,3.0,11.0,2.0,13.0,3.0,3.0,18.0,12.0,10.0,16.0,11.0,8.0,18.0,14.0,16.0,19.0,10.0,18.0,16.0,3.0,12.0,5.0,19.0,17.0,12.0,11.0,10.0,18.0,13.0,10.0,8.0,12.0,20.0,13.0,14.0,20.0,3.0,12.0,14.0,5.0,9.0,13.0,13.0,17.0,18.0,18.0,20.0,7.0,32.0,106.0,18.0,16.0,3.0,184.0,83.0,1.0,1.0,1.0,1.0,1.0,1.0,1.0,1.0,1.0,1.0,1.0,8.0,10.0,11.0,12.0,14.0,8.0,16.0,11.0,6.0,15.0,16.0,13.0,15.0,14.0,19.0,18.0,19.0,15.0,8.0,15.0,12.0,20.0,12.0,19.0,12.0,17.0,17.0,14.0,11.0,13.0,14.0,12.0,13.0,10.0,11.0,20.0,12.0,15.0,14.0,16.0,8.0,17.0,11.0,9.0,16.0,20.0,12.0,14.0,12.0,8.0,13.0,26.0,0.0,0.0,0.0,0.0,171.0,69.0,2.0,3.0,4.0,3.0,1.0,1.0,1.0,2.0,1.0,2.0,1.0,7.0,7.0,12.0,14.0,14.0,7.0,7.0,9.0,6.0,8.0,8.0,5.0,6.0,11.0,9.0,11.0,8.0,10.0,8.0,9.0,12.0,11.0,15.0,7.0,13.0,8.0,7.0,9.0,12.0,12.0,12.0,10.0,10.0,10.0,14.0,20.0,8.0,8.0,14.0,9.0,11.0,4.0,9.0,13.0,12.0,10.0,12.0,10.0,3.0,7.0,8.0,31.0,24.0,0.0,0.0,0.0,186.0,82.0,1.0,1.0,1.0,1.0,1.0,1.0,1.0,1.0,1.0,1.0,1.0,4.0,8.0,11.0,14.0,14.0,11.0,17.0,16.0,5.0,11.0,13.0,12.0,16.0,14.0,14.0,13.0,12.0,15.0,14.0,13.0,13.0,16.0,13.0,11.0,18.0,15.0,18.0,18.0,11.0,12.0,11.0,13.0,15.0,14.0,11.0,20.0,17.0,13.0,15.0,13.0,16.0,6.0,17.0,12.0,16.0,16.0,15.0,19.0,18.0,18.0,3.0,29.0,62.0,4.0,0.0,0.0,190.0,86.0,2.0,2.0,1.0,4.0,1.0,1.0,1.0,1.0,2.0,1.0,2.0,9.0,9.0,12.0,9.0,13.0,12.0,14.0,12.0,8.0,16.0,17.0,13.0,15.0,13.0,11.0,20.0,16.0,14.0,16.0,19.0,12.0,17.0,13.0,19.0,7.0,20.0,16.0,14.0,14.0,13.0,15.0,14.0,9.0,15.0,14.0,20.0,16.0,15.0,16.0,11.0,14.0,5.0,11.0,14.0,15.0,16.0,14.0,18.0,14.0,9.0,3.0,31.0,29.0,4.0,0.0,0.0,167.0,60.0,3.0,3.0,1.0,1.0,1.0,1.0,2.0,1.0,1.0,3.0,2.0,11.0,15.0,15.0,12.0,13.0,8.0,7.0,12.0,6.0,5.0,15.0,11.0,8.0,15.0,15.0,15.0,12.0,14.0,13.0,14.0,14.0,15.0,16.0,4.0,17.0,9.0,14.0,15.0,15.0,14.0,8.0,4.0,14.0,10.0,14.0,20.0,10.0,7.0,16.0,11.0,15.0,15.0,15.0,8.0,16.0,16.0,12.0,14.0,13.0,11.0,9.0
0,2,32.0,31.0,0.0,3.0,0.0,194.0,88.0,13.0,13.0,13.0,10.0,14.0,13.0,17.0,16.0,12.0,17.0,14.0,2.0,5.0,5.0,6.0,7.0,2.0,4.0,4.0,14.0,5.0,6.0,5.0,4.0,5.0,11.0,11.0,12.0,12.0,13.0,7.0,13.0,12.0,7.0,15.0,1.0,13.0,13.0,11.0,10.0,11.0,13.0,16.0,20.0,13.0,10.0,13.0,13.0,14.0,13.0,5.0,13.0,13.0,2.0,14.0,12.0,8.0,11.0,14.0,14.0,14.0,6.0,25.0,49.0,1.0,0.0,0.0,184.0,76.0,3.0,3.0,1.0,2.0,3.0,1.0,1.0,1.0,1.0,3.0,2.0,5.0,8.0,9.0,8.0,12.0,5.0,11.0,7.0,8.0,14.0,12.0,10.0,16.0,11.0,10.0,17.0,15.0,15.0,12.0,10.0,14.0,15.0,7.0,12.0,7.0,18.0,14.0,8.0,12.0,10.0,14.0,12.0,15.0,15.0,15.0,20.0,13.0,13.0,14.0,6.0,15.0,4.0,7.0,14.0,18.0,10.0,16.0,12.0,10.0,8.0,17.0,23.0,17.0,0.0,13.0,0.0,184.0,78.0,1.0,1.0,2.0,1.0,1.0,2.0,1.0,2.0,3.0,1.0,2.0,5.0,8.0,11.0,9.0,10.0,12.0,12.0,14.0,10.0,16.0,13.0,11.0,14.0,10.0,14.0,16.0,16.0,11.0,10.0,14.0,13.0,10.0,10.0,12.0,8.0,13.0,12.0,10.0,11.0,8.0,16.0,13.0,20.0,11.0,15.0,10.0,12.0,15.0,11.0,9.0,15.0,10.0,12.0,8.0,12.0,15.0,13.0,8.0,13.0,9.0,17.0,30.0,78.0,1.0,10.0,3.0,186.0,82.0,1.0,3.0,3.0,3.0,2.0,2.0,1.0,3.0,1.0,2.0,1.0,15.0,15.0,11.0,8.0,12.0,16.0,14.0,14.0,18.0,13.0,14.0,9.0,15.0,12.0,14.0,11.0,11.0,13.0,15.0,13.0,14.0,13.0,11.0,18.0,13.0,13.0,16.0,17.0,11.0,12.0,13.0,12.0,20.0,15.0,10.0,8.0,16.0,14.0,14.0,11.0,12.0,1.0,13.0,8.0,17.0,6.0,12.0,17.0,15.0,13.0,8.0,27.0,55.0,11.0,4.0,2.0,192.0,83.0,2.0,1.0,1.0,2.0,1.0,2.0,1.0,2.0,3.0,2.0,3.0,8.0,14.0,17.0,9.0,19.0,14.0,8.0,12.0,12.0,3.0,14.0,10.0,6.0,18.0,14.0,7.0,15.0,11.0,10.0,13.0,8.0,14.0,19.0,4.0,14.0,7.0,6.0,8.0,13.0,16.0,18.0,14.0,18.0,12.0,15.0,20.0,14.0,15.0,12.0,14.0,13.0,8.0,13.0,14.0,18.0,3.0,7.0,14.0,8.0,6.0,15.0,24.0,49.0,11.0,5.0,0.0,178.0,72.0,1.0,2.0,2.0,1.0,3.0,3.0,4.0,2.0,3.0,3.0,2.0,12.0,13.0,12.0,10.0,15.0,15.0,8.0,14.0,13.0,10.0,14.0,15.0,13.0,15.0,17.0,16.0,13.0,15.0,17.0,13.0,15.0,17.0,11.0,12.0,14.0,10.0,18.0,17.0,16.0,14.0,14.0,11.0,20.0,19.0,16.0,9.0,19.0,11.0,18.0,8.0,18.0,6.0,18.0,14.0,17.0,12.0,18.0,15.0,13.0,10.0,10.0,28.0,49.0,7.0,16.0,2.0,172.0,69.0,2.0,3.0,3.0,3.0,2.0,3.0,1.0,3.0,2.0,2.0,3.0,17.0,14.0,11.0,12.0,14.0,17.0,6.0,13.0,8.0,10.0,13.0,12.0,11.0,13.0,18.0,10.0,14.0,11.0,14.0,12.0,12.0,16.0,9.0,10.0,14.0,10.0,17.0,19.0,12.0,14.0,14.0,7.0,14.0,18.0,15.0,20.0,18.0,9.0,17.0,8.0,16.0,9.0,17.0,11.0,11.0,15.0,12.0,18.0,14.0,12.0,3.0,29.0,60.0,14.0,3.0,1.0,185.0,76.0,2.0,1.0,4.0,3.0,1.0,3.0,2.0,3.0,2.0,3.0,1.0,6.0,9.0,11.0,13.0,11.0,6.0,12.0,9.0,4.0,6.0,9.0,10.0,8.0,12.0,18.0,12.0,14.0,8.0,12.0,9.0,8.0,16.0,13.0,11.0,15.0,9.0,13.0,18.0,16.0,13.0,10.0,12.0,14.0,18.0,16.0,20.0,17.0,10.0,14.0,10.0,14.0,7.0,10.0,8.0,12.0,14.0,10.0,16.0,12.0,10.0,8.0,28.0,48.0,1.0,17.0,1.0,183.0,80.0,1.0,1.0,1.0,1.0,3.0,4.0,3.0,1.0,3.0,1.0,3.0,6.0,8.0,9.0,7.0,11.0,6.0,12.0,8.0,10.0,13.0,12.0,6.0,16.0,11.0,18.0,12.0,17.0,10.0,17.0,9.0,12.0,17.0,6.0,15.0,13.0,13.0,18.0,19.0,13.0,11.0,16.0,11.0,14.0,19.0,18.0,20.0,19.0,14.0,18.0,10.0,17.0,6.0,8.0,12.0,16.0,14.0,13.0,18.0,15.0,10.0,4.0,29.0,40.0,0.0,23.0,3.0,180.0,72.0,3.0,3.0,1.0,1.0,1.0,2.0,1.0,3.0,3.0,3.0,1.0,9.0,15.0,11.0,10.0,14.0,11.0,8.0,13.0,14.0,9.0,12.0,13.0,11.0,13.0,15.0,9.0,13.0,10.0,13.0,12.0,10.0,13.0,13.0,8.0,12.0,9.0,14.0,16.0,14.0,14.0,10.0,10.0,8.0,18.0,16.0,20.0,16.0,9.0,15.0,6.0,14.0,2.0,12.0,10.0,12.0,8.0,12.0,18.0,15.0,18.0,3.0,33.0,56.0,26.0,3.0,2.0,196.0,93.0,1.0,3.0,4.0,2.0,3.0,1.0,2.0,3.0,4.0,3.0,2.0,5.0,7.0,7.0,17.0,15.0,7.0,17.0,9.0,4.0,5.0,12.0,14.0,5.0,14.0,7.0,15.0,10.0,14.0,10.0,12.0,13.0,13.0,10.0,11.0,16.0,5.0,13.0,9.0,8.0,9.0,14.0,15.0,20.0,8.0,11.0,14.0,11.0,15.0,9.0,5.0,12.0,15.0,10.0,14.0,12.0,10.0,9.0,12.0,12.0,10.0,11.0,40.0,107.0,0.0,10.0,0.0,191.0,91.0,11.0,11.0,13.0,15.0,13.0,13.0,12.0,11.0,12.0,11.0,14.0,7.0,2.0,2.0,2.0,7.0,9.0,12.0,1.0,2.0,7.0,10.0,7.0,13.0,7.0,13.0,12.0,11.0,10.0,13.0,7.0,12.0,16.0,5.0,12.0,5.0,11.0,10.0,10.0,6.0,12.0,12.0,16.0,20.0,16.0,5.0,14.0,14.0,14.0,10.0,4.0,13.0,4.0,10.0,17.0,14.0,13.0,16.0,16.0,12.0,9.0,12.0,23.0,16.0,0.0,5.0,0.0,186.0,81.0,3.0,1.0,1.0,3.0,3.0,1.0,3.0,3.0,2.0,2.0,2.0,4.0,8.0,7.0,3.0,12.0,5.0,12.0,8.0,8.0,14.0,13.0,6.0,12.0,8.0,12.0,13.0,11.0,13.0,13.0,11.0,12.0,15.0,5.0,7.0,6.0,15.0,14.0,12.0,11.0,9.0,13.0,13.0,6.0,8.0,11.0,20.0,13.0,13.0,10.0,5.0,12.0,4.0,12.0,8.0,12.0,10.0,7.0,16.0,15.0,14.0,4.0,26.0,33.0,0.0,7.0,0.0,188.0,84.0,1.0,1.0,2.0,3.0,3.0,3.0,3.0,4.0,1.0,1.0,2.0,5.0,10.0,10.0,5.0,12.0,5.0,12.0,9.0,13.0,10.0,11.0,8.0,13.0,10.0,16.0,10.0,17.0,12.0,10.0,10.0,12.0,10.0,10.0,9.0,8.0,13.0,13.0,14.0,12.0,14.0,12.0,11.0,20.0,10.0,13.0,7.0,13.0,15.0,10.0,9.0,10.0,9.0,10.0,12.0,10.0,10.0,12.0,10.0,8.0,15.0,5.0,26.0,16.0,0.0,11.0,1.0,182.0,70.0,1.0,3.0,2.0,2.0,3.0,2.0,3.0,1.0,2.0,1.0,2.0,6.0,7.0,9.0,5.0,9.0,2.0,10.0,8.0,9.0,9.0,11.0,8.0,13.0,9.0,11.0,13.0,11.0,10.0,12.0,9.0,14.0,7.0,9.0,9.0,9.0,12.0,10.0,10.0,14.0,13.0,10.0,9.0,10.0,12.0,11.0,20.0,11.0,10.0,10.0,10.0,4.0,11.0,11.0,18.0,9.0,11.0,11.0,9.0,11.0,20.0,2.0,29.0,82.0,20.0,0.0,0.0,179.0,72.0,3.0,3.0,3.0,1.0,2.0,2.0,1.0,2.0,1.0,4.0,1.0,16.0,16.0,12.0,13.0,14.0,16.0,3.0,16.0,8.0,4.0,14.0,12.0,7.0,14.0,8.0,13.0,4.0,13.0,12.0,14.0,13.0,10.0,12.0,8.0,12.0,10.0,10.0,10.0,14.0,14.0,12.0,10.0,20.0,11.0,13.0,15.0,13.0,9.0,12.0,8.0,15.0,6.0,11.0,7.0,10.0,13.0,15.0,13.0,9.0,12.0,12.0,16.0,0.0,0.0,0.0,0.0,180.0,0.0,1.0,1.0,1.0,3.0,3.0,2.0,2.0,1.0,2.0,2.0,3.0,1.0,3.0,3.0,2.0,1.0,3.0,1.0,1.0,1.0,1.0,2.0,1.0,1.0,4.0,10.0,1.0,3.0,3.0,1.0,1.0,4.0,7.0,12.0,10.0,1.0,1.0,7.0,10.0,14.0,8.0,6.0,8.0,9.0,15.0,12.0,20.0,5.0,1.0,9.0,7.0,12.0,5.0,7.0,12.0,10.0,14.0,10.0,9.0,3.0,9.0,8.0,28.0,36.0,9.0,6.0,5.0,193.0,87.0,1.0,3.0,4.0,3.0,3.0,3.0,3.0,1.0,3.0,2.0,3.0,6.0,9.0,10.0,13.0,13.0,9.0,14.0,11.0,5.0,6.0,11.0,10.0,7.0,12.0,14.0,13.0,15.0,11.0,12.0,10.0,13.0,13.0,11.0,8.0,14.0,9.0,16.0,14.0,11.0,11.0,15.0,16.0,15.0,14.0,12.0,20.0,14.0,16.0,13.0,8.0,13.0,13.0,10.0,16.0,16.0,10.0,12.0,15.0,9.0,10.0,8.0,37.0,88.0,24.0,0.0,0.0,186.0,78.0,1.0,2.0,3.0,2.0,1.0,1.0,1.0,3.0,3.0,3.0,3.0,7.0,13.0,11.0,10.0,14.0,6.0,13.0,11.0,2.0,8.0,12.0,10.0,11.0,15.0,9.0,12.0,11.0,14.0,11.0,14.0,12.0,15.0,14.0,14.0,13.0,12.0,14.0,13.0,7.0,11.0,11.0,11.0,16.0,11.0,10.0,20.0,10.0,8.0,10.0,5.0,13.0,15.0,15.0,15.0,12.0,14.0,14.0,17.0,15.0,15.0,2.0,27.0,23.0,3.0,5.0,2.0,179.0,72.0,2.0,3.0,2.0,2.0,2.0,4.0,2.0,2.0,3.0,2.0,1.0,8.0,9.0,14.0,14.0,14.0,11.0,9.0,9.0,4.0,5.0,12.0,11.0,4.0,14.0,9.0,13.0,10.0,12.0,12.0,14.0,11.0,11.0,14.0,8.0,14.0,12.0,12.0,11.0,13.0,14.0,12.0,11.0,12.0,12.0,12.0,20.0,12.0,10.0,12.0,4.0,11.0,8.0,8.0,16.0,16.0,14.0,10.0,12.0,11.0,12.0,10.0,22.0,7.0,1.0,10.0,2.0,173.0,70.0,3.0,1.0,2.0,2.0,1.0,2.0,2.0,1.0,1.0,1.0,4.0,12.0,11.0,14.0,13.0,13.0,10.0,8.0,14.0,8.0,9.0,12.0,10.0,10.0,13.0,17.0,9.0,16.0,8.0,10.0,12.0,8.0,17.0,13.0,10.0,13.0,8.0,13.0,17.0,14.0,14.0,16.0,9.0,14.0,15.0,13.0,20.0,12.0,10.0,12.0,10.0,14.0,4.0,15.0,14.0,16.0,8.0,13.0,12.0,12.0,9.0,10.0,29.0,18.0,1.0,0.0,0.0,190.0,88.0,1.0,2.0,2.0,1.0,1.0,4.0,1.0,3.0,3.0,1.0,3.0,5.0,4.0,5.0,5.0,10.0,5.0,12.0,8.0,5.0,13.0,9.0,7.0,13.0,9.0,11.0,14.0,14.0,11.0,8.0,9.0,12.0,12.0,8.0,10.0,8.0,13.0,12.0,12.0,11.0,11.0,13.0,13.0,10.0,13.0,11.0,20.0,13.0,15.0,11.0,11.0,11.0,6.0,10.0,14.0,12.0,12.0,10.0,12.0,12.0,10.0,10.0
1,1,30.0,42.0,0.0,13.0,0.0,195.0,88.0,16.0,13.0,14.0,6.0,14.0,13.0,13.0,15.0,12.0,10.0,14.0,1.0,8.0,5.0,2.0,8.0,2.0,8.0,2.0,5.0,3.0,9.0,5.0,3.0,8.0,10.0,12.0,10.0,14.0,10.0,10.0,14.0,13.0,3.0,14.0,3.0,12.0,14.0,12.0,8.0,13.0,18.0,18.0,17.0,14.0,11.0,20.0,14.0,17.0,14.0,4.0,14.0,4.0,1.0,12.0,13.0,14.0,9.0,15.0,13.0,13.0,5.0,35.0,103.0,2.0,16.0,0.0,178.0,72.0,3.0,3.0,3.0,1.0,2.0,1.0,2.0,2.0,1.0,3.0,2.0,16.0,15.0,12.0,10.0,14.0,16.0,10.0,13.0,13.0,12.0,13.0,9.0,14.0,15.0,11.0,12.0,12.0,12.0,12.0,12.0,13.0,13.0,8.0,16.0,14.0,10.0,14.0,15.0,13.0,12.0,10.0,9.0,20.0,16.0,12.0,8.0,13.0,10.0,14.0,4.0,15.0,6.0,10.0,19.0,14.0,16.0,16.0,14.0,15.0,16.0,3.0,26.0,32.0,0.0,3.0,0.0,184.0,75.0,3.0,1.0,3.0,2.0,3.0,1.0,3.0,3.0,2.0,1.0,2.0,5.0,11.0,12.0,8.0,13.0,8.0,14.0,7.0,7.0,14.0,12.0,10.0,15.0,11.0,11.0,16.0,12.0,15.0,10.0,14.0,13.0,15.0,14.0,14.0,8.0,14.0,14.0,14.0,11.0,11.0,14.0,13.0,15.0,16.0,13.0,20.0,14.0,14.0,13.0,6.0,17.0,3.0,15.0,16.0,15.0,13.0,13.0,15.0,14.0,10.0,3.0,27.0,24.0,3.0,0.0,0.0,177.0,74.0,4.0,3.0,2.0,3.0,1.0,3.0,1.0,3.0,3.0,1.0,1.0,12.0,11.0,11.0,12.0,12.0,12.0,9.0,10.0,7.0,6.0,12.0,13.0,5.0,12.0,11.0,12.0,10.0,10.0,13.0,13.0,11.0,15.0,13.0,11.0,12.0,10.0,11.0,13.0,14.0,12.0,9.0,7.0,10.0,14.0,14.0,20.0,14.0,12.0,12.0,5.0,13.0,7.0,14.0,14.0,14.0,12.0,7.0,14.0,12.0,12.0,10.0,31.0,34.0,1.0,0.0,0.0,180.0,78.0,1.0,3.0,4.0,1.0,1.0,2.0,2.0,3.0,2.0,2.0,2.0,11.0,9.0,10.0,8.0,11.0,11.0,13.0,12.0,9.0,14.0,12.0,9.0,14.0,10.0,11.0,13.0,14.0,14.0,14.0,12.0,14.0,15.0,10.0,17.0,12.0,15.0,14.0,13.0,11.0,12.0,15.0,12.0,5.0,12.0,12.0,20.0,12.0,12.0,14.0,9.0,13.0,8.0,11.0,11.0,15.0,11.0,14.0,14.0,13.0,14.0,5.0,26.0,41.0,10.0,24.0,9.0,167.0,63.0,1.0,1.0,3.0,2.0,1.0,2.0,1.0,2.0,3.0,2.0,1.0,13.0,13.0,14.0,10.0,13.0,12.0,5.0,13.0,7.0,5.0,8.0,12.0,14.0,13.0,12.0,10.0,9.0,11.0,9.0,13.0,10.0,13.0,15.0,11.0,13.0,7.0,13.0,11.0,15.0,16.0,11.0,4.0,11.0,12.0,14.0,20.0,13.0,5.0,12.0,11.0,12.0,7.0,15.0,16.0,14.0,11.0,9.0,15.0,13.0,13.0,10.0,29.0,5.0,4.0,26.0,5.0,178.0,76.0,1.0,1.0,3.0,2.0,2.0,3.0,2.0,1.0,1.0,3.0,3.0,12.0,11.0,12.0,15.0,13.0,15.0,12.0,15.0,3.0,4.0,10.0,16.0,5.0,13.0,12.0,13.0,15.0,14.0,10.0,11.0,10.0,15.0,15.0,11.0,16.0,7.0,9.0,12.0,12.0,11.0,14.0,11.0,20.0,14.0,11.0,12.0,12.0,14.0,13.0,8.0,13.0,10.0,8.0,14.0,14.0,13.0,14.0,17.0,11.0,13.0,7.0,30.0,4.0,0.0,18.0,2.0,179.0,74.0,1.0,3.0,2.0,2.0,2.0,1.0,2.0,3.0,1.0,3.0,1.0,12.0,11.0,12.0,11.0,12.0,12.0,12.0,10.0,5.0,12.0,11.0,10.0,11.0,13.0,13.0,14.0,12.0,13.0,12.0,12.0,11.0,15.0,13.0,10.0,13.0,12.0,11.0,11.0,11.0,12.0,14.0,9.0,16.0,13.0,11.0,20.0,12.0,10.0,12.0,9.0,12.0,8.0,14.0,14.0,15.0,14.0,14.0,16.0,14.0,14.0,4.0,29.0,43.0,11.0,15.0,5.0,182.0,75.0,4.0,2.0,1.0,3.0,1.0,3.0,3.0,3.0,2.0,2.0,2.0,11.0,11.0,12.0,14.0,13.0,12.0,13.0,13.0,8.0,4.0,12.0,14.0,5.0,14.0,7.0,14.0,8.0,13.0,12.0,12.0,13.0,12.0,13.0,5.0,14.0,8.0,13.0,14.0,13.0,13.0,10.0,11.0,10.0,12.0,14.0,20.0,11.0,11.0,15.0,8.0,14.0,6.0,12.0,15.0,12.0,15.0,10.0,14.0,10.0,14.0,2.0,29.0,12.0,0.0,0.0,0.0,185.0,76.0,1.0,2.0,3.0,2.0,2.0,3.0,1.0,4.0,3.0,2.0,2.0,8.0,8.0,9.0,10.0,10.0,6.0,13.0,8.0,8.0,13.0,10.0,16.0,15.0,9.0,14.0,11.0,15.0,13.0,13.0,11.0,12.0,15.0,12.0,16.0,13.0,13.0,13.0,14.0,11.0,12.0,14.0,15.0,8.0,12.0,11.0,20.0,14.0,16.0,13.0,8.0,15.0,8.0,11.0,16.0,13.0,13.0,15.0,13.0,14.0,20.0,5.0,32.0,16.0,0.0,5.0,0.0,187.0,81.0,3.0,1.0,3.0,1.0,2.0,1.0,3.0,1.0,1.0,1.0,3.0,7.0,11.0,9.0,12.0,12.0,7.0,14.0,8.0,15.0,12.0,12.0,13.0,16.0,12.0,11.0,13.0,14.0,12.0,10.0,13.0,12.0,15.0,13.0,16.0,14.0,14.0,15.0,13.0,12.0,9.0,12.0,15.0,5.0,14.0,14.0,20.0,14.0,13.0,14.0,14.0,13.0,16.0,12.0,15.0,15.0,13.0,15.0,14.0,12.0,9.0,10.0,27.0,22.0,0.0,31.0,0.0,183.0,79.0,11.0,15.0,10.0,13.0,12.0,16.0,17.0,16.0,18.0,8.0,15.0,8.0,1.0,2.0,3.0,11.0,10.0,7.0,3.0,2.0,3.0,12.0,7.0,3.0,12.0,10.0,17.0,12.0,18.0,13.0,10.0,15.0,14.0,2.0,11.0,2.0,14.0,17.0,10.0,14.0,11.0,14.0,9.0,15.0,17.0,10.0,20.0,13.0,12.0,16.0,5.0,15.0,5.0,12.0,10.0,12.0,14.0,17.0,17.0,12.0,16.0,6.0,32.0,85.0,5.0,30.0,1.0,182.0,75.0,2.0,3.0,1.0,3.0,1.0,1.0,4.0,1.0,2.0,4.0,1.0,4.0,12.0,12.0,10.0,11.0,2.0,12.0,10.0,12.0,14.0,14.0,5.0,12.0,13.0,19.0,14.0,19.0,16.0,16.0,11.0,14.0,18.0,8.0,13.0,16.0,16.0,16.0,19.0,14.0,13.0,14.0,11.0,9.0,15.0,15.0,20.0,17.0,14.0,16.0,14.0,14.0,7.0,11.0,15.0,16.0,13.0,15.0,14.0,6.0,7.0,12.0,24.0,34.0,7.0,11.0,3.0,185.0,83.0,2.0,4.0,2.0,2.0,2.0,3.0,1.0,1.0,2.0,2.0,4.0,7.0,10.0,10.0,12.0,15.0,9.0,12.0,13.0,8.0,6.0,11.0,10.0,8.0,13.0,14.0,12.0,15.0,10.0,10.0,12.0,14.0,13.0,13.0,10.0,16.0,8.0,15.0,17.0,13.0,11.0,17.0,12.0,20.0,14.0,16.0,11.0,15.0,15.0,9.0,9.0,14.0,5.0,7.0,15.0,18.0,7.0,14.0,9.0,9.0,7.0,16.0,23.0,47.0,6.0,5.0,0.0,185.0,82.0,3.0,2.0,1.0,1.0,1.0,3.0,2.0,2.0,1.0,3.0,1.0,9.0,11.0,11.0,9.0,14.0,12.0,10.0,15.0,6.0,12.0,17.0,10.0,13.0,16.0,16.0,13.0,15.0,14.0,12.0,16.0,13.0,13.0,12.0,12.0,10.0,12.0,16.0,14.0,12.0,11.0,16.0,13.0,20.0,14.0,13.0,12.0,16.0,15.0,13.0,15.0,15.0,5.0,10.0,14.0,17.0,8.0,14.0,13.0,10.0,6.0,15.0,31.0,63.0,2.0,0.0,0.0,184.0,78.0,1.0,1.0,1.0,1.0,1.0,1.0,1.0,1.0,1.0,1.0,1.0,7.0,10.0,9.0,7.0,11.0,6.0,11.0,8.0,14.0,14.0,12.0,5.0,18.0,11.0,19.0,14.0,17.0,10.0,15.0,9.0,11.0,17.0,8.0,13.0,12.0,12.0,14.0,18.0,13.0,14.0,17.0,10.0,8.0,15.0,13.0,20.0,19.0,12.0,15.0,14.0,15.0,10.0,14.0,16.0,16.0,8.0,13.0,15.0,11.0,10.0,14.0,15.0,0.0,0.0,0.0,0.0,165.0,0.0,2.0,3.0,1.0,2.0,1.0,2.0,3.0,3.0,3.0,3.0,1.0,3.0,5.0,3.0,3.0,5.0,2.0,6.0,4.0,4.0,6.0,7.0,4.0,11.0,5.0,14.0,4.0,9.0,5.0,6.0,4.0,10.0,14.0,13.0,9.0,5.0,5.0,7.0,8.0,11.0,6.0,6.0,5.0,20.0,12.0,6.0,6.0,12.0,6.0,4.0,14.0,11.0,4.0,6.0,14.0,13.0,14.0,11.0,8.0,5.0,8.0,10.0,30.0,52.0,6.0,16.0,4.0,179.0,73.0,1.0,2.0,1.0,1.0,3.0,3.0,1.0,3.0,3.0,2.0,4.0,9.0,12.0,12.0,14.0,14.0,12.0,12.0,16.0,12.0,12.0,14.0,12.0,13.0,14.0,12.0,14.0,14.0,13.0,15.0,10.0,14.0,12.0,10.0,15.0,15.0,12.0,15.0,14.0,9.0,12.0,15.0,9.0,10.0,9.0,11.0,20.0,15.0,13.0,13.0,11.0,14.0,12.0,14.0,14.0,14.0,14.0,14.0,12.0,11.0,11.0,10.0,25.0,46.0,5.0,9.0,6.0,182.0,76.0,3.0,1.0,1.0,2.0,2.0,1.0,1.0,1.0,2.0,3.0,2.0,9.0,11.0,15.0,12.0,15.0,9.0,10.0,14.0,6.0,7.0,13.0,12.0,8.0,14.0,15.0,12.0,8.0,10.0,10.0,14.0,12.0,11.0,15.0,6.0,14.0,8.0,15.0,17.0,12.0,14.0,9.0,10.0,10.0,13.0,15.0,20.0,15.0,10.0,11.0,5.0,11.0,5.0,14.0,10.0,16.0,7.0,9.0,14.0,12.0,10.0,8.0,29.0,64.0,2.0,2.0,0.0,192.0,90.0,1.0,3.0,4.0,3.0,1.0,2.0,2.0,1.0,2.0,1.0,3.0,5.0,8.0,12.0,4.0,11.0,4.0,10.0,5.0,10.0,15.0,10.0,9.0,15.0,12.0,14.0,13.0,16.0,12.0,11.0,8.0,11.0,10.0,8.0,14.0,7.0,12.0,14.0,11.0,12.0,11.0,16.0,17.0,12.0,13.0,15.0,20.0,13.0,17.0,12.0,9.0,13.0,14.0,9.0,17.0,12.0,15.0,12.0,16.0,15.0,17.0,5.0,24.0,24.0,6.0,5.0,1.0,186.0,85.0,1.0,4.0,1.0,2.0,1.0,3.0,3.0,2.0,3.0,1.0,2.0,6.0,9.0,10.0,8.0,12.0,10.0,16.0,11.0,8.0,14.0,14.0,16.0,13.0,12.0,12.0,15.0,13.0,17.0,10.0,14.0,13.0,12.0,9.0,11.0,9.0,13.0,16.0,10.0,9.0,10.0,16.0,14.0,12.0,12.0,11.0,20.0,12.0,15.0,12.0,10.0,14.0,10.0,4.0,10.0,13.0,12.0,14.0,15.0,14.0,16.0,6.0,24.0,57.0,18.0,7.0,1.0,169.0,72.0,1.0,3.0,1.0,1.0,3.0,2.0,1.0,3.0,2.0,2.0,4.0,12.0,14.0,15.0,12.0,17.0,13.0,4.0,14.0,4.0,6.0,14.0,10.0,6.0,15.0,14.0,12.0,13.0,11.0,9.0,13.0,10.0,14.0,18.0,5.0,15.0,6.0,10.0,10.0,16.0,17.0,16.0,5.0,20.0,10.0,14.0,12.0,14.0,13.0,12.0,8.0,12.0,8.0,14.0,10.0,15.0,13.0,13.0,16.0,12.0,14.0,8.0
2,1,29.0,63.0,0.0,21.0,0.0,196.0,81.0,15.0,15.0,17.0,14.0,17.0,11.0,19.0,17.0,14.0,16.0,14.0,3.0,3.0,2.0,1.0,9.0,7.0,7.0,1.0,1.0,1.0,8.0,13.0,3.0,7.0,10.0,11.0,14.0,10.0,13.0,3.0,13.0,16.0,4.0,14.0,2.0,12.0,12.0,12.0,13.0,15.0,11.0,17.0,10.0,13.0,7.0,20.0,14.0,14.0,13.0,4.0,14.0,7.0,13.0,9.0,14.0,12.0,12.0,13.0,7.0,15.0,5.0,26.0,19.0,0.0,7.0,0.0,183.0,74.0,2.0,1.0,1.0,1.0,3.0,2.0,2.0,1.0,2.0,2.0,3.0,13.0,13.0,14.0,7.0,12.0,12.0,15.0,7.0,14.0,12.0,12.0,6.0,13.0,12.0,11.0,13.0,15.0,13.0,13.0,11.0,9.0,13.0,10.0,12.0,12.0,12.0,15.0,16.0,18.0,15.0,15.0,12.0,10.0,13.0,18.0,20.0,15.0,15.0,13.0,5.0,12.0,6.0,14.0,9.0,15.0,14.0,7.0,8.0,12.0,11.0,7.0,22.0,0.0,0.0,0.0,0.0,173.0,58.0,2.0,1.0,3.0,3.0,2.0,1.0,2.0,2.0,2.0,2.0,2.0,10.0,10.0,10.0,12.0,10.0,6.0,15.0,10.0,7.0,5.0,12.0,9.0,9.0,11.0,10.0,11.0,9.0,8.0,12.0,10.0,8.0,10.0,6.0,9.0,12.0,8.0,12.0,15.0,12.0,13.0,10.0,8.0,9.0,14.0,14.0,20.0,11.0,7.0,11.0,5.0,15.0,5.0,8.0,16.0,12.0,9.0,10.0,12.0,10.0,11.0,1.0,30.0,47.0,3.0,1.0,0.0,193.0,86.0,1.0,2.0,3.0,3.0,3.0,3.0,3.0,3.0,2.0,2.0,3.0,3.0,5.0,10.0,9.0,11.0,4.0,15.0,8.0,6.0,15.0,13.0,6.0,17.0,13.0,14.0,14.0,19.0,15.0,14.0,13.0,13.0,14.0,14.0,16.0,13.0,14.0,15.0,16.0,13.0,11.0,13.0,14.0,8.0,14.0,12.0,20.0,16.0,15.0,13.0,9.0,18.0,7.0,7.0,18.0,16.0,12.0,16.0,14.0,12.0,13.0,5.0,26.0,29.0,1.0,14.0,1.0,194.0,90.0,1.0,2.0,3.0,4.0,1.0,2.0,3.0,3.0,3.0,2.0,2.0,4.0,4.0,7.0,7.0,11.0,2.0,17.0,2.0,8.0,15.0,8.0,4.0,16.0,12.0,14.0,16.0,15.0,11.0,13.0,3.0,14.0,14.0,5.0,12.0,4.0,16.0,15.0,14.0,13.0,12.0,14.0,16.0,9.0,12.0,14.0,20.0,16.0,17.0,14.0,8.0,13.0,11.0,8.0,17.0,14.0,13.0,13.0,15.0,16.0,17.0,6.0,21.0,26.0,2.0,8.0,3.0,171.0,69.0,2.0,1.0,2.0,1.0,3.0,2.0,2.0,3.0,2.0,1.0,2.0,10.0,11.0,15.0,12.0,13.0,10.0,5.0,9.0,9.0,9.0,12.0,7.0,9.0,13.0,13.0,13.0,13.0,11.0,10.0,12.0,10.0,13.0,15.0,4.0,13.0,10.0,14.0,13.0,17.0,16.0,13.0,4.0,9.0,15.0,16.0,20.0,14.0,10.0,13.0,4.0,11.0,5.0,18.0,11.0,16.0,7.0,8.0,15.0,10.0,14.0,8.0,28.0,26.0,0.0,1.0,0.0,173.0,73.0,2.0,1.0,4.0,2.0,1.0,3.0,3.0,2.0,1.0,2.0,3.0,11.0,13.0,17.0,13.0,17.0,10.0,6.0,11.0,2.0,10.0,15.0,9.0,10.0,18.0,9.0,15.0,11.0,15.0,12.0,15.0,14.0,15.0,17.0,12.0,16.0,13.0,15.0,17.0,13.0,16.0,15.0,6.0,16.0,15.0,10.0,20.0,15.0,10.0,15.0,7.0,14.0,11.0,12.0,13.0,14.0,16.0,13.0,15.0,12.0,13.0,9.0,22.0,16.0,5.0,14.0,8.0,190.0,83.0,1.0,2.0,1.0,1.0,3.0,2.0,3.0,2.0,2.0,2.0,2.0,6.0,11.0,12.0,16.0,13.0,10.0,16.0,15.0,6.0,8.0,12.0,14.0,5.0,14.0,9.0,14.0,15.0,15.0,17.0,13.0,14.0,16.0,8.0,12.0,15.0,10.0,15.0,16.0,14.0,12.0,14.0,15.0,15.0,16.0,13.0,20.0,16.0,14.0,15.0,8.0,13.0,5.0,9.0,7.0,9.0,18.0,12.0,16.0,12.0,12.0,5.0,30.0,115.0,53.0,0.0,0.0,178.0,78.0,4.0,1.0,1.0,4.0,2.0,3.0,2.0,2.0,2.0,3.0,2.0,14.0,15.0,12.0,15.0,11.0,14.0,14.0,14.0,7.0,7.0,15.0,16.0,9.0,15.0,17.0,14.0,18.0,13.0,12.0,14.0,14.0,15.0,14.0,15.0,15.0,9.0,17.0,14.0,12.0,11.0,15.0,11.0,14.0,12.0,13.0,20.0,14.0,15.0,10.0,15.0,16.0,12.0,12.0,15.0,18.0,6.0,12.0,7.0,8.0,10.0,16.0,22.0,11.0,2.0,9.0,0.0,188.0,86.0,2.0,3.0,2.0,1.0,3.0,1.0,1.0,2.0,3.0,3.0,3.0,3.0,13.0,8.0,7.0,14.0,12.0,15.0,9.0,5.0,15.0,13.0,8.0,15.0,13.0,13.0,15.0,16.0,15.0,14.0,11.0,14.0,15.0,5.0,12.0,10.0,17.0,14.0,15.0,16.0,12.0,12.0,13.0,8.0,14.0,15.0,20.0,13.0,13.0,17.0,5.0,10.0,13.0,17.0,16.0,13.0,17.0,14.0,16.0,14.0,14.0,5.0,20.0,12.0,1.0,2.0,0.0,185.0,77.0,3.0,3.0,1.0,1.0,3.0,1.0,4.0,1.0,1.0,1.0,4.0,8.0,12.0,15.0,16.0,14.0,8.0,14.0,14.0,9.0,12.0,16.0,12.0,12.0,15.0,14.0,13.0,15.0,15.0,14.0,15.0,13.0,14.0,16.0,7.0,14.0,13.0,14.0,16.0,15.0,15.0,14.0,13.0,8.0,14.0,14.0,20.0,15.0,13.0,15.0,12.0,12.0,4.0,15.0,13.0,17.0,13.0,12.0,15.0,10.0,9.0,2.0,29.0,62.0,0.0,6.0,0.0,196.0,90.0,18.0,11.0,12.0,4.0,12.0,18.0,16.0,14.0,14.0,14.0,18.0,7.0,3.0,2.0,3.0,7.0,10.0,2.0,3.0,3.0,1.0,5.0,3.0,2.0,6.0,12.0,13.0,12.0,9.0,12.0,6.0,11.0,13.0,1.0,8.0,6.0,12.0,11.0,10.0,10.0,14.0,12.0,19.0,13.0,13.0,11.0,20.0,11.0,15.0,10.0,8.0,12.0,7.0,12.0,13.0,13.0,13.0,11.0,13.0,13.0,13.0,6.0,26.0,73.0,0.0,8.0,0.0,181.0,71.0,1.0,1.0,2.0,2.0,2.0,2.0,3.0,1.0,3.0,4.0,3.0,9.0,10.0,9.0,6.0,12.0,8.0,11.0,7.0,10.0,11.0,11.0,10.0,12.0,10.0,10.0,12.0,13.0,12.0,11.0,9.0,10.0,13.0,5.0,14.0,13.0,11.0,15.0,19.0,13.0,12.0,13.0,9.0,20.0,20.0,13.0,15.0,20.0,12.0,15.0,5.0,15.0,5.0,13.0,14.0,12.0,15.0,12.0,16.0,9.0,10.0,3.0,27.0,34.0,1.0,13.0,0.0,175.0,64.0,3.0,1.0,1.0,2.0,2.0,3.0,4.0,1.0,4.0,3.0,3.0,7.0,9.0,8.0,3.0,13.0,6.0,12.0,4.0,2.0,13.0,10.0,3.0,14.0,8.0,15.0,13.0,12.0,10.0,13.0,9.0,12.0,14.0,8.0,9.0,11.0,13.0,14.0,16.0,15.0,14.0,12.0,9.0,20.0,14.0,16.0,5.0,17.0,12.0,15.0,11.0,12.0,4.0,10.0,11.0,16.0,10.0,13.0,10.0,8.0,10.0,15.0,23.0,25.0,0.0,0.0,0.0,181.0,77.0,1.0,2.0,3.0,1.0,2.0,2.0,3.0,1.0,3.0,2.0,3.0,13.0,15.0,12.0,6.0,14.0,14.0,14.0,6.0,11.0,14.0,14.0,10.0,14.0,13.0,13.0,15.0,18.0,15.0,13.0,14.0,14.0,17.0,9.0,6.0,13.0,15.0,14.0,15.0,13.0,13.0,15.0,10.0,20.0,13.0,11.0,8.0,14.0,14.0,15.0,6.0,9.0,5.0,11.0,10.0,13.0,14.0,9.0,15.0,13.0,12.0,4.0,27.0,17.0,0.0,0.0,0.0,181.0,81.0,1.0,3.0,1.0,2.0,2.0,2.0,2.0,2.0,2.0,1.0,3.0,4.0,5.0,10.0,6.0,12.0,4.0,14.0,4.0,8.0,13.0,11.0,10.0,15.0,11.0,13.0,15.0,14.0,15.0,12.0,9.0,12.0,14.0,2.0,14.0,9.0,14.0,15.0,13.0,13.0,12.0,12.0,12.0,11.0,19.0,13.0,20.0,16.0,12.0,15.0,8.0,14.0,8.0,15.0,10.0,11.0,12.0,13.0,14.0,14.0,15.0,3.0,31.0,65.0,2.0,0.0,0.0,182.0,91.0,2.0,2.0,1.0,2.0,1.0,2.0,2.0,3.0,3.0,1.0,2.0,3.0,4.0,7.0,4.0,10.0,3.0,15.0,4.0,6.0,13.0,12.0,4.0,15.0,10.0,16.0,16.0,18.0,11.0,14.0,9.0,12.0,15.0,8.0,18.0,7.0,17.0,13.0,10.0,10.0,11.0,9.0,12.0,14.0,13.0,11.0,20.0,16.0,17.0,15.0,14.0,16.0,1.0,6.0,10.0,16.0,16.0,14.0,14.0,8.0,8.0,16.0,26.0,31.0,0.0,7.0,2.0,168.0,62.0,2.0,3.0,1.0,2.0,3.0,1.0,2.0,1.0,3.0,1.0,1.0,8.0,9.0,13.0,9.0,15.0,7.0,7.0,8.0,3.0,14.0,15.0,6.0,13.0,15.0,13.0,15.0,15.0,15.0,15.0,13.0,14.0,13.0,12.0,8.0,14.0,13.0,17.0,18.0,13.0,15.0,14.0,6.0,11.0,15.0,12.0,20.0,15.0,10.0,14.0,6.0,15.0,8.0,11.0,10.0,14.0,14.0,13.0,15.0,15.0,12.0,2.0,27.0,35.0,4.0,4.0,2.0,186.0,84.0,3.0,3.0,3.0,1.0,3.0,2.0,3.0,2.0,3.0,3.0,3.0,11.0,12.0,14.0,12.0,13.0,10.0,10.0,13.0,10.0,6.0,10.0,14.0,7.0,11.0,9.0,9.0,8.0,10.0,10.0,9.0,8.0,15.0,14.0,8.0,12.0,8.0,12.0,12.0,14.0,11.0,16.0,12.0,20.0,15.0,15.0,10.0,11.0,14.0,10.0,3.0,15.0,7.0,14.0,8.0,14.0,16.0,12.0,15.0,16.0,13.0,4.0,25.0,44.0,11.0,12.0,2.0,178.0,67.0,3.0,2.0,2.0,4.0,1.0,1.0,3.0,2.0,2.0,1.0,2.0,9.0,13.0,15.0,12.0,15.0,8.0,5.0,12.0,3.0,9.0,15.0,12.0,12.0,17.0,10.0,14.0,13.0,16.0,14.0,17.0,14.0,15.0,14.0,12.0,17.0,11.0,16.0,16.0,13.0,16.0,14.0,8.0,12.0,16.0,12.0,20.0,16.0,12.0,14.0,6.0,15.0,12.0,16.0,14.0,14.0,16.0,14.0,17.0,16.0,14.0,6.0,26.0,61.0,22.0,13.0,3.0,186.0,82.0,2.0,2.0,2.0,1.0,3.0,2.0,1.0,1.0,2.0,1.0,3.0,14.0,16.0,16.0,17.0,15.0,17.0,19.0,19.0,15.0,6.0,14.0,13.0,9.0,16.0,10.0,14.0,11.0,13.0,11.0,13.0,13.0,16.0,17.0,9.0,18.0,7.0,10.0,10.0,15.0,14.0,14.0,15.0,20.0,13.0,19.0,11.0,18.0,17.0,13.0,10.0,13.0,15.0,16.0,8.0,14.0,11.0,14.0,14.0,17.0,14.0,12.0,29.0,67.0,4.0,5.0,0.0,183.0,73.0,3.0,3.0,3.0,2.0,3.0,1.0,2.0,1.0,1.0,2.0,2.0,9.0,11.0,10.0,14.0,12.0,6.0,14.0,12.0,12.0,16.0,14.0,14.0,15.0,13.0,12.0,12.0,15.0,15.0,14.0,13.0,15.0,16.0,8.0,14.0,13.0,13.0,16.0,16.0,13.0,13.0,14.0,15.0,20.0,14.0,11.0,4.0,15.0,14.0,14.0,2.0,16.0,9.0,12.0,10.0,14.0,19.0,12.0,14.0,18.0,10.0,8.0
0,0,28.0,42.0,0.0,12.0,0.0,190.0,84.0,16.0,14.0,16.0,5.0,16.0,14.0,17.0,18.0,15.0,12.0,14.0,6.0,3.0,5.0,2.0,7.0,8.0,8.0,3.0,12.0,3.0,8.0,1.0,1.0,11.0,12.0,12.0,13.0,14.0,14.0,10.0,13.0,15.0,11.0,16.0,11.0,16.0,13.0,14.0,11.0,14.0,16.0,16.0,20.0,13.0,10.0,5.0,12.0,15.0,14.0,7.0,15.0,8.0,13.0,19.0,8.0,20.0,15.0,17.0,18.0,17.0,4.0,18.0,0.0,0.0,0.0,0.0,173.0,0.0,3.0,1.0,2.0,3.0,1.0,3.0,3.0,2.0,1.0,1.0,1.0,5.0,5.0,12.0,10.0,14.0,7.0,7.0,10.0,2.0,6.0,12.0,5.0,8.0,14.0,11.0,6.0,8.0,10.0,7.0,13.0,11.0,7.0,13.0,6.0,7.0,5.0,8.0,11.0,13.0,14.0,7.0,8.0,5.0,13.0,14.0,20.0,9.0,5.0,9.0,6.0,9.0,5.0,9.0,13.0,11.0,8.0,12.0,13.0,1.0,5.0,3.0,22.0,12.0,2.0,13.0,0.0,170.0,71.0,2.0,2.0,1.0,3.0,2.0,2.0,1.0,1.0,1.0,3.0,2.0,15.0,15.0,12.0,10.0,14.0,15.0,8.0,13.0,12.0,9.0,13.0,10.0,10.0,14.0,14.0,16.0,10.0,17.0,14.0,12.0,16.0,14.0,12.0,8.0,14.0,10.0,17.0,16.0,16.0,17.0,10.0,6.0,20.0,17.0,13.0,8.0,15.0,7.0,15.0,6.0,15.0,8.0,17.0,13.0,13.0,12.0,12.0,14.0,16.0,16.0,8.0,38.0,89.0,6.0,14.0,1.0,183.0,79.0,3.0,3.0,2.0,3.0,2.0,3.0,2.0,4.0,3.0,2.0,3.0,4.0,8.0,8.0,7.0,12.0,6.0,14.0,8.0,11.0,17.0,12.0,11.0,16.0,12.0,15.0,16.0,17.0,15.0,17.0,10.0,16.0,18.0,6.0,15.0,8.0,16.0,17.0,13.0,8.0,8.0,12.0,11.0,10.0,13.0,8.0,20.0,10.0,11.0,16.0,12.0,16.0,11.0,7.0,15.0,16.0,16.0,15.0,18.0,16.0,14.0,4.0,31.0,133.0,61.0,10.0,3.0,186.0,84.0,2.0,1.0,3.0,1.0,3.0,2.0,2.0,3.0,1.0,3.0,2.0,12.0,14.0,15.0,19.0,16.0,14.0,18.0,19.0,6.0,2.0,14.0,19.0,8.0,15.0,6.0,17.0,16.0,13.0,16.0,13.0,17.0,20.0,18.0,15.0,18.0,5.0,6.0,7.0,13.0,12.0,13.0,16.0,15.0,19.0,17.0,20.0,17.0,16.0,17.0,12.0,14.0,7.0,10.0,18.0,20.0,13.0,19.0,20.0,7.0,7.0,12.0,29.0,90.0,4.0,16.0,2.0,170.0,61.0,2.0,3.0,3.0,1.0,3.0,1.0,2.0,2.0,2.0,2.0,1.0,15.0,14.0,15.0,9.0,17.0,16.0,7.0,12.0,4.0,11.0,18.0,15.0,12.0,17.0,15.0,15.0,16.0,13.0,16.0,17.0,14.0,16.0,15.0,14.0,12.0,14.0,18.0,16.0,13.0,14.0,12.0,8.0,10.0,14.0,11.0,20.0,14.0,10.0,14.0,9.0,17.0,10.0,14.0,13.0,17.0,15.0,16.0,17.0,15.0,16.0,7.0,21.0,0.0,0.0,0.0,0.0,178.0,79.0,1.0,4.0,3.0,3.0,3.0,3.0,3.0,1.0,1.0,2.0,1.0,6.0,6.0,8.0,5.0,9.0,5.0,6.0,6.0,3.0,7.0,11.0,4.0,5.0,11.0,8.0,10.0,4.0,9.0,5.0,14.0,9.0,3.0,10.0,1.0,8.0,8.0,8.0,10.0,14.0,8.0,7.0,7.0,9.0,14.0,11.0,20.0,7.0,5.0,8.0,8.0,6.0,8.0,8.0,12.0,12.0,11.0,10.0,12.0,10.0,20.0,7.0,24.0,15.0,0.0,15.0,2.0,187.0,83.0,2.0,3.0,2.0,2.0,3.0,3.0,3.0,2.0,1.0,3.0,4.0,8.0,9.0,12.0,9.0,15.0,10.0,7.0,10.0,11.0,13.0,15.0,12.0,16.0,14.0,13.0,15.0,14.0,16.0,18.0,14.0,15.0,12.0,5.0,15.0,10.0,16.0,17.0,13.0,9.0,10.0,19.0,14.0,13.0,16.0,11.0,20.0,16.0,18.0,17.0,8.0,14.0,6.0,6.0,14.0,10.0,18.0,15.0,19.0,16.0,15.0,5.0,22.0,13.0,0.0,6.0,1.0,188.0,84.0,2.0,2.0,2.0,3.0,3.0,2.0,3.0,1.0,2.0,1.0,2.0,11.0,12.0,16.0,11.0,15.0,12.0,11.0,15.0,9.0,8.0,16.0,14.0,12.0,17.0,12.0,11.0,11.0,12.0,10.0,14.0,11.0,12.0,16.0,9.0,14.0,11.0,12.0,13.0,14.0,14.0,13.0,12.0,16.0,13.0,14.0,20.0,14.0,14.0,8.0,12.0,14.0,10.0,13.0,14.0,13.0,14.0,13.0,15.0,14.0,12.0,5.0,26.0,0.0,0.0,0.0,0.0,173.0,63.0,3.0,2.0,1.0,2.0,2.0,1.0,1.0,2.0,3.0,2.0,3.0,6.0,4.0,3.0,6.0,14.0,4.0,6.0,6.0,1.0,7.0,9.0,1.0,7.0,12.0,8.0,8.0,4.0,9.0,7.0,10.0,14.0,8.0,8.0,8.0,9.0,5.0,8.0,12.0,14.0,14.0,7.0,6.0,5.0,8.0,14.0,20.0,11.0,8.0,8.0,8.0,8.0,5.0,8.0,12.0,8.0,10.0,10.0,14.0,13.0,18.0,2.0,32.0,56.0,8.0,28.0,6.0,175.0,67.0,2.0,1.0,3.0,2.0,1.0,4.0,2.0,1.0,1.0,2.0,1.0,17.0,19.0,17.0,9.0,15.0,13.0,7.0,15.0,7.0,2.0,12.0,15.0,2.0,17.0,14.0,10.0,10.0,12.0,12.0,12.0,10.0,10.0,20.0,5.0,8.0,5.0,6.0,7.0,15.0,15.0,13.0,8.0,11.0,12.0,14.0,20.0,12.0,12.0,10.0,17.0,17.0,6.0,12.0,7.0,5.0,7.0,7.0,12.0,6.0,6.0,16.0,32.0,31.0,0.0,3.0,0.0,194.0,88.0,13.0,13.0,13.0,10.0,14.0,13.0,17.0,16.0,12.0,17.0,14.0,2.0,5.0,5.0,6.0,7.0,2.0,4.0,4.0,14.0,5.0,6.0,5.0,4.0,5.0,11.0,11.0,12.0,12.0,13.0,7.0,13.0,12.0,7.0,15.0,1.0,13.0,13.0,11.0,10.0,11.0,13.0,16.0,20.0,13.0,10.0,13.0,13.0,14.0,13.0,5.0,13.0,13.0,2.0,14.0,12.0,8.0,11.0,14.0,14.0,14.0,6.0,23.0,17.0,0.0,13.0,0.0,184.0,78.0,1.0,1.0,2.0,1.0,1.0,2.0,1.0,2.0,3.0,1.0,2.0,5.0,8.0,11.0,9.0,10.0,12.0,12.0,14.0,10.0,16.0,13.0,11.0,14.0,10.0,14.0,16.0,16.0,11.0,10.0,14.0,13.0,10.0,10.0,12.0,8.0,13.0,12.0,10.0,11.0,8.0,16.0,13.0,20.0,11.0,15.0,10.0,12.0,15.0,11.0,9.0,15.0,10.0,12.0,8.0,12.0,15.0,13.0,8.0,13.0,9.0,17.0,30.0,78.0,1.0,10.0,3.0,186.0,82.0,1.0,3.0,3.0,3.0,2.0,2.0,1.0,3.0,1.0,2.0,1.0,15.0,15.0,11.0,8.0,12.0,16.0,14.0,14.0,18.0,13.0,14.0,9.0,15.0,12.0,14.0,11.0,11.0,13.0,15.0,13.0,14.0,13.0,11.0,18.0,13.0,13.0,16.0,17.0,11.0,12.0,13.0,12.0,20.0,15.0,10.0,8.0,16.0,14.0,14.0,11.0,12.0,1.0,13.0,8.0,17.0,6.0,12.0,17.0,15.0,13.0,8.0,27.0,18.0,0.0,9.0,0.0,189.0,74.0,3.0,1.0,2.0,1.0,2.0,2.0,1.0,2.0,2.0,3.0,2.0,9.0,10.0,9.0,6.0,10.0,9.0,14.0,11.0,8.0,15.0,12.0,9.0,16.0,10.0,17.0,12.0,17.0,10.0,16.0,9.0,10.0,17.0,7.0,16.0,11.0,14.0,18.0,17.0,11.0,10.0,16.0,14.0,8.0,17.0,12.0,20.0,17.0,14.0,17.0,12.0,17.0,6.0,11.0,9.0,12.0,15.0,15.0,17.0,12.0,14.0,3.0,27.0,55.0,11.0,4.0,2.0,192.0,83.0,2.0,1.0,1.0,2.0,1.0,2.0,1.0,2.0,3.0,2.0,3.0,8.0,14.0,17.0,9.0,19.0,14.0,8.0,12.0,12.0,3.0,14.0,10.0,6.0,18.0,14.0,7.0,15.0,11.0,10.0,13.0,8.0,14.0,19.0,4.0,14.0,7.0,6.0,8.0,13.0,16.0,18.0,14.0,18.0,12.0,15.0,20.0,14.0,15.0,12.0,14.0,13.0,8.0,13.0,14.0,18.0,3.0,7.0,14.0,8.0,6.0,15.0,24.0,49.0,11.0,5.0,0.0,178.0,72.0,1.0,2.0,2.0,1.0,3.0,3.0,4.0,2.0,3.0,3.0,2.0,12.0,13.0,12.0,10.0,15.0,15.0,8.0,14.0,13.0,10.0,14.0,15.0,13.0,15.0,17.0,16.0,13.0,15.0,17.0,13.0,15.0,17.0,11.0,12.0,14.0,10.0,18.0,17.0,16.0,14.0,14.0,11.0,20.0,19.0,16.0,9.0,19.0,11.0,18.0,8.0,18.0,6.0,18.0,14.0,17.0,12.0,18.0,15.0,13.0,10.0,10.0,29.0,60.0,14.0,3.0,1.0,185.0,76.0,2.0,1.0,4.0,3.0,1.0,3.0,2.0,3.0,2.0,3.0,1.0,6.0,9.0,11.0,13.0,11.0,6.0,12.0,9.0,4.0,6.0,9.0,10.0,8.0,12.0,18.0,12.0,14.0,8.0,12.0,9.0,8.0,16.0,13.0,11.0,15.0,9.0,13.0,18.0,16.0,13.0,10.0,12.0,14.0,18.0,16.0,20.0,17.0,10.0,14.0,10.0,14.0,7.0,10.0,8.0,12.0,14.0,10.0,16.0,12.0,10.0,8.0,28.0,48.0,1.0,17.0,1.0,183.0,80.0,1.0,1.0,1.0,1.0,3.0,4.0,3.0,1.0,3.0,1.0,3.0,6.0,8.0,9.0,7.0,11.0,6.0,12.0,8.0,10.0,13.0,12.0,6.0,16.0,11.0,18.0,12.0,17.0,10.0,17.0,9.0,12.0,17.0,6.0,15.0,13.0,13.0,18.0,19.0,13.0,11.0,16.0,11.0,14.0,19.0,18.0,20.0,19.0,14.0,18.0,10.0,17.0,6.0,8.0,12.0,16.0,14.0,13.0,18.0,15.0,10.0,4.0,29.0,50.0,4.0,8.0,1.0,194.0,90.0,2.0,2.0,1.0,3.0,1.0,3.0,3.0,3.0,3.0,1.0,1.0,4.0,7.0,5.0,8.0,8.0,6.0,18.0,6.0,12.0,12.0,8.0,8.0,13.0,7.0,10.0,14.0,15.0,12.0,14.0,7.0,12.0,15.0,6.0,10.0,7.0,16.0,17.0,12.0,9.0,8.0,16.0,18.0,10.0,13.0,13.0,20.0,14.0,17.0,14.0,6.0,14.0,13.0,3.0,12.0,13.0,16.0,10.0,14.0,15.0,16.0,3.0,29.0,40.0,0.0,23.0,3.0,180.0,72.0,3.0,3.0,1.0,1.0,1.0,2.0,1.0,3.0,3.0,3.0,1.0,9.0,15.0,11.0,10.0,14.0,11.0,8.0,13.0,14.0,9.0,12.0,13.0,11.0,13.0,15.0,9.0,13.0,10.0,13.0,12.0,10.0,13.0,13.0,8.0,12.0,9.0,14.0,16.0,14.0,14.0,10.0,10.0,8.0,18.0,16.0,20.0,16.0,9.0,15.0,6.0,14.0,2.0,12.0,10.0,12.0,8.0,12.0,18.0,15.0,18.0,3.0,22.0,21.0,3.0,7.0,1.0,177.0,74.0,3.0,2.0,3.0,3.0,3.0,1.0,1.0,3.0,3.0,1.0,2.0,9.0,11.0,13.0,15.0,12.0,9.0,8.0,11.0,6.0,6.0,12.0,10.0,8.0,13.0,17.0,11.0,14.0,12.0,10.0,13.0,9.0,15.0,13.0,7.0,14.0,8.0,10.0,17.0,16.0,13.0,14.0,9.0,14.0,17.0,14.0,20.0,16.0,11.0,15.0,6.0,15.0,4.0,15.0,10.0,18.0,7.0,16.0,13.0,8.0,8.0,15.0
0,0,27.0,22.0,0.0,31.0,0.0,183.0,79.0,11.0,15.0,10.0,13.0,12.0,16.0,17.0,16.0,18.0,8.0,15.0,8.0,1.0,2.0,3.0,11.0,10.0,7.0,3.0,2.0,3.0,12.0,7.0,3.0,12.0,10.0,17.0,12.0,18.0,13.0,10.0,15.0,14.0,2.0,11.0,2.0,14.0,17.0,10.0,14.0,11.0,14.0,9.0,15.0,17.0,10.0,20.0,13.0,12.0,16.0,5.0,15.0,5.0,12.0,10.0,12.0,14.0,17.0,17.0,12.0,16.0,6.0,32.0,85.0,5.0,30.0,1.0,182.0,75.0,2.0,3.0,1.0,3.0,1.0,1.0,4.0,1.0,2.0,4.0,1.0,4.0,12.0,12.0,10.0,11.0,2.0,12.0,10.0,12.0,14.0,14.0,5.0,12.0,13.0,19.0,14.0,19.0,16.0,16.0,11.0,14.0,18.0,8.0,13.0,16.0,16.0,16.0,19.0,14.0,13.0,14.0,11.0,9.0,15.0,15.0,20.0,17.0,14.0,16.0,14.0,14.0,7.0,11.0,15.0,16.0,13.0,15.0,14.0,6.0,7.0,12.0,19.0,14.0,1.0,4.0,0.0,184.0,84.0,3.0,3.0,1.0,1.0,2.0,3.0,1.0,1.0,1.0,1.0,3.0,8.0,10.0,13.0,13.0,14.0,8.0,11.0,10.0,8.0,7.0,12.0,13.0,9.0,12.0,16.0,11.0,17.0,12.0,8.0,13.0,10.0,15.0,15.0,7.0,14.0,8.0,15.0,17.0,14.0,13.0,17.0,12.0,9.0,14.0,17.0,20.0,13.0,15.0,10.0,5.0,11.0,8.0,14.0,12.0,16.0,13.0,13.0,14.0,18.0,15.0,4.0,23.0,47.0,6.0,5.0,0.0,185.0,82.0,3.0,2.0,1.0,1.0,1.0,3.0,2.0,2.0,1.0,3.0,1.0,9.0,11.0,11.0,9.0,14.0,12.0,10.0,15.0,6.0,12.0,17.0,10.0,13.0,16.0,16.0,13.0,15.0,14.0,12.0,16.0,13.0,13.0,12.0,12.0,10.0,12.0,16.0,14.0,12.0,11.0,16.0,13.0,20.0,14.0,13.0,12.0,16.0,15.0,13.0,15.0,15.0,5.0,10.0,14.0,17.0,8.0,14.0,13.0,10.0,6.0,15.0,31.0,63.0,2.0,0.0,0.0,184.0,78.0,1.0,1.0,1.0,1.0,1.0,1.0,1.0,1.0,1.0,1.0,1.0,7.0,10.0,9.0,7.0,11.0,6.0,11.0,8.0,14.0,14.0,12.0,5.0,18.0,11.0,19.0,14.0,17.0,10.0,15.0,9.0,11.0,17.0,8.0,13.0,12.0,12.0,14.0,18.0,13.0,14.0,17.0,10.0,8.0,15.0,13.0,20.0,19.0,12.0,15.0,14.0,15.0,10.0,14.0,16.0,16.0,8.0,13.0,15.0,11.0,10.0,14.0,15.0,0.0,0.0,0.0,0.0,165.0,0.0,2.0,3.0,1.0,2.0,1.0,2.0,3.0,3.0,3.0,3.0,1.0,3.0,5.0,3.0,3.0,5.0,2.0,6.0,4.0,4.0,6.0,7.0,4.0,11.0,5.0,14.0,4.0,9.0,5.0,6.0,4.0,10.0,14.0,13.0,9.0,5.0,5.0,7.0,8.0,11.0,6.0,6.0,5.0,20.0,12.0,6.0,6.0,12.0,6.0,4.0,14.0,11.0,4.0,6.0,14.0,13.0,14.0,11.0,8.0,5.0,8.0,10.0,30.0,52.0,6.0,16.0,4.0,179.0,73.0,1.0,2.0,1.0,1.0,3.0,3.0,1.0,3.0,3.0,2.0,4.0,9.0,12.0,12.0,14.0,14.0,12.0,12.0,16.0,12.0,12.0,14.0,12.0,13.0,14.0,12.0,14.0,14.0,13.0,15.0,10.0,14.0,12.0,10.0,15.0,15.0,12.0,15.0,14.0,9.0,12.0,15.0,9.0,10.0,9.0,11.0,20.0,15.0,13.0,13.0,11.0,14.0,12.0,14.0,14.0,14.0,14.0,14.0,12.0,11.0,11.0,10.0,25.0,46.0,5.0,9.0,6.0,182.0,76.0,3.0,1.0,1.0,2.0,2.0,1.0,1.0,1.0,2.0,3.0,2.0,9.0,11.0,15.0,12.0,15.0,9.0,10.0,14.0,6.0,7.0,13.0,12.0,8.0,14.0,15.0,12.0,8.0,10.0,10.0,14.0,12.0,11.0,15.0,6.0,14.0,8.0,15.0,17.0,12.0,14.0,9.0,10.0,10.0,13.0,15.0,20.0,15.0,10.0,11.0,5.0,11.0,5.0,14.0,10.0,16.0,7.0,9.0,14.0,12.0,10.0,8.0,29.0,64.0,2.0,2.0,0.0,192.0,90.0,1.0,3.0,4.0,3.0,1.0,2.0,2.0,1.0,2.0,1.0,3.0,5.0,8.0,12.0,4.0,11.0,4.0,10.0,5.0,10.0,15.0,10.0,9.0,15.0,12.0,14.0,13.0,16.0,12.0,11.0,8.0,11.0,10.0,8.0,14.0,7.0,12.0,14.0,11.0,12.0,11.0,16.0,17.0,12.0,13.0,15.0,20.0,13.0,17.0,12.0,9.0,13.0,14.0,9.0,17.0,12.0,15.0,12.0,16.0,15.0,17.0,5.0,24.0,24.0,6.0,5.0,1.0,186.0,85.0,1.0,4.0,1.0,2.0,1.0,3.0,3.0,2.0,3.0,1.0,2.0,6.0,9.0,10.0,8.0,12.0,10.0,16.0,11.0,8.0,14.0,14.0,16.0,13.0,12.0,12.0,15.0,13.0,17.0,10.0,14.0,13.0,12.0,9.0,11.0,9.0,13.0,16.0,10.0,9.0,10.0,16.0,14.0,12.0,12.0,11.0,20.0,12.0,15.0,12.0,10.0,14.0,10.0,4.0,10.0,13.0,12.0,14.0,15.0,14.0,16.0,6.0,24.0,57.0,18.0,7.0,1.0,169.0,72.0,1.0,3.0,1.0,1.0,3.0,2.0,1.0,3.0,2.0,2.0,4.0,12.0,14.0,15.0,12.0,17.0,13.0,4.0,14.0,4.0,6.0,14.0,10.0,6.0,15.0,14.0,12.0,13.0,11.0,9.0,13.0,10.0,14.0,18.0,5.0,15.0,6.0,10.0,10.0,16.0,17.0,16.0,5.0,20.0,10.0,14.0,12.0,14.0,13.0,12.0,8.0,12.0,8.0,14.0,10.0,15.0,13.0,13.0,16.0,12.0,14.0,8.0,29.0,82.0,0.0,8.0,0.0,188.0,78.0,12.0,12.0,14.0,14.0,17.0,8.0,15.0,18.0,17.0,18.0,11.0,5.0,2.0,3.0,2.0,11.0,10.0,1.0,9.0,3.0,7.0,10.0,1.0,13.0,8.0,10.0,14.0,18.0,14.0,16.0,9.0,16.0,15.0,6.0,16.0,3.0,17.0,14.0,8.0,15.0,17.0,15.0,15.0,20.0,15.0,14.0,6.0,15.0,14.0,15.0,10.0,15.0,5.0,1.0,14.0,15.0,17.0,18.0,17.0,18.0,18.0,4.0,35.0,80.0,0.0,11.0,0.0,174.0,74.0,3.0,4.0,2.0,2.0,2.0,2.0,1.0,2.0,2.0,3.0,2.0,8.0,14.0,13.0,7.0,15.0,8.0,14.0,4.0,14.0,14.0,13.0,9.0,16.0,15.0,15.0,15.0,16.0,17.0,13.0,11.0,15.0,19.0,14.0,18.0,14.0,17.0,16.0,14.0,12.0,13.0,15.0,9.0,20.0,17.0,12.0,9.0,13.0,11.0,16.0,14.0,16.0,4.0,10.0,18.0,14.0,17.0,17.0,14.0,14.0,14.0,12.0,30.0,32.0,1.0,0.0,0.0,190.0,88.0,1.0,2.0,2.0,2.0,3.0,1.0,1.0,3.0,3.0,2.0,2.0,5.0,7.0,9.0,8.0,10.0,7.0,16.0,11.0,9.0,15.0,13.0,5.0,16.0,12.0,17.0,16.0,17.0,13.0,13.0,11.0,12.0,16.0,7.0,14.0,10.0,14.0,15.0,15.0,14.0,12.0,17.0,16.0,9.0,15.0,14.0,20.0,16.0,18.0,15.0,15.0,14.0,10.0,12.0,14.0,15.0,12.0,14.0,12.0,13.0,11.0,15.0,30.0,48.0,4.0,16.0,3.0,173.0,72.0,4.0,1.0,4.0,2.0,1.0,2.0,1.0,2.0,3.0,1.0,4.0,14.0,12.0,14.0,13.0,15.0,15.0,5.0,14.0,2.0,2.0,16.0,14.0,11.0,17.0,12.0,15.0,13.0,13.0,16.0,14.0,13.0,16.0,12.0,13.0,16.0,14.0,18.0,18.0,11.0,15.0,15.0,6.0,11.0,17.0,12.0,20.0,17.0,12.0,8.0,17.0,14.0,8.0,12.0,13.0,15.0,12.0,15.0,15.0,11.0,7.0,6.0,25.0,34.0,13.0,6.0,2.0,175.0,72.0,3.0,1.0,4.0,14.0,1.0,1.0,1.0,3.0,2.0,2.0,2.0,14.0,17.0,17.0,18.0,19.0,15.0,15.0,14.0,4.0,5.0,14.0,13.0,11.0,17.0,13.0,15.0,13.0,14.0,15.0,15.0,15.0,17.0,17.0,14.0,18.0,10.0,12.0,15.0,15.0,15.0,15.0,9.0,20.0,15.0,14.0,15.0,13.0,10.0,16.0,6.0,14.0,5.0,14.0,13.0,18.0,12.0,12.0,14.0,14.0,8.0,13.0,30.0,33.0,7.0,0.0,0.0,186.0,84.0,2.0,2.0,2.0,2.0,2.0,3.0,1.0,2.0,3.0,2.0,2.0,8.0,12.0,13.0,16.0,12.0,13.0,14.0,14.0,6.0,8.0,12.0,15.0,8.0,13.0,13.0,14.0,16.0,15.0,15.0,12.0,15.0,16.0,13.0,14.0,16.0,9.0,14.0,18.0,14.0,13.0,17.0,13.0,8.0,9.0,13.0,20.0,15.0,17.0,14.0,13.0,13.0,12.0,7.0,16.0,15.0,14.0,13.0,10.0,13.0,9.0,12.0,23.0,38.0,6.0,13.0,4.0,191.0,84.0,3.0,2.0,1.0,3.0,1.0,3.0,3.0,1.0,1.0,4.0,2.0,7.0,12.0,17.0,15.0,19.0,15.0,13.0,18.0,4.0,11.0,16.0,12.0,13.0,18.0,13.0,14.0,13.0,15.0,14.0,16.0,12.0,17.0,19.0,12.0,15.0,12.0,13.0,15.0,13.0,15.0,18.0,16.0,15.0,17.0,16.0,20.0,17.0,17.0,16.0,14.0,12.0,5.0,10.0,17.0,19.0,12.0,14.0,14.0,14.0,13.0,8.0,26.0,44.0,1.0,18.0,1.0,188.0,83.0,2.0,2.0,2.0,1.0,1.0,1.0,3.0,2.0,3.0,4.0,1.0,7.0,12.0,15.0,11.0,13.0,10.0,12.0,11.0,5.0,9.0,13.0,13.0,11.0,12.0,11.0,13.0,13.0,13.0,13.0,13.0,12.0,12.0,12.0,12.0,15.0,9.0,13.0,13.0,14.0,13.0,14.0,13.0,8.0,16.0,15.0,20.0,15.0,15.0,10.0,6.0,13.0,5.0,10.0,14.0,15.0,10.0,14.0,13.0,14.0,14.0,10.0,33.0,64.0,0.0,12.0,0.0,181.0,73.0,3.0,2.0,2.0,2.0,3.0,2.0,1.0,4.0,3.0,1.0,1.0,11.0,13.0,11.0,5.0,13.0,7.0,16.0,8.0,8.0,14.0,12.0,5.0,15.0,14.0,12.0,14.0,14.0,15.0,13.0,13.0,15.0,15.0,10.0,8.0,13.0,14.0,15.0,16.0,12.0,12.0,13.0,12.0,10.0,18.0,13.0,20.0,16.0,15.0,15.0,8.0,14.0,9.0,10.0,16.0,16.0,16.0,14.0,14.0,14.0,17.0,9.0,20.0,11.0,1.0,9.0,2.0,178.0,71.0,2.0,2.0,1.0,1.0,2.0,1.0,2.0,2.0,1.0,2.0,1.0,12.0,13.0,15.0,11.0,14.0,10.0,8.0,11.0,8.0,6.0,12.0,10.0,7.0,14.0,15.0,11.0,13.0,10.0,11.0,12.0,10.0,12.0,15.0,6.0,12.0,8.0,13.0,15.0,17.0,16.0,13.0,10.0,10.0,16.0,19.0,20.0,12.0,10.0,14.0,6.0,15.0,8.0,15.0,16.0,18.0,7.0,14.0,13.0,13.0,17.0,14.0,30.0,36.0,1.0,0.0,0.0,186.0,75.0,3.0,1.0,2.0,1.0,1.0,3.0,3.0,3.0,2.0,4.0,1.0,2.0,5.0,8.0,8.0,13.0,3.0,17.0,4.0,4.0,17.0,12.0,5.0,19.0,12.0,16.0,17.0,18.0,16.0,15.0,10.0,14.0,16.0,5.0,14.0,10.0,16.0,15.0,16.0,15.0,12.0,14.0,14.0,8.0,15.0,14.0,20.0,15.0,15.0,18.0,11.0,16.0,7.0,8.0,14.0,15.0,16.0,15.0,17.0,15.0,15.0,5.0
0,0,32.0,21.0,0.0,12.0,0.0,193.0,94.0,12.0,17.0,8.0,7.0,17.0,14.0,14.0,14.0,14.0,5.0,13.0,3.0,4.0,5.0,3.0,7.0,5.0,4.0,3.0,6.0,5.0,12.0,8.0,6.0,7.0,8.0,14.0,13.0,9.0,9.0,8.0,13.0,18.0,3.0,11.0,3.0,16.0,16.0,3.0,11.0,9.0,16.0,14.0,7.0,12.0,9.0,20.0,14.0,15.0,16.0,9.0,14.0,10.0,2.0,16.0,14.0,12.0,18.0,16.0,12.0,16.0,8.0,29.0,71.0,2.0,7.0,0.0,176.0,72.0,2.0,3.0,3.0,1.0,2.0,1.0,3.0,2.0,3.0,1.0,3.0,8.0,14.0,10.0,5.0,11.0,5.0,10.0,6.0,13.0,12.0,12.0,6.0,14.0,11.0,12.0,16.0,10.0,13.0,16.0,9.0,13.0,12.0,6.0,12.0,10.0,14.0,18.0,13.0,14.0,15.0,10.0,8.0,10.0,15.0,13.0,20.0,16.0,8.0,18.0,8.0,17.0,5.0,10.0,14.0,14.0,16.0,13.0,15.0,17.0,18.0,3.0,31.0,85.0,5.0,13.0,0.0,191.0,81.0,1.0,4.0,2.0,3.0,1.0,1.0,1.0,3.0,2.0,3.0,2.0,2.0,5.0,9.0,9.0,11.0,2.0,17.0,3.0,5.0,15.0,13.0,2.0,16.0,12.0,14.0,16.0,16.0,13.0,12.0,7.0,14.0,17.0,7.0,9.0,12.0,16.0,14.0,12.0,12.0,13.0,14.0,16.0,8.0,14.0,13.0,20.0,13.0,16.0,17.0,11.0,15.0,10.0,4.0,14.0,16.0,16.0,13.0,16.0,15.0,13.0,8.0,34.0,83.0,4.0,0.0,0.0,188.0,86.0,1.0,2.0,3.0,3.0,1.0,1.0,1.0,1.0,3.0,3.0,3.0,6.0,9.0,12.0,7.0,12.0,5.0,16.0,9.0,14.0,14.0,12.0,7.0,14.0,10.0,15.0,13.0,18.0,13.0,14.0,8.0,12.0,15.0,9.0,11.0,5.0,14.0,14.0,16.0,10.0,10.0,10.0,13.0,20.0,15.0,10.0,10.0,12.0,14.0,17.0,11.0,15.0,3.0,12.0,15.0,13.0,13.0,12.0,15.0,12.0,10.0,5.0,26.0,56.0,5.0,8.0,0.0,173.0,71.0,3.0,1.0,2.0,2.0,1.0,2.0,3.0,1.0,3.0,1.0,3.0,13.0,13.0,16.0,11.0,15.0,12.0,7.0,13.0,5.0,5.0,13.0,13.0,5.0,15.0,12.0,12.0,8.0,7.0,8.0,13.0,8.0,12.0,14.0,7.0,14.0,5.0,7.0,11.0,16.0,17.0,12.0,6.0,6.0,12.0,16.0,20.0,12.0,11.0,9.0,14.0,13.0,5.0,12.0,15.0,15.0,11.0,10.0,12.0,7.0,8.0,12.0,21.0,14.0,2.0,8.0,3.0,181.0,74.0,1.0,2.0,2.0,2.0,1.0,2.0,1.0,1.0,2.0,1.0,2.0,13.0,12.0,13.0,11.0,15.0,11.0,8.0,12.0,4.0,7.0,14.0,15.0,9.0,15.0,14.0,14.0,12.0,10.0,10.0,16.0,13.0,10.0,15.0,7.0,16.0,10.0,12.0,14.0,12.0,13.0,7.0,8.0,12.0,12.0,11.0,20.0,13.0,8.0,11.0,9.0,13.0,10.0,12.0,16.0,14.0,7.0,9.0,12.0,11.0,12.0,10.0,30.0,46.0,0.0,0.0,0.0,184.0,74.0,2.0,3.0,1.0,1.0,2.0,2.0,1.0,2.0,3.0,2.0,2.0,5.0,7.0,9.0,6.0,11.0,6.0,14.0,8.0,12.0,14.0,11.0,7.0,14.0,10.0,12.0,14.0,16.0,14.0,14.0,11.0,13.0,13.0,7.0,7.0,11.0,14.0,15.0,16.0,11.0,12.0,14.0,12.0,10.0,17.0,13.0,20.0,14.0,11.0,16.0,9.0,14.0,12.0,11.0,15.0,12.0,14.0,11.0,16.0,14.0,16.0,7.0,28.0,91.0,19.0,2.0,0.0,183.0,79.0,3.0,1.0,2.0,2.0,2.0,1.0,2.0,3.0,2.0,3.0,1.0,14.0,13.0,13.0,14.0,15.0,12.0,15.0,14.0,8.0,8.0,16.0,14.0,9.0,17.0,11.0,14.0,12.0,15.0,10.0,16.0,14.0,15.0,15.0,17.0,18.0,14.0,15.0,10.0,15.0,15.0,13.0,11.0,15.0,15.0,14.0,20.0,14.0,13.0,13.0,6.0,12.0,5.0,14.0,17.0,16.0,19.0,13.0,18.0,14.0,12.0,8.0,29.0,54.0,6.0,11.0,0.0,186.0,84.0,1.0,2.0,2.0,2.0,1.0,1.0,3.0,4.0,2.0,3.0,2.0,6.0,8.0,12.0,8.0,12.0,9.0,12.0,13.0,8.0,13.0,13.0,11.0,15.0,13.0,14.0,15.0,17.0,14.0,12.0,11.0,13.0,14.0,12.0,13.0,14.0,14.0,16.0,15.0,12.0,13.0,17.0,13.0,12.0,16.0,14.0,20.0,16.0,17.0,14.0,16.0,12.0,12.0,13.0,14.0,12.0,18.0,14.0,14.0,12.0,10.0,2.0,25.0,30.0,7.0,20.0,2.0,179.0,75.0,1.0,3.0,1.0,1.0,1.0,1.0,3.0,3.0,2.0,2.0,1.0,9.0,12.0,12.0,10.0,13.0,8.0,5.0,11.0,6.0,5.0,13.0,12.0,7.0,12.0,9.0,9.0,11.0,10.0,9.0,12.0,10.0,9.0,12.0,6.0,12.0,6.0,10.0,10.0,17.0,16.0,13.0,10.0,13.0,14.0,16.0,20.0,12.0,10.0,14.0,4.0,11.0,7.0,11.0,16.0,15.0,10.0,9.0,12.0,10.0,12.0,14.0,33.0,34.0,1.0,12.0,0.0,171.0,73.0,2.0,1.0,3.0,2.0,2.0,1.0,2.0,3.0,2.0,1.0,1.0,11.0,11.0,10.0,9.0,12.0,10.0,9.0,12.0,8.0,13.0,16.0,3.0,14.0,12.0,8.0,14.0,11.0,12.0,12.0,16.0,14.0,11.0,12.0,14.0,8.0,12.0,17.0,15.0,9.0,7.0,14.0,8.0,12.0,12.0,10.0,20.0,15.0,14.0,15.0,11.0,15.0,15.0,6.0,14.0,11.0,12.0,11.0,9.0,2.0,12.0,5.0,29.0,63.0,0.0,21.0,0.0,196.0,81.0,15.0,15.0,17.0,14.0,17.0,11.0,19.0,17.0,14.0,16.0,14.0,3.0,3.0,2.0,1.0,9.0,7.0,7.0,1.0,1.0,1.0,8.0,13.0,3.0,7.0,10.0,11.0,14.0,10.0,13.0,3.0,13.0,16.0,4.0,14.0,2.0,12.0,12.0,12.0,13.0,15.0,11.0,17.0,10.0,13.0,7.0,20.0,14.0,14.0,13.0,4.0,14.0,7.0,13.0,9.0,14.0,12.0,12.0,13.0,7.0,15.0,5.0,30.0,47.0,3.0,1.0,0.0,193.0,86.0,1.0,2.0,3.0,3.0,3.0,3.0,3.0,3.0,2.0,2.0,3.0,3.0,5.0,10.0,9.0,11.0,4.0,15.0,8.0,6.0,15.0,13.0,6.0,17.0,13.0,14.0,14.0,19.0,15.0,14.0,13.0,13.0,14.0,14.0,16.0,13.0,14.0,15.0,16.0,13.0,11.0,13.0,14.0,8.0,14.0,12.0,20.0,16.0,15.0,13.0,9.0,18.0,7.0,7.0,18.0,16.0,12.0,16.0,14.0,12.0,13.0,5.0,26.0,29.0,1.0,14.0,1.0,194.0,90.0,1.0,2.0,3.0,4.0,1.0,2.0,3.0,3.0,3.0,2.0,2.0,4.0,4.0,7.0,7.0,11.0,2.0,17.0,2.0,8.0,15.0,8.0,4.0,16.0,12.0,14.0,16.0,15.0,11.0,13.0,3.0,14.0,14.0,5.0,12.0,4.0,16.0,15.0,14.0,13.0,12.0,14.0,16.0,9.0,12.0,14.0,20.0,16.0,17.0,14.0,8.0,13.0,11.0,8.0,17.0,14.0,13.0,13.0,15.0,16.0,17.0,6.0,28.0,26.0,0.0,1.0,0.0,173.0,73.0,2.0,1.0,4.0,2.0,1.0,3.0,3.0,2.0,1.0,2.0,3.0,11.0,13.0,17.0,13.0,17.0,10.0,6.0,11.0,2.0,10.0,15.0,9.0,10.0,18.0,9.0,15.0,11.0,15.0,12.0,15.0,14.0,15.0,17.0,12.0,16.0,13.0,15.0,17.0,13.0,16.0,15.0,6.0,16.0,15.0,10.0,20.0,15.0,10.0,15.0,7.0,14.0,11.0,12.0,13.0,14.0,16.0,13.0,15.0,12.0,13.0,9.0,29.0,11.0,4.0,0.0,0.0,178.0,77.0,1.0,3.0,1.0,1.0,3.0,1.0,2.0,1.0,3.0,1.0,2.0,7.0,10.0,12.0,16.0,13.0,7.0,12.0,10.0,5.0,3.0,12.0,16.0,13.0,13.0,17.0,13.0,17.0,13.0,15.0,12.0,12.0,17.0,12.0,10.0,14.0,5.0,17.0,17.0,17.0,12.0,12.0,11.0,10.0,16.0,18.0,20.0,17.0,14.0,14.0,17.0,15.0,7.0,10.0,8.0,16.0,13.0,15.0,14.0,5.0,7.0,17.0,25.0,13.0,0.0,8.0,0.0,176.0,67.0,1.0,3.0,1.0,2.0,1.0,3.0,3.0,1.0,1.0,2.0,2.0,3.0,12.0,13.0,8.0,14.0,3.0,8.0,8.0,9.0,14.0,14.0,5.0,16.0,13.0,13.0,13.0,14.0,12.0,13.0,11.0,14.0,15.0,10.0,9.0,15.0,14.0,17.0,16.0,16.0,15.0,14.0,8.0,8.0,18.0,16.0,20.0,17.0,12.0,17.0,8.0,15.0,5.0,12.0,16.0,15.0,15.0,15.0,15.0,13.0,15.0,7.0,26.0,27.0,0.0,27.0,4.0,183.0,67.0,1.0,3.0,4.0,2.0,3.0,2.0,2.0,1.0,3.0,1.0,2.0,12.0,13.0,12.0,11.0,15.0,11.0,11.0,12.0,4.0,13.0,16.0,10.0,14.0,14.0,14.0,14.0,14.0,15.0,15.0,14.0,15.0,17.0,13.0,16.0,14.0,15.0,17.0,18.0,13.0,13.0,13.0,12.0,8.0,18.0,14.0,20.0,18.0,14.0,15.0,8.0,15.0,9.0,13.0,15.0,17.0,17.0,17.0,18.0,13.0,15.0,6.0,26.0,21.0,6.0,15.0,4.0,183.0,79.0,1.0,2.0,1.0,2.0,1.0,3.0,1.0,3.0,1.0,3.0,1.0,7.0,12.0,15.0,16.0,16.0,10.0,11.0,13.0,3.0,7.0,13.0,13.0,7.0,16.0,12.0,15.0,11.0,15.0,14.0,14.0,13.0,11.0,15.0,4.0,16.0,5.0,12.0,12.0,14.0,17.0,16.0,11.0,20.0,10.0,13.0,13.0,14.0,13.0,15.0,5.0,15.0,14.0,9.0,13.0,18.0,13.0,13.0,14.0,13.0,16.0,8.0,22.0,11.0,2.0,9.0,0.0,188.0,86.0,2.0,3.0,2.0,1.0,3.0,1.0,1.0,2.0,3.0,3.0,3.0,3.0,13.0,8.0,7.0,14.0,12.0,15.0,9.0,5.0,15.0,13.0,8.0,15.0,13.0,13.0,15.0,16.0,15.0,14.0,11.0,14.0,15.0,5.0,12.0,10.0,17.0,14.0,15.0,16.0,12.0,12.0,13.0,8.0,14.0,15.0,20.0,13.0,13.0,17.0,5.0,10.0,13.0,17.0,16.0,13.0,17.0,14.0,16.0,14.0,14.0,5.0,24.0,34.0,2.0,7.0,0.0,174.0,65.0,2.0,3.0,2.0,3.0,2.0,1.0,1.0,4.0,3.0,3.0,3.0,12.0,12.0,15.0,11.0,16.0,11.0,6.0,12.0,3.0,8.0,15.0,12.0,12.0,16.0,15.0,15.0,17.0,14.0,14.0,16.0,15.0,13.0,16.0,13.0,16.0,11.0,17.0,15.0,14.0,14.0,16.0,6.0,20.0,13.0,13.0,8.0,14.0,11.0,14.0,13.0,15.0,15.0,15.0,11.0,15.0,17.0,14.0,12.0,10.0,10.0,14.0,26.0,9.0,0.0,16.0,0.0,179.0,76.0,1.0,1.0,1.0,2.0,1.0,1.0,2.0,2.0,3.0,3.0,3.0,11.0,13.0,13.0,10.0,11.0,13.0,9.0,4.0,8.0,13.0,12.0,10.0,14.0,13.0,11.0,13.0,14.0,13.0,12.0,11.0,15.0,16.0,9.0,10.0,10.0,14.0,12.0,15.0,17.0,13.0,11.0,8.0,20.0,16.0,14.0,10.0,16.0,12.0,18.0,6.0,12.0,5.0,15.0,15.0,15.0,10.0,15.0,18.0,14.0,17.0,5.0
0,1,31.0,15.0,0.0,10.0,0.0,188.0,86.0,14.0,12.0,11.0,2.0,13.0,12.0,12.0,14.0,8.0,11.0,10.0,8.0,2.0,2.0,1.0,9.0,10.0,6.0,1.0,1.0,2.0,7.0,4.0,3.0,5.0,7.0,12.0,14.0,13.0,13.0,10.0,11.0,17.0,1.0,12.0,7.0,12.0,15.0,15.0,10.0,13.0,12.0,13.0,10.0,12.0,8.0,20.0,15.0,14.0,15.0,5.0,15.0,3.0,11.0,18.0,12.0,13.0,16.0,17.0,15.0,14.0,5.0,36.0,65.0,8.0,0.0,0.0,195.0,90.0,2.0,1.0,2.0,2.0,1.0,2.0,4.0,3.0,2.0,1.0,1.0,1.0,4.0,7.0,7.0,9.0,5.0,16.0,2.0,7.0,16.0,10.0,5.0,15.0,8.0,12.0,15.0,18.0,14.0,17.0,5.0,15.0,16.0,2.0,16.0,5.0,18.0,15.0,13.0,6.0,9.0,10.0,16.0,10.0,13.0,6.0,20.0,12.0,14.0,17.0,5.0,15.0,5.0,8.0,14.0,11.0,10.0,12.0,18.0,15.0,15.0,2.0,28.0,53.0,1.0,3.0,0.0,188.0,78.0,1.0,3.0,2.0,3.0,1.0,2.0,2.0,2.0,1.0,4.0,1.0,4.0,5.0,7.0,6.0,13.0,4.0,15.0,3.0,9.0,16.0,12.0,5.0,16.0,14.0,12.0,15.0,14.0,13.0,13.0,10.0,12.0,15.0,3.0,13.0,6.0,16.0,14.0,14.0,12.0,13.0,15.0,15.0,16.0,15.0,12.0,20.0,16.0,14.0,14.0,8.0,14.0,13.0,10.0,14.0,14.0,16.0,14.0,17.0,16.0,18.0,6.0,31.0,87.0,8.0,3.0,0.0,172.0,73.0,1.0,3.0,3.0,2.0,1.0,2.0,2.0,2.0,1.0,1.0,1.0,15.0,12.0,12.0,9.0,14.0,13.0,6.0,10.0,4.0,13.0,16.0,11.0,13.0,14.0,13.0,14.0,15.0,13.0,16.0,14.0,16.0,14.0,11.0,18.0,14.0,14.0,18.0,19.0,11.0,11.0,15.0,6.0,11.0,16.0,11.0,20.0,15.0,8.0,18.0,7.0,14.0,2.0,14.0,15.0,18.0,16.0,14.0,14.0,13.0,15.0,3.0,24.0,8.0,2.0,0.0,0.0,178.0,74.0,3.0,3.0,2.0,1.0,1.0,1.0,1.0,3.0,3.0,1.0,3.0,4.0,5.0,13.0,13.0,11.0,3.0,5.0,10.0,4.0,5.0,10.0,10.0,8.0,10.0,10.0,11.0,12.0,11.0,14.0,10.0,11.0,11.0,11.0,5.0,13.0,4.0,11.0,17.0,15.0,13.0,13.0,9.0,8.0,12.0,14.0,20.0,15.0,11.0,11.0,6.0,11.0,6.0,10.0,8.0,12.0,12.0,9.0,11.0,11.0,14.0,10.0,25.0,37.0,1.0,10.0,0.0,173.0,69.0,1.0,1.0,2.0,1.0,1.0,1.0,1.0,3.0,1.0,2.0,3.0,8.0,9.0,9.0,9.0,12.0,7.0,11.0,9.0,5.0,12.0,12.0,7.0,13.0,13.0,14.0,14.0,14.0,12.0,12.0,12.0,12.0,14.0,9.0,12.0,9.0,14.0,15.0,15.0,12.0,13.0,12.0,9.0,11.0,14.0,11.0,20.0,15.0,12.0,15.0,9.0,11.0,16.0,12.0,14.0,15.0,12.0,14.0,15.0,15.0,17.0,3.0,25.0,17.0,1.0,2.0,0.0,183.0,81.0,1.0,2.0,2.0,3.0,3.0,3.0,1.0,2.0,2.0,3.0,3.0,11.0,14.0,13.0,11.0,13.0,9.0,10.0,11.0,6.0,7.0,11.0,8.0,7.0,12.0,6.0,11.0,12.0,13.0,13.0,11.0,12.0,16.0,12.0,5.0,12.0,8.0,16.0,17.0,12.0,11.0,13.0,11.0,10.0,16.0,12.0,20.0,16.0,11.0,14.0,3.0,13.0,7.0,14.0,14.0,16.0,16.0,10.0,17.0,17.0,14.0,6.0,25.0,38.0,0.0,11.0,3.0,180.0,77.0,2.0,3.0,2.0,1.0,2.0,3.0,2.0,2.0,2.0,2.0,2.0,15.0,12.0,9.0,11.0,13.0,14.0,9.0,12.0,6.0,11.0,15.0,12.0,12.0,13.0,14.0,13.0,13.0,14.0,14.0,13.0,12.0,14.0,10.0,13.0,11.0,11.0,13.0,12.0,14.0,12.0,12.0,9.0,12.0,15.0,11.0,20.0,14.0,9.0,15.0,11.0,13.0,5.0,11.0,6.0,12.0,11.0,11.0,14.0,10.0,12.0,5.0,36.0,103.0,1.0,0.0,0.0,183.0,78.0,1.0,1.0,2.0,3.0,2.0,3.0,1.0,3.0,2.0,3.0,4.0,7.0,8.0,6.0,4.0,11.0,6.0,14.0,6.0,10.0,12.0,9.0,1.0,14.0,9.0,8.0,14.0,14.0,12.0,14.0,9.0,15.0,14.0,2.0,12.0,8.0,14.0,14.0,13.0,7.0,7.0,8.0,12.0,9.0,9.0,9.0,20.0,12.0,12.0,12.0,6.0,12.0,10.0,13.0,7.0,12.0,17.0,11.0,18.0,15.0,14.0,1.0,30.0,26.0,2.0,7.0,2.0,166.0,59.0,1.0,1.0,3.0,1.0,2.0,3.0,3.0,3.0,2.0,3.0,3.0,10.0,13.0,14.0,12.0,12.0,13.0,11.0,12.0,3.0,8.0,11.0,14.0,8.0,11.0,16.0,10.0,13.0,9.0,10.0,11.0,8.0,15.0,13.0,8.0,12.0,7.0,12.0,14.0,13.0,13.0,9.0,6.0,10.0,13.0,12.0,20.0,12.0,8.0,10.0,16.0,12.0,14.0,12.0,10.0,15.0,12.0,12.0,8.0,5.0,4.0,8.0,27.0,32.0,2.0,15.0,0.0,188.0,73.0,3.0,2.0,2.0,2.0,2.0,1.0,2.0,1.0,1.0,3.0,2.0,3.0,4.0,8.0,10.0,12.0,4.0,15.0,4.0,7.0,14.0,12.0,4.0,16.0,12.0,11.0,14.0,13.0,14.0,14.0,8.0,15.0,16.0,5.0,11.0,11.0,14.0,13.0,14.0,11.0,9.0,13.0,15.0,13.0,15.0,12.0,20.0,15.0,13.0,15.0,6.0,13.0,13.0,8.0,9.0,12.0,15.0,13.0,18.0,17.0,17.0,3.0,30.0,71.0,0.0,20.0,0.0,192.0,90.0,14.0,19.0,12.0,16.0,16.0,19.0,19.0,18.0,20.0,8.0,20.0,4.0,1.0,3.0,1.0,13.0,9.0,10.0,3.0,2.0,3.0,13.0,10.0,1.0,12.0,8.0,20.0,16.0,20.0,14.0,12.0,12.0,18.0,6.0,13.0,1.0,18.0,16.0,14.0,15.0,18.0,16.0,15.0,15.0,13.0,10.0,20.0,12.0,17.0,17.0,7.0,19.0,4.0,14.0,5.0,13.0,15.0,20.0,16.0,12.0,19.0,8.0,26.0,20.0,1.0,0.0,0.0,185.0,75.0,1.0,1.0,1.0,3.0,2.0,3.0,1.0,1.0,1.0,2.0,1.0,11.0,12.0,11.0,8.0,12.0,10.0,8.0,10.0,14.0,10.0,13.0,11.0,15.0,12.0,12.0,16.0,12.0,16.0,16.0,12.0,15.0,12.0,9.0,10.0,13.0,13.0,18.0,14.0,12.0,10.0,13.0,11.0,20.0,18.0,15.0,12.0,16.0,11.0,17.0,6.0,17.0,5.0,16.0,7.0,10.0,16.0,15.0,17.0,17.0,19.0,3.0,27.0,50.0,4.0,21.0,5.0,191.0,92.0,3.0,1.0,1.0,3.0,1.0,1.0,1.0,3.0,1.0,3.0,1.0,5.0,9.0,12.0,10.0,14.0,8.0,15.0,9.0,8.0,17.0,15.0,11.0,17.0,15.0,12.0,18.0,14.0,19.0,13.0,14.0,17.0,14.0,9.0,14.0,10.0,18.0,16.0,12.0,9.0,11.0,17.0,16.0,14.0,15.0,12.0,20.0,14.0,16.0,16.0,9.0,14.0,6.0,7.0,8.0,13.0,16.0,14.0,17.0,18.0,16.0,10.0,29.0,65.0,5.0,15.0,5.0,189.0,90.0,4.0,4.0,2.0,1.0,3.0,2.0,1.0,3.0,2.0,2.0,1.0,6.0,10.0,11.0,13.0,14.0,8.0,16.0,12.0,11.0,15.0,14.0,10.0,13.0,14.0,15.0,15.0,16.0,15.0,18.0,13.0,17.0,18.0,10.0,12.0,16.0,17.0,20.0,19.0,10.0,11.0,15.0,14.0,11.0,10.0,14.0,20.0,17.0,16.0,16.0,12.0,15.0,19.0,14.0,15.0,16.0,9.0,15.0,18.0,16.0,17.0,4.0,27.0,79.0,20.0,16.0,5.0,183.0,72.0,3.0,3.0,4.0,2.0,3.0,3.0,1.0,2.0,3.0,3.0,3.0,15.0,16.0,17.0,12.0,19.0,13.0,7.0,11.0,4.0,6.0,19.0,13.0,9.0,19.0,7.0,18.0,9.0,19.0,15.0,20.0,18.0,14.0,19.0,8.0,20.0,6.0,19.0,12.0,14.0,16.0,14.0,9.0,20.0,15.0,13.0,10.0,15.0,9.0,13.0,5.0,16.0,6.0,10.0,16.0,16.0,12.0,17.0,15.0,14.0,16.0,10.0,26.0,77.0,32.0,6.0,1.0,186.0,74.0,1.0,1.0,2.0,2.0,1.0,2.0,2.0,2.0,2.0,3.0,1.0,7.0,11.0,11.0,15.0,13.0,7.0,12.0,10.0,10.0,7.0,12.0,15.0,8.0,12.0,18.0,19.0,13.0,16.0,18.0,14.0,17.0,18.0,15.0,12.0,20.0,10.0,17.0,18.0,12.0,13.0,15.0,12.0,12.0,19.0,14.0,20.0,19.0,11.0,17.0,9.0,18.0,3.0,16.0,10.0,16.0,16.0,19.0,15.0,10.0,11.0,10.0,27.0,65.0,1.0,15.0,1.0,192.0,90.0,3.0,3.0,2.0,3.0,2.0,3.0,2.0,3.0,1.0,3.0,3.0,7.0,14.0,11.0,6.0,13.0,5.0,10.0,7.0,16.0,18.0,15.0,7.0,18.0,13.0,10.0,17.0,13.0,16.0,12.0,14.0,15.0,11.0,11.0,11.0,7.0,15.0,12.0,9.0,14.0,13.0,17.0,17.0,18.0,14.0,18.0,20.0,14.0,18.0,16.0,8.0,16.0,6.0,16.0,6.0,14.0,7.0,15.0,11.0,15.0,9.0,13.0,26.0,71.0,11.0,10.0,2.0,182.0,78.0,1.0,2.0,3.0,3.0,2.0,3.0,2.0,4.0,3.0,2.0,2.0,18.0,18.0,14.0,13.0,18.0,14.0,7.0,17.0,8.0,8.0,20.0,13.0,9.0,16.0,10.0,17.0,10.0,18.0,14.0,18.0,19.0,9.0,11.0,12.0,14.0,12.0,18.0,13.0,12.0,9.0,12.0,10.0,15.0,12.0,13.0,20.0,16.0,14.0,13.0,10.0,14.0,7.0,13.0,8.0,14.0,8.0,14.0,17.0,18.0,17.0,7.0,24.0,56.0,17.0,2.0,0.0,176.0,75.0,1.0,1.0,3.0,3.0,3.0,3.0,2.0,2.0,2.0,1.0,1.0,12.0,12.0,16.0,13.0,18.0,10.0,8.0,13.0,5.0,6.0,14.0,10.0,8.0,18.0,12.0,16.0,8.0,13.0,13.0,18.0,18.0,9.0,17.0,6.0,17.0,8.0,15.0,12.0,13.0,15.0,13.0,7.0,9.0,12.0,11.0,20.0,12.0,8.0,15.0,5.0,15.0,11.0,15.0,7.0,11.0,12.0,13.0,13.0,15.0,18.0,8.0,21.0,5.0,0.0,14.0,2.0,176.0,70.0,3.0,3.0,2.0,3.0,1.0,2.0,2.0,1.0,3.0,2.0,2.0,10.0,12.0,11.0,12.0,13.0,8.0,10.0,11.0,10.0,12.0,14.0,12.0,13.0,14.0,17.0,16.0,13.0,15.0,12.0,13.0,15.0,16.0,9.0,10.0,14.0,10.0,18.0,17.0,13.0,15.0,11.0,10.0,14.0,14.0,10.0,20.0,16.0,8.0,13.0,8.0,15.0,5.0,18.0,11.0,18.0,10.0,14.0,13.0,15.0,12.0,8.0,30.0,0.0,0.0,0.0,0.0,174.0,70.0,3.0,3.0,2.0,3.0,3.0,1.0,2.0,2.0,1.0,2.0,1.0,10.0,9.0,12.0,10.0,11.0,13.0,9.0,9.0,5.0,10.0,9.0,10.0,7.0,12.0,10.0,12.0,11.0,11.0,11.0,11.0,12.0,11.0,10.0,10.0,12.0,11.0,11.0,12.0,11.0,10.0,11.0,10.0,20.0,13.0,11.0,11.0,11.0,10.0,12.0,3.0,10.0,10.0,15.0,11.0,11.0,11.0,9.0,12.0,8.0,11.0,10.0
0,1,29.0,17.0,0.0,4.0,0.0,192.0,80.0,13.0,11.0,14.0,5.0,17.0,12.0,15.0,15.0,13.0,13.0,12.0,3.0,2.0,6.0,3.0,9.0,7.0,7.0,1.0,2.0,3.0,9.0,4.0,2.0,8.0,10.0,14.0,16.0,15.0,14.0,8.0,14.0,15.0,7.0,13.0,3.0,15.0,16.0,9.0,11.0,14.0,15.0,15.0,5.0,13.0,12.0,20.0,13.0,13.0,18.0,8.0,15.0,7.0,12.0,15.0,18.0,15.0,14.0,16.0,16.0,13.0,2.0,23.0,30.0,0.0,5.0,0.0,183.0,74.0,1.0,1.0,3.0,2.0,4.0,1.0,1.0,2.0,2.0,1.0,1.0,6.0,13.0,12.0,2.0,13.0,5.0,12.0,6.0,12.0,14.0,13.0,8.0,14.0,13.0,12.0,13.0,12.0,13.0,14.0,11.0,12.0,13.0,5.0,11.0,12.0,14.0,15.0,13.0,15.0,14.0,13.0,11.0,12.0,10.0,15.0,20.0,13.0,11.0,12.0,11.0,11.0,14.0,15.0,18.0,14.0,17.0,12.0,15.0,19.0,17.0,9.0,28.0,12.0,0.0,10.0,0.0,189.0,86.0,2.0,1.0,1.0,3.0,2.0,2.0,2.0,1.0,2.0,2.0,3.0,4.0,5.0,11.0,5.0,12.0,5.0,14.0,5.0,11.0,14.0,14.0,7.0,13.0,12.0,16.0,14.0,15.0,11.0,12.0,10.0,13.0,12.0,10.0,11.0,9.0,16.0,12.0,14.0,12.0,12.0,16.0,15.0,20.0,12.0,14.0,10.0,16.0,16.0,12.0,10.0,12.0,9.0,10.0,14.0,16.0,8.0,10.0,14.0,16.0,16.0,6.0,25.0,14.0,1.0,0.0,0.0,186.0,83.0,1.0,3.0,3.0,3.0,2.0,3.0,1.0,3.0,1.0,1.0,1.0,6.0,9.0,13.0,14.0,12.0,10.0,13.0,15.0,5.0,4.0,13.0,11.0,8.0,15.0,18.0,16.0,18.0,14.0,14.0,12.0,12.0,18.0,13.0,13.0,15.0,6.0,11.0,16.0,14.0,13.0,17.0,13.0,20.0,14.0,16.0,9.0,15.0,14.0,12.0,17.0,13.0,5.0,11.0,8.0,14.0,13.0,14.0,15.0,12.0,11.0,11.0,25.0,21.0,2.0,18.0,5.0,173.0,67.0,1.0,2.0,2.0,2.0,3.0,3.0,2.0,3.0,2.0,2.0,4.0,15.0,13.0,12.0,13.0,13.0,12.0,11.0,16.0,5.0,9.0,13.0,12.0,12.0,14.0,14.0,12.0,15.0,12.0,9.0,13.0,10.0,18.0,16.0,9.0,15.0,9.0,15.0,17.0,16.0,15.0,11.0,8.0,9.0,16.0,15.0,20.0,16.0,9.0,15.0,8.0,16.0,5.0,20.0,5.0,14.0,19.0,13.0,18.0,19.0,13.0,3.0,33.0,30.0,1.0,0.0,0.0,187.0,83.0,1.0,3.0,4.0,2.0,1.0,1.0,2.0,3.0,1.0,1.0,3.0,13.0,13.0,12.0,8.0,16.0,10.0,16.0,13.0,10.0,14.0,16.0,13.0,16.0,15.0,13.0,15.0,14.0,16.0,15.0,14.0,14.0,13.0,11.0,13.0,10.0,17.0,18.0,10.0,10.0,12.0,17.0,14.0,20.0,12.0,12.0,10.0,13.0,16.0,16.0,16.0,15.0,13.0,11.0,16.0,16.0,13.0,15.0,12.0,8.0,8.0,11.0,26.0,15.0,1.0,16.0,8.0,185.0,80.0,2.0,3.0,3.0,3.0,2.0,4.0,2.0,2.0,2.0,1.0,2.0,6.0,7.0,12.0,17.0,11.0,7.0,16.0,13.0,5.0,5.0,11.0,14.0,6.0,12.0,15.0,16.0,15.0,14.0,14.0,9.0,13.0,16.0,10.0,10.0,18.0,6.0,11.0,15.0,13.0,12.0,16.0,11.0,12.0,16.0,16.0,20.0,15.0,13.0,15.0,8.0,15.0,7.0,7.0,7.0,16.0,10.0,12.0,15.0,12.0,12.0,9.0,23.0,4.0,0.0,6.0,1.0,181.0,79.0,3.0,3.0,1.0,1.0,3.0,2.0,2.0,2.0,1.0,1.0,2.0,13.0,10.0,11.0,12.0,12.0,12.0,12.0,9.0,9.0,13.0,14.0,9.0,14.0,13.0,16.0,14.0,18.0,15.0,12.0,13.0,14.0,16.0,12.0,11.0,14.0,13.0,16.0,16.0,14.0,14.0,9.0,10.0,12.0,14.0,13.0,20.0,15.0,15.0,14.0,15.0,18.0,7.0,8.0,9.0,14.0,12.0,18.0,15.0,8.0,12.0,9.0,35.0,61.0,0.0,15.0,0.0,187.0,87.0,1.0,3.0,2.0,2.0,3.0,1.0,3.0,1.0,4.0,1.0,2.0,2.0,2.0,8.0,3.0,11.0,2.0,13.0,3.0,3.0,18.0,12.0,10.0,16.0,11.0,8.0,18.0,14.0,16.0,19.0,10.0,18.0,16.0,3.0,12.0,5.0,19.0,17.0,12.0,11.0,10.0,18.0,13.0,10.0,8.0,12.0,20.0,13.0,14.0,20.0,3.0,12.0,14.0,5.0,9.0,13.0,13.0,17.0,18.0,18.0,20.0,7.0,29.0,62.0,4.0,0.0,0.0,190.0,86.0,2.0,2.0,1.0,4.0,1.0,1.0,1.0,1.0,2.0,1.0,2.0,9.0,9.0,12.0,9.0,13.0,12.0,14.0,12.0,8.0,16.0,17.0,13.0,15.0,13.0,11.0,20.0,16.0,14.0,16.0,19.0,12.0,17.0,13.0,19.0,7.0,20.0,16.0,14.0,14.0,13.0,15.0,14.0,9.0,15.0,14.0,20.0,16.0,15.0,16.0,11.0,14.0,5.0,11.0,14.0,15.0,16.0,14.0,18.0,14.0,9.0,3.0,22.0,7.0,0.0,10.0,0.0,183.0,75.0,1.0,3.0,4.0,2.0,1.0,3.0,3.0,4.0,1.0,2.0,2.0,14.0,14.0,16.0,13.0,16.0,14.0,10.0,13.0,6.0,6.0,14.0,14.0,9.0,17.0,11.0,14.0,12.0,13.0,12.0,13.0,13.0,13.0,17.0,9.0,14.0,9.0,13.0,12.0,15.0,14.0,12.0,11.0,20.0,15.0,15.0,10.0,14.0,10.0,14.0,11.0,12.0,10.0,15.0,14.0,15.0,15.0,13.0,13.0,14.0,12.0,9.0,29.0,13.0,0.0,10.0,0.0,188.0,89.0,15.0,14.0,13.0,9.0,15.0,14.0,14.0,17.0,11.0,10.0,11.0,3.0,2.0,2.0,2.0,11.0,5.0,6.0,2.0,10.0,3.0,11.0,2.0,5.0,11.0,10.0,10.0,12.0,13.0,9.0,9.0,10.0,15.0,5.0,14.0,11.0,14.0,10.0,9.0,9.0,15.0,15.0,15.0,11.0,12.0,9.0,20.0,13.0,15.0,12.0,1.0,11.0,5.0,1.0,15.0,10.0,15.0,8.0,15.0,11.0,11.0,12.0,27.0,38.0,0.0,13.0,1.0,178.0,67.0,3.0,3.0,4.0,1.0,1.0,2.0,3.0,2.0,1.0,3.0,2.0,5.0,13.0,14.0,10.0,12.0,8.0,14.0,13.0,12.0,12.0,12.0,7.0,14.0,12.0,14.0,14.0,15.0,13.0,13.0,8.0,13.0,16.0,11.0,10.0,13.0,13.0,15.0,15.0,15.0,12.0,15.0,10.0,9.0,14.0,14.0,20.0,17.0,14.0,12.0,11.0,12.0,7.0,10.0,10.0,13.0,18.0,12.0,15.0,15.0,12.0,7.0,29.0,14.0,1.0,8.0,0.0,183.0,88.0,3.0,2.0,1.0,1.0,2.0,3.0,1.0,2.0,1.0,3.0,2.0,2.0,9.0,9.0,10.0,8.0,2.0,15.0,5.0,10.0,13.0,11.0,8.0,15.0,10.0,14.0,10.0,17.0,9.0,10.0,9.0,12.0,14.0,4.0,17.0,12.0,12.0,15.0,16.0,12.0,12.0,13.0,13.0,10.0,15.0,11.0,20.0,16.0,15.0,13.0,9.0,14.0,4.0,11.0,20.0,12.0,12.0,9.0,14.0,15.0,15.0,4.0,25.0,39.0,0.0,7.0,1.0,180.0,72.0,3.0,3.0,2.0,1.0,1.0,2.0,3.0,2.0,1.0,1.0,1.0,8.0,9.0,9.0,9.0,11.0,5.0,13.0,9.0,4.0,16.0,13.0,8.0,18.0,10.0,14.0,14.0,16.0,12.0,13.0,10.0,15.0,14.0,6.0,10.0,8.0,15.0,16.0,17.0,12.0,12.0,14.0,10.0,10.0,14.0,13.0,20.0,17.0,14.0,14.0,11.0,13.0,8.0,14.0,12.0,5.0,16.0,14.0,15.0,10.0,10.0,17.0,29.0,67.0,16.0,0.0,0.0,180.0,81.0,2.0,3.0,3.0,3.0,1.0,3.0,1.0,4.0,2.0,3.0,3.0,7.0,10.0,14.0,11.0,11.0,6.0,14.0,9.0,3.0,6.0,11.0,13.0,9.0,12.0,13.0,14.0,17.0,10.0,10.0,12.0,13.0,15.0,10.0,9.0,15.0,10.0,17.0,20.0,17.0,15.0,14.0,13.0,8.0,16.0,17.0,20.0,15.0,10.0,14.0,10.0,13.0,5.0,10.0,15.0,12.0,11.0,15.0,15.0,15.0,5.0,8.0,27.0,42.0,5.0,0.0,0.0,175.0,70.0,2.0,3.0,3.0,1.0,1.0,2.0,3.0,3.0,2.0,3.0,3.0,12.0,11.0,13.0,11.0,11.0,12.0,11.0,12.0,6.0,5.0,12.0,10.0,9.0,11.0,17.0,11.0,14.0,11.0,11.0,12.0,11.0,13.0,14.0,5.0,13.0,8.0,12.0,15.0,15.0,12.0,14.0,9.0,20.0,14.0,16.0,9.0,15.0,13.0,12.0,16.0,10.0,5.0,5.0,13.0,14.0,11.0,12.0,10.0,11.0,6.0,17.0,24.0,5.0,0.0,18.0,1.0,193.0,77.0,4.0,2.0,1.0,1.0,1.0,3.0,2.0,4.0,1.0,3.0,2.0,5.0,5.0,6.0,7.0,9.0,5.0,16.0,6.0,9.0,14.0,10.0,6.0,16.0,7.0,15.0,14.0,16.0,9.0,13.0,7.0,13.0,16.0,5.0,14.0,7.0,14.0,14.0,13.0,12.0,8.0,10.0,17.0,8.0,14.0,11.0,20.0,17.0,16.0,13.0,7.0,12.0,2.0,9.0,13.0,15.0,10.0,14.0,14.0,14.0,16.0,14.0,24.0,25.0,0.0,12.0,2.0,185.0,79.0,3.0,4.0,3.0,2.0,1.0,2.0,2.0,3.0,3.0,3.0,2.0,10.0,11.0,13.0,13.0,15.0,8.0,14.0,14.0,6.0,8.0,15.0,10.0,11.0,14.0,8.0,13.0,12.0,15.0,14.0,13.0,10.0,14.0,10.0,11.0,14.0,14.0,16.0,15.0,13.0,14.0,16.0,15.0,10.0,14.0,13.0,20.0,14.0,15.0,13.0,7.0,14.0,7.0,11.0,18.0,17.0,14.0,13.0,15.0,15.0,18.0,3.0,30.0,36.0,3.0,14.0,4.0,186.0,78.0,3.0,2.0,3.0,2.0,1.0,1.0,2.0,1.0,1.0,1.0,2.0,6.0,12.0,10.0,9.0,13.0,7.0,13.0,12.0,9.0,13.0,12.0,8.0,14.0,13.0,13.0,11.0,13.0,11.0,14.0,7.0,13.0,14.0,9.0,12.0,10.0,16.0,14.0,16.0,11.0,11.0,12.0,13.0,20.0,16.0,12.0,12.0,16.0,12.0,14.0,9.0,12.0,4.0,16.0,8.0,10.0,15.0,10.0,16.0,15.0,13.0,2.0,24.0,27.0,6.0,12.0,7.0,176.0,65.0,4.0,3.0,1.0,1.0,3.0,2.0,2.0,2.0,1.0,3.0,3.0,13.0,14.0,13.0,11.0,13.0,14.0,7.0,13.0,6.0,10.0,13.0,13.0,10.0,13.0,14.0,13.0,13.0,14.0,12.0,13.0,13.0,16.0,14.0,9.0,12.0,12.0,13.0,13.0,13.0,14.0,13.0,8.0,20.0,13.0,14.0,10.0,13.0,12.0,12.0,13.0,12.0,10.0,13.0,15.0,13.0,13.0,10.0,11.0,12.0,9.0,9.0,33.0,23.0,0.0,6.0,1.0,188.0,88.0,3.0,4.0,3.0,1.0,3.0,2.0,2.0,3.0,3.0,4.0,3.0,11.0,13.0,13.0,14.0,12.0,11.0,16.0,14.0,9.0,9.0,12.0,14.0,10.0,12.0,9.0,10.0,11.0,14.0,11.0,9.0,13.0,9.0,10.0,6.0,13.0,11.0,14.0,15.0,11.0,13.0,12.0,14.0,20.0,15.0,14.0,8.0,12.0,14.0,14.0,3.0,11.0,6.0,11.0,12.0,7.0,15.0,9.0,14.0,18.0,18.0,3.0
3,3,40.0,107.0,0.0,10.0,0.0,191.0,91.0,11.0,11.0,13.0,15.0,13.0,13.0,12.0,11.0,12.0,11.0,14.0,7.0,2.0,2.0,2.0,7.0,9.0,12.0,1.0,2.0,7.0,10.0,7.0,13.0,7.0,13.0,12.0,11.0,10.0,13.0,7.0,12.0,16.0,5.0,12.0,5.0,11.0,10.0,10.0,6.0,12.0,12.0,16.0,20.0,16.0,5.0,14.0,14.0,14.0,10.0,4.0,13.0,4.0,10.0,17.0,14.0,13.0,16.0,16.0,12.0,9.0,12.0,23.0,16.0,0.0,5.0,0.0,186.0,81.0,3.0,1.0,1.0,3.0,3.0,1.0,3.0,3.0,2.0,2.0,2.0,4.0,8.0,7.0,3.0,12.0,5.0,12.0,8.0,8.0,14.0,13.0,6.0,12.0,8.0,12.0,13.0,11.0,13.0,13.0,11.0,12.0,15.0,5.0,7.0,6.0,15.0,14.0,12.0,11.0,9.0,13.0,13.0,6.0,8.0,11.0,20.0,13.0,13.0,10.0,5.0,12.0,4.0,12.0,8.0,12.0,10.0,7.0,16.0,15.0,14.0,4.0,27.0,5.0,0.0,0.0,0.0,181.0,76.0,2.0,3.0,2.0,2.0,1.0,4.0,3.0,2.0,2.0,2.0,1.0,9.0,13.0,11.0,10.0,12.0,9.0,8.0,9.0,11.0,13.0,10.0,5.0,14.0,13.0,7.0,11.0,13.0,11.0,13.0,10.0,11.0,15.0,8.0,8.0,13.0,10.0,12.0,13.0,12.0,14.0,11.0,11.0,20.0,12.0,14.0,12.0,14.0,9.0,10.0,4.0,10.0,7.0,12.0,12.0,14.0,12.0,12.0,14.0,15.0,8.0,5.0,27.0,40.0,1.0,0.0,0.0,193.0,91.0,2.0,3.0,1.0,2.0,1.0,1.0,1.0,3.0,3.0,2.0,3.0,9.0,10.0,10.0,10.0,12.0,9.0,14.0,11.0,9.0,13.0,12.0,11.0,14.0,11.0,10.0,13.0,10.0,11.0,12.0,10.0,13.0,12.0,11.0,10.0,13.0,13.0,13.0,12.0,13.0,14.0,12.0,16.0,20.0,12.0,14.0,12.0,13.0,14.0,12.0,8.0,11.0,8.0,13.0,13.0,8.0,12.0,10.0,8.0,3.0,19.0,3.0,29.0,82.0,20.0,0.0,0.0,179.0,72.0,3.0,3.0,3.0,1.0,2.0,2.0,1.0,2.0,1.0,4.0,1.0,16.0,16.0,12.0,13.0,14.0,16.0,3.0,16.0,8.0,4.0,14.0,12.0,7.0,14.0,8.0,13.0,4.0,13.0,12.0,14.0,13.0,10.0,12.0,8.0,12.0,10.0,10.0,10.0,14.0,14.0,12.0,10.0,20.0,11.0,13.0,15.0,13.0,9.0,12.0,8.0,15.0,6.0,11.0,7.0,10.0,13.0,15.0,13.0,9.0,12.0,12.0,28.0,36.0,9.0,6.0,5.0,193.0,87.0,1.0,3.0,4.0,3.0,3.0,3.0,3.0,1.0,3.0,2.0,3.0,6.0,9.0,10.0,13.0,13.0,9.0,14.0,11.0,5.0,6.0,11.0,10.0,7.0,12.0,14.0,13.0,15.0,11.0,12.0,10.0,13.0,13.0,11.0,8.0,14.0,9.0,16.0,14.0,11.0,11.0,15.0,16.0,15.0,14.0,12.0,20.0,14.0,16.0,13.0,8.0,13.0,13.0,10.0,16.0,16.0,10.0,12.0,15.0,9.0,10.0,8.0,37.0,88.0,24.0,0.0,0.0,186.0,78.0,1.0,2.0,3.0,2.0,1.0,1.0,1.0,3.0,3.0,3.0,3.0,7.0,13.0,11.0,10.0,14.0,6.0,13.0,11.0,2.0,8.0,12.0,10.0,11.0,15.0,9.0,12.0,11.0,14.0,11.0,14.0,12.0,15.0,14.0,14.0,13.0,12.0,14.0,13.0,7.0,11.0,11.0,11.0,16.0,11.0,10.0,20.0,10.0,8.0,10.0,5.0,13.0,15.0,15.0,15.0,12.0,14.0,14.0,17.0,15.0,15.0,2.0,27.0,14.0,1.0,0.0,0.0,177.0,77.0,3.0,3.0,2.0,1.0,3.0,2.0,3.0,1.0,2.0,4.0,2.0,13.0,12.0,11.0,12.0,12.0,10.0,8.0,12.0,5.0,6.0,13.0,8.0,6.0,12.0,6.0,11.0,12.0,9.0,8.0,9.0,11.0,10.0,12.0,5.0,13.0,9.0,13.0,13.0,15.0,11.0,13.0,9.0,14.0,13.0,14.0,20.0,12.0,10.0,8.0,7.0,11.0,9.0,11.0,14.0,12.0,13.0,10.0,10.0,10.0,11.0,7.0,28.0,24.0,0.0,7.0,0.0,190.0,76.0,3.0,3.0,1.0,3.0,1.0,4.0,4.0,3.0,3.0,3.0,1.0,7.0,9.0,8.0,7.0,10.0,9.0,10.0,11.0,10.0,13.0,12.0,8.0,14.0,11.0,14.0,13.0,16.0,10.0,12.0,8.0,11.0,13.0,6.0,12.0,8.0,13.0,16.0,14.0,9.0,10.0,15.0,15.0,12.0,12.0,11.0,20.0,14.0,14.0,15.0,13.0,14.0,11.0,9.0,15.0,15.0,11.0,11.0,14.0,10.0,16.0,4.0,29.0,18.0,1.0,0.0,0.0,190.0,88.0,1.0,2.0,2.0,1.0,1.0,4.0,1.0,3.0,3.0,1.0,3.0,5.0,4.0,5.0,5.0,10.0,5.0,12.0,8.0,5.0,13.0,9.0,7.0,13.0,9.0,11.0,14.0,14.0,11.0,8.0,9.0,12.0,12.0,8.0,10.0,8.0,13.0,12.0,12.0,11.0,11.0,13.0,13.0,10.0,13.0,11.0,20.0,13.0,15.0,11.0,11.0,11.0,6.0,10.0,14.0,12.0,12.0,10.0,12.0,12.0,10.0,10.0,33.0,94.0,6.0,0.0,0.0,194.0,96.0,3.0,2.0,1.0,3.0,3.0,3.0,1.0,3.0,1.0,4.0,1.0,9.0,7.0,7.0,12.0,9.0,9.0,16.0,8.0,11.0,15.0,10.0,4.0,14.0,10.0,6.0,13.0,6.0,11.0,13.0,9.0,12.0,17.0,9.0,11.0,13.0,13.0,15.0,15.0,8.0,9.0,18.0,17.0,5.0,12.0,8.0,20.0,15.0,17.0,16.0,6.0,13.0,8.0,10.0,9.0,14.0,16.0,12.0,16.0,13.0,8.0,8.0,28.0,42.0,0.0,12.0,0.0,190.0,84.0,16.0,14.0,16.0,5.0,16.0,14.0,17.0,18.0,15.0,12.0,14.0,6.0,3.0,5.0,2.0,7.0,8.0,8.0,3.0,12.0,3.0,8.0,1.0,1.0,11.0,12.0,12.0,13.0,14.0,14.0,10.0,13.0,15.0,11.0,16.0,11.0,16.0,13.0,14.0,11.0,14.0,16.0,16.0,20.0,13.0,10.0,5.0,12.0,15.0,14.0,7.0,15.0,8.0,13.0,19.0,8.0,20.0,15.0,17.0,18.0,17.0,4.0,18.0,0.0,0.0,0.0,0.0,173.0,0.0,3.0,1.0,2.0,3.0,1.0,3.0,3.0,2.0,1.0,1.0,1.0,5.0,5.0,12.0,10.0,14.0,7.0,7.0,10.0,2.0,6.0,12.0,5.0,8.0,14.0,11.0,6.0,8.0,10.0,7.0,13.0,11.0,7.0,13.0,6.0,7.0,5.0,8.0,11.0,13.0,14.0,7.0,8.0,5.0,13.0,14.0,20.0,9.0,5.0,9.0,6.0,9.0,5.0,9.0,13.0,11.0,8.0,12.0,13.0,1.0,5.0,3.0,38.0,89.0,6.0,14.0,1.0,183.0,79.0,3.0,3.0,2.0,3.0,2.0,3.0,2.0,4.0,3.0,2.0,3.0,4.0,8.0,8.0,7.0,12.0,6.0,14.0,8.0,11.0,17.0,12.0,11.0,16.0,12.0,15.0,16.0,17.0,15.0,17.0,10.0,16.0,18.0,6.0,15.0,8.0,16.0,17.0,13.0,8.0,8.0,12.0,11.0,10.0,13.0,8.0,20.0,10.0,11.0,16.0,12.0,16.0,11.0,7.0,15.0,16.0,16.0,15.0,18.0,16.0,14.0,4.0,31.0,133.0,61.0,10.0,3.0,186.0,84.0,2.0,1.0,3.0,1.0,3.0,2.0,2.0,3.0,1.0,3.0,2.0,12.0,14.0,15.0,19.0,16.0,14.0,18.0,19.0,6.0,2.0,14.0,19.0,8.0,15.0,6.0,17.0,16.0,13.0,16.0,13.0,17.0,20.0,18.0,15.0,18.0,5.0,6.0,7.0,13.0,12.0,13.0,16.0,15.0,19.0,17.0,20.0,17.0,16.0,17.0,12.0,14.0,7.0,10.0,18.0,20.0,13.0,19.0,20.0,7.0,7.0,12.0,29.0,90.0,4.0,16.0,2.0,170.0,61.0,2.0,3.0,3.0,1.0,3.0,1.0,2.0,2.0,2.0,2.0,1.0,15.0,14.0,15.0,9.0,17.0,16.0,7.0,12.0,4.0,11.0,18.0,15.0,12.0,17.0,15.0,15.0,16.0,13.0,16.0,17.0,14.0,16.0,15.0,14.0,12.0,14.0,18.0,16.0,13.0,14.0,12.0,8.0,10.0,14.0,11.0,20.0,14.0,10.0,14.0,9.0,17.0,10.0,14.0,13.0,17.0,15.0,16.0,17.0,15.0,16.0,7.0,23.0,22.0,0.0,13.0,3.0,179.0,73.0,3.0,3.0,2.0,3.0,1.0,3.0,1.0,2.0,2.0,2.0,2.0,14.0,14.0,15.0,12.0,15.0,12.0,7.0,12.0,6.0,9.0,18.0,15.0,10.0,17.0,12.0,13.0,12.0,17.0,16.0,16.0,16.0,14.0,13.0,13.0,14.0,13.0,15.0,13.0,13.0,15.0,14.0,9.0,14.0,14.0,13.0,20.0,14.0,11.0,16.0,6.0,16.0,6.0,12.0,15.0,11.0,10.0,13.0,18.0,18.0,14.0,6.0,21.0,0.0,0.0,0.0,0.0,178.0,79.0,1.0,4.0,3.0,3.0,3.0,3.0,3.0,1.0,1.0,2.0,1.0,6.0,6.0,8.0,5.0,9.0,5.0,6.0,6.0,3.0,7.0,11.0,4.0,5.0,11.0,8.0,10.0,4.0,9.0,5.0,14.0,9.0,3.0,10.0,1.0,8.0,8.0,8.0,10.0,14.0,8.0,7.0,7.0,9.0,14.0,11.0,20.0,7.0,5.0,8.0,8.0,6.0,8.0,8.0,12.0,12.0,11.0,10.0,12.0,10.0,20.0,7.0,24.0,15.0,0.0,15.0,2.0,187.0,83.0,2.0,3.0,2.0,2.0,3.0,3.0,3.0,2.0,1.0,3.0,4.0,8.0,9.0,12.0,9.0,15.0,10.0,7.0,10.0,11.0,13.0,15.0,12.0,16.0,14.0,13.0,15.0,14.0,16.0,18.0,14.0,15.0,12.0,5.0,15.0,10.0,16.0,17.0,13.0,9.0,10.0,19.0,14.0,13.0,16.0,11.0,20.0,16.0,18.0,17.0,8.0,14.0,6.0,6.0,14.0,10.0,18.0,15.0,19.0,16.0,15.0,5.0,22.0,13.0,0.0,6.0,1.0,188.0,84.0,2.0,2.0,2.0,3.0,3.0,2.0,3.0,1.0,2.0,1.0,2.0,11.0,12.0,16.0,11.0,15.0,12.0,11.0,15.0,9.0,8.0,16.0,14.0,12.0,17.0,12.0,11.0,11.0,12.0,10.0,14.0,11.0,12.0,16.0,9.0,14.0,11.0,12.0,13.0,14.0,14.0,13.0,12.0,16.0,13.0,14.0,20.0,14.0,14.0,8.0,12.0,14.0,10.0,13.0,14.0,13.0,14.0,13.0,15.0,14.0,12.0,5.0,26.0,0.0,0.0,0.0,0.0,173.0,63.0,3.0,2.0,1.0,2.0,2.0,1.0,1.0,2.0,3.0,2.0,3.0,6.0,4.0,3.0,6.0,14.0,4.0,6.0,6.0,1.0,7.0,9.0,1.0,7.0,12.0,8.0,8.0,4.0,9.0,7.0,10.0,14.0,8.0,8.0,8.0,9.0,5.0,8.0,12.0,14.0,14.0,7.0,6.0,5.0,8.0,14.0,20.0,11.0,8.0,8.0,8.0,8.0,5.0,8.0,12.0,8.0,10.0,10.0,14.0,13.0,18.0,2.0,32.0,13.0,1.0,2.0,0.0,176.0,74.0,1.0,1.0,2.0,1.0,3.0,2.0,1.0,3.0,3.0,2.0,2.0,11.0,12.0,14.0,11.0,13.0,13.0,10.0,15.0,13.0,12.0,14.0,11.0,13.0,14.0,15.0,12.0,15.0,14.0,13.0,13.0,15.0,14.0,14.0,12.0,14.0,10.0,13.0,14.0,12.0,12.0,16.0,10.0,20.0,11.0,13.0,12.0,11.0,15.0,13.0,14.0,16.0,8.0,15.0,14.0,12.0,13.0,10.0,7.0,8.0,18.0,12.0
0,1,31.0,25.0,0.0,6.0,0.0,191.0,84.0,11.0,14.0,13.0,12.0,15.0,14.0,15.0,16.0,13.0,14.0,14.0,8.0,2.0,10.0,5.0,11.0,11.0,7.0,10.0,2.0,5.0,10.0,11.0,11.0,9.0,12.0,13.0,15.0,13.0,13.0,8.0,13.0,16.0,12.0,14.0,1.0,16.0,13.0,11.0,12.0,13.0,16.0,16.0,8.0,16.0,13.0,20.0,15.0,15.0,17.0,8.0,15.0,7.0,2.0,15.0,15.0,17.0,15.0,17.0,16.0,15.0,6.0,28.0,38.0,0.0,2.0,0.0,186.0,78.0,3.0,3.0,1.0,3.0,2.0,1.0,1.0,2.0,4.0,1.0,2.0,8.0,13.0,12.0,5.0,13.0,6.0,11.0,15.0,14.0,13.0,12.0,8.0,14.0,13.0,15.0,12.0,14.0,13.0,13.0,13.0,13.0,17.0,12.0,10.0,13.0,13.0,15.0,17.0,14.0,14.0,14.0,13.0,20.0,10.0,14.0,8.0,14.0,14.0,14.0,13.0,14.0,7.0,11.0,12.0,14.0,14.0,11.0,16.0,7.0,12.0,4.0,27.0,51.0,15.0,8.0,3.0,186.0,79.0,1.0,2.0,2.0,2.0,3.0,2.0,2.0,2.0,3.0,2.0,3.0,12.0,13.0,15.0,14.0,15.0,14.0,13.0,12.0,5.0,7.0,13.0,12.0,7.0,14.0,8.0,14.0,11.0,14.0,11.0,11.0,13.0,13.0,13.0,6.0,16.0,8.0,12.0,12.0,16.0,13.0,13.0,13.0,15.0,13.0,15.0,20.0,14.0,12.0,14.0,7.0,15.0,6.0,17.0,13.0,16.0,9.0,15.0,10.0,12.0,10.0,16.0,30.0,92.0,4.0,9.0,0.0,192.0,84.0,2.0,2.0,2.0,1.0,2.0,3.0,3.0,1.0,2.0,3.0,2.0,7.0,9.0,10.0,9.0,12.0,10.0,13.0,7.0,12.0,14.0,13.0,6.0,15.0,12.0,15.0,16.0,13.0,14.0,13.0,10.0,15.0,17.0,7.0,14.0,10.0,14.0,12.0,10.0,10.0,11.0,13.0,15.0,14.0,14.0,11.0,20.0,14.0,14.0,15.0,4.0,14.0,12.0,11.0,13.0,14.0,15.0,13.0,13.0,17.0,15.0,8.0,28.0,80.0,12.0,4.0,2.0,184.0,78.0,2.0,3.0,3.0,3.0,3.0,3.0,3.0,4.0,3.0,3.0,3.0,18.0,15.0,14.0,13.0,17.0,16.0,8.0,18.0,10.0,9.0,18.0,16.0,10.0,17.0,11.0,14.0,11.0,14.0,14.0,17.0,15.0,12.0,12.0,14.0,14.0,12.0,14.0,13.0,12.0,11.0,11.0,12.0,14.0,12.0,14.0,20.0,15.0,14.0,14.0,12.0,13.0,6.0,12.0,14.0,14.0,13.0,11.0,13.0,14.0,18.0,12.0,30.0,93.0,11.0,15.0,2.0,173.0,65.0,3.0,2.0,2.0,3.0,3.0,3.0,4.0,1.0,1.0,1.0,1.0,16.0,16.0,17.0,9.0,19.0,13.0,8.0,12.0,7.0,8.0,19.0,14.0,11.0,18.0,12.0,17.0,13.0,15.0,16.0,18.0,18.0,16.0,13.0,13.0,12.0,12.0,16.0,17.0,14.0,17.0,13.0,7.0,13.0,13.0,13.0,20.0,17.0,8.0,15.0,12.0,14.0,11.0,16.0,10.0,15.0,13.0,17.0,16.0,16.0,17.0,5.0,34.0,124.0,21.0,10.0,4.0,182.0,78.0,2.0,3.0,3.0,1.0,1.0,2.0,1.0,2.0,3.0,2.0,3.0,15.0,18.0,11.0,8.0,14.0,17.0,10.0,13.0,10.0,13.0,13.0,16.0,15.0,12.0,19.0,15.0,19.0,16.0,13.0,15.0,15.0,18.0,14.0,19.0,13.0,14.0,17.0,16.0,10.0,10.0,13.0,9.0,10.0,14.0,10.0,20.0,11.0,14.0,15.0,18.0,14.0,5.0,17.0,20.0,13.0,20.0,12.0,20.0,4.0,7.0,5.0,23.0,20.0,4.0,13.0,7.0,181.0,68.0,2.0,4.0,2.0,3.0,3.0,1.0,1.0,3.0,1.0,4.0,3.0,6.0,14.0,14.0,11.0,15.0,10.0,9.0,13.0,3.0,11.0,15.0,9.0,13.0,15.0,12.0,14.0,13.0,14.0,13.0,14.0,13.0,14.0,12.0,7.0,14.0,13.0,14.0,17.0,13.0,13.0,14.0,10.0,15.0,18.0,14.0,20.0,16.0,13.0,14.0,11.0,11.0,5.0,13.0,15.0,15.0,12.0,17.0,14.0,12.0,9.0,11.0,30.0,69.0,24.0,9.0,1.0,190.0,85.0,3.0,2.0,3.0,2.0,2.0,2.0,1.0,3.0,2.0,3.0,2.0,6.0,10.0,10.0,16.0,13.0,6.0,19.0,8.0,7.0,6.0,13.0,15.0,9.0,14.0,18.0,16.0,18.0,14.0,15.0,11.0,15.0,18.0,13.0,11.0,14.0,9.0,18.0,19.0,11.0,12.0,17.0,17.0,15.0,18.0,14.0,20.0,18.0,17.0,15.0,17.0,16.0,4.0,10.0,15.0,15.0,6.0,18.0,15.0,7.0,9.0,14.0,27.0,24.0,1.0,14.0,0.0,186.0,76.0,1.0,1.0,1.0,3.0,1.0,1.0,1.0,1.0,3.0,2.0,3.0,8.0,13.0,13.0,9.0,15.0,10.0,13.0,11.0,7.0,13.0,16.0,11.0,15.0,15.0,11.0,15.0,12.0,15.0,10.0,14.0,13.0,12.0,14.0,13.0,9.0,13.0,16.0,13.0,12.0,13.0,14.0,12.0,12.0,13.0,13.0,20.0,15.0,13.0,13.0,12.0,8.0,7.0,12.0,12.0,12.0,8.0,12.0,15.0,16.0,19.0,2.0,27.0,41.0,1.0,19.0,2.0,184.0,73.0,3.0,1.0,1.0,1.0,1.0,1.0,3.0,3.0,3.0,3.0,3.0,2.0,10.0,12.0,11.0,11.0,3.0,16.0,10.0,14.0,14.0,13.0,7.0,18.0,12.0,14.0,11.0,18.0,12.0,9.0,10.0,10.0,18.0,4.0,14.0,15.0,12.0,16.0,18.0,14.0,12.0,14.0,16.0,9.0,15.0,17.0,20.0,17.0,13.0,12.0,12.0,14.0,6.0,16.0,7.0,18.0,15.0,11.0,12.0,10.0,8.0,10.0,28.0,42.0,0.0,12.0,0.0,190.0,84.0,16.0,14.0,16.0,5.0,16.0,14.0,17.0,18.0,15.0,12.0,14.0,6.0,3.0,5.0,2.0,7.0,8.0,8.0,3.0,12.0,3.0,8.0,1.0,1.0,11.0,12.0,12.0,13.0,14.0,14.0,10.0,13.0,15.0,11.0,16.0,11.0,16.0,13.0,14.0,11.0,14.0,16.0,16.0,20.0,13.0,10.0,5.0,12.0,15.0,14.0,7.0,15.0,8.0,13.0,19.0,8.0,20.0,15.0,17.0,18.0,17.0,4.0,18.0,0.0,0.0,0.0,0.0,173.0,0.0,3.0,1.0,2.0,3.0,1.0,3.0,3.0,2.0,1.0,1.0,1.0,5.0,5.0,12.0,10.0,14.0,7.0,7.0,10.0,2.0,6.0,12.0,5.0,8.0,14.0,11.0,6.0,8.0,10.0,7.0,13.0,11.0,7.0,13.0,6.0,7.0,5.0,8.0,11.0,13.0,14.0,7.0,8.0,5.0,13.0,14.0,20.0,9.0,5.0,9.0,6.0,9.0,5.0,9.0,13.0,11.0,8.0,12.0,13.0,1.0,5.0,3.0,32.0,16.0,0.0,1.0,0.0,187.0,81.0,3.0,3.0,3.0,2.0,2.0,2.0,2.0,3.0,2.0,1.0,1.0,6.0,9.0,10.0,7.0,11.0,9.0,16.0,8.0,10.0,14.0,13.0,8.0,15.0,13.0,14.0,14.0,14.0,13.0,14.0,11.0,13.0,14.0,10.0,20.0,10.0,16.0,17.0,17.0,9.0,11.0,13.0,16.0,10.0,15.0,9.0,20.0,13.0,15.0,15.0,10.0,14.0,4.0,10.0,12.0,16.0,10.0,14.0,14.0,13.0,12.0,5.0,22.0,12.0,2.0,13.0,0.0,170.0,71.0,2.0,2.0,1.0,3.0,2.0,2.0,1.0,1.0,1.0,3.0,2.0,15.0,15.0,12.0,10.0,14.0,15.0,8.0,13.0,12.0,9.0,13.0,10.0,10.0,14.0,14.0,16.0,10.0,17.0,14.0,12.0,16.0,14.0,12.0,8.0,14.0,10.0,17.0,16.0,16.0,17.0,10.0,6.0,20.0,17.0,13.0,8.0,15.0,7.0,15.0,6.0,15.0,8.0,17.0,13.0,13.0,12.0,12.0,14.0,16.0,16.0,8.0,31.0,133.0,61.0,10.0,3.0,186.0,84.0,2.0,1.0,3.0,1.0,3.0,2.0,2.0,3.0,1.0,3.0,2.0,12.0,14.0,15.0,19.0,16.0,14.0,18.0,19.0,6.0,2.0,14.0,19.0,8.0,15.0,6.0,17.0,16.0,13.0,16.0,13.0,17.0,20.0,18.0,15.0,18.0,5.0,6.0,7.0,13.0,12.0,13.0,16.0,15.0,19.0,17.0,20.0,17.0,16.0,17.0,12.0,14.0,7.0,10.0,18.0,20.0,13.0,19.0,20.0,7.0,7.0,12.0,23.0,22.0,0.0,13.0,3.0,179.0,73.0,3.0,3.0,2.0,3.0,1.0,3.0,1.0,2.0,2.0,2.0,2.0,14.0,14.0,15.0,12.0,15.0,12.0,7.0,12.0,6.0,9.0,18.0,15.0,10.0,17.0,12.0,13.0,12.0,17.0,16.0,16.0,16.0,14.0,13.0,13.0,14.0,13.0,15.0,13.0,13.0,15.0,14.0,9.0,14.0,14.0,13.0,20.0,14.0,11.0,16.0,6.0,16.0,6.0,12.0,15.0,11.0,10.0,13.0,18.0,18.0,14.0,6.0,24.0,15.0,0.0,15.0,2.0,187.0,83.0,2.0,3.0,2.0,2.0,3.0,3.0,3.0,2.0,1.0,3.0,4.0,8.0,9.0,12.0,9.0,15.0,10.0,7.0,10.0,11.0,13.0,15.0,12.0,16.0,14.0,13.0,15.0,14.0,16.0,18.0,14.0,15.0,12.0,5.0,15.0,10.0,16.0,17.0,13.0,9.0,10.0,19.0,14.0,13.0,16.0,11.0,20.0,16.0,18.0,17.0,8.0,14.0,6.0,6.0,14.0,10.0,18.0,15.0,19.0,16.0,15.0,5.0,22.0,13.0,0.0,6.0,1.0,188.0,84.0,2.0,2.0,2.0,3.0,3.0,2.0,3.0,1.0,2.0,1.0,2.0,11.0,12.0,16.0,11.0,15.0,12.0,11.0,15.0,9.0,8.0,16.0,14.0,12.0,17.0,12.0,11.0,11.0,12.0,10.0,14.0,11.0,12.0,16.0,9.0,14.0,11.0,12.0,13.0,14.0,14.0,13.0,12.0,16.0,13.0,14.0,20.0,14.0,14.0,8.0,12.0,14.0,10.0,13.0,14.0,13.0,14.0,13.0,15.0,14.0,12.0,5.0,26.0,0.0,0.0,0.0,0.0,173.0,63.0,3.0,2.0,1.0,2.0,2.0,1.0,1.0,2.0,3.0,2.0,3.0,6.0,4.0,3.0,6.0,14.0,4.0,6.0,6.0,1.0,7.0,9.0,1.0,7.0,12.0,8.0,8.0,4.0,9.0,7.0,10.0,14.0,8.0,8.0,8.0,9.0,5.0,8.0,12.0,14.0,14.0,7.0,6.0,5.0,8.0,14.0,20.0,11.0,8.0,8.0,8.0,8.0,5.0,8.0,12.0,8.0,10.0,10.0,14.0,13.0,18.0,2.0,18.0,0.0,0.0,0.0,0.0,170.0,0.0,1.0,2.0,3.0,1.0,4.0,2.0,1.0,1.0,2.0,2.0,3.0,6.0,12.0,12.0,3.0,12.0,3.0,7.0,5.0,6.0,7.0,8.0,1.0,13.0,8.0,8.0,6.0,8.0,3.0,12.0,7.0,11.0,1.0,6.0,8.0,5.0,5.0,7.0,7.0,13.0,13.0,6.0,2.0,8.0,12.0,13.0,20.0,11.0,5.0,8.0,7.0,3.0,8.0,8.0,17.0,10.0,10.0,10.0,11.0,8.0,8.0,2.0,27.0,14.0,0.0,13.0,1.0,175.0,73.0,2.0,1.0,1.0,2.0,3.0,2.0,2.0,3.0,2.0,3.0,3.0,15.0,12.0,12.0,12.0,15.0,12.0,9.0,15.0,8.0,15.0,15.0,18.0,16.0,14.0,17.0,15.0,16.0,15.0,17.0,14.0,15.0,18.0,11.0,17.0,13.0,16.0,18.0,18.0,11.0,12.0,14.0,10.0,11.0,15.0,11.0,20.0,17.0,12.0,18.0,13.0,14.0,7.0,14.0,12.0,12.0,19.0,15.0,18.0,13.0,11.0,5.0
1,0,29.0,62.0,0.0,6.0,0.0,196.0,90.0,18.0,11.0,12.0,4.0,12.0,18.0,16.0,14.0,14.0,14.0,18.0,7.0,3.0,2.0,3.0,7.0,10.0,2.0,3.0,3.0,1.0,5.0,3.0,2.0,6.0,12.0,13.0,12.0,9.0,12.0,6.0,11.0,13.0,1.0,8.0,6.0,12.0,11.0,10.0,10.0,14.0,12.0,19.0,13.0,13.0,11.0,20.0,11.0,15.0,10.0,8.0,12.0,7.0,12.0,13.0,13.0,13.0,11.0,13.0,13.0,13.0,6.0,26.0,73.0,0.0,8.0,0.0,181.0,71.0,1.0,1.0,2.0,2.0,2.0,2.0,3.0,1.0,3.0,4.0,3.0,9.0,10.0,9.0,6.0,12.0,8.0,11.0,7.0,10.0,11.0,11.0,10.0,12.0,10.0,10.0,12.0,13.0,12.0,11.0,9.0,10.0,13.0,5.0,14.0,13.0,11.0,15.0,19.0,13.0,12.0,13.0,9.0,20.0,20.0,13.0,15.0,20.0,12.0,15.0,5.0,15.0,5.0,13.0,14.0,12.0,15.0,12.0,16.0,9.0,10.0,3.0,27.0,34.0,1.0,13.0,0.0,175.0,64.0,3.0,1.0,1.0,2.0,2.0,3.0,4.0,1.0,4.0,3.0,3.0,7.0,9.0,8.0,3.0,13.0,6.0,12.0,4.0,2.0,13.0,10.0,3.0,14.0,8.0,15.0,13.0,12.0,10.0,13.0,9.0,12.0,14.0,8.0,9.0,11.0,13.0,14.0,16.0,15.0,14.0,12.0,9.0,20.0,14.0,16.0,5.0,17.0,12.0,15.0,11.0,12.0,4.0,10.0,11.0,16.0,10.0,13.0,10.0,8.0,10.0,15.0,23.0,25.0,0.0,0.0,0.0,181.0,77.0,1.0,2.0,3.0,1.0,2.0,2.0,3.0,1.0,3.0,2.0,3.0,13.0,15.0,12.0,6.0,14.0,14.0,14.0,6.0,11.0,14.0,14.0,10.0,14.0,13.0,13.0,15.0,18.0,15.0,13.0,14.0,14.0,17.0,9.0,6.0,13.0,15.0,14.0,15.0,13.0,13.0,15.0,10.0,20.0,13.0,11.0,8.0,14.0,14.0,15.0,6.0,9.0,5.0,11.0,10.0,13.0,14.0,9.0,15.0,13.0,12.0,4.0,27.0,17.0,0.0,0.0,0.0,181.0,81.0,1.0,3.0,1.0,2.0,2.0,2.0,2.0,2.0,2.0,1.0,3.0,4.0,5.0,10.0,6.0,12.0,4.0,14.0,4.0,8.0,13.0,11.0,10.0,15.0,11.0,13.0,15.0,14.0,15.0,12.0,9.0,12.0,14.0,2.0,14.0,9.0,14.0,15.0,13.0,13.0,12.0,12.0,12.0,11.0,19.0,13.0,20.0,16.0,12.0,15.0,8.0,14.0,8.0,15.0,10.0,11.0,12.0,13.0,14.0,14.0,15.0,3.0,31.0,65.0,2.0,0.0,0.0,182.0,91.0,2.0,2.0,1.0,2.0,1.0,2.0,2.0,3.0,3.0,1.0,2.0,3.0,4.0,7.0,4.0,10.0,3.0,15.0,4.0,6.0,13.0,12.0,4.0,15.0,10.0,16.0,16.0,18.0,11.0,14.0,9.0,12.0,15.0,8.0,18.0,7.0,17.0,13.0,10.0,10.0,11.0,9.0,12.0,14.0,13.0,11.0,20.0,16.0,17.0,15.0,14.0,16.0,1.0,6.0,10.0,16.0,16.0,14.0,14.0,8.0,8.0,16.0,26.0,31.0,0.0,7.0,2.0,168.0,62.0,2.0,3.0,1.0,2.0,3.0,1.0,2.0,1.0,3.0,1.0,1.0,8.0,9.0,13.0,9.0,15.0,7.0,7.0,8.0,3.0,14.0,15.0,6.0,13.0,15.0,13.0,15.0,15.0,15.0,15.0,13.0,14.0,13.0,12.0,8.0,14.0,13.0,17.0,18.0,13.0,15.0,14.0,6.0,11.0,15.0,12.0,20.0,15.0,10.0,14.0,6.0,15.0,8.0,11.0,10.0,14.0,14.0,13.0,15.0,15.0,12.0,2.0,25.0,44.0,11.0,12.0,2.0,178.0,67.0,3.0,2.0,2.0,4.0,1.0,1.0,3.0,2.0,2.0,1.0,2.0,9.0,13.0,15.0,12.0,15.0,8.0,5.0,12.0,3.0,9.0,15.0,12.0,12.0,17.0,10.0,14.0,13.0,16.0,14.0,17.0,14.0,15.0,14.0,12.0,17.0,11.0,16.0,16.0,13.0,16.0,14.0,8.0,12.0,16.0,12.0,20.0,16.0,12.0,14.0,6.0,15.0,12.0,16.0,14.0,14.0,16.0,14.0,17.0,16.0,14.0,6.0,26.0,61.0,22.0,13.0,3.0,186.0,82.0,2.0,2.0,2.0,1.0,3.0,2.0,1.0,1.0,2.0,1.0,3.0,14.0,16.0,16.0,17.0,15.0,17.0,19.0,19.0,15.0,6.0,14.0,13.0,9.0,16.0,10.0,14.0,11.0,13.0,11.0,13.0,13.0,16.0,17.0,9.0,18.0,7.0,10.0,10.0,15.0,14.0,14.0,15.0,20.0,13.0,19.0,11.0,18.0,17.0,13.0,10.0,13.0,15.0,16.0,8.0,14.0,11.0,14.0,14.0,17.0,14.0,12.0,29.0,67.0,4.0,5.0,0.0,183.0,73.0,3.0,3.0,3.0,2.0,3.0,1.0,2.0,1.0,1.0,2.0,2.0,9.0,11.0,10.0,14.0,12.0,6.0,14.0,12.0,12.0,16.0,14.0,14.0,15.0,13.0,12.0,12.0,15.0,15.0,14.0,13.0,15.0,16.0,8.0,14.0,13.0,13.0,16.0,16.0,13.0,13.0,14.0,15.0,20.0,14.0,11.0,4.0,15.0,14.0,14.0,2.0,16.0,9.0,12.0,10.0,14.0,19.0,12.0,14.0,18.0,10.0,8.0,26.0,44.0,7.0,14.0,4.0,188.0,76.0,1.0,2.0,3.0,2.0,2.0,3.0,1.0,1.0,2.0,2.0,2.0,4.0,8.0,10.0,13.0,13.0,2.0,16.0,12.0,4.0,10.0,13.0,14.0,8.0,13.0,14.0,13.0,15.0,13.0,11.0,13.0,14.0,13.0,12.0,8.0,13.0,9.0,16.0,15.0,11.0,12.0,12.0,16.0,10.0,13.0,12.0,20.0,13.0,16.0,13.0,4.0,12.0,5.0,9.0,16.0,11.0,12.0,12.0,15.0,16.0,15.0,12.0,31.0,15.0,0.0,10.0,0.0,188.0,86.0,14.0,12.0,11.0,2.0,13.0,12.0,12.0,14.0,8.0,11.0,10.0,8.0,2.0,2.0,1.0,9.0,10.0,6.0,1.0,1.0,2.0,7.0,4.0,3.0,5.0,7.0,12.0,14.0,13.0,13.0,10.0,11.0,17.0,1.0,12.0,7.0,12.0,15.0,15.0,10.0,13.0,12.0,13.0,10.0,12.0,8.0,20.0,15.0,14.0,15.0,5.0,15.0,3.0,11.0,18.0,12.0,13.0,16.0,17.0,15.0,14.0,5.0,36.0,65.0,8.0,0.0,0.0,195.0,90.0,2.0,1.0,2.0,2.0,1.0,2.0,4.0,3.0,2.0,1.0,1.0,1.0,4.0,7.0,7.0,9.0,5.0,16.0,2.0,7.0,16.0,10.0,5.0,15.0,8.0,12.0,15.0,18.0,14.0,17.0,5.0,15.0,16.0,2.0,16.0,5.0,18.0,15.0,13.0,6.0,9.0,10.0,16.0,10.0,13.0,6.0,20.0,12.0,14.0,17.0,5.0,15.0,5.0,8.0,14.0,11.0,10.0,12.0,18.0,15.0,15.0,2.0,28.0,53.0,1.0,3.0,0.0,188.0,78.0,1.0,3.0,2.0,3.0,1.0,2.0,2.0,2.0,1.0,4.0,1.0,4.0,5.0,7.0,6.0,13.0,4.0,15.0,3.0,9.0,16.0,12.0,5.0,16.0,14.0,12.0,15.0,14.0,13.0,13.0,10.0,12.0,15.0,3.0,13.0,6.0,16.0,14.0,14.0,12.0,13.0,15.0,15.0,16.0,15.0,12.0,20.0,16.0,14.0,14.0,8.0,14.0,13.0,10.0,14.0,14.0,16.0,14.0,17.0,16.0,18.0,6.0,31.0,87.0,8.0,3.0,0.0,172.0,73.0,1.0,3.0,3.0,2.0,1.0,2.0,2.0,2.0,1.0,1.0,1.0,15.0,12.0,12.0,9.0,14.0,13.0,6.0,10.0,4.0,13.0,16.0,11.0,13.0,14.0,13.0,14.0,15.0,13.0,16.0,14.0,16.0,14.0,11.0,18.0,14.0,14.0,18.0,19.0,11.0,11.0,15.0,6.0,11.0,16.0,11.0,20.0,15.0,8.0,18.0,7.0,14.0,2.0,14.0,15.0,18.0,16.0,14.0,14.0,13.0,15.0,3.0,28.0,54.0,17.0,2.0,0.0,193.0,88.0,3.0,3.0,3.0,2.0,2.0,2.0,3.0,3.0,1.0,3.0,1.0,9.0,10.0,13.0,11.0,12.0,13.0,13.0,13.0,5.0,5.0,10.0,13.0,9.0,12.0,12.0,11.0,10.0,12.0,11.0,11.0,11.0,15.0,12.0,9.0,15.0,10.0,15.0,15.0,11.0,11.0,14.0,15.0,8.0,14.0,12.0,20.0,13.0,14.0,13.0,14.0,16.0,12.0,15.0,15.0,12.0,12.0,12.0,14.0,14.0,9.0,13.0,25.0,37.0,1.0,10.0,0.0,173.0,69.0,1.0,1.0,2.0,1.0,1.0,1.0,1.0,3.0,1.0,2.0,3.0,8.0,9.0,9.0,9.0,12.0,7.0,11.0,9.0,5.0,12.0,12.0,7.0,13.0,13.0,14.0,14.0,14.0,12.0,12.0,12.0,12.0,14.0,9.0,12.0,9.0,14.0,15.0,15.0,12.0,13.0,12.0,9.0,11.0,14.0,11.0,20.0,15.0,12.0,15.0,9.0,11.0,16.0,12.0,14.0,15.0,12.0,14.0,15.0,15.0,17.0,3.0,25.0,17.0,1.0,2.0,0.0,183.0,81.0,1.0,2.0,2.0,3.0,3.0,3.0,1.0,2.0,2.0,3.0,3.0,11.0,14.0,13.0,11.0,13.0,9.0,10.0,11.0,6.0,7.0,11.0,8.0,7.0,12.0,6.0,11.0,12.0,13.0,13.0,11.0,12.0,16.0,12.0,5.0,12.0,8.0,16.0,17.0,12.0,11.0,13.0,11.0,10.0,16.0,12.0,20.0,16.0,11.0,14.0,3.0,13.0,7.0,14.0,14.0,16.0,16.0,10.0,17.0,17.0,14.0,6.0,25.0,38.0,0.0,11.0,3.0,180.0,77.0,2.0,3.0,2.0,1.0,2.0,3.0,2.0,2.0,2.0,2.0,2.0,15.0,12.0,9.0,11.0,13.0,14.0,9.0,12.0,6.0,11.0,15.0,12.0,12.0,13.0,14.0,13.0,13.0,14.0,14.0,13.0,12.0,14.0,10.0,13.0,11.0,11.0,13.0,12.0,14.0,12.0,12.0,9.0,12.0,15.0,11.0,20.0,14.0,9.0,15.0,11.0,13.0,5.0,11.0,6.0,12.0,11.0,11.0,14.0,10.0,12.0,5.0,36.0,103.0,1.0,0.0,0.0,183.0,78.0,1.0,1.0,2.0,3.0,2.0,3.0,1.0,3.0,2.0,3.0,4.0,7.0,8.0,6.0,4.0,11.0,6.0,14.0,6.0,10.0,12.0,9.0,1.0,14.0,9.0,8.0,14.0,14.0,12.0,14.0,9.0,15.0,14.0,2.0,12.0,8.0,14.0,14.0,13.0,7.0,7.0,8.0,12.0,9.0,9.0,9.0,20.0,12.0,12.0,12.0,6.0,12.0,10.0,13.0,7.0,12.0,17.0,11.0,18.0,15.0,14.0,1.0,30.0,26.0,2.0,7.0,2.0,166.0,59.0,1.0,1.0,3.0,1.0,2.0,3.0,3.0,3.0,2.0,3.0,3.0,10.0,13.0,14.0,12.0,12.0,13.0,11.0,12.0,3.0,8.0,11.0,14.0,8.0,11.0,16.0,10.0,13.0,9.0,10.0,11.0,8.0,15.0,13.0,8.0,12.0,7.0,12.0,14.0,13.0,13.0,9.0,6.0,10.0,13.0,12.0,20.0,12.0,8.0,10.0,16.0,12.0,14.0,12.0,10.0,15.0,12.0,12.0,8.0,5.0,4.0,8.0,27.0,32.0,2.0,15.0,0.0,188.0,73.0,3.0,2.0,2.0,2.0,2.0,1.0,2.0,1.0,1.0,3.0,2.0,3.0,4.0,8.0,10.0,12.0,4.0,15.0,4.0,7.0,14.0,12.0,4.0,16.0,12.0,11.0,14.0,13.0,14.0,14.0,8.0,15.0,16.0,5.0,11.0,11.0,14.0,13.0,14.0,11.0,9.0,13.0,15.0,13.0,15.0,12.0,20.0,15.0,13.0,15.0,6.0,13.0,13.0,8.0,9.0,12.0,15.0,13.0,18.0,17.0,17.0,3.0
0,4,40.0,107.0,0.0,10.0,0.0,191.0,91.0,11.0,11.0,13.0,15.0,13.0,13.0,12.0,11.0,12.0,11.0,14.0,7.0,2.0,2.0,2.0,7.0,9.0,12.0,1.0,2.0,7.0,10.0,7.0,13.0,7.0,13.0,12.0,11.0,10.0,13.0,7.0,12.0,16.0,5.0,12.0,5.0,11.0,10.0,10.0,6.0,12.0,12.0,16.0,20.0,16.0,5.0,14.0,14.0,14.0,10.0,4.0,13.0,4.0,10.0,17.0,14.0,13.0,16.0,16.0,12.0,9.0,12.0,23.0,16.0,0.0,5.0,0.0,186.0,81.0,3.0,1.0,1.0,3.0,3.0,1.0,3.0,3.0,2.0,2.0,2.0,4.0,8.0,7.0,3.0,12.0,5.0,12.0,8.0,8.0,14.0,13.0,6.0,12.0,8.0,12.0,13.0,11.0,13.0,13.0,11.0,12.0,15.0,5.0,7.0,6.0,15.0,14.0,12.0,11.0,9.0,13.0,13.0,6.0,8.0,11.0,20.0,13.0,13.0,10.0,5.0,12.0,4.0,12.0,8.0,12.0,10.0,7.0,16.0,15.0,14.0,4.0,26.0,33.0,0.0,7.0,0.0,188.0,84.0,1.0,1.0,2.0,3.0,3.0,3.0,3.0,4.0,1.0,1.0,2.0,5.0,10.0,10.0,5.0,12.0,5.0,12.0,9.0,13.0,10.0,11.0,8.0,13.0,10.0,16.0,10.0,17.0,12.0,10.0,10.0,12.0,10.0,10.0,9.0,8.0,13.0,13.0,14.0,12.0,14.0,12.0,11.0,20.0,10.0,13.0,7.0,13.0,15.0,10.0,9.0,10.0,9.0,10.0,12.0,10.0,10.0,12.0,10.0,8.0,15.0,5.0,29.0,82.0,20.0,0.0,0.0,179.0,72.0,3.0,3.0,3.0,1.0,2.0,2.0,1.0,2.0,1.0,4.0,1.0,16.0,16.0,12.0,13.0,14.0,16.0,3.0,16.0,8.0,4.0,14.0,12.0,7.0,14.0,8.0,13.0,4.0,13.0,12.0,14.0,13.0,10.0,12.0,8.0,12.0,10.0,10.0,10.0,14.0,14.0,12.0,10.0,20.0,11.0,13.0,15.0,13.0,9.0,12.0,8.0,15.0,6.0,11.0,7.0,10.0,13.0,15.0,13.0,9.0,12.0,12.0,16.0,0.0,0.0,0.0,0.0,180.0,0.0,1.0,1.0,1.0,3.0,3.0,2.0,2.0,1.0,2.0,2.0,3.0,1.0,3.0,3.0,2.0,1.0,3.0,1.0,1.0,1.0,1.0,2.0,1.0,1.0,4.0,10.0,1.0,3.0,3.0,1.0,1.0,4.0,7.0,12.0,10.0,1.0,1.0,7.0,10.0,14.0,8.0,6.0,8.0,9.0,15.0,12.0,20.0,5.0,1.0,9.0,7.0,12.0,5.0,7.0,12.0,10.0,14.0,10.0,9.0,3.0,9.0,8.0,28.0,36.0,9.0,6.0,5.0,193.0,87.0,1.0,3.0,4.0,3.0,3.0,3.0,3.0,1.0,3.0,2.0,3.0,6.0,9.0,10.0,13.0,13.0,9.0,14.0,11.0,5.0,6.0,11.0,10.0,7.0,12.0,14.0,13.0,15.0,11.0,12.0,10.0,13.0,13.0,11.0,8.0,14.0,9.0,16.0,14.0,11.0,11.0,15.0,16.0,15.0,14.0,12.0,20.0,14.0,16.0,13.0,8.0,13.0,13.0,10.0,16.0,16.0,10.0,12.0,15.0,9.0,10.0,8.0,37.0,88.0,24.0,0.0,0.0,186.0,78.0,1.0,2.0,3.0,2.0,1.0,1.0,1.0,3.0,3.0,3.0,3.0,7.0,13.0,11.0,10.0,14.0,6.0,13.0,11.0,2.0,8.0,12.0,10.0,11.0,15.0,9.0,12.0,11.0,14.0,11.0,14.0,12.0,15.0,14.0,14.0,13.0,12.0,14.0,13.0,7.0,11.0,11.0,11.0,16.0,11.0,10.0,20.0,10.0,8.0,10.0,5.0,13.0,15.0,15.0,15.0,12.0,14.0,14.0,17.0,15.0,15.0,2.0,27.0,14.0,1.0,0.0,0.0,177.0,77.0,3.0,3.0,2.0,1.0,3.0,2.0,3.0,1.0,2.0,4.0,2.0,13.0,12.0,11.0,12.0,12.0,10.0,8.0,12.0,5.0,6.0,13.0,8.0,6.0,12.0,6.0,11.0,12.0,9.0,8.0,9.0,11.0,10.0,12.0,5.0,13.0,9.0,13.0,13.0,15.0,11.0,13.0,9.0,14.0,13.0,14.0,20.0,12.0,10.0,8.0,7.0,11.0,9.0,11.0,14.0,12.0,13.0,10.0,10.0,10.0,11.0,7.0,28.0,24.0,0.0,7.0,0.0,190.0,76.0,3.0,3.0,1.0,3.0,1.0,4.0,4.0,3.0,3.0,3.0,1.0,7.0,9.0,8.0,7.0,10.0,9.0,10.0,11.0,10.0,13.0,12.0,8.0,14.0,11.0,14.0,13.0,16.0,10.0,12.0,8.0,11.0,13.0,6.0,12.0,8.0,13.0,16.0,14.0,9.0,10.0,15.0,15.0,12.0,12.0,11.0,20.0,14.0,14.0,15.0,13.0,14.0,11.0,9.0,15.0,15.0,11.0,11.0,14.0,10.0,16.0,4.0,29.0,18.0,1.0,0.0,0.0,190.0,88.0,1.0,2.0,2.0,1.0,1.0,4.0,1.0,3.0,3.0,1.0,3.0,5.0,4.0,5.0,5.0,10.0,5.0,12.0,8.0,5.0,13.0,9.0,7.0,13.0,9.0,11.0,14.0,14.0,11.0,8.0,9.0,12.0,12.0,8.0,10.0,8.0,13.0,12.0,12.0,11.0,11.0,13.0,13.0,10.0,13.0,11.0,20.0,13.0,15.0,11.0,11.0,11.0,6.0,10.0,14.0,12.0,12.0,10.0,12.0,12.0,10.0,10.0,33.0,94.0,6.0,0.0,0.0,194.0,96.0,3.0,2.0,1.0,3.0,3.0,3.0,1.0,3.0,1.0,4.0,1.0,9.0,7.0,7.0,12.0,9.0,9.0,16.0,8.0,11.0,15.0,10.0,4.0,14.0,10.0,6.0,13.0,6.0,11.0,13.0,9.0,12.0,17.0,9.0,11.0,13.0,13.0,15.0,15.0,8.0,9.0,18.0,17.0,5.0,12.0,8.0,20.0,15.0,17.0,16.0,6.0,13.0,8.0,10.0,9.0,14.0,16.0,12.0,16.0,13.0,8.0,8.0,24.0,42.0,0.0,4.0,0.0,199.0,94.0,18.0,13.0,12.0,5.0,17.0,15.0,17.0,16.0,10.0,5.0,15.0,7.0,1.0,10.0,2.0,10.0,10.0,10.0,1.0,3.0,2.0,13.0,3.0,2.0,13.0,8.0,15.0,14.0,14.0,15.0,10.0,15.0,15.0,14.0,11.0,3.0,13.0,14.0,10.0,11.0,14.0,12.0,19.0,20.0,12.0,10.0,10.0,9.0,13.0,14.0,5.0,18.0,5.0,12.0,14.0,14.0,15.0,16.0,15.0,14.0,14.0,8.0,27.0,60.0,2.0,5.0,0.0,186.0,81.0,1.0,1.0,3.0,3.0,1.0,3.0,1.0,1.0,3.0,3.0,2.0,6.0,7.0,9.0,6.0,13.0,11.0,16.0,15.0,12.0,16.0,15.0,6.0,16.0,15.0,11.0,17.0,15.0,15.0,14.0,11.0,15.0,12.0,8.0,16.0,8.0,17.0,15.0,15.0,13.0,13.0,13.0,14.0,12.0,16.0,12.0,20.0,14.0,15.0,16.0,5.0,14.0,4.0,12.0,11.0,13.0,15.0,12.0,18.0,15.0,9.0,9.0,30.0,57.0,1.0,12.0,1.0,183.0,80.0,2.0,2.0,1.0,2.0,1.0,3.0,1.0,1.0,1.0,2.0,2.0,7.0,8.0,10.0,9.0,13.0,10.0,17.0,13.0,13.0,15.0,13.0,11.0,16.0,14.0,15.0,15.0,14.0,15.0,13.0,11.0,14.0,18.0,7.0,14.0,13.0,14.0,15.0,16.0,11.0,11.0,13.0,16.0,20.0,9.0,13.0,10.0,14.0,14.0,14.0,11.0,14.0,15.0,13.0,18.0,14.0,15.0,13.0,16.0,13.0,11.0,3.0,28.0,24.0,6.0,13.0,1.0,176.0,65.0,1.0,2.0,1.0,2.0,2.0,3.0,2.0,1.0,1.0,1.0,1.0,7.0,10.0,13.0,14.0,15.0,8.0,8.0,15.0,8.0,14.0,14.0,10.0,19.0,15.0,19.0,13.0,20.0,13.0,13.0,13.0,14.0,18.0,13.0,14.0,16.0,12.0,15.0,20.0,16.0,15.0,17.0,8.0,11.0,16.0,13.0,20.0,17.0,15.0,15.0,17.0,14.0,6.0,16.0,16.0,14.0,16.0,16.0,10.0,11.0,10.0,17.0,29.0,82.0,6.0,0.0,0.0,189.0,79.0,3.0,1.0,3.0,3.0,2.0,3.0,3.0,1.0,2.0,2.0,4.0,7.0,7.0,13.0,8.0,13.0,11.0,14.0,9.0,12.0,14.0,14.0,8.0,16.0,14.0,9.0,14.0,14.0,18.0,13.0,14.0,15.0,16.0,13.0,12.0,10.0,14.0,15.0,15.0,13.0,14.0,13.0,15.0,20.0,12.0,12.0,10.0,16.0,16.0,14.0,10.0,13.0,11.0,12.0,13.0,17.0,13.0,16.0,8.0,9.0,9.0,10.0,27.0,73.0,7.0,12.0,0.0,186.0,73.0,2.0,2.0,1.0,2.0,1.0,3.0,2.0,1.0,3.0,1.0,1.0,11.0,10.0,13.0,11.0,14.0,11.0,14.0,13.0,8.0,8.0,15.0,17.0,12.0,14.0,12.0,18.0,13.0,13.0,18.0,12.0,13.0,13.0,12.0,11.0,14.0,14.0,15.0,16.0,13.0,12.0,14.0,13.0,13.0,16.0,13.0,20.0,15.0,12.0,18.0,13.0,13.0,9.0,16.0,15.0,15.0,11.0,13.0,18.0,12.0,15.0,6.0,25.0,45.0,12.0,2.0,0.0,181.0,76.0,3.0,2.0,4.0,3.0,3.0,3.0,3.0,1.0,1.0,3.0,2.0,15.0,17.0,15.0,16.0,17.0,15.0,7.0,16.0,8.0,7.0,17.0,12.0,8.0,17.0,12.0,14.0,9.0,14.0,12.0,17.0,15.0,15.0,16.0,11.0,16.0,10.0,12.0,15.0,13.0,13.0,13.0,8.0,16.0,16.0,13.0,20.0,17.0,12.0,14.0,8.0,15.0,4.0,14.0,12.0,18.0,10.0,11.0,17.0,10.0,12.0,13.0,23.0,50.0,14.0,5.0,1.0,191.0,94.0,2.0,1.0,2.0,3.0,1.0,2.0,3.0,1.0,1.0,1.0,2.0,4.0,11.0,13.0,17.0,13.0,12.0,14.0,14.0,6.0,6.0,11.0,16.0,6.0,13.0,10.0,14.0,14.0,15.0,14.0,11.0,12.0,16.0,12.0,12.0,14.0,9.0,14.0,10.0,14.0,10.0,18.0,16.0,20.0,17.0,16.0,11.0,13.0,19.0,14.0,6.0,14.0,7.0,6.0,11.0,18.0,14.0,18.0,18.0,15.0,12.0,8.0,25.0,70.0,14.0,0.0,0.0,173.0,76.0,1.0,3.0,1.0,3.0,3.0,2.0,2.0,3.0,3.0,1.0,4.0,13.0,12.0,20.0,13.0,17.0,13.0,7.0,13.0,5.0,3.0,15.0,19.0,4.0,18.0,8.0,12.0,17.0,15.0,13.0,16.0,13.0,16.0,18.0,6.0,14.0,7.0,11.0,13.0,17.0,20.0,16.0,8.0,16.0,16.0,16.0,20.0,17.0,9.0,15.0,8.0,15.0,3.0,8.0,15.0,18.0,14.0,15.0,14.0,17.0,14.0,9.0,29.0,51.0,8.0,0.0,0.0,169.0,61.0,4.0,3.0,1.0,2.0,4.0,1.0,1.0,4.0,3.0,2.0,1.0,14.0,15.0,16.0,14.0,18.0,12.0,7.0,14.0,7.0,6.0,15.0,13.0,7.0,16.0,12.0,13.0,14.0,14.0,13.0,14.0,13.0,15.0,16.0,12.0,17.0,6.0,11.0,13.0,15.0,16.0,12.0,6.0,12.0,13.0,15.0,20.0,12.0,10.0,13.0,10.0,14.0,6.0,13.0,17.0,14.0,13.0,15.0,13.0,6.0,12.0,10.0,24.0,9.0,0.0,7.0,1.0,190.0,82.0,2.0,2.0,3.0,3.0,1.0,2.0,2.0,1.0,1.0,3.0,1.0,8.0,14.0,13.0,11.0,12.0,10.0,12.0,11.0,9.0,11.0,13.0,8.0,13.0,13.0,10.0,14.0,14.0,13.0,13.0,14.0,14.0,16.0,11.0,6.0,12.0,12.0,16.0,16.0,12.0,11.0,11.0,14.0,8.0,14.0,14.0,20.0,15.0,13.0,14.0,9.0,13.0,8.0,14.0,13.0,14.0,12.0,14.0,16.0,12.0,15.0,2.0
3,0,30.0,71.0,0.0,20.0,0.0,192.0,90.0,14.0,19.0,12.0,16.0,16.0,19.0,19.0,18.0,20.0,8.0,20.0,4.0,1.0,3.0,1.0,13.0,9.0,10.0,3.0,2.0,3.0,13.0,10.0,1.0,12.0,8.0,20.0,16.0,20.0,14.0,12.0,12.0,18.0,6.0,13.0,1.0,18.0,16.0,14.0,15.0,18.0,16.0,15.0,15.0,13.0,10.0,20.0,12.0,17.0,17.0,7.0,19.0,4.0,14.0,5.0,13.0,15.0,20.0,16.0,12.0,19.0,8.0,26.0,20.0,1.0,0.0,0.0,185.0,75.0,1.0,1.0,1.0,3.0,2.0,3.0,1.0,1.0,1.0,2.0,1.0,11.0,12.0,11.0,8.0,12.0,10.0,8.0,10.0,14.0,10.0,13.0,11.0,15.0,12.0,12.0,16.0,12.0,16.0,16.0,12.0,15.0,12.0,9.0,10.0,13.0,13.0,18.0,14.0,12.0,10.0,13.0,11.0,20.0,18.0,15.0,12.0,16.0,11.0,17.0,6.0,17.0,5.0,16.0,7.0,10.0,16.0,15.0,17.0,17.0,19.0,3.0,27.0,50.0,4.0,21.0,5.0,191.0,92.0,3.0,1.0,1.0,3.0,1.0,1.0,1.0,3.0,1.0,3.0,1.0,5.0,9.0,12.0,10.0,14.0,8.0,15.0,9.0,8.0,17.0,15.0,11.0,17.0,15.0,12.0,18.0,14.0,19.0,13.0,14.0,17.0,14.0,9.0,14.0,10.0,18.0,16.0,12.0,9.0,11.0,17.0,16.0,14.0,15.0,12.0,20.0,14.0,16.0,16.0,9.0,14.0,6.0,7.0,8.0,13.0,16.0,14.0,17.0,18.0,16.0,10.0,29.0,65.0,5.0,15.0,5.0,189.0,90.0,4.0,4.0,2.0,1.0,3.0,2.0,1.0,3.0,2.0,2.0,1.0,6.0,10.0,11.0,13.0,14.0,8.0,16.0,12.0,11.0,15.0,14.0,10.0,13.0,14.0,15.0,15.0,16.0,15.0,18.0,13.0,17.0,18.0,10.0,12.0,16.0,17.0,20.0,19.0,10.0,11.0,15.0,14.0,11.0,10.0,14.0,20.0,17.0,16.0,16.0,12.0,15.0,19.0,14.0,15.0,16.0,9.0,15.0,18.0,16.0,17.0,4.0,27.0,79.0,20.0,16.0,5.0,183.0,72.0,3.0,3.0,4.0,2.0,3.0,3.0,1.0,2.0,3.0,3.0,3.0,15.0,16.0,17.0,12.0,19.0,13.0,7.0,11.0,4.0,6.0,19.0,13.0,9.0,19.0,7.0,18.0,9.0,19.0,15.0,20.0,18.0,14.0,19.0,8.0,20.0,6.0,19.0,12.0,14.0,16.0,14.0,9.0,20.0,15.0,13.0,10.0,15.0,9.0,13.0,5.0,16.0,6.0,10.0,16.0,16.0,12.0,17.0,15.0,14.0,16.0,10.0,22.0,24.0,2.0,1.0,1.0,187.0,75.0,1.0,2.0,1.0,1.0,2.0,1.0,2.0,1.0,2.0,3.0,3.0,13.0,13.0,16.0,13.0,17.0,10.0,9.0,17.0,8.0,6.0,14.0,10.0,8.0,16.0,10.0,12.0,9.0,12.0,10.0,15.0,11.0,10.0,15.0,7.0,13.0,8.0,12.0,11.0,15.0,14.0,10.0,16.0,18.0,12.0,13.0,20.0,14.0,11.0,8.0,5.0,15.0,12.0,13.0,11.0,17.0,8.0,10.0,16.0,12.0,14.0,13.0,26.0,77.0,32.0,6.0,1.0,186.0,74.0,1.0,1.0,2.0,2.0,1.0,2.0,2.0,2.0,2.0,3.0,1.0,7.0,11.0,11.0,15.0,13.0,7.0,12.0,10.0,10.0,7.0,12.0,15.0,8.0,12.0,18.0,19.0,13.0,16.0,18.0,14.0,17.0,18.0,15.0,12.0,20.0,10.0,17.0,18.0,12.0,13.0,15.0,12.0,12.0,19.0,14.0,20.0,19.0,11.0,17.0,9.0,18.0,3.0,16.0,10.0,16.0,16.0,19.0,15.0,10.0,11.0,10.0,27.0,65.0,1.0,15.0,1.0,192.0,90.0,3.0,3.0,2.0,3.0,2.0,3.0,2.0,3.0,1.0,3.0,3.0,7.0,14.0,11.0,6.0,13.0,5.0,10.0,7.0,16.0,18.0,15.0,7.0,18.0,13.0,10.0,17.0,13.0,16.0,12.0,14.0,15.0,11.0,11.0,11.0,7.0,15.0,12.0,9.0,14.0,13.0,17.0,17.0,18.0,14.0,18.0,20.0,14.0,18.0,16.0,8.0,16.0,6.0,16.0,6.0,14.0,7.0,15.0,11.0,15.0,9.0,13.0,26.0,71.0,11.0,10.0,2.0,182.0,78.0,1.0,2.0,3.0,3.0,2.0,3.0,2.0,4.0,3.0,2.0,2.0,18.0,18.0,14.0,13.0,18.0,14.0,7.0,17.0,8.0,8.0,20.0,13.0,9.0,16.0,10.0,17.0,10.0,18.0,14.0,18.0,19.0,9.0,11.0,12.0,14.0,12.0,18.0,13.0,12.0,9.0,12.0,10.0,15.0,12.0,13.0,20.0,16.0,14.0,13.0,10.0,14.0,7.0,13.0,8.0,14.0,8.0,14.0,17.0,18.0,17.0,7.0,21.0,5.0,0.0,14.0,2.0,176.0,70.0,3.0,3.0,2.0,3.0,1.0,2.0,2.0,1.0,3.0,2.0,2.0,10.0,12.0,11.0,12.0,13.0,8.0,10.0,11.0,10.0,12.0,14.0,12.0,13.0,14.0,17.0,16.0,13.0,15.0,12.0,13.0,15.0,16.0,9.0,10.0,14.0,10.0,18.0,17.0,13.0,15.0,11.0,10.0,14.0,14.0,10.0,20.0,16.0,8.0,13.0,8.0,15.0,5.0,18.0,11.0,18.0,10.0,14.0,13.0,15.0,12.0,8.0,30.0,0.0,0.0,0.0,0.0,174.0,70.0,3.0,3.0,2.0,3.0,3.0,1.0,2.0,2.0,1.0,2.0,1.0,10.0,9.0,12.0,10.0,11.0,13.0,9.0,9.0,5.0,10.0,9.0,10.0,7.0,12.0,10.0,12.0,11.0,11.0,11.0,11.0,12.0,11.0,10.0,10.0,12.0,11.0,11.0,12.0,11.0,10.0,11.0,10.0,20.0,13.0,11.0,11.0,11.0,10.0,12.0,3.0,10.0,10.0,15.0,11.0,11.0,11.0,9.0,12.0,8.0,11.0,10.0,32.0,21.0,0.0,12.0,0.0,193.0,94.0,12.0,17.0,8.0,7.0,17.0,14.0,14.0,14.0,14.0,5.0,13.0,3.0,4.0,5.0,3.0,7.0,5.0,4.0,3.0,6.0,5.0,12.0,8.0,6.0,7.0,8.0,14.0,13.0,9.0,9.0,8.0,13.0,18.0,3.0,11.0,3.0,16.0,16.0,3.0,11.0,9.0,16.0,14.0,7.0,12.0,9.0,20.0,14.0,15.0,16.0,9.0,14.0,10.0,2.0,16.0,14.0,12.0,18.0,16.0,12.0,16.0,8.0,29.0,71.0,2.0,7.0,0.0,176.0,72.0,2.0,3.0,3.0,1.0,2.0,1.0,3.0,2.0,3.0,1.0,3.0,8.0,14.0,10.0,5.0,11.0,5.0,10.0,6.0,13.0,12.0,12.0,6.0,14.0,11.0,12.0,16.0,10.0,13.0,16.0,9.0,13.0,12.0,6.0,12.0,10.0,14.0,18.0,13.0,14.0,15.0,10.0,8.0,10.0,15.0,13.0,20.0,16.0,8.0,18.0,8.0,17.0,5.0,10.0,14.0,14.0,16.0,13.0,15.0,17.0,18.0,3.0,31.0,85.0,5.0,13.0,0.0,191.0,81.0,1.0,4.0,2.0,3.0,1.0,1.0,1.0,3.0,2.0,3.0,2.0,2.0,5.0,9.0,9.0,11.0,2.0,17.0,3.0,5.0,15.0,13.0,2.0,16.0,12.0,14.0,16.0,16.0,13.0,12.0,7.0,14.0,17.0,7.0,9.0,12.0,16.0,14.0,12.0,12.0,13.0,14.0,16.0,8.0,14.0,13.0,20.0,13.0,16.0,17.0,11.0,15.0,10.0,4.0,14.0,16.0,16.0,13.0,16.0,15.0,13.0,8.0,34.0,83.0,4.0,0.0,0.0,188.0,86.0,1.0,2.0,3.0,3.0,1.0,1.0,1.0,1.0,3.0,3.0,3.0,6.0,9.0,12.0,7.0,12.0,5.0,16.0,9.0,14.0,14.0,12.0,7.0,14.0,10.0,15.0,13.0,18.0,13.0,14.0,8.0,12.0,15.0,9.0,11.0,5.0,14.0,14.0,16.0,10.0,10.0,10.0,13.0,20.0,15.0,10.0,10.0,12.0,14.0,17.0,11.0,15.0,3.0,12.0,15.0,13.0,13.0,12.0,15.0,12.0,10.0,5.0,23.0,16.0,0.0,18.0,0.0,189.0,79.0,1.0,2.0,2.0,3.0,3.0,1.0,4.0,1.0,3.0,3.0,2.0,6.0,8.0,6.0,6.0,8.0,6.0,14.0,9.0,10.0,15.0,10.0,8.0,14.0,10.0,11.0,15.0,10.0,10.0,10.0,9.0,11.0,17.0,8.0,8.0,9.0,13.0,12.0,18.0,13.0,12.0,14.0,14.0,8.0,13.0,14.0,20.0,14.0,14.0,13.0,10.0,13.0,7.0,7.0,12.0,12.0,14.0,15.0,18.0,15.0,14.0,5.0,26.0,56.0,5.0,8.0,0.0,173.0,71.0,3.0,1.0,2.0,2.0,1.0,2.0,3.0,1.0,3.0,1.0,3.0,13.0,13.0,16.0,11.0,15.0,12.0,7.0,13.0,5.0,5.0,13.0,13.0,5.0,15.0,12.0,12.0,8.0,7.0,8.0,13.0,8.0,12.0,14.0,7.0,14.0,5.0,7.0,11.0,16.0,17.0,12.0,6.0,6.0,12.0,16.0,20.0,12.0,11.0,9.0,14.0,13.0,5.0,12.0,15.0,15.0,11.0,10.0,12.0,7.0,8.0,12.0,24.0,14.0,0.0,21.0,1.0,177.0,67.0,2.0,3.0,3.0,2.0,2.0,3.0,2.0,3.0,2.0,1.0,4.0,11.0,11.0,13.0,13.0,13.0,12.0,5.0,13.0,6.0,9.0,14.0,13.0,5.0,14.0,12.0,13.0,13.0,14.0,14.0,12.0,14.0,11.0,15.0,8.0,11.0,13.0,11.0,14.0,13.0,14.0,13.0,7.0,12.0,6.0,14.0,20.0,16.0,12.0,11.0,12.0,10.0,12.0,14.0,9.0,9.0,12.0,12.0,9.0,7.0,11.0,6.0,21.0,4.0,0.0,14.0,3.0,187.0,80.0,2.0,1.0,2.0,3.0,1.0,2.0,2.0,1.0,3.0,2.0,3.0,5.0,8.0,10.0,10.0,12.0,7.0,14.0,8.0,11.0,14.0,12.0,9.0,15.0,11.0,13.0,15.0,12.0,11.0,10.0,10.0,11.0,16.0,6.0,12.0,10.0,16.0,12.0,14.0,12.0,10.0,12.0,13.0,20.0,12.0,13.0,8.0,15.0,12.0,14.0,10.0,8.0,8.0,10.0,10.0,12.0,12.0,10.0,16.0,12.0,8.0,8.0,28.0,91.0,19.0,2.0,0.0,183.0,79.0,3.0,1.0,2.0,2.0,2.0,1.0,2.0,3.0,2.0,3.0,1.0,14.0,13.0,13.0,14.0,15.0,12.0,15.0,14.0,8.0,8.0,16.0,14.0,9.0,17.0,11.0,14.0,12.0,15.0,10.0,16.0,14.0,15.0,15.0,17.0,18.0,14.0,15.0,10.0,15.0,15.0,13.0,11.0,15.0,15.0,14.0,20.0,14.0,13.0,13.0,6.0,12.0,5.0,14.0,17.0,16.0,19.0,13.0,18.0,14.0,12.0,8.0,29.0,54.0,6.0,11.0,0.0,186.0,84.0,1.0,2.0,2.0,2.0,1.0,1.0,3.0,4.0,2.0,3.0,2.0,6.0,8.0,12.0,8.0,12.0,9.0,12.0,13.0,8.0,13.0,13.0,11.0,15.0,13.0,14.0,15.0,17.0,14.0,12.0,11.0,13.0,14.0,12.0,13.0,14.0,14.0,16.0,15.0,12.0,13.0,17.0,13.0,12.0,16.0,14.0,20.0,16.0,17.0,14.0,16.0,12.0,12.0,13.0,14.0,12.0,18.0,14.0,14.0,12.0,10.0,2.0,28.0,29.0,4.0,10.0,4.0,183.0,75.0,2.0,2.0,1.0,2.0,1.0,1.0,1.0,1.0,1.0,1.0,2.0,10.0,11.0,15.0,14.0,13.0,12.0,12.0,13.0,8.0,7.0,12.0,14.0,9.0,10.0,13.0,11.0,12.0,10.0,14.0,7.0,11.0,16.0,14.0,7.0,11.0,5.0,9.0,11.0,16.0,12.0,15.0,11.0,12.0,14.0,15.0,20.0,14.0,10.0,10.0,14.0,17.0,6.0,11.0,13.0,11.0,17.0,13.0,14.0,10.0,7.0,5.0
3,1,29.0,62.0,0.0,6.0,0.0,196.0,90.0,18.0,11.0,12.0,4.0,12.0,18.0,16.0,14.0,14.0,14.0,18.0,7.0,3.0,2.0,3.0,7.0,10.0,2.0,3.0,3.0,1.0,5.0,3.0,2.0,6.0,12.0,13.0,12.0,9.0,12.0,6.0,11.0,13.0,1.0,8.0,6.0,12.0,11.0,10.0,10.0,14.0,12.0,19.0,13.0,13.0,11.0,20.0,11.0,15.0,10.0,8.0,12.0,7.0,12.0,13.0,13.0,13.0,11.0,13.0,13.0,13.0,6.0,26.0,73.0,0.0,8.0,0.0,181.0,71.0,1.0,1.0,2.0,2.0,2.0,2.0,3.0,1.0,3.0,4.0,3.0,9.0,10.0,9.0,6.0,12.0,8.0,11.0,7.0,10.0,11.0,11.0,10.0,12.0,10.0,10.0,12.0,13.0,12.0,11.0,9.0,10.0,13.0,5.0,14.0,13.0,11.0,15.0,19.0,13.0,12.0,13.0,9.0,20.0,20.0,13.0,15.0,20.0,12.0,15.0,5.0,15.0,5.0,13.0,14.0,12.0,15.0,12.0,16.0,9.0,10.0,3.0,27.0,34.0,1.0,13.0,0.0,175.0,64.0,3.0,1.0,1.0,2.0,2.0,3.0,4.0,1.0,4.0,3.0,3.0,7.0,9.0,8.0,3.0,13.0,6.0,12.0,4.0,2.0,13.0,10.0,3.0,14.0,8.0,15.0,13.0,12.0,10.0,13.0,9.0,12.0,14.0,8.0,9.0,11.0,13.0,14.0,16.0,15.0,14.0,12.0,9.0,20.0,14.0,16.0,5.0,17.0,12.0,15.0,11.0,12.0,4.0,10.0,11.0,16.0,10.0,13.0,10.0,8.0,10.0,15.0,23.0,25.0,0.0,0.0,0.0,181.0,77.0,1.0,2.0,3.0,1.0,2.0,2.0,3.0,1.0,3.0,2.0,3.0,13.0,15.0,12.0,6.0,14.0,14.0,14.0,6.0,11.0,14.0,14.0,10.0,14.0,13.0,13.0,15.0,18.0,15.0,13.0,14.0,14.0,17.0,9.0,6.0,13.0,15.0,14.0,15.0,13.0,13.0,15.0,10.0,20.0,13.0,11.0,8.0,14.0,14.0,15.0,6.0,9.0,5.0,11.0,10.0,13.0,14.0,9.0,15.0,13.0,12.0,4.0,27.0,17.0,0.0,0.0,0.0,181.0,81.0,1.0,3.0,1.0,2.0,2.0,2.0,2.0,2.0,2.0,1.0,3.0,4.0,5.0,10.0,6.0,12.0,4.0,14.0,4.0,8.0,13.0,11.0,10.0,15.0,11.0,13.0,15.0,14.0,15.0,12.0,9.0,12.0,14.0,2.0,14.0,9.0,14.0,15.0,13.0,13.0,12.0,12.0,12.0,11.0,19.0,13.0,20.0,16.0,12.0,15.0,8.0,14.0,8.0,15.0,10.0,11.0,12.0,13.0,14.0,14.0,15.0,3.0,31.0,65.0,2.0,0.0,0.0,182.0,91.0,2.0,2.0,1.0,2.0,1.0,2.0,2.0,3.0,3.0,1.0,2.0,3.0,4.0,7.0,4.0,10.0,3.0,15.0,4.0,6.0,13.0,12.0,4.0,15.0,10.0,16.0,16.0,18.0,11.0,14.0,9.0,12.0,15.0,8.0,18.0,7.0,17.0,13.0,10.0,10.0,11.0,9.0,12.0,14.0,13.0,11.0,20.0,16.0,17.0,15.0,14.0,16.0,1.0,6.0,10.0,16.0,16.0,14.0,14.0,8.0,8.0,16.0,26.0,31.0,0.0,7.0,2.0,168.0,62.0,2.0,3.0,1.0,2.0,3.0,1.0,2.0,1.0,3.0,1.0,1.0,8.0,9.0,13.0,9.0,15.0,7.0,7.0,8.0,3.0,14.0,15.0,6.0,13.0,15.0,13.0,15.0,15.0,15.0,15.0,13.0,14.0,13.0,12.0,8.0,14.0,13.0,17.0,18.0,13.0,15.0,14.0,6.0,11.0,15.0,12.0,20.0,15.0,10.0,14.0,6.0,15.0,8.0,11.0,10.0,14.0,14.0,13.0,15.0,15.0,12.0,2.0,27.0,35.0,4.0,4.0,2.0,186.0,84.0,3.0,3.0,3.0,1.0,3.0,2.0,3.0,2.0,3.0,3.0,3.0,11.0,12.0,14.0,12.0,13.0,10.0,10.0,13.0,10.0,6.0,10.0,14.0,7.0,11.0,9.0,9.0,8.0,10.0,10.0,9.0,8.0,15.0,14.0,8.0,12.0,8.0,12.0,12.0,14.0,11.0,16.0,12.0,20.0,15.0,15.0,10.0,11.0,14.0,10.0,3.0,15.0,7.0,14.0,8.0,14.0,16.0,12.0,15.0,16.0,13.0,4.0,25.0,44.0,11.0,12.0,2.0,178.0,67.0,3.0,2.0,2.0,4.0,1.0,1.0,3.0,2.0,2.0,1.0,2.0,9.0,13.0,15.0,12.0,15.0,8.0,5.0,12.0,3.0,9.0,15.0,12.0,12.0,17.0,10.0,14.0,13.0,16.0,14.0,17.0,14.0,15.0,14.0,12.0,17.0,11.0,16.0,16.0,13.0,16.0,14.0,8.0,12.0,16.0,12.0,20.0,16.0,12.0,14.0,6.0,15.0,12.0,16.0,14.0,14.0,16.0,14.0,17.0,16.0,14.0,6.0,26.0,61.0,22.0,13.0,3.0,186.0,82.0,2.0,2.0,2.0,1.0,3.0,2.0,1.0,1.0,2.0,1.0,3.0,14.0,16.0,16.0,17.0,15.0,17.0,19.0,19.0,15.0,6.0,14.0,13.0,9.0,16.0,10.0,14.0,11.0,13.0,11.0,13.0,13.0,16.0,17.0,9.0,18.0,7.0,10.0,10.0,15.0,14.0,14.0,15.0,20.0,13.0,19.0,11.0,18.0,17.0,13.0,10.0,13.0,15.0,16.0,8.0,14.0,11.0,14.0,14.0,17.0,14.0,12.0,29.0,67.0,4.0,5.0,0.0,183.0,73.0,3.0,3.0,3.0,2.0,3.0,1.0,2.0,1.0,1.0,2.0,2.0,9.0,11.0,10.0,14.0,12.0,6.0,14.0,12.0,12.0,16.0,14.0,14.0,15.0,13.0,12.0,12.0,15.0,15.0,14.0,13.0,15.0,16.0,8.0,14.0,13.0,13.0,16.0,16.0,13.0,13.0,14.0,15.0,20.0,14.0,11.0,4.0,15.0,14.0,14.0,2.0,16.0,9.0,12.0,10.0,14.0,19.0,12.0,14.0,18.0,10.0,8.0,24.0,42.0,0.0,4.0,0.0,199.0,94.0,18.0,13.0,12.0,5.0,17.0,15.0,17.0,16.0,10.0,5.0,15.0,7.0,1.0,10.0,2.0,10.0,10.0,10.0,1.0,3.0,2.0,13.0,3.0,2.0,13.0,8.0,15.0,14.0,14.0,15.0,10.0,15.0,15.0,14.0,11.0,3.0,13.0,14.0,10.0,11.0,14.0,12.0,19.0,20.0,12.0,10.0,10.0,9.0,13.0,14.0,5.0,18.0,5.0,12.0,14.0,14.0,15.0,16.0,15.0,14.0,14.0,8.0,27.0,60.0,2.0,5.0,0.0,186.0,81.0,1.0,1.0,3.0,3.0,1.0,3.0,1.0,1.0,3.0,3.0,2.0,6.0,7.0,9.0,6.0,13.0,11.0,16.0,15.0,12.0,16.0,15.0,6.0,16.0,15.0,11.0,17.0,15.0,15.0,14.0,11.0,15.0,12.0,8.0,16.0,8.0,17.0,15.0,15.0,13.0,13.0,13.0,14.0,12.0,16.0,12.0,20.0,14.0,15.0,16.0,5.0,14.0,4.0,12.0,11.0,13.0,15.0,12.0,18.0,15.0,9.0,9.0,28.0,24.0,6.0,13.0,1.0,176.0,65.0,1.0,2.0,1.0,2.0,2.0,3.0,2.0,1.0,1.0,1.0,1.0,7.0,10.0,13.0,14.0,15.0,8.0,8.0,15.0,8.0,14.0,14.0,10.0,19.0,15.0,19.0,13.0,20.0,13.0,13.0,13.0,14.0,18.0,13.0,14.0,16.0,12.0,15.0,20.0,16.0,15.0,17.0,8.0,11.0,16.0,13.0,20.0,17.0,15.0,15.0,17.0,14.0,6.0,16.0,16.0,14.0,16.0,16.0,10.0,11.0,10.0,17.0,27.0,73.0,7.0,12.0,0.0,186.0,73.0,2.0,2.0,1.0,2.0,1.0,3.0,2.0,1.0,3.0,1.0,1.0,11.0,10.0,13.0,11.0,14.0,11.0,14.0,13.0,8.0,8.0,15.0,17.0,12.0,14.0,12.0,18.0,13.0,13.0,18.0,12.0,13.0,13.0,12.0,11.0,14.0,14.0,15.0,16.0,13.0,12.0,14.0,13.0,13.0,16.0,13.0,20.0,15.0,12.0,18.0,13.0,13.0,9.0,16.0,15.0,15.0,11.0,13.0,18.0,12.0,15.0,6.0,25.0,45.0,12.0,2.0,0.0,181.0,76.0,3.0,2.0,4.0,3.0,3.0,3.0,3.0,1.0,1.0,3.0,2.0,15.0,17.0,15.0,16.0,17.0,15.0,7.0,16.0,8.0,7.0,17.0,12.0,8.0,17.0,12.0,14.0,9.0,14.0,12.0,17.0,15.0,15.0,16.0,11.0,16.0,10.0,12.0,15.0,13.0,13.0,13.0,8.0,16.0,16.0,13.0,20.0,17.0,12.0,14.0,8.0,15.0,4.0,14.0,12.0,18.0,10.0,11.0,17.0,10.0,12.0,13.0,23.0,50.0,14.0,5.0,1.0,191.0,94.0,2.0,1.0,2.0,3.0,1.0,2.0,3.0,1.0,1.0,1.0,2.0,4.0,11.0,13.0,17.0,13.0,12.0,14.0,14.0,6.0,6.0,11.0,16.0,6.0,13.0,10.0,14.0,14.0,15.0,14.0,11.0,12.0,16.0,12.0,12.0,14.0,9.0,14.0,10.0,14.0,10.0,18.0,16.0,20.0,17.0,16.0,11.0,13.0,19.0,14.0,6.0,14.0,7.0,6.0,11.0,18.0,14.0,18.0,18.0,15.0,12.0,8.0,25.0,70.0,14.0,0.0,0.0,173.0,76.0,1.0,3.0,1.0,3.0,3.0,2.0,2.0,3.0,3.0,1.0,4.0,13.0,12.0,20.0,13.0,17.0,13.0,7.0,13.0,5.0,3.0,15.0,19.0,4.0,18.0,8.0,12.0,17.0,15.0,13.0,16.0,13.0,16.0,18.0,6.0,14.0,7.0,11.0,13.0,17.0,20.0,16.0,8.0,16.0,16.0,16.0,20.0,17.0,9.0,15.0,8.0,15.0,3.0,8.0,15.0,18.0,14.0,15.0,14.0,17.0,14.0,9.0,22.0,9.0,1.0,7.0,1.0,180.0,66.0,1.0,1.0,2.0,2.0,2.0,3.0,1.0,3.0,2.0,2.0,1.0,14.0,13.0,17.0,14.0,14.0,15.0,8.0,13.0,6.0,4.0,14.0,15.0,4.0,17.0,11.0,12.0,11.0,14.0,11.0,15.0,13.0,15.0,15.0,8.0,16.0,7.0,10.0,13.0,16.0,14.0,14.0,10.0,13.0,12.0,17.0,20.0,13.0,11.0,12.0,10.0,13.0,11.0,12.0,10.0,16.0,10.0,13.0,12.0,12.0,16.0,7.0,21.0,8.0,0.0,2.0,1.0,184.0,75.0,3.0,2.0,2.0,3.0,3.0,2.0,3.0,3.0,3.0,2.0,4.0,6.0,8.0,13.0,9.0,13.0,5.0,13.0,6.0,10.0,12.0,11.0,10.0,15.0,13.0,15.0,13.0,13.0,13.0,14.0,10.0,11.0,11.0,9.0,8.0,6.0,11.0,14.0,15.0,15.0,14.0,14.0,13.0,11.0,12.0,14.0,20.0,13.0,14.0,13.0,7.0,13.0,9.0,9.0,15.0,15.0,12.0,11.0,11.0,15.0,14.0,2.0,24.0,9.0,0.0,7.0,1.0,190.0,82.0,2.0,2.0,3.0,3.0,1.0,2.0,2.0,1.0,1.0,3.0,1.0,8.0,14.0,13.0,11.0,12.0,10.0,12.0,11.0,9.0,11.0,13.0,8.0,13.0,13.0,10.0,14.0,14.0,13.0,13.0,14.0,14.0,16.0,11.0,6.0,12.0,12.0,16.0,16.0,12.0,11.0,11.0,14.0,8.0,14.0,14.0,20.0,15.0,13.0,14.0,9.0,13.0,8.0,14.0,13.0,14.0,12.0,14.0,16.0,12.0,15.0,2.0,21.0,5.0,0.0,9.0,0.0,177.0,83.0,2.0,3.0,3.0,3.0,1.0,2.0,4.0,1.0,1.0,2.0,2.0,11.0,14.0,13.0,6.0,13.0,9.0,7.0,9.0,5.0,12.0,10.0,10.0,13.0,13.0,14.0,12.0,14.0,11.0,11.0,8.0,10.0,15.0,12.0,8.0,12.0,12.0,12.0,13.0,15.0,12.0,13.0,10.0,20.0,16.0,16.0,15.0,12.0,14.0,10.0,14.0,12.0,12.0,14.0,13.0,13.0,12.0,12.0,10.0,14.0,13.0,4.0
1,1,30.0,71.0,0.0,20.0,0.0,192.0,90.0,14.0,19.0,12.0,16.0,16.0,19.0,19.0,18.0,20.0,8.0,20.0,4.0,1.0,3.0,1.0,13.0,9.0,10.0,3.0,2.0,3.0,13.0,10.0,1.0,12.0,8.0,20.0,16.0,20.0,14.0,12.0,12.0,18.0,6.0,13.0,1.0,18.0,16.0,14.0,15.0,18.0,16.0,15.0,15.0,13.0,10.0,20.0,12.0,17.0,17.0,7.0,19.0,4.0,14.0,5.0,13.0,15.0,20.0,16.0,12.0,19.0,8.0,26.0,20.0,1.0,0.0,0.0,185.0,75.0,1.0,1.0,1.0,3.0,2.0,3.0,1.0,1.0,1.0,2.0,1.0,11.0,12.0,11.0,8.0,12.0,10.0,8.0,10.0,14.0,10.0,13.0,11.0,15.0,12.0,12.0,16.0,12.0,16.0,16.0,12.0,15.0,12.0,9.0,10.0,13.0,13.0,18.0,14.0,12.0,10.0,13.0,11.0,20.0,18.0,15.0,12.0,16.0,11.0,17.0,6.0,17.0,5.0,16.0,7.0,10.0,16.0,15.0,17.0,17.0,19.0,3.0,28.0,40.0,2.0,22.0,3.0,187.0,82.0,1.0,1.0,3.0,1.0,3.0,1.0,1.0,1.0,2.0,1.0,1.0,4.0,8.0,6.0,8.0,10.0,4.0,16.0,5.0,12.0,18.0,10.0,8.0,18.0,9.0,16.0,14.0,17.0,10.0,18.0,8.0,12.0,17.0,3.0,14.0,8.0,15.0,18.0,12.0,11.0,10.0,15.0,15.0,12.0,16.0,13.0,20.0,16.0,14.0,17.0,10.0,17.0,12.0,14.0,10.0,13.0,17.0,15.0,18.0,16.0,13.0,3.0,27.0,50.0,4.0,21.0,5.0,191.0,92.0,3.0,1.0,1.0,3.0,1.0,1.0,1.0,3.0,1.0,3.0,1.0,5.0,9.0,12.0,10.0,14.0,8.0,15.0,9.0,8.0,17.0,15.0,11.0,17.0,15.0,12.0,18.0,14.0,19.0,13.0,14.0,17.0,14.0,9.0,14.0,10.0,18.0,16.0,12.0,9.0,11.0,17.0,16.0,14.0,15.0,12.0,20.0,14.0,16.0,16.0,9.0,14.0,6.0,7.0,8.0,13.0,16.0,14.0,17.0,18.0,16.0,10.0,29.0,65.0,5.0,15.0,5.0,189.0,90.0,4.0,4.0,2.0,1.0,3.0,2.0,1.0,3.0,2.0,2.0,1.0,6.0,10.0,11.0,13.0,14.0,8.0,16.0,12.0,11.0,15.0,14.0,10.0,13.0,14.0,15.0,15.0,16.0,15.0,18.0,13.0,17.0,18.0,10.0,12.0,16.0,17.0,20.0,19.0,10.0,11.0,15.0,14.0,11.0,10.0,14.0,20.0,17.0,16.0,16.0,12.0,15.0,19.0,14.0,15.0,16.0,9.0,15.0,18.0,16.0,17.0,4.0,27.0,79.0,20.0,16.0,5.0,183.0,72.0,3.0,3.0,4.0,2.0,3.0,3.0,1.0,2.0,3.0,3.0,3.0,15.0,16.0,17.0,12.0,19.0,13.0,7.0,11.0,4.0,6.0,19.0,13.0,9.0,19.0,7.0,18.0,9.0,19.0,15.0,20.0,18.0,14.0,19.0,8.0,20.0,6.0,19.0,12.0,14.0,16.0,14.0,9.0,20.0,15.0,13.0,10.0,15.0,9.0,13.0,5.0,16.0,6.0,10.0,16.0,16.0,12.0,17.0,15.0,14.0,16.0,10.0,26.0,77.0,32.0,6.0,1.0,186.0,74.0,1.0,1.0,2.0,2.0,1.0,2.0,2.0,2.0,2.0,3.0,1.0,7.0,11.0,11.0,15.0,13.0,7.0,12.0,10.0,10.0,7.0,12.0,15.0,8.0,12.0,18.0,19.0,13.0,16.0,18.0,14.0,17.0,18.0,15.0,12.0,20.0,10.0,17.0,18.0,12.0,13.0,15.0,12.0,12.0,19.0,14.0,20.0,19.0,11.0,17.0,9.0,18.0,3.0,16.0,10.0,16.0,16.0,19.0,15.0,10.0,11.0,10.0,27.0,65.0,1.0,15.0,1.0,192.0,90.0,3.0,3.0,2.0,3.0,2.0,3.0,2.0,3.0,1.0,3.0,3.0,7.0,14.0,11.0,6.0,13.0,5.0,10.0,7.0,16.0,18.0,15.0,7.0,18.0,13.0,10.0,17.0,13.0,16.0,12.0,14.0,15.0,11.0,11.0,11.0,7.0,15.0,12.0,9.0,14.0,13.0,17.0,17.0,18.0,14.0,18.0,20.0,14.0,18.0,16.0,8.0,16.0,6.0,16.0,6.0,14.0,7.0,15.0,11.0,15.0,9.0,13.0,26.0,71.0,11.0,10.0,2.0,182.0,78.0,1.0,2.0,3.0,3.0,2.0,3.0,2.0,4.0,3.0,2.0,2.0,18.0,18.0,14.0,13.0,18.0,14.0,7.0,17.0,8.0,8.0,20.0,13.0,9.0,16.0,10.0,17.0,10.0,18.0,14.0,18.0,19.0,9.0,11.0,12.0,14.0,12.0,18.0,13.0,12.0,9.0,12.0,10.0,15.0,12.0,13.0,20.0,16.0,14.0,13.0,10.0,14.0,7.0,13.0,8.0,14.0,8.0,14.0,17.0,18.0,17.0,7.0,21.0,5.0,0.0,14.0,2.0,176.0,70.0,3.0,3.0,2.0,3.0,1.0,2.0,2.0,1.0,3.0,2.0,2.0,10.0,12.0,11.0,12.0,13.0,8.0,10.0,11.0,10.0,12.0,14.0,12.0,13.0,14.0,17.0,16.0,13.0,15.0,12.0,13.0,15.0,16.0,9.0,10.0,14.0,10.0,18.0,17.0,13.0,15.0,11.0,10.0,14.0,14.0,10.0,20.0,16.0,8.0,13.0,8.0,15.0,5.0,18.0,11.0,18.0,10.0,14.0,13.0,15.0,12.0,8.0,30.0,0.0,0.0,0.0,0.0,174.0,70.0,3.0,3.0,2.0,3.0,3.0,1.0,2.0,2.0,1.0,2.0,1.0,10.0,9.0,12.0,10.0,11.0,13.0,9.0,9.0,5.0,10.0,9.0,10.0,7.0,12.0,10.0,12.0,11.0,11.0,11.0,11.0,12.0,11.0,10.0,10.0,12.0,11.0,11.0,12.0,11.0,10.0,11.0,10.0,20.0,13.0,11.0,11.0,11.0,10.0,12.0,3.0,10.0,10.0,15.0,11.0,11.0,11.0,9.0,12.0,8.0,11.0,10.0,38.0,161.0,0.0,11.0,0.0,192.0,91.0,14.0,20.0,20.0,16.0,14.0,12.0,17.0,19.0,18.0,16.0,13.0,1.0,1.0,1.0,1.0,9.0,1.0,1.0,1.0,1.0,1.0,8.0,4.0,1.0,8.0,5.0,17.0,17.0,17.0,16.0,7.0,17.0,18.0,12.0,20.0,1.0,20.0,6.0,10.0,8.0,14.0,14.0,14.0,7.0,12.0,8.0,20.0,10.0,15.0,19.0,5.0,17.0,12.0,1.0,12.0,16.0,20.0,18.0,16.0,15.0,14.0,4.0,23.0,30.0,0.0,5.0,0.0,183.0,74.0,1.0,1.0,3.0,2.0,4.0,1.0,1.0,2.0,2.0,1.0,1.0,6.0,13.0,12.0,2.0,13.0,5.0,12.0,6.0,12.0,14.0,13.0,8.0,14.0,13.0,12.0,13.0,12.0,13.0,14.0,11.0,12.0,13.0,5.0,11.0,12.0,14.0,15.0,13.0,15.0,14.0,13.0,11.0,12.0,10.0,15.0,20.0,13.0,11.0,12.0,11.0,11.0,14.0,15.0,18.0,14.0,17.0,12.0,15.0,19.0,17.0,9.0,31.0,88.0,7.0,26.0,6.0,187.0,86.0,2.0,1.0,4.0,2.0,3.0,3.0,3.0,1.0,1.0,1.0,2.0,2.0,10.0,8.0,8.0,10.0,2.0,16.0,11.0,20.0,17.0,12.0,4.0,18.0,8.0,17.0,16.0,20.0,15.0,15.0,10.0,13.0,18.0,8.0,14.0,13.0,17.0,16.0,19.0,12.0,10.0,17.0,14.0,20.0,17.0,15.0,7.0,16.0,18.0,16.0,15.0,16.0,14.0,14.0,12.0,15.0,17.0,14.0,14.0,16.0,18.0,11.0,25.0,21.0,2.0,18.0,5.0,173.0,67.0,1.0,2.0,2.0,2.0,3.0,3.0,2.0,3.0,2.0,2.0,4.0,15.0,13.0,12.0,13.0,13.0,12.0,11.0,16.0,5.0,9.0,13.0,12.0,12.0,14.0,14.0,12.0,15.0,12.0,9.0,13.0,10.0,18.0,16.0,9.0,15.0,9.0,15.0,17.0,16.0,15.0,11.0,8.0,9.0,16.0,15.0,20.0,16.0,9.0,15.0,8.0,16.0,5.0,20.0,5.0,14.0,19.0,13.0,18.0,19.0,13.0,3.0,30.0,17.0,7.0,16.0,4.0,193.0,86.0,1.0,1.0,1.0,1.0,1.0,1.0,1.0,1.0,1.0,1.0,1.0,4.0,6.0,9.0,16.0,16.0,8.0,17.0,13.0,5.0,9.0,14.0,12.0,7.0,14.0,14.0,15.0,13.0,15.0,13.0,13.0,14.0,18.0,16.0,12.0,16.0,9.0,12.0,11.0,9.0,14.0,17.0,16.0,10.0,13.0,9.0,20.0,14.0,17.0,13.0,15.0,16.0,9.0,8.0,14.0,16.0,14.0,17.0,16.0,7.0,3.0,13.0,23.0,4.0,0.0,6.0,1.0,181.0,79.0,3.0,3.0,1.0,1.0,3.0,2.0,2.0,2.0,1.0,1.0,2.0,13.0,10.0,11.0,12.0,12.0,12.0,12.0,9.0,9.0,13.0,14.0,9.0,14.0,13.0,16.0,14.0,18.0,15.0,12.0,13.0,14.0,16.0,12.0,11.0,14.0,13.0,16.0,16.0,14.0,14.0,9.0,10.0,12.0,14.0,13.0,20.0,15.0,15.0,14.0,15.0,18.0,7.0,8.0,9.0,14.0,12.0,18.0,15.0,8.0,12.0,9.0,35.0,61.0,0.0,15.0,0.0,187.0,87.0,1.0,3.0,2.0,2.0,3.0,1.0,3.0,1.0,4.0,1.0,2.0,2.0,2.0,8.0,3.0,11.0,2.0,13.0,3.0,3.0,18.0,12.0,10.0,16.0,11.0,8.0,18.0,14.0,16.0,19.0,10.0,18.0,16.0,3.0,12.0,5.0,19.0,17.0,12.0,11.0,10.0,18.0,13.0,10.0,8.0,12.0,20.0,13.0,14.0,20.0,3.0,12.0,14.0,5.0,9.0,13.0,13.0,17.0,18.0,18.0,20.0,7.0,26.0,0.0,0.0,0.0,0.0,171.0,69.0,2.0,3.0,4.0,3.0,1.0,1.0,1.0,2.0,1.0,2.0,1.0,7.0,7.0,12.0,14.0,14.0,7.0,7.0,9.0,6.0,8.0,8.0,5.0,6.0,11.0,9.0,11.0,8.0,10.0,8.0,9.0,12.0,11.0,15.0,7.0,13.0,8.0,7.0,9.0,12.0,12.0,12.0,10.0,10.0,10.0,14.0,20.0,8.0,8.0,14.0,9.0,11.0,4.0,9.0,13.0,12.0,10.0,12.0,10.0,3.0,7.0,8.0,31.0,24.0,0.0,0.0,0.0,186.0,82.0,1.0,1.0,1.0,1.0,1.0,1.0,1.0,1.0,1.0,1.0,1.0,4.0,8.0,11.0,14.0,14.0,11.0,17.0,16.0,5.0,11.0,13.0,12.0,16.0,14.0,14.0,13.0,12.0,15.0,14.0,13.0,13.0,16.0,13.0,11.0,18.0,15.0,18.0,18.0,11.0,12.0,11.0,13.0,15.0,14.0,11.0,20.0,17.0,13.0,15.0,13.0,16.0,6.0,17.0,12.0,16.0,16.0,15.0,19.0,18.0,18.0,3.0,29.0,62.0,4.0,0.0,0.0,190.0,86.0,2.0,2.0,1.0,4.0,1.0,1.0,1.0,1.0,2.0,1.0,2.0,9.0,9.0,12.0,9.0,13.0,12.0,14.0,12.0,8.0,16.0,17.0,13.0,15.0,13.0,11.0,20.0,16.0,14.0,16.0,19.0,12.0,17.0,13.0,19.0,7.0,20.0,16.0,14.0,14.0,13.0,15.0,14.0,9.0,15.0,14.0,20.0,16.0,15.0,16.0,11.0,14.0,5.0,11.0,14.0,15.0,16.0,14.0,18.0,14.0,9.0,3.0,31.0,29.0,4.0,0.0,0.0,167.0,60.0,3.0,3.0,1.0,1.0,1.0,1.0,2.0,1.0,1.0,3.0,2.0,11.0,15.0,15.0,12.0,13.0,8.0,7.0,12.0,6.0,5.0,15.0,11.0,8.0,15.0,15.0,15.0,12.0,14.0,13.0,14.0,14.0,15.0,16.0,4.0,17.0,9.0,14.0,15.0,15.0,14.0,8.0,4.0,14.0,10.0,14.0,20.0,10.0,7.0,16.0,11.0,15.0,15.0,15.0,8.0,16.0,16.0,12.0,14.0,13.0,11.0,9.0
2,0,28.0,42.0,0.0,12.0,0.0,190.0,84.0,16.0,14.0,16.0,5.0,16.0,14.0,17.0,18.0,15.0,12.0,14.0,6.0,3.0,5.0,2.0,7.0,8.0,8.0,3.0,12.0,3.0,8.0,1.0,1.0,11.0,12.0,12.0,13.0,14.0,14.0,10.0,13.0,15.0,11.0,16.0,11.0,16.0,13.0,14.0,11.0,14.0,16.0,16.0,20.0,13.0,10.0,5.0,12.0,15.0,14.0,7.0,15.0,8.0,13.0,19.0,8.0,20.0,15.0,17.0,18.0,17.0,4.0,25.0,0.0,0.0,0.0,0.0,184.0,81.0,2.0,1.0,1.0,1.0,3.0,1.0,2.0,3.0,1.0,3.0,3.0,7.0,9.0,10.0,9.0,10.0,7.0,12.0,7.0,9.0,12.0,9.0,7.0,13.0,9.0,12.0,12.0,14.0,11.0,13.0,8.0,11.0,13.0,11.0,10.0,9.0,12.0,14.0,13.0,13.0,12.0,10.0,13.0,8.0,14.0,12.0,20.0,15.0,12.0,12.0,12.0,11.0,5.0,8.0,11.0,13.0,9.0,13.0,11.0,7.0,9.0,1.0,32.0,16.0,0.0,1.0,0.0,187.0,81.0,3.0,3.0,3.0,2.0,2.0,2.0,2.0,3.0,2.0,1.0,1.0,6.0,9.0,10.0,7.0,11.0,9.0,16.0,8.0,10.0,14.0,13.0,8.0,15.0,13.0,14.0,14.0,14.0,13.0,14.0,11.0,13.0,14.0,10.0,20.0,10.0,16.0,17.0,17.0,9.0,11.0,13.0,16.0,10.0,15.0,9.0,20.0,13.0,15.0,15.0,10.0,14.0,4.0,10.0,12.0,16.0,10.0,14.0,14.0,13.0,12.0,5.0,22.0,12.0,2.0,13.0,0.0,170.0,71.0,2.0,2.0,1.0,3.0,2.0,2.0,1.0,1.0,1.0,3.0,2.0,15.0,15.0,12.0,10.0,14.0,15.0,8.0,13.0,12.0,9.0,13.0,10.0,10.0,14.0,14.0,16.0,10.0,17.0,14.0,12.0,16.0,14.0,12.0,8.0,14.0,10.0,17.0,16.0,16.0,17.0,10.0,6.0,20.0,17.0,13.0,8.0,15.0,7.0,15.0,6.0,15.0,8.0,17.0,13.0,13.0,12.0,12.0,14.0,16.0,16.0,8.0,31.0,133.0,61.0,10.0,3.0,186.0,84.0,2.0,1.0,3.0,1.0,3.0,2.0,2.0,3.0,1.0,3.0,2.0,12.0,14.0,15.0,19.0,16.0,14.0,18.0,19.0,6.0,2.0,14.0,19.0,8.0,15.0,6.0,17.0,16.0,13.0,16.0,13.0,17.0,20.0,18.0,15.0,18.0,5.0,6.0,7.0,13.0,12.0,13.0,16.0,15.0,19.0,17.0,20.0,17.0,16.0,17.0,12.0,14.0,7.0,10.0,18.0,20.0,13.0,19.0,20.0,7.0,7.0,12.0,23.0,22.0,0.0,13.0,3.0,179.0,73.0,3.0,3.0,2.0,3.0,1.0,3.0,1.0,2.0,2.0,2.0,2.0,14.0,14.0,15.0,12.0,15.0,12.0,7.0,12.0,6.0,9.0,18.0,15.0,10.0,17.0,12.0,13.0,12.0,17.0,16.0,16.0,16.0,14.0,13.0,13.0,14.0,13.0,15.0,13.0,13.0,15.0,14.0,9.0,14.0,14.0,13.0,20.0,14.0,11.0,16.0,6.0,16.0,6.0,12.0,15.0,11.0,10.0,13.0,18.0,18.0,14.0,6.0,27.0,0.0,0.0,0.0,0.0,185.0,0.0,4.0,1.0,3.0,3.0,1.0,1.0,3.0,3.0,1.0,1.0,1.0,7.0,5.0,6.0,8.0,13.0,7.0,2.0,10.0,3.0,11.0,7.0,7.0,10.0,9.0,9.0,9.0,9.0,9.0,9.0,7.0,13.0,10.0,10.0,9.0,7.0,8.0,8.0,12.0,13.0,13.0,8.0,9.0,10.0,12.0,12.0,20.0,13.0,9.0,10.0,10.0,1.0,10.0,10.0,20.0,11.0,10.0,10.0,10.0,2.0,17.0,6.0,18.0,11.0,1.0,0.0,0.0,176.0,76.0,2.0,3.0,3.0,1.0,2.0,1.0,3.0,2.0,3.0,2.0,2.0,9.0,11.0,14.0,10.0,15.0,9.0,10.0,14.0,10.0,9.0,12.0,11.0,12.0,15.0,17.0,12.0,18.0,14.0,10.0,13.0,10.0,18.0,13.0,9.0,13.0,9.0,15.0,18.0,15.0,15.0,18.0,10.0,10.0,17.0,13.0,20.0,17.0,14.0,12.0,12.0,12.0,4.0,13.0,20.0,17.0,12.0,14.0,13.0,10.0,10.0,13.0,26.0,0.0,0.0,0.0,0.0,173.0,63.0,3.0,2.0,1.0,2.0,2.0,1.0,1.0,2.0,3.0,2.0,3.0,6.0,4.0,3.0,6.0,14.0,4.0,6.0,6.0,1.0,7.0,9.0,1.0,7.0,12.0,8.0,8.0,4.0,9.0,7.0,10.0,14.0,8.0,8.0,8.0,9.0,5.0,8.0,12.0,14.0,14.0,7.0,6.0,5.0,8.0,14.0,20.0,11.0,8.0,8.0,8.0,8.0,5.0,8.0,12.0,8.0,10.0,10.0,14.0,13.0,18.0,2.0,18.0,0.0,0.0,0.0,0.0,170.0,0.0,1.0,2.0,3.0,1.0,4.0,2.0,1.0,1.0,2.0,2.0,3.0,6.0,12.0,12.0,3.0,12.0,3.0,7.0,5.0,6.0,7.0,8.0,1.0,13.0,8.0,8.0,6.0,8.0,3.0,12.0,7.0,11.0,1.0,6.0,8.0,5.0,5.0,7.0,7.0,13.0,13.0,6.0,2.0,8.0,12.0,13.0,20.0,11.0,5.0,8.0,7.0,3.0,8.0,8.0,17.0,10.0,10.0,10.0,11.0,8.0,8.0,2.0,27.0,14.0,0.0,13.0,1.0,175.0,73.0,2.0,1.0,1.0,2.0,3.0,2.0,2.0,3.0,2.0,3.0,3.0,15.0,12.0,12.0,12.0,15.0,12.0,9.0,15.0,8.0,15.0,15.0,18.0,16.0,14.0,17.0,15.0,16.0,15.0,17.0,14.0,15.0,18.0,11.0,17.0,13.0,16.0,18.0,18.0,11.0,12.0,14.0,10.0,11.0,15.0,11.0,20.0,17.0,12.0,18.0,13.0,14.0,7.0,14.0,12.0,12.0,19.0,15.0,18.0,13.0,11.0,5.0,29.0,62.0,0.0,6.0,0.0,196.0,90.0,18.0,11.0,12.0,4.0,12.0,18.0,16.0,14.0,14.0,14.0,18.0,7.0,3.0,2.0,3.0,7.0,10.0,2.0,3.0,3.0,1.0,5.0,3.0,2.0,6.0,12.0,13.0,12.0,9.0,12.0,6.0,11.0,13.0,1.0,8.0,6.0,12.0,11.0,10.0,10.0,14.0,12.0,19.0,13.0,13.0,11.0,20.0,11.0,15.0,10.0,8.0,12.0,7.0,12.0,13.0,13.0,13.0,11.0,13.0,13.0,13.0,6.0,26.0,73.0,0.0,8.0,0.0,181.0,71.0,1.0,1.0,2.0,2.0,2.0,2.0,3.0,1.0,3.0,4.0,3.0,9.0,10.0,9.0,6.0,12.0,8.0,11.0,7.0,10.0,11.0,11.0,10.0,12.0,10.0,10.0,12.0,13.0,12.0,11.0,9.0,10.0,13.0,5.0,14.0,13.0,11.0,15.0,19.0,13.0,12.0,13.0,9.0,20.0,20.0,13.0,15.0,20.0,12.0,15.0,5.0,15.0,5.0,13.0,14.0,12.0,15.0,12.0,16.0,9.0,10.0,3.0,27.0,34.0,1.0,13.0,0.0,175.0,64.0,3.0,1.0,1.0,2.0,2.0,3.0,4.0,1.0,4.0,3.0,3.0,7.0,9.0,8.0,3.0,13.0,6.0,12.0,4.0,2.0,13.0,10.0,3.0,14.0,8.0,15.0,13.0,12.0,10.0,13.0,9.0,12.0,14.0,8.0,9.0,11.0,13.0,14.0,16.0,15.0,14.0,12.0,9.0,20.0,14.0,16.0,5.0,17.0,12.0,15.0,11.0,12.0,4.0,10.0,11.0,16.0,10.0,13.0,10.0,8.0,10.0,15.0,27.0,17.0,0.0,0.0,0.0,181.0,81.0,1.0,3.0,1.0,2.0,2.0,2.0,2.0,2.0,2.0,1.0,3.0,4.0,5.0,10.0,6.0,12.0,4.0,14.0,4.0,8.0,13.0,11.0,10.0,15.0,11.0,13.0,15.0,14.0,15.0,12.0,9.0,12.0,14.0,2.0,14.0,9.0,14.0,15.0,13.0,13.0,12.0,12.0,12.0,11.0,19.0,13.0,20.0,16.0,12.0,15.0,8.0,14.0,8.0,15.0,10.0,11.0,12.0,13.0,14.0,14.0,15.0,3.0,31.0,65.0,2.0,0.0,0.0,182.0,91.0,2.0,2.0,1.0,2.0,1.0,2.0,2.0,3.0,3.0,1.0,2.0,3.0,4.0,7.0,4.0,10.0,3.0,15.0,4.0,6.0,13.0,12.0,4.0,15.0,10.0,16.0,16.0,18.0,11.0,14.0,9.0,12.0,15.0,8.0,18.0,7.0,17.0,13.0,10.0,10.0,11.0,9.0,12.0,14.0,13.0,11.0,20.0,16.0,17.0,15.0,14.0,16.0,1.0,6.0,10.0,16.0,16.0,14.0,14.0,8.0,8.0,16.0,26.0,31.0,0.0,7.0,2.0,168.0,62.0,2.0,3.0,1.0,2.0,3.0,1.0,2.0,1.0,3.0,1.0,1.0,8.0,9.0,13.0,9.0,15.0,7.0,7.0,8.0,3.0,14.0,15.0,6.0,13.0,15.0,13.0,15.0,15.0,15.0,15.0,13.0,14.0,13.0,12.0,8.0,14.0,13.0,17.0,18.0,13.0,15.0,14.0,6.0,11.0,15.0,12.0,20.0,15.0,10.0,14.0,6.0,15.0,8.0,11.0,10.0,14.0,14.0,13.0,15.0,15.0,12.0,2.0,27.0,36.0,2.0,11.0,3.0,183.0,74.0,1.0,3.0,1.0,2.0,3.0,3.0,2.0,2.0,2.0,2.0,1.0,9.0,10.0,10.0,14.0,12.0,11.0,11.0,14.0,4.0,12.0,13.0,11.0,11.0,13.0,6.0,14.0,9.0,15.0,15.0,11.0,15.0,12.0,9.0,13.0,14.0,15.0,15.0,15.0,11.0,14.0,12.0,12.0,11.0,13.0,11.0,20.0,15.0,10.0,12.0,3.0,16.0,6.0,6.0,20.0,12.0,14.0,11.0,17.0,15.0,19.0,1.0,27.0,35.0,4.0,4.0,2.0,186.0,84.0,3.0,3.0,3.0,1.0,3.0,2.0,3.0,2.0,3.0,3.0,3.0,11.0,12.0,14.0,12.0,13.0,10.0,10.0,13.0,10.0,6.0,10.0,14.0,7.0,11.0,9.0,9.0,8.0,10.0,10.0,9.0,8.0,15.0,14.0,8.0,12.0,8.0,12.0,12.0,14.0,11.0,16.0,12.0,20.0,15.0,15.0,10.0,11.0,14.0,10.0,3.0,15.0,7.0,14.0,8.0,14.0,16.0,12.0,15.0,16.0,13.0,4.0,26.0,61.0,22.0,13.0,3.0,186.0,82.0,2.0,2.0,2.0,1.0,3.0,2.0,1.0,1.0,2.0,1.0,3.0,14.0,16.0,16.0,17.0,15.0,17.0,19.0,19.0,15.0,6.0,14.0,13.0,9.0,16.0,10.0,14.0,11.0,13.0,11.0,13.0,13.0,16.0,17.0,9.0,18.0,7.0,10.0,10.0,15.0,14.0,14.0,15.0,20.0,13.0,19.0,11.0,18.0,17.0,13.0,10.0,13.0,15.0,16.0,8.0,14.0,11.0,14.0,14.0,17.0,14.0,12.0,29.0,67.0,4.0,5.0,0.0,183.0,73.0,3.0,3.0,3.0,2.0,3.0,1.0,2.0,1.0,1.0,2.0,2.0,9.0,11.0,10.0,14.0,12.0,6.0,14.0,12.0,12.0,16.0,14.0,14.0,15.0,13.0,12.0,12.0,15.0,15.0,14.0,13.0,15.0,16.0,8.0,14.0,13.0,13.0,16.0,16.0,13.0,13.0,14.0,15.0,20.0,14.0,11.0,4.0,15.0,14.0,14.0,2.0,16.0,9.0,12.0,10.0,14.0,19.0,12.0,14.0,18.0,10.0,8.0,25.0,0.0,0.0,12.0,3.0,188.0,86.0,1.0,3.0,3.0,2.0,2.0,3.0,2.0,1.0,1.0,2.0,2.0,9.0,8.0,11.0,11.0,10.0,6.0,12.0,11.0,4.0,6.0,10.0,12.0,7.0,10.0,15.0,10.0,13.0,10.0,10.0,8.0,9.0,17.0,8.0,10.0,11.0,7.0,15.0,16.0,12.0,10.0,11.0,12.0,8.0,15.0,10.0,20.0,14.0,13.0,9.0,13.0,8.0,5.0,7.0,2.0,11.0,12.0,12.0,11.0,6.0,6.0,8.0
0,2,30.0,71.0,0.0,20.0,0.0,192.0,90.0,14.0,19.0,12.0,16.0,16.0,19.0,19.0,18.0,20.0,8.0,20.0,4.0,1.0,3.0,1.0,13.0,9.0,10.0,3.0,2.0,3.0,13.0,10.0,1.0,12.0,8.0,20.0,16.0,20.0,14.0,12.0,12.0,18.0,6.0,13.0,1.0,18.0,16.0,14.0,15.0,18.0,16.0,15.0,15.0,13.0,10.0,20.0,12.0,17.0,17.0,7.0,19.0,4.0,14.0,5.0,13.0,15.0,20.0,16.0,12.0,19.0,8.0,26.0,20.0,1.0,0.0,0.0,185.0,75.0,1.0,1.0,1.0,3.0,2.0,3.0,1.0,1.0,1.0,2.0,1.0,11.0,12.0,11.0,8.0,12.0,10.0,8.0,10.0,14.0,10.0,13.0,11.0,15.0,12.0,12.0,16.0,12.0,16.0,16.0,12.0,15.0,12.0,9.0,10.0,13.0,13.0,18.0,14.0,12.0,10.0,13.0,11.0,20.0,18.0,15.0,12.0,16.0,11.0,17.0,6.0,17.0,5.0,16.0,7.0,10.0,16.0,15.0,17.0,17.0,19.0,3.0,28.0,40.0,2.0,22.0,3.0,187.0,82.0,1.0,1.0,3.0,1.0,3.0,1.0,1.0,1.0,2.0,1.0,1.0,4.0,8.0,6.0,8.0,10.0,4.0,16.0,5.0,12.0,18.0,10.0,8.0,18.0,9.0,16.0,14.0,17.0,10.0,18.0,8.0,12.0,17.0,3.0,14.0,8.0,15.0,18.0,12.0,11.0,10.0,15.0,15.0,12.0,16.0,13.0,20.0,16.0,14.0,17.0,10.0,17.0,12.0,14.0,10.0,13.0,17.0,15.0,18.0,16.0,13.0,3.0,31.0,120.0,24.0,7.0,2.0,183.0,79.0,1.0,1.0,1.0,1.0,2.0,3.0,3.0,1.0,3.0,2.0,3.0,12.0,13.0,13.0,12.0,15.0,13.0,11.0,13.0,9.0,11.0,16.0,14.0,14.0,16.0,14.0,16.0,15.0,18.0,18.0,14.0,17.0,16.0,10.0,18.0,11.0,15.0,17.0,11.0,8.0,11.0,14.0,10.0,10.0,12.0,10.0,20.0,10.0,14.0,16.0,10.0,17.0,14.0,12.0,12.0,17.0,17.0,16.0,17.0,19.0,14.0,6.0,27.0,79.0,20.0,16.0,5.0,183.0,72.0,3.0,3.0,4.0,2.0,3.0,3.0,1.0,2.0,3.0,3.0,3.0,15.0,16.0,17.0,12.0,19.0,13.0,7.0,11.0,4.0,6.0,19.0,13.0,9.0,19.0,7.0,18.0,9.0,19.0,15.0,20.0,18.0,14.0,19.0,8.0,20.0,6.0,19.0,12.0,14.0,16.0,14.0,9.0,20.0,15.0,13.0,10.0,15.0,9.0,13.0,5.0,16.0,6.0,10.0,16.0,16.0,12.0,17.0,15.0,14.0,16.0,10.0,22.0,24.0,2.0,1.0,1.0,187.0,75.0,1.0,2.0,1.0,1.0,2.0,1.0,2.0,1.0,2.0,3.0,3.0,13.0,13.0,16.0,13.0,17.0,10.0,9.0,17.0,8.0,6.0,14.0,10.0,8.0,16.0,10.0,12.0,9.0,12.0,10.0,15.0,11.0,10.0,15.0,7.0,13.0,8.0,12.0,11.0,15.0,14.0,10.0,16.0,18.0,12.0,13.0,20.0,14.0,11.0,8.0,5.0,15.0,12.0,13.0,11.0,17.0,8.0,10.0,16.0,12.0,14.0,13.0,26.0,77.0,32.0,6.0,1.0,186.0,74.0,1.0,1.0,2.0,2.0,1.0,2.0,2.0,2.0,2.0,3.0,1.0,7.0,11.0,11.0,15.0,13.0,7.0,12.0,10.0,10.0,7.0,12.0,15.0,8.0,12.0,18.0,19.0,13.0,16.0,18.0,14.0,17.0,18.0,15.0,12.0,20.0,10.0,17.0,18.0,12.0,13.0,15.0,12.0,12.0,19.0,14.0,20.0,19.0,11.0,17.0,9.0,18.0,3.0,16.0,10.0,16.0,16.0,19.0,15.0,10.0,11.0,10.0,18.0,0.0,0.0,0.0,0.0,187.0,0.0,3.0,3.0,1.0,1.0,1.0,2.0,3.0,2.0,4.0,3.0,1.0,6.0,7.0,10.0,11.0,10.0,7.0,9.0,9.0,6.0,4.0,8.0,8.0,4.0,9.0,8.0,10.0,8.0,9.0,7.0,9.0,7.0,13.0,11.0,6.0,10.0,5.0,8.0,9.0,11.0,10.0,11.0,14.0,10.0,10.0,12.0,20.0,9.0,8.0,11.0,8.0,11.0,9.0,9.0,6.0,12.0,11.0,14.0,12.0,13.0,13.0,8.0,27.0,65.0,1.0,15.0,1.0,192.0,90.0,3.0,3.0,2.0,3.0,2.0,3.0,2.0,3.0,1.0,3.0,3.0,7.0,14.0,11.0,6.0,13.0,5.0,10.0,7.0,16.0,18.0,15.0,7.0,18.0,13.0,10.0,17.0,13.0,16.0,12.0,14.0,15.0,11.0,11.0,11.0,7.0,15.0,12.0,9.0,14.0,13.0,17.0,17.0,18.0,14.0,18.0,20.0,14.0,18.0,16.0,8.0,16.0,6.0,16.0,6.0,14.0,7.0,15.0,11.0,15.0,9.0,13.0,26.0,71.0,11.0,10.0,2.0,182.0,78.0,1.0,2.0,3.0,3.0,2.0,3.0,2.0,4.0,3.0,2.0,2.0,18.0,18.0,14.0,13.0,18.0,14.0,7.0,17.0,8.0,8.0,20.0,13.0,9.0,16.0,10.0,17.0,10.0,18.0,14.0,18.0,19.0,9.0,11.0,12.0,14.0,12.0,18.0,13.0,12.0,9.0,12.0,10.0,15.0,12.0,13.0,20.0,16.0,14.0,13.0,10.0,14.0,7.0,13.0,8.0,14.0,8.0,14.0,17.0,18.0,17.0,7.0,21.0,5.0,0.0,14.0,2.0,176.0,70.0,3.0,3.0,2.0,3.0,1.0,2.0,2.0,1.0,3.0,2.0,2.0,10.0,12.0,11.0,12.0,13.0,8.0,10.0,11.0,10.0,12.0,14.0,12.0,13.0,14.0,17.0,16.0,13.0,15.0,12.0,13.0,15.0,16.0,9.0,10.0,14.0,10.0,18.0,17.0,13.0,15.0,11.0,10.0,14.0,14.0,10.0,20.0,16.0,8.0,13.0,8.0,15.0,5.0,18.0,11.0,18.0,10.0,14.0,13.0,15.0,12.0,8.0,29.0,82.0,0.0,8.0,0.0,188.0,78.0,12.0,12.0,14.0,14.0,17.0,8.0,15.0,18.0,17.0,18.0,11.0,5.0,2.0,3.0,2.0,11.0,10.0,1.0,9.0,3.0,7.0,10.0,1.0,13.0,8.0,10.0,14.0,18.0,14.0,16.0,9.0,16.0,15.0,6.0,16.0,3.0,17.0,14.0,8.0,15.0,17.0,15.0,15.0,20.0,15.0,14.0,6.0,15.0,14.0,15.0,10.0,15.0,5.0,1.0,14.0,15.0,17.0,18.0,17.0,18.0,18.0,4.0,35.0,80.0,0.0,11.0,0.0,174.0,74.0,3.0,4.0,2.0,2.0,2.0,2.0,1.0,2.0,2.0,3.0,2.0,8.0,14.0,13.0,7.0,15.0,8.0,14.0,4.0,14.0,14.0,13.0,9.0,16.0,15.0,15.0,15.0,16.0,17.0,13.0,11.0,15.0,19.0,14.0,18.0,14.0,17.0,16.0,14.0,12.0,13.0,15.0,9.0,20.0,17.0,12.0,9.0,13.0,11.0,16.0,14.0,16.0,4.0,10.0,18.0,14.0,17.0,17.0,14.0,14.0,14.0,12.0,25.0,34.0,13.0,6.0,2.0,175.0,72.0,3.0,1.0,4.0,14.0,1.0,1.0,1.0,3.0,2.0,2.0,2.0,14.0,17.0,17.0,18.0,19.0,15.0,15.0,14.0,4.0,5.0,14.0,13.0,11.0,17.0,13.0,15.0,13.0,14.0,15.0,15.0,15.0,17.0,17.0,14.0,18.0,10.0,12.0,15.0,15.0,15.0,15.0,9.0,20.0,15.0,14.0,15.0,13.0,10.0,16.0,6.0,14.0,5.0,14.0,13.0,18.0,12.0,12.0,14.0,14.0,8.0,13.0,29.0,26.0,6.0,12.0,4.0,175.0,77.0,1.0,2.0,1.0,3.0,3.0,2.0,1.0,2.0,1.0,2.0,2.0,16.0,14.0,16.0,15.0,15.0,18.0,6.0,15.0,6.0,6.0,18.0,11.0,5.0,17.0,9.0,12.0,10.0,16.0,12.0,16.0,14.0,14.0,16.0,6.0,16.0,6.0,10.0,10.0,13.0,15.0,14.0,8.0,15.0,15.0,14.0,20.0,13.0,12.0,11.0,9.0,16.0,7.0,8.0,8.0,11.0,8.0,13.0,12.0,13.0,11.0,10.0,29.0,55.0,20.0,0.0,0.0,192.0,88.0,1.0,3.0,1.0,2.0,3.0,2.0,1.0,3.0,2.0,2.0,2.0,4.0,8.0,12.0,16.0,14.0,12.0,18.0,14.0,3.0,8.0,11.0,14.0,7.0,15.0,14.0,16.0,17.0,14.0,14.0,14.0,14.0,16.0,13.0,9.0,16.0,9.0,19.0,18.0,11.0,10.0,19.0,17.0,20.0,15.0,13.0,10.0,15.0,19.0,15.0,10.0,16.0,8.0,3.0,15.0,14.0,14.0,15.0,16.0,14.0,14.0,8.0,29.0,51.0,8.0,24.0,0.0,175.0,70.0,3.0,4.0,2.0,3.0,2.0,3.0,2.0,2.0,2.0,1.0,3.0,6.0,12.0,12.0,10.0,13.0,7.0,12.0,12.0,8.0,14.0,13.0,9.0,16.0,13.0,14.0,16.0,16.0,15.0,16.0,11.0,14.0,16.0,8.0,14.0,14.0,15.0,18.0,18.0,15.0,14.0,16.0,8.0,20.0,16.0,14.0,8.0,18.0,14.0,16.0,13.0,14.0,7.0,14.0,15.0,14.0,14.0,14.0,16.0,16.0,16.0,5.0,23.0,38.0,6.0,13.0,4.0,191.0,84.0,3.0,2.0,1.0,3.0,1.0,3.0,3.0,1.0,1.0,4.0,2.0,7.0,12.0,17.0,15.0,19.0,15.0,13.0,18.0,4.0,11.0,16.0,12.0,13.0,18.0,13.0,14.0,13.0,15.0,14.0,16.0,12.0,17.0,19.0,12.0,15.0,12.0,13.0,15.0,13.0,15.0,18.0,16.0,15.0,17.0,16.0,20.0,17.0,17.0,16.0,14.0,12.0,5.0,10.0,17.0,19.0,12.0,14.0,14.0,14.0,13.0,8.0,26.0,44.0,1.0,18.0,1.0,188.0,83.0,2.0,2.0,2.0,1.0,1.0,1.0,3.0,2.0,3.0,4.0,1.0,7.0,12.0,15.0,11.0,13.0,10.0,12.0,11.0,5.0,9.0,13.0,13.0,11.0,12.0,11.0,13.0,13.0,13.0,13.0,13.0,12.0,12.0,12.0,12.0,15.0,9.0,13.0,13.0,14.0,13.0,14.0,13.0,8.0,16.0,15.0,20.0,15.0,15.0,10.0,6.0,13.0,5.0,10.0,14.0,15.0,10.0,14.0,13.0,14.0,14.0,10.0,33.0,64.0,0.0,12.0,0.0,181.0,73.0,3.0,2.0,2.0,2.0,3.0,2.0,1.0,4.0,3.0,1.0,1.0,11.0,13.0,11.0,5.0,13.0,7.0,16.0,8.0,8.0,14.0,12.0,5.0,15.0,14.0,12.0,14.0,14.0,15.0,13.0,13.0,15.0,15.0,10.0,8.0,13.0,14.0,15.0,16.0,12.0,12.0,13.0,12.0,10.0,18.0,13.0,20.0,16.0,15.0,15.0,8.0,14.0,9.0,10.0,16.0,16.0,16.0,14.0,14.0,14.0,17.0,9.0,30.0,36.0,1.0,0.0,0.0,186.0,75.0,3.0,1.0,2.0,1.0,1.0,3.0,3.0,3.0,2.0,4.0,1.0,2.0,5.0,8.0,8.0,13.0,3.0,17.0,4.0,4.0,17.0,12.0,5.0,19.0,12.0,16.0,17.0,18.0,16.0,15.0,10.0,14.0,16.0,5.0,14.0,10.0,16.0,15.0,16.0,15.0,12.0,14.0,14.0,8.0,15.0,14.0,20.0,15.0,15.0,18.0,11.0,16.0,7.0,8.0,14.0,15.0,16.0,15.0,17.0,15.0,15.0,5.0,22.0,3.0,0.0,7.0,1.0,182.0,75.0,3.0,3.0,1.0,3.0,2.0,3.0,1.0,1.0,2.0,2.0,1.0,4.0,11.0,10.0,6.0,14.0,7.0,13.0,10.0,9.0,16.0,14.0,8.0,15.0,14.0,13.0,17.0,15.0,16.0,14.0,11.0,14.0,15.0,8.0,11.0,10.0,15.0,16.0,14.0,14.0,14.0,14.0,11.0,20.0,15.0,14.0,10.0,15.0,15.0,15.0,12.0,15.0,8.0,11.0,12.0,14.0,16.0,15.0,14.0,14.0,14.0,5.0
1,0,28.0,42.0,0.0,12.0,0.0,190.0,84.0,16.0,14.0,16.0,5.0,16.0,14.0,17.0,18.0,15.0,12.0,14.0,6.0,3.0,5.0,2.0,7.0,8.0,8.0,3.0,12.0,3.0,8.0,1.0,1.0,11.0,12.0,12.0,13.0,14.0,14.0,10.0,13.0,15.0,11.0,16.0,11.0,16.0,13.0,14.0,11.0,14.0,16.0,16.0,20.0,13.0,10.0,5.0,12.0,15.0,14.0,7.0,15.0,8.0,13.0,19.0,8.0,20.0,15.0,17.0,18.0,17.0,4.0,18.0,0.0,0.0,0.0,0.0,173.0,0.0,3.0,1.0,2.0,3.0,1.0,3.0,3.0,2.0,1.0,1.0,1.0,5.0,5.0,12.0,10.0,14.0,7.0,7.0,10.0,2.0,6.0,12.0,5.0,8.0,14.0,11.0,6.0,8.0,10.0,7.0,13.0,11.0,7.0,13.0,6.0,7.0,5.0,8.0,11.0,13.0,14.0,7.0,8.0,5.0,13.0,14.0,20.0,9.0,5.0,9.0,6.0,9.0,5.0,9.0,13.0,11.0,8.0,12.0,13.0,1.0,5.0,3.0,32.0,16.0,0.0,1.0,0.0,187.0,81.0,3.0,3.0,3.0,2.0,2.0,2.0,2.0,3.0,2.0,1.0,1.0,6.0,9.0,10.0,7.0,11.0,9.0,16.0,8.0,10.0,14.0,13.0,8.0,15.0,13.0,14.0,14.0,14.0,13.0,14.0,11.0,13.0,14.0,10.0,20.0,10.0,16.0,17.0,17.0,9.0,11.0,13.0,16.0,10.0,15.0,9.0,20.0,13.0,15.0,15.0,10.0,14.0,4.0,10.0,12.0,16.0,10.0,14.0,14.0,13.0,12.0,5.0,22.0,12.0,2.0,13.0,0.0,170.0,71.0,2.0,2.0,1.0,3.0,2.0,2.0,1.0,1.0,1.0,3.0,2.0,15.0,15.0,12.0,10.0,14.0,15.0,8.0,13.0,12.0,9.0,13.0,10.0,10.0,14.0,14.0,16.0,10.0,17.0,14.0,12.0,16.0,14.0,12.0,8.0,14.0,10.0,17.0,16.0,16.0,17.0,10.0,6.0,20.0,17.0,13.0,8.0,15.0,7.0,15.0,6.0,15.0,8.0,17.0,13.0,13.0,12.0,12.0,14.0,16.0,16.0,8.0,31.0,133.0,61.0,10.0,3.0,186.0,84.0,2.0,1.0,3.0,1.0,3.0,2.0,2.0,3.0,1.0,3.0,2.0,12.0,14.0,15.0,19.0,16.0,14.0,18.0,19.0,6.0,2.0,14.0,19.0,8.0,15.0,6.0,17.0,16.0,13.0,16.0,13.0,17.0,20.0,18.0,15.0,18.0,5.0,6.0,7.0,13.0,12.0,13.0,16.0,15.0,19.0,17.0,20.0,17.0,16.0,17.0,12.0,14.0,7.0,10.0,18.0,20.0,13.0,19.0,20.0,7.0,7.0,12.0,23.0,22.0,0.0,13.0,3.0,179.0,73.0,3.0,3.0,2.0,3.0,1.0,3.0,1.0,2.0,2.0,2.0,2.0,14.0,14.0,15.0,12.0,15.0,12.0,7.0,12.0,6.0,9.0,18.0,15.0,10.0,17.0,12.0,13.0,12.0,17.0,16.0,16.0,16.0,14.0,13.0,13.0,14.0,13.0,15.0,13.0,13.0,15.0,14.0,9.0,14.0,14.0,13.0,20.0,14.0,11.0,16.0,6.0,16.0,6.0,12.0,15.0,11.0,10.0,13.0,18.0,18.0,14.0,6.0,24.0,15.0,0.0,15.0,2.0,187.0,83.0,2.0,3.0,2.0,2.0,3.0,3.0,3.0,2.0,1.0,3.0,4.0,8.0,9.0,12.0,9.0,15.0,10.0,7.0,10.0,11.0,13.0,15.0,12.0,16.0,14.0,13.0,15.0,14.0,16.0,18.0,14.0,15.0,12.0,5.0,15.0,10.0,16.0,17.0,13.0,9.0,10.0,19.0,14.0,13.0,16.0,11.0,20.0,16.0,18.0,17.0,8.0,14.0,6.0,6.0,14.0,10.0,18.0,15.0,19.0,16.0,15.0,5.0,18.0,11.0,1.0,0.0,0.0,176.0,76.0,2.0,3.0,3.0,1.0,2.0,1.0,3.0,2.0,3.0,2.0,2.0,9.0,11.0,14.0,10.0,15.0,9.0,10.0,14.0,10.0,9.0,12.0,11.0,12.0,15.0,17.0,12.0,18.0,14.0,10.0,13.0,10.0,18.0,13.0,9.0,13.0,9.0,15.0,18.0,15.0,15.0,18.0,10.0,10.0,17.0,13.0,20.0,17.0,14.0,12.0,12.0,12.0,4.0,13.0,20.0,17.0,12.0,14.0,13.0,10.0,10.0,13.0,26.0,0.0,0.0,0.0,0.0,173.0,63.0,3.0,2.0,1.0,2.0,2.0,1.0,1.0,2.0,3.0,2.0,3.0,6.0,4.0,3.0,6.0,14.0,4.0,6.0,6.0,1.0,7.0,9.0,1.0,7.0,12.0,8.0,8.0,4.0,9.0,7.0,10.0,14.0,8.0,8.0,8.0,9.0,5.0,8.0,12.0,14.0,14.0,7.0,6.0,5.0,8.0,14.0,20.0,11.0,8.0,8.0,8.0,8.0,5.0,8.0,12.0,8.0,10.0,10.0,14.0,13.0,18.0,2.0,18.0,0.0,0.0,0.0,0.0,170.0,0.0,1.0,2.0,3.0,1.0,4.0,2.0,1.0,1.0,2.0,2.0,3.0,6.0,12.0,12.0,3.0,12.0,3.0,7.0,5.0,6.0,7.0,8.0,1.0,13.0,8.0,8.0,6.0,8.0,3.0,12.0,7.0,11.0,1.0,6.0,8.0,5.0,5.0,7.0,7.0,13.0,13.0,6.0,2.0,8.0,12.0,13.0,20.0,11.0,5.0,8.0,7.0,3.0,8.0,8.0,17.0,10.0,10.0,10.0,11.0,8.0,8.0,2.0,27.0,14.0,0.0,13.0,1.0,175.0,73.0,2.0,1.0,1.0,2.0,3.0,2.0,2.0,3.0,2.0,3.0,3.0,15.0,12.0,12.0,12.0,15.0,12.0,9.0,15.0,8.0,15.0,15.0,18.0,16.0,14.0,17.0,15.0,16.0,15.0,17.0,14.0,15.0,18.0,11.0,17.0,13.0,16.0,18.0,18.0,11.0,12.0,14.0,10.0,11.0,15.0,11.0,20.0,17.0,12.0,18.0,13.0,14.0,7.0,14.0,12.0,12.0,19.0,15.0,18.0,13.0,11.0,5.0,29.0,82.0,0.0,8.0,0.0,188.0,78.0,12.0,12.0,14.0,14.0,17.0,8.0,15.0,18.0,17.0,18.0,11.0,5.0,2.0,3.0,2.0,11.0,10.0,1.0,9.0,3.0,7.0,10.0,1.0,13.0,8.0,10.0,14.0,18.0,14.0,16.0,9.0,16.0,15.0,6.0,16.0,3.0,17.0,14.0,8.0,15.0,17.0,15.0,15.0,20.0,15.0,14.0,6.0,15.0,14.0,15.0,10.0,15.0,5.0,1.0,14.0,15.0,17.0,18.0,17.0,18.0,18.0,4.0,35.0,80.0,0.0,11.0,0.0,174.0,74.0,3.0,4.0,2.0,2.0,2.0,2.0,1.0,2.0,2.0,3.0,2.0,8.0,14.0,13.0,7.0,15.0,8.0,14.0,4.0,14.0,14.0,13.0,9.0,16.0,15.0,15.0,15.0,16.0,17.0,13.0,11.0,15.0,19.0,14.0,18.0,14.0,17.0,16.0,14.0,12.0,13.0,15.0,9.0,20.0,17.0,12.0,9.0,13.0,11.0,16.0,14.0,16.0,4.0,10.0,18.0,14.0,17.0,17.0,14.0,14.0,14.0,12.0,25.0,34.0,13.0,6.0,2.0,175.0,72.0,3.0,1.0,4.0,14.0,1.0,1.0,1.0,3.0,2.0,2.0,2.0,14.0,17.0,17.0,18.0,19.0,15.0,15.0,14.0,4.0,5.0,14.0,13.0,11.0,17.0,13.0,15.0,13.0,14.0,15.0,15.0,15.0,17.0,17.0,14.0,18.0,10.0,12.0,15.0,15.0,15.0,15.0,9.0,20.0,15.0,14.0,15.0,13.0,10.0,16.0,6.0,14.0,5.0,14.0,13.0,18.0,12.0,12.0,14.0,14.0,8.0,13.0,29.0,26.0,6.0,12.0,4.0,175.0,77.0,1.0,2.0,1.0,3.0,3.0,2.0,1.0,2.0,1.0,2.0,2.0,16.0,14.0,16.0,15.0,15.0,18.0,6.0,15.0,6.0,6.0,18.0,11.0,5.0,17.0,9.0,12.0,10.0,16.0,12.0,16.0,14.0,14.0,16.0,6.0,16.0,6.0,10.0,10.0,13.0,15.0,14.0,8.0,15.0,15.0,14.0,20.0,13.0,12.0,11.0,9.0,16.0,7.0,8.0,8.0,11.0,8.0,13.0,12.0,13.0,11.0,10.0,29.0,55.0,20.0,0.0,0.0,192.0,88.0,1.0,3.0,1.0,2.0,3.0,2.0,1.0,3.0,2.0,2.0,2.0,4.0,8.0,12.0,16.0,14.0,12.0,18.0,14.0,3.0,8.0,11.0,14.0,7.0,15.0,14.0,16.0,17.0,14.0,14.0,14.0,14.0,16.0,13.0,9.0,16.0,9.0,19.0,18.0,11.0,10.0,19.0,17.0,20.0,15.0,13.0,10.0,15.0,19.0,15.0,10.0,16.0,8.0,3.0,15.0,14.0,14.0,15.0,16.0,14.0,14.0,8.0,29.0,51.0,8.0,24.0,0.0,175.0,70.0,3.0,4.0,2.0,3.0,2.0,3.0,2.0,2.0,2.0,1.0,3.0,6.0,12.0,12.0,10.0,13.0,7.0,12.0,12.0,8.0,14.0,13.0,9.0,16.0,13.0,14.0,16.0,16.0,15.0,16.0,11.0,14.0,16.0,8.0,14.0,14.0,15.0,18.0,18.0,15.0,14.0,16.0,8.0,20.0,16.0,14.0,8.0,18.0,14.0,16.0,13.0,14.0,7.0,14.0,15.0,14.0,14.0,14.0,16.0,16.0,16.0,5.0,23.0,38.0,6.0,13.0,4.0,191.0,84.0,3.0,2.0,1.0,3.0,1.0,3.0,3.0,1.0,1.0,4.0,2.0,7.0,12.0,17.0,15.0,19.0,15.0,13.0,18.0,4.0,11.0,16.0,12.0,13.0,18.0,13.0,14.0,13.0,15.0,14.0,16.0,12.0,17.0,19.0,12.0,15.0,12.0,13.0,15.0,13.0,15.0,18.0,16.0,15.0,17.0,16.0,20.0,17.0,17.0,16.0,14.0,12.0,5.0,10.0,17.0,19.0,12.0,14.0,14.0,14.0,13.0,8.0,26.0,44.0,1.0,18.0,1.0,188.0,83.0,2.0,2.0,2.0,1.0,1.0,1.0,3.0,2.0,3.0,4.0,1.0,7.0,12.0,15.0,11.0,13.0,10.0,12.0,11.0,5.0,9.0,13.0,13.0,11.0,12.0,11.0,13.0,13.0,13.0,13.0,13.0,12.0,12.0,12.0,12.0,15.0,9.0,13.0,13.0,14.0,13.0,14.0,13.0,8.0,16.0,15.0,20.0,15.0,15.0,10.0,6.0,13.0,5.0,10.0,14.0,15.0,10.0,14.0,13.0,14.0,14.0,10.0,33.0,64.0,0.0,12.0,0.0,181.0,73.0,3.0,2.0,2.0,2.0,3.0,2.0,1.0,4.0,3.0,1.0,1.0,11.0,13.0,11.0,5.0,13.0,7.0,16.0,8.0,8.0,14.0,12.0,5.0,15.0,14.0,12.0,14.0,14.0,15.0,13.0,13.0,15.0,15.0,10.0,8.0,13.0,14.0,15.0,16.0,12.0,12.0,13.0,12.0,10.0,18.0,13.0,20.0,16.0,15.0,15.0,8.0,14.0,9.0,10.0,16.0,16.0,16.0,14.0,14.0,14.0,17.0,9.0,30.0,36.0,1.0,0.0,0.0,186.0,75.0,3.0,1.0,2.0,1.0,1.0,3.0,3.0,3.0,2.0,4.0,1.0,2.0,5.0,8.0,8.0,13.0,3.0,17.0,4.0,4.0,17.0,12.0,5.0,19.0,12.0,16.0,17.0,18.0,16.0,15.0,10.0,14.0,16.0,5.0,14.0,10.0,16.0,15.0,16.0,15.0,12.0,14.0,14.0,8.0,15.0,14.0,20.0,15.0,15.0,18.0,11.0,16.0,7.0,8.0,14.0,15.0,16.0,15.0,17.0,15.0,15.0,5.0,22.0,3.0,0.0,7.0,1.0,182.0,75.0,3.0,3.0,1.0,3.0,2.0,3.0,1.0,1.0,2.0,2.0,1.0,4.0,11.0,10.0,6.0,14.0,7.0,13.0,10.0,9.0,16.0,14.0,8.0,15.0,14.0,13.0,17.0,15.0,16.0,14.0,11.0,14.0,15.0,8.0,11.0,10.0,15.0,16.0,14.0,14.0,14.0,14.0,11.0,20.0,15.0,14.0,10.0,15.0,15.0,15.0,12.0,15.0,8.0,11.0,12.0,14.0,16.0,15.0,14.0,14.0,14.0,5.0
2,1,22.0,0.0,0.0,0.0,0.0,184.0,80.0,9.0,11.0,13.0,11.0,8.0,13.0,10.0,12.0,10.0,8.0,8.0,8.0,3.0,2.0,2.0,9.0,10.0,9.0,1.0,3.0,3.0,9.0,1.0,2.0,7.0,10.0,9.0,13.0,9.0,11.0,10.0,10.0,10.0,3.0,12.0,1.0,12.0,11.0,10.0,11.0,13.0,11.0,12.0,5.0,10.0,9.0,20.0,10.0,10.0,10.0,10.0,10.0,8.0,10.0,14.0,11.0,11.0,10.0,12.0,11.0,16.0,8.0,30.0,0.0,0.0,0.0,0.0,186.0,73.0,1.0,2.0,2.0,3.0,4.0,2.0,3.0,2.0,4.0,3.0,2.0,9.0,6.0,5.0,9.0,13.0,4.0,6.0,7.0,9.0,12.0,9.0,5.0,12.0,11.0,8.0,11.0,11.0,10.0,12.0,10.0,12.0,9.0,8.0,14.0,8.0,13.0,10.0,10.0,12.0,15.0,10.0,10.0,5.0,10.0,12.0,20.0,11.0,11.0,10.0,8.0,10.0,9.0,10.0,12.0,8.0,7.0,14.0,11.0,6.0,14.0,4.0,25.0,0.0,0.0,0.0,0.0,190.0,78.0,2.0,2.0,1.0,3.0,2.0,3.0,2.0,1.0,3.0,3.0,1.0,9.0,9.0,11.0,9.0,10.0,9.0,14.0,9.0,10.0,13.0,13.0,4.0,13.0,9.0,11.0,11.0,11.0,10.0,12.0,12.0,13.0,12.0,11.0,15.0,10.0,13.0,10.0,13.0,11.0,10.0,11.0,15.0,8.0,12.0,11.0,20.0,13.0,12.0,14.0,12.0,12.0,10.0,11.0,10.0,12.0,13.0,10.0,12.0,10.0,11.0,9.0,24.0,2.0,0.0,9.0,0.0,175.0,69.0,2.0,1.0,1.0,2.0,2.0,3.0,1.0,3.0,3.0,1.0,3.0,12.0,12.0,15.0,12.0,11.0,9.0,9.0,15.0,8.0,5.0,13.0,10.0,11.0,14.0,10.0,12.0,10.0,13.0,13.0,12.0,12.0,12.0,16.0,6.0,14.0,11.0,12.0,11.0,12.0,14.0,8.0,8.0,12.0,8.0,12.0,20.0,10.0,10.0,10.0,8.0,9.0,13.0,7.0,10.0,9.0,11.0,8.0,10.0,10.0,12.0,7.0,30.0,0.0,0.0,0.0,0.0,180.0,75.0,1.0,1.0,3.0,1.0,3.0,2.0,2.0,3.0,1.0,2.0,1.0,12.0,10.0,13.0,10.0,9.0,11.0,7.0,11.0,7.0,4.0,11.0,10.0,4.0,13.0,7.0,12.0,10.0,14.0,14.0,11.0,14.0,9.0,12.0,12.0,9.0,9.0,13.0,16.0,13.0,12.0,11.0,12.0,8.0,12.0,13.0,20.0,12.0,11.0,15.0,7.0,13.0,7.0,11.0,13.0,12.0,9.0,13.0,16.0,14.0,15.0,8.0,23.0,0.0,0.0,5.0,1.0,183.0,79.0,3.0,1.0,2.0,1.0,3.0,3.0,4.0,2.0,2.0,1.0,1.0,10.0,5.0,6.0,4.0,11.0,6.0,15.0,4.0,8.0,13.0,12.0,2.0,12.0,7.0,9.0,12.0,11.0,11.0,13.0,6.0,13.0,10.0,6.0,8.0,10.0,14.0,9.0,11.0,10.0,10.0,8.0,8.0,11.0,9.0,9.0,20.0,13.0,13.0,11.0,8.0,11.0,4.0,9.0,10.0,10.0,11.0,10.0,11.0,10.0,10.0,9.0,21.0,0.0,0.0,6.0,0.0,185.0,77.0,1.0,3.0,4.0,3.0,3.0,1.0,2.0,2.0,3.0,2.0,3.0,12.0,13.0,11.0,8.0,12.0,13.0,11.0,15.0,11.0,13.0,13.0,7.0,11.0,12.0,11.0,12.0,12.0,12.0,14.0,12.0,12.0,13.0,1.0,5.0,12.0,12.0,13.0,13.0,13.0,12.0,11.0,10.0,20.0,11.0,13.0,8.0,12.0,12.0,13.0,10.0,6.0,9.0,11.0,10.0,12.0,12.0,11.0,12.0,12.0,12.0,1.0,23.0,0.0,0.0,9.0,2.0,179.0,69.0,2.0,3.0,2.0,3.0,3.0,1.0,2.0,3.0,3.0,3.0,1.0,11.0,11.0,11.0,9.0,12.0,10.0,9.0,8.0,7.0,5.0,12.0,5.0,5.0,11.0,12.0,11.0,7.0,11.0,12.0,13.0,13.0,13.0,12.0,11.0,13.0,12.0,12.0,12.0,13.0,13.0,13.0,11.0,12.0,7.0,13.0,20.0,12.0,12.0,12.0,8.0,9.0,11.0,8.0,11.0,12.0,10.0,12.0,12.0,11.0,11.0,11.0,22.0,0.0,0.0,0.0,0.0,182.0,75.0,1.0,1.0,3.0,4.0,3.0,1.0,1.0,2.0,1.0,2.0,2.0,8.0,8.0,12.0,9.0,13.0,8.0,7.0,10.0,3.0,7.0,12.0,10.0,8.0,12.0,10.0,11.0,11.0,9.0,12.0,12.0,12.0,12.0,11.0,8.0,12.0,10.0,13.0,10.0,14.0,13.0,11.0,9.0,11.0,14.0,13.0,20.0,11.0,10.0,12.0,10.0,11.0,10.0,18.0,11.0,9.0,12.0,12.0,12.0,8.0,15.0,7.0,29.0,0.0,0.0,0.0,0.0,181.0,70.0,2.0,3.0,1.0,1.0,3.0,1.0,3.0,1.0,3.0,2.0,1.0,12.0,12.0,13.0,12.0,13.0,12.0,7.0,11.0,5.0,3.0,11.0,15.0,3.0,14.0,12.0,11.0,11.0,12.0,12.0,13.0,12.0,14.0,12.0,5.0,12.0,10.0,8.0,11.0,11.0,13.0,12.0,9.0,11.0,14.0,11.0,20.0,13.0,12.0,13.0,12.0,12.0,7.0,10.0,14.0,12.0,10.0,10.0,8.0,9.0,7.0,11.0,20.0,0.0,0.0,0.0,0.0,188.0,76.0,2.0,2.0,4.0,2.0,1.0,1.0,3.0,3.0,3.0,2.0,1.0,10.0,9.0,11.0,12.0,12.0,6.0,10.0,11.0,3.0,10.0,8.0,9.0,10.0,11.0,3.0,11.0,5.0,13.0,10.0,12.0,11.0,10.0,10.0,5.0,12.0,9.0,11.0,11.0,11.0,12.0,11.0,13.0,11.0,13.0,10.0,20.0,11.0,13.0,11.0,7.0,3.0,6.0,9.0,12.0,8.0,11.0,11.0,12.0,11.0,11.0,13.0,28.0,2.0,1.0,19.0,9.0,183.0,73.0,3.0,1.0,4.0,3.0,2.0,2.0,3.0,1.0,3.0,3.0,2.0,10.0,11.0,15.0,13.0,16.0,7.0,11.0,10.0,5.0,5.0,14.0,14.0,5.0,15.0,7.0,11.0,8.0,15.0,11.0,13.0,13.0,14.0,15.0,7.0,15.0,7.0,9.0,7.0,12.0,14.0,13.0,11.0,14.0,8.0,13.0,20.0,12.0,11.0,10.0,6.0,14.0,13.0,7.0,11.0,13.0,9.0,9.0,13.0,11.0,12.0,9.0,27.0,18.0,1.0,0.0,0.0,191.0,84.0,3.0,4.0,1.0,3.0,3.0,1.0,4.0,2.0,1.0,3.0,2.0,4.0,6.0,7.0,8.0,12.0,10.0,15.0,8.0,5.0,15.0,10.0,11.0,17.0,12.0,17.0,14.0,17.0,11.0,14.0,11.0,13.0,15.0,11.0,14.0,6.0,15.0,16.0,14.0,12.0,10.0,14.0,15.0,11.0,12.0,13.0,20.0,13.0,16.0,14.0,14.0,15.0,10.0,12.0,11.0,16.0,18.0,8.0,12.0,7.0,9.0,15.0,26.0,28.0,2.0,24.0,1.0,188.0,85.0,3.0,2.0,1.0,1.0,2.0,2.0,3.0,1.0,3.0,3.0,1.0,10.0,11.0,9.0,8.0,11.0,12.0,11.0,12.0,18.0,14.0,11.0,8.0,14.0,10.0,17.0,14.0,16.0,10.0,14.0,10.0,12.0,15.0,7.0,13.0,11.0,12.0,18.0,17.0,11.0,10.0,12.0,14.0,12.0,17.0,12.0,20.0,17.0,14.0,14.0,10.0,14.0,9.0,15.0,17.0,14.0,13.0,13.0,17.0,14.0,16.0,8.0,26.0,40.0,11.0,0.0,0.0,177.0,75.0,2.0,1.0,1.0,2.0,4.0,3.0,1.0,3.0,4.0,2.0,1.0,14.0,14.0,13.0,12.0,12.0,10.0,9.0,13.0,7.0,9.0,11.0,12.0,10.0,14.0,13.0,12.0,13.0,11.0,10.0,13.0,12.0,13.0,13.0,8.0,13.0,9.0,12.0,15.0,16.0,14.0,13.0,10.0,12.0,13.0,16.0,20.0,14.0,12.0,9.0,12.0,13.0,12.0,13.0,11.0,16.0,9.0,10.0,8.0,12.0,12.0,16.0,26.0,24.0,2.0,0.0,0.0,193.0,78.0,2.0,1.0,1.0,3.0,3.0,1.0,2.0,4.0,3.0,2.0,3.0,8.0,8.0,12.0,12.0,13.0,8.0,15.0,10.0,10.0,14.0,13.0,11.0,16.0,12.0,18.0,15.0,14.0,13.0,13.0,10.0,11.0,13.0,10.0,12.0,8.0,14.0,16.0,16.0,12.0,15.0,17.0,16.0,7.0,17.0,14.0,20.0,12.0,17.0,16.0,15.0,14.0,8.0,12.0,8.0,12.0,10.0,11.0,8.0,10.0,9.0,5.0,27.0,9.0,2.0,5.0,2.0,193.0,79.0,1.0,2.0,1.0,2.0,2.0,1.0,2.0,1.0,1.0,3.0,4.0,4.0,13.0,11.0,14.0,14.0,7.0,19.0,11.0,6.0,8.0,12.0,13.0,10.0,12.0,15.0,13.0,18.0,13.0,13.0,10.0,11.0,14.0,10.0,10.0,13.0,9.0,15.0,16.0,10.0,9.0,16.0,19.0,20.0,11.0,13.0,10.0,13.0,18.0,13.0,12.0,13.0,17.0,8.0,12.0,11.0,10.0,13.0,5.0,7.0,11.0,15.0,26.0,29.0,16.0,0.0,0.0,174.0,74.0,4.0,3.0,1.0,1.0,3.0,1.0,2.0,2.0,2.0,3.0,2.0,8.0,10.0,14.0,14.0,13.0,8.0,15.0,12.0,10.0,6.0,12.0,10.0,7.0,13.0,12.0,11.0,11.0,12.0,11.0,13.0,11.0,16.0,14.0,8.0,14.0,7.0,12.0,14.0,15.0,16.0,12.0,10.0,14.0,14.0,14.0,20.0,13.0,8.0,11.0,7.0,13.0,6.0,16.0,15.0,16.0,8.0,15.0,14.0,13.0,12.0,8.0,24.0,0.0,0.0,5.0,0.0,185.0,75.0,1.0,1.0,1.0,1.0,1.0,1.0,1.0,1.0,1.0,1.0,1.0,7.0,9.0,15.0,8.0,15.0,8.0,12.0,12.0,8.0,15.0,15.0,10.0,14.0,15.0,11.0,15.0,14.0,14.0,15.0,14.0,14.0,16.0,10.0,12.0,12.0,15.0,16.0,16.0,10.0,11.0,15.0,10.0,9.0,16.0,12.0,20.0,16.0,15.0,14.0,10.0,15.0,10.0,15.0,14.0,15.0,14.0,15.0,16.0,12.0,14.0,6.0,29.0,0.0,0.0,20.0,3.0,181.0,77.0,2.0,1.0,1.0,3.0,1.0,3.0,2.0,1.0,1.0,3.0,3.0,13.0,13.0,12.0,8.0,13.0,12.0,10.0,10.0,6.0,10.0,16.0,18.0,14.0,13.0,14.0,13.0,14.0,15.0,13.0,16.0,13.0,15.0,12.0,18.0,12.0,13.0,20.0,18.0,9.0,12.0,15.0,8.0,10.0,15.0,12.0,20.0,15.0,12.0,15.0,12.0,15.0,6.0,9.0,18.0,10.0,20.0,14.0,20.0,14.0,12.0,2.0,22.0,0.0,0.0,0.0,0.0,181.0,73.0,1.0,1.0,1.0,1.0,3.0,1.0,3.0,2.0,1.0,1.0,3.0,5.0,14.0,12.0,11.0,13.0,3.0,13.0,8.0,13.0,12.0,13.0,5.0,12.0,13.0,6.0,13.0,11.0,15.0,12.0,12.0,10.0,9.0,12.0,9.0,13.0,14.0,14.0,15.0,14.0,12.0,13.0,11.0,10.0,14.0,14.0,20.0,14.0,9.0,14.0,8.0,10.0,5.0,13.0,13.0,11.0,12.0,12.0,11.0,12.0,12.0,2.0,26.0,0.0,0.0,0.0,0.0,180.0,82.0,2.0,1.0,1.0,1.0,2.0,2.0,2.0,4.0,1.0,2.0,1.0,10.0,13.0,14.0,11.0,11.0,7.0,17.0,10.0,16.0,9.0,11.0,10.0,9.0,12.0,11.0,11.0,12.0,11.0,9.0,10.0,11.0,10.0,13.0,9.0,12.0,10.0,14.0,16.0,15.0,13.0,14.0,18.0,10.0,18.0,16.0,20.0,15.0,16.0,11.0,5.0,12.0,8.0,12.0,14.0,13.0,12.0,13.0,15.0,16.0,16.0,6.0
3,0,29.0,13.0,0.0,10.0,0.0,188.0,89.0,15.0,14.0,13.0,9.0,15.0,14.0,14.0,17.0,11.0,10.0,11.0,3.0,2.0,2.0,2.0,11.0,5.0,6.0,2.0,10.0,3.0,11.0,2.0,5.0,11.0,10.0,10.0,12.0,13.0,9.0,9.0,10.0,15.0,5.0,14.0,11.0,14.0,10.0,9.0,9.0,15.0,15.0,15.0,11.0,12.0,9.0,20.0,13.0,15.0,12.0,1.0,11.0,5.0,1.0,15.0,10.0,15.0,8.0,15.0,11.0,11.0,12.0,27.0,18.0,1.0,0.0,0.0,191.0,84.0,3.0,4.0,1.0,3.0,3.0,1.0,4.0,2.0,1.0,3.0,2.0,4.0,6.0,7.0,8.0,12.0,10.0,15.0,8.0,5.0,15.0,10.0,11.0,17.0,12.0,17.0,14.0,17.0,11.0,14.0,11.0,13.0,15.0,11.0,14.0,6.0,15.0,16.0,14.0,12.0,10.0,14.0,15.0,11.0,12.0,13.0,20.0,13.0,16.0,14.0,14.0,15.0,10.0,12.0,11.0,16.0,18.0,8.0,12.0,7.0,9.0,15.0,26.0,28.0,2.0,24.0,1.0,188.0,85.0,3.0,2.0,1.0,1.0,2.0,2.0,3.0,1.0,3.0,3.0,1.0,10.0,11.0,9.0,8.0,11.0,12.0,11.0,12.0,18.0,14.0,11.0,8.0,14.0,10.0,17.0,14.0,16.0,10.0,14.0,10.0,12.0,15.0,7.0,13.0,11.0,12.0,18.0,17.0,11.0,10.0,12.0,14.0,12.0,17.0,12.0,20.0,17.0,14.0,14.0,10.0,14.0,9.0,15.0,17.0,14.0,13.0,13.0,17.0,14.0,16.0,8.0,26.0,40.0,11.0,0.0,0.0,177.0,75.0,2.0,1.0,1.0,2.0,4.0,3.0,1.0,3.0,4.0,2.0,1.0,14.0,14.0,13.0,12.0,12.0,10.0,9.0,13.0,7.0,9.0,11.0,12.0,10.0,14.0,13.0,12.0,13.0,11.0,10.0,13.0,12.0,13.0,13.0,8.0,13.0,9.0,12.0,15.0,16.0,14.0,13.0,10.0,12.0,13.0,16.0,20.0,14.0,12.0,9.0,12.0,13.0,12.0,13.0,11.0,16.0,9.0,10.0,8.0,12.0,12.0,16.0,26.0,24.0,2.0,0.0,0.0,193.0,78.0,2.0,1.0,1.0,3.0,3.0,1.0,2.0,4.0,3.0,2.0,3.0,8.0,8.0,12.0,12.0,13.0,8.0,15.0,10.0,10.0,14.0,13.0,11.0,16.0,12.0,18.0,15.0,14.0,13.0,13.0,10.0,11.0,13.0,10.0,12.0,8.0,14.0,16.0,16.0,12.0,15.0,17.0,16.0,7.0,17.0,14.0,20.0,12.0,17.0,16.0,15.0,14.0,8.0,12.0,8.0,12.0,10.0,11.0,8.0,10.0,9.0,5.0,27.0,9.0,2.0,5.0,2.0,193.0,79.0,1.0,2.0,1.0,2.0,2.0,1.0,2.0,1.0,1.0,3.0,4.0,4.0,13.0,11.0,14.0,14.0,7.0,19.0,11.0,6.0,8.0,12.0,13.0,10.0,12.0,15.0,13.0,18.0,13.0,13.0,10.0,11.0,14.0,10.0,10.0,13.0,9.0,15.0,16.0,10.0,9.0,16.0,19.0,20.0,11.0,13.0,10.0,13.0,18.0,13.0,12.0,13.0,17.0,8.0,12.0,11.0,10.0,13.0,5.0,7.0,11.0,15.0,26.0,29.0,16.0,0.0,0.0,174.0,74.0,4.0,3.0,1.0,1.0,3.0,1.0,2.0,2.0,2.0,3.0,2.0,8.0,10.0,14.0,14.0,13.0,8.0,15.0,12.0,10.0,6.0,12.0,10.0,7.0,13.0,12.0,11.0,11.0,12.0,11.0,13.0,11.0,16.0,14.0,8.0,14.0,7.0,12.0,14.0,15.0,16.0,12.0,10.0,14.0,14.0,14.0,20.0,13.0,8.0,11.0,7.0,13.0,6.0,16.0,15.0,16.0,8.0,15.0,14.0,13.0,12.0,8.0,29.0,0.0,0.0,20.0,3.0,181.0,77.0,2.0,1.0,1.0,3.0,1.0,3.0,2.0,1.0,1.0,3.0,3.0,13.0,13.0,12.0,8.0,13.0,12.0,10.0,10.0,6.0,10.0,16.0,18.0,14.0,13.0,14.0,13.0,14.0,15.0,13.0,16.0,13.0,15.0,12.0,18.0,12.0,13.0,20.0,18.0,9.0,12.0,15.0,8.0,10.0,15.0,12.0,20.0,15.0,12.0,15.0,12.0,15.0,6.0,9.0,18.0,10.0,20.0,14.0,20.0,14.0,12.0,2.0,22.0,0.0,0.0,0.0,0.0,181.0,73.0,1.0,1.0,1.0,1.0,3.0,1.0,3.0,2.0,1.0,1.0,3.0,5.0,14.0,12.0,11.0,13.0,3.0,13.0,8.0,13.0,12.0,13.0,5.0,12.0,13.0,6.0,13.0,11.0,15.0,12.0,12.0,10.0,9.0,12.0,9.0,13.0,14.0,14.0,15.0,14.0,12.0,13.0,11.0,10.0,14.0,14.0,20.0,14.0,9.0,14.0,8.0,10.0,5.0,13.0,13.0,11.0,12.0,12.0,11.0,12.0,12.0,2.0,26.0,0.0,0.0,0.0,0.0,180.0,82.0,2.0,1.0,1.0,1.0,2.0,2.0,2.0,4.0,1.0,2.0,1.0,10.0,13.0,14.0,11.0,11.0,7.0,17.0,10.0,16.0,9.0,11.0,10.0,9.0,12.0,11.0,11.0,12.0,11.0,9.0,10.0,11.0,10.0,13.0,9.0,12.0,10.0,14.0,16.0,15.0,13.0,14.0,18.0,10.0,18.0,16.0,20.0,15.0,16.0,11.0,5.0,12.0,8.0,12.0,14.0,13.0,12.0,13.0,15.0,16.0,16.0,6.0,17.0,0.0,0.0,0.0,0.0,191.0,71.0,3.0,1.0,2.0,2.0,2.0,1.0,3.0,3.0,2.0,1.0,2.0,9.0,9.0,4.0,7.0,12.0,9.0,10.0,6.0,1.0,15.0,12.0,3.0,13.0,10.0,10.0,12.0,9.0,11.0,11.0,11.0,10.0,16.0,9.0,10.0,9.0,14.0,11.0,11.0,10.0,9.0,10.0,13.0,10.0,14.0,11.0,20.0,10.0,11.0,9.0,6.0,10.0,8.0,10.0,18.0,12.0,11.0,12.0,12.0,12.0,13.0,5.0,22.0,0.0,0.0,0.0,0.0,184.0,80.0,9.0,11.0,13.0,11.0,8.0,13.0,10.0,12.0,10.0,8.0,8.0,8.0,3.0,2.0,2.0,9.0,10.0,9.0,1.0,3.0,3.0,9.0,1.0,2.0,7.0,10.0,9.0,13.0,9.0,11.0,10.0,10.0,10.0,3.0,12.0,1.0,12.0,11.0,10.0,11.0,13.0,11.0,12.0,5.0,10.0,9.0,20.0,10.0,10.0,10.0,10.0,10.0,8.0,10.0,14.0,11.0,11.0,10.0,12.0,11.0,16.0,8.0,30.0,0.0,0.0,0.0,0.0,186.0,73.0,1.0,2.0,2.0,3.0,4.0,2.0,3.0,2.0,4.0,3.0,2.0,9.0,6.0,5.0,9.0,13.0,4.0,6.0,7.0,9.0,12.0,9.0,5.0,12.0,11.0,8.0,11.0,11.0,10.0,12.0,10.0,12.0,9.0,8.0,14.0,8.0,13.0,10.0,10.0,12.0,15.0,10.0,10.0,5.0,10.0,12.0,20.0,11.0,11.0,10.0,8.0,10.0,9.0,10.0,12.0,8.0,7.0,14.0,11.0,6.0,14.0,4.0,25.0,0.0,0.0,0.0,0.0,190.0,78.0,2.0,2.0,1.0,3.0,2.0,3.0,2.0,1.0,3.0,3.0,1.0,9.0,9.0,11.0,9.0,10.0,9.0,14.0,9.0,10.0,13.0,13.0,4.0,13.0,9.0,11.0,11.0,11.0,10.0,12.0,12.0,13.0,12.0,11.0,15.0,10.0,13.0,10.0,13.0,11.0,10.0,11.0,15.0,8.0,12.0,11.0,20.0,13.0,12.0,14.0,12.0,12.0,10.0,11.0,10.0,12.0,13.0,10.0,12.0,10.0,11.0,9.0,24.0,2.0,0.0,9.0,0.0,175.0,69.0,2.0,1.0,1.0,2.0,2.0,3.0,1.0,3.0,3.0,1.0,3.0,12.0,12.0,15.0,12.0,11.0,9.0,9.0,15.0,8.0,5.0,13.0,10.0,11.0,14.0,10.0,12.0,10.0,13.0,13.0,12.0,12.0,12.0,16.0,6.0,14.0,11.0,12.0,11.0,12.0,14.0,8.0,8.0,12.0,8.0,12.0,20.0,10.0,10.0,10.0,8.0,9.0,13.0,7.0,10.0,9.0,11.0,8.0,10.0,10.0,12.0,7.0,30.0,0.0,0.0,0.0,0.0,180.0,75.0,1.0,1.0,3.0,1.0,3.0,2.0,2.0,3.0,1.0,2.0,1.0,12.0,10.0,13.0,10.0,9.0,11.0,7.0,11.0,7.0,4.0,11.0,10.0,4.0,13.0,7.0,12.0,10.0,14.0,14.0,11.0,14.0,9.0,12.0,12.0,9.0,9.0,13.0,16.0,13.0,12.0,11.0,12.0,8.0,12.0,13.0,20.0,12.0,11.0,15.0,7.0,13.0,7.0,11.0,13.0,12.0,9.0,13.0,16.0,14.0,15.0,8.0,23.0,0.0,0.0,5.0,1.0,183.0,79.0,3.0,1.0,2.0,1.0,3.0,3.0,4.0,2.0,2.0,1.0,1.0,10.0,5.0,6.0,4.0,11.0,6.0,15.0,4.0,8.0,13.0,12.0,2.0,12.0,7.0,9.0,12.0,11.0,11.0,13.0,6.0,13.0,10.0,6.0,8.0,10.0,14.0,9.0,11.0,10.0,10.0,8.0,8.0,11.0,9.0,9.0,20.0,13.0,13.0,11.0,8.0,11.0,4.0,9.0,10.0,10.0,11.0,10.0,11.0,10.0,10.0,9.0,21.0,0.0,0.0,6.0,0.0,185.0,77.0,1.0,3.0,4.0,3.0,3.0,1.0,2.0,2.0,3.0,2.0,3.0,12.0,13.0,11.0,8.0,12.0,13.0,11.0,15.0,11.0,13.0,13.0,7.0,11.0,12.0,11.0,12.0,12.0,12.0,14.0,12.0,12.0,13.0,1.0,5.0,12.0,12.0,13.0,13.0,13.0,12.0,11.0,10.0,20.0,11.0,13.0,8.0,12.0,12.0,13.0,10.0,6.0,9.0,11.0,10.0,12.0,12.0,11.0,12.0,12.0,12.0,1.0,23.0,0.0,0.0,9.0,2.0,179.0,69.0,2.0,3.0,2.0,3.0,3.0,1.0,2.0,3.0,3.0,3.0,1.0,11.0,11.0,11.0,9.0,12.0,10.0,9.0,8.0,7.0,5.0,12.0,5.0,5.0,11.0,12.0,11.0,7.0,11.0,12.0,13.0,13.0,13.0,12.0,11.0,13.0,12.0,12.0,12.0,13.0,13.0,13.0,11.0,12.0,7.0,13.0,20.0,12.0,12.0,12.0,8.0,9.0,11.0,8.0,11.0,12.0,10.0,12.0,12.0,11.0,11.0,11.0,22.0,0.0,0.0,0.0,0.0,182.0,75.0,1.0,1.0,3.0,4.0,3.0,1.0,1.0,2.0,1.0,2.0,2.0,8.0,8.0,12.0,9.0,13.0,8.0,7.0,10.0,3.0,7.0,12.0,10.0,8.0,12.0,10.0,11.0,11.0,9.0,12.0,12.0,12.0,12.0,11.0,8.0,12.0,10.0,13.0,10.0,14.0,13.0,11.0,9.0,11.0,14.0,13.0,20.0,11.0,10.0,12.0,10.0,11.0,10.0,18.0,11.0,9.0,12.0,12.0,12.0,8.0,15.0,7.0,29.0,0.0,0.0,0.0,0.0,181.0,70.0,2.0,3.0,1.0,1.0,3.0,1.0,3.0,1.0,3.0,2.0,1.0,12.0,12.0,13.0,12.0,13.0,12.0,7.0,11.0,5.0,3.0,11.0,15.0,3.0,14.0,12.0,11.0,11.0,12.0,12.0,13.0,12.0,14.0,12.0,5.0,12.0,10.0,8.0,11.0,11.0,13.0,12.0,9.0,11.0,14.0,11.0,20.0,13.0,12.0,13.0,12.0,12.0,7.0,10.0,14.0,12.0,10.0,10.0,8.0,9.0,7.0,11.0,20.0,0.0,0.0,0.0,0.0,188.0,76.0,2.0,2.0,4.0,2.0,1.0,1.0,3.0,3.0,3.0,2.0,1.0,10.0,9.0,11.0,12.0,12.0,6.0,10.0,11.0,3.0,10.0,8.0,9.0,10.0,11.0,3.0,11.0,5.0,13.0,10.0,12.0,11.0,10.0,10.0,5.0,12.0,9.0,11.0,11.0,11.0,12.0,11.0,13.0,11.0,13.0,10.0,20.0,11.0,13.0,11.0,7.0,3.0,6.0,9.0,12.0,8.0,11.0,11.0,12.0,11.0,11.0,13.0
3,0,29.0,0.0,0.0,24.0,0.0,189.0,79.0,14.0,14.0,12.0,5.0,14.0,13.0,15.0,17.0,11.0,15.0,12.0,1.0,1.0,1.0,1.0,5.0,1.0,4.0,1.0,1.0,1.0,7.0,1.0,1.0,6.0,8.0,14.0,14.0,10.0,12.0,8.0,12.0,15.0,5.0,11.0,1.0,15.0,9.0,14.0,11.0,17.0,13.0,15.0,5.0,14.0,12.0,20.0,13.0,13.0,14.0,3.0,11.0,4.0,1.0,10.0,13.0,18.0,7.0,17.0,15.0,18.0,4.0,31.0,0.0,0.0,0.0,0.0,182.0,80.0,4.0,2.0,3.0,2.0,1.0,2.0,3.0,2.0,3.0,2.0,3.0,6.0,10.0,7.0,6.0,14.0,7.0,9.0,15.0,8.0,14.0,15.0,9.0,15.0,13.0,17.0,16.0,13.0,13.0,15.0,12.0,16.0,15.0,9.0,16.0,13.0,13.0,13.0,13.0,11.0,9.0,14.0,9.0,13.0,10.0,10.0,20.0,15.0,15.0,16.0,10.0,15.0,5.0,11.0,10.0,13.0,13.0,12.0,14.0,13.0,11.0,4.0,33.0,2.0,0.0,2.0,0.0,180.0,76.0,3.0,3.0,3.0,1.0,1.0,1.0,1.0,2.0,3.0,2.0,2.0,6.0,12.0,7.0,6.0,9.0,9.0,11.0,10.0,11.0,13.0,10.0,8.0,14.0,10.0,17.0,16.0,18.0,13.0,13.0,11.0,11.0,15.0,5.0,13.0,12.0,13.0,17.0,16.0,13.0,13.0,17.0,10.0,11.0,17.0,12.0,20.0,16.0,16.0,13.0,13.0,11.0,5.0,16.0,16.0,11.0,12.0,11.0,12.0,12.0,15.0,5.0,24.0,1.0,0.0,8.0,0.0,172.0,68.0,3.0,3.0,2.0,3.0,3.0,1.0,2.0,2.0,1.0,4.0,1.0,12.0,14.0,14.0,13.0,14.0,14.0,7.0,14.0,4.0,5.0,13.0,14.0,6.0,16.0,12.0,12.0,11.0,13.0,15.0,12.0,14.0,13.0,15.0,11.0,15.0,6.0,11.0,12.0,16.0,16.0,11.0,7.0,16.0,15.0,14.0,20.0,12.0,8.0,14.0,9.0,15.0,8.0,14.0,12.0,14.0,11.0,12.0,11.0,11.0,12.0,7.0,25.0,0.0,0.0,0.0,0.0,179.0,77.0,3.0,3.0,4.0,1.0,1.0,3.0,1.0,1.0,2.0,1.0,4.0,6.0,11.0,14.0,13.0,11.0,6.0,8.0,13.0,4.0,7.0,12.0,8.0,8.0,15.0,9.0,12.0,14.0,12.0,13.0,11.0,13.0,13.0,14.0,6.0,14.0,9.0,14.0,15.0,17.0,15.0,11.0,9.0,20.0,12.0,15.0,8.0,14.0,11.0,14.0,12.0,12.0,5.0,13.0,12.0,14.0,12.0,13.0,13.0,13.0,12.0,9.0,32.0,3.0,1.0,0.0,0.0,188.0,77.0,3.0,3.0,3.0,2.0,3.0,2.0,1.0,3.0,2.0,1.0,1.0,6.0,15.0,11.0,5.0,12.0,2.0,14.0,7.0,15.0,14.0,12.0,8.0,14.0,11.0,13.0,14.0,13.0,9.0,14.0,9.0,12.0,14.0,5.0,10.0,13.0,15.0,14.0,14.0,14.0,12.0,14.0,13.0,20.0,13.0,15.0,9.0,16.0,15.0,9.0,15.0,12.0,8.0,15.0,12.0,12.0,12.0,11.0,16.0,12.0,13.0,6.0,28.0,2.0,0.0,0.0,0.0,192.0,89.0,1.0,3.0,2.0,2.0,2.0,2.0,2.0,3.0,1.0,1.0,1.0,6.0,6.0,10.0,6.0,11.0,4.0,14.0,9.0,8.0,16.0,12.0,4.0,15.0,12.0,12.0,17.0,14.0,12.0,16.0,12.0,14.0,18.0,10.0,13.0,7.0,15.0,14.0,14.0,10.0,10.0,15.0,16.0,20.0,14.0,13.0,10.0,15.0,16.0,14.0,9.0,15.0,12.0,7.0,10.0,15.0,15.0,12.0,14.0,12.0,10.0,2.0,31.0,0.0,0.0,0.0,0.0,183.0,78.0,1.0,1.0,1.0,1.0,1.0,1.0,1.0,1.0,1.0,1.0,1.0,9.0,14.0,10.0,4.0,11.0,6.0,11.0,8.0,14.0,13.0,12.0,6.0,13.0,12.0,12.0,13.0,16.0,10.0,14.0,11.0,13.0,12.0,6.0,13.0,9.0,13.0,13.0,14.0,12.0,11.0,10.0,11.0,14.0,11.0,12.0,20.0,15.0,13.0,14.0,7.0,10.0,7.0,16.0,10.0,12.0,12.0,7.0,12.0,14.0,14.0,5.0,21.0,0.0,0.0,1.0,1.0,183.0,70.0,3.0,2.0,1.0,1.0,4.0,1.0,1.0,1.0,3.0,2.0,2.0,12.0,15.0,14.0,15.0,15.0,14.0,11.0,13.0,5.0,5.0,14.0,18.0,7.0,15.0,17.0,12.0,9.0,13.0,10.0,13.0,11.0,13.0,15.0,11.0,14.0,7.0,12.0,10.0,16.0,15.0,12.0,11.0,20.0,11.0,15.0,11.0,13.0,10.0,13.0,15.0,13.0,5.0,14.0,11.0,17.0,13.0,13.0,10.0,8.0,8.0,9.0,35.0,0.0,0.0,18.0,0.0,185.0,83.0,2.0,1.0,2.0,3.0,3.0,3.0,3.0,3.0,2.0,1.0,2.0,4.0,7.0,8.0,7.0,10.0,5.0,13.0,5.0,11.0,14.0,10.0,6.0,14.0,9.0,14.0,15.0,15.0,12.0,14.0,11.0,13.0,13.0,8.0,16.0,9.0,16.0,16.0,16.0,10.0,10.0,14.0,13.0,10.0,14.0,12.0,20.0,16.0,16.0,12.0,10.0,13.0,9.0,6.0,14.0,11.0,16.0,12.0,14.0,16.0,12.0,3.0,23.0,2.0,0.0,4.0,0.0,178.0,78.0,2.0,1.0,3.0,3.0,2.0,2.0,1.0,2.0,3.0,3.0,3.0,12.0,12.0,13.0,8.0,14.0,13.0,10.0,13.0,10.0,15.0,13.0,6.0,15.0,13.0,15.0,13.0,14.0,12.0,13.0,13.0,12.0,15.0,8.0,8.0,13.0,15.0,12.0,14.0,15.0,14.0,15.0,10.0,20.0,15.0,14.0,9.0,16.0,15.0,16.0,12.0,13.0,11.0,11.0,13.0,13.0,13.0,14.0,13.0,14.0,12.0,4.0,32.0,0.0,0.0,3.0,0.0,187.0,87.0,13.0,12.0,15.0,4.0,13.0,8.0,14.0,14.0,7.0,14.0,15.0,4.0,1.0,1.0,2.0,5.0,6.0,6.0,1.0,2.0,3.0,5.0,2.0,2.0,4.0,9.0,12.0,15.0,12.0,12.0,3.0,13.0,11.0,1.0,14.0,2.0,13.0,13.0,10.0,8.0,11.0,14.0,13.0,5.0,9.0,8.0,20.0,12.0,12.0,12.0,7.0,11.0,6.0,11.0,20.0,9.0,20.0,9.0,14.0,12.0,8.0,7.0,29.0,0.0,0.0,5.0,1.0,182.0,72.0,1.0,1.0,2.0,3.0,1.0,1.0,3.0,1.0,3.0,2.0,4.0,11.0,11.0,9.0,4.0,11.0,8.0,12.0,10.0,13.0,13.0,12.0,5.0,13.0,12.0,13.0,12.0,15.0,13.0,15.0,10.0,12.0,11.0,6.0,15.0,10.0,12.0,15.0,15.0,11.0,10.0,13.0,10.0,12.0,12.0,12.0,20.0,14.0,9.0,12.0,5.0,9.0,4.0,11.0,20.0,12.0,8.0,10.0,12.0,12.0,11.0,6.0,27.0,38.0,2.0,7.0,1.0,168.0,57.0,1.0,1.0,2.0,2.0,1.0,1.0,1.0,1.0,3.0,1.0,2.0,12.0,14.0,16.0,11.0,13.0,13.0,7.0,13.0,4.0,7.0,13.0,10.0,8.0,14.0,13.0,8.0,8.0,11.0,12.0,13.0,5.0,10.0,12.0,4.0,12.0,5.0,13.0,13.0,15.0,16.0,11.0,7.0,20.0,8.0,14.0,12.0,12.0,4.0,11.0,10.0,7.0,8.0,7.0,8.0,14.0,12.0,8.0,11.0,8.0,10.0,9.0,27.0,23.0,1.0,2.0,0.0,181.0,69.0,1.0,4.0,2.0,4.0,1.0,3.0,1.0,1.0,1.0,4.0,3.0,15.0,15.0,11.0,11.0,13.0,14.0,8.0,14.0,7.0,9.0,13.0,14.0,9.0,13.0,8.0,13.0,7.0,12.0,9.0,13.0,13.0,10.0,13.0,8.0,12.0,6.0,15.0,12.0,12.0,12.0,12.0,9.0,16.0,13.0,12.0,20.0,12.0,9.0,12.0,8.0,12.0,9.0,12.0,13.0,11.0,10.0,11.0,15.0,8.0,13.0,4.0,23.0,0.0,0.0,0.0,0.0,193.0,87.0,3.0,2.0,3.0,2.0,1.0,1.0,2.0,3.0,3.0,3.0,2.0,5.0,6.0,1.0,2.0,10.0,6.0,10.0,7.0,2.0,13.0,10.0,1.0,13.0,7.0,9.0,11.0,6.0,6.0,12.0,6.0,13.0,7.0,9.0,13.0,6.0,13.0,6.0,8.0,12.0,9.0,7.0,14.0,10.0,5.0,11.0,20.0,13.0,10.0,9.0,9.0,9.0,8.0,9.0,10.0,8.0,10.0,12.0,14.0,1.0,19.0,6.0,31.0,0.0,0.0,0.0,0.0,183.0,82.0,3.0,3.0,3.0,2.0,3.0,1.0,3.0,2.0,3.0,3.0,3.0,5.0,9.0,11.0,14.0,13.0,6.0,13.0,11.0,5.0,5.0,13.0,13.0,8.0,13.0,13.0,13.0,16.0,14.0,12.0,11.0,12.0,6.0,7.0,11.0,15.0,10.0,14.0,15.0,11.0,11.0,17.0,12.0,20.0,13.0,11.0,10.0,15.0,16.0,13.0,10.0,12.0,7.0,7.0,9.0,9.0,12.0,10.0,13.0,10.0,14.0,2.0,28.0,0.0,0.0,0.0,0.0,178.0,73.0,1.0,1.0,1.0,1.0,3.0,1.0,1.0,2.0,1.0,4.0,3.0,12.0,12.0,13.0,11.0,13.0,7.0,7.0,13.0,9.0,6.0,13.0,13.0,9.0,13.0,10.0,13.0,9.0,11.0,11.0,13.0,13.0,11.0,12.0,7.0,13.0,9.0,14.0,11.0,13.0,13.0,9.0,8.0,12.0,13.0,13.0,20.0,14.0,10.0,12.0,12.0,12.0,9.0,12.0,14.0,11.0,12.0,8.0,13.0,13.0,12.0,7.0,35.0,22.0,1.0,23.0,0.0,183.0,80.0,1.0,1.0,2.0,2.0,1.0,3.0,2.0,3.0,1.0,1.0,3.0,4.0,6.0,6.0,8.0,8.0,10.0,18.0,10.0,11.0,14.0,9.0,12.0,14.0,8.0,18.0,14.0,17.0,12.0,14.0,8.0,12.0,15.0,5.0,14.0,8.0,15.0,16.0,12.0,8.0,8.0,11.0,12.0,8.0,12.0,9.0,20.0,12.0,14.0,13.0,16.0,15.0,8.0,10.0,12.0,16.0,12.0,13.0,18.0,9.0,10.0,4.0,23.0,1.0,0.0,0.0,0.0,179.0,70.0,1.0,2.0,2.0,2.0,1.0,2.0,2.0,2.0,3.0,3.0,3.0,8.0,8.0,9.0,5.0,12.0,7.0,12.0,9.0,10.0,13.0,12.0,2.0,14.0,13.0,14.0,11.0,16.0,11.0,14.0,10.0,12.0,11.0,8.0,9.0,11.0,13.0,16.0,16.0,11.0,12.0,14.0,8.0,12.0,11.0,11.0,20.0,16.0,10.0,12.0,9.0,12.0,5.0,11.0,9.0,12.0,13.0,13.0,9.0,9.0,19.0,2.0,20.0,0.0,0.0,0.0,0.0,178.0,74.0,2.0,2.0,1.0,1.0,2.0,1.0,1.0,2.0,1.0,3.0,4.0,7.0,8.0,10.0,7.0,12.0,8.0,11.0,9.0,10.0,12.0,12.0,7.0,12.0,12.0,11.0,13.0,13.0,11.0,13.0,11.0,12.0,19.0,8.0,10.0,11.0,12.0,14.0,14.0,12.0,13.0,12.0,8.0,20.0,12.0,13.0,14.0,14.0,9.0,10.0,9.0,4.0,11.0,11.0,19.0,11.0,10.0,10.0,12.0,9.0,16.0,5.0,30.0,0.0,0.0,0.0,0.0,181.0,77.0,1.0,1.0,1.0,1.0,1.0,1.0,1.0,1.0,1.0,1.0,1.0,13.0,12.0,13.0,12.0,14.0,15.0,6.0,15.0,3.0,9.0,14.0,14.0,9.0,14.0,11.0,13.0,11.0,13.0,13.0,13.0,14.0,10.0,14.0,13.0,13.0,10.0,13.0,13.0,12.0,13.0,11.0,10.0,10.0,12.0,12.0,20.0,14.0,7.0,13.0,9.0,10.0,10.0,13.0,8.0,11.0,10.0,11.0,14.0,19.0,18.0,2.0
0,3,21.0,0.0,0.0,7.0,0.0,190.0,80.0,13.0,12.0,13.0,11.0,12.0,11.0,14.0,11.0,11.0,7.0,12.0,5.0,5.0,5.0,5.0,10.0,3.0,8.0,5.0,3.0,3.0,10.0,5.0,8.0,9.0,12.0,11.0,11.0,10.0,11.0,11.0,12.0,5.0,2.0,11.0,1.0,12.0,13.0,11.0,10.0,12.0,12.0,13.0,8.0,11.0,11.0,20.0,8.0,10.0,11.0,5.0,1.0,3.0,11.0,11.0,12.0,12.0,11.0,12.0,10.0,11.0,8.0,23.0,0.0,0.0,1.0,0.0,191.0,85.0,3.0,4.0,2.0,1.0,3.0,3.0,2.0,2.0,2.0,1.0,1.0,7.0,9.0,10.0,5.0,11.0,11.0,11.0,9.0,9.0,13.0,11.0,10.0,13.0,8.0,12.0,12.0,11.0,11.0,12.0,9.0,12.0,10.0,12.0,10.0,10.0,13.0,10.0,12.0,10.0,12.0,13.0,13.0,10.0,11.0,10.0,20.0,12.0,13.0,12.0,8.0,11.0,6.0,9.0,11.0,10.0,12.0,10.0,11.0,11.0,10.0,9.0,21.0,0.0,0.0,0.0,0.0,183.0,74.0,1.0,3.0,1.0,3.0,2.0,1.0,2.0,2.0,3.0,2.0,2.0,14.0,13.0,14.0,12.0,13.0,14.0,6.0,13.0,8.0,5.0,13.0,15.0,5.0,14.0,9.0,13.0,12.0,12.0,11.0,14.0,13.0,11.0,14.0,15.0,13.0,7.0,9.0,10.0,12.0,12.0,14.0,8.0,20.0,10.0,13.0,10.0,11.0,8.0,13.0,8.0,12.0,5.0,13.0,7.0,13.0,13.0,11.0,12.0,12.0,12.0,8.0,30.0,0.0,0.0,0.0,0.0,183.0,77.0,2.0,1.0,3.0,2.0,3.0,2.0,3.0,3.0,4.0,3.0,3.0,11.0,11.0,10.0,9.0,11.0,12.0,11.0,10.0,9.0,10.0,9.0,11.0,10.0,10.0,14.0,11.0,12.0,11.0,11.0,10.0,11.0,14.0,12.0,11.0,9.0,11.0,12.0,11.0,11.0,10.0,11.0,11.0,8.0,12.0,11.0,20.0,11.0,9.0,13.0,17.0,11.0,7.0,18.0,13.0,13.0,12.0,11.0,10.0,9.0,8.0,6.0,22.0,0.0,0.0,0.0,0.0,180.0,69.0,1.0,1.0,1.0,2.0,1.0,1.0,3.0,3.0,2.0,1.0,2.0,12.0,12.0,13.0,11.0,13.0,12.0,10.0,13.0,8.0,8.0,14.0,12.0,9.0,14.0,11.0,12.0,11.0,12.0,12.0,14.0,12.0,10.0,14.0,15.0,12.0,10.0,12.0,12.0,13.0,13.0,11.0,11.0,20.0,9.0,13.0,8.0,12.0,11.0,14.0,11.0,12.0,9.0,9.0,11.0,11.0,12.0,11.0,11.0,11.0,12.0,9.0,24.0,0.0,0.0,0.0,0.0,178.0,71.0,3.0,2.0,1.0,2.0,3.0,2.0,1.0,1.0,2.0,4.0,1.0,12.0,12.0,12.0,11.0,12.0,8.0,9.0,9.0,8.0,5.0,13.0,12.0,6.0,12.0,10.0,11.0,11.0,11.0,12.0,13.0,11.0,10.0,13.0,11.0,13.0,12.0,12.0,13.0,12.0,12.0,12.0,10.0,20.0,8.0,13.0,12.0,12.0,12.0,12.0,7.0,10.0,11.0,9.0,10.0,10.0,11.0,10.0,12.0,11.0,11.0,9.0,22.0,0.0,0.0,1.0,0.0,178.0,75.0,1.0,3.0,2.0,2.0,3.0,2.0,1.0,3.0,3.0,2.0,2.0,12.0,12.0,10.0,7.0,11.0,10.0,10.0,11.0,11.0,13.0,12.0,10.0,14.0,11.0,12.0,11.0,12.0,11.0,10.0,9.0,10.0,14.0,12.0,13.0,13.0,13.0,11.0,12.0,13.0,11.0,10.0,9.0,20.0,12.0,13.0,8.0,13.0,12.0,12.0,7.0,13.0,10.0,9.0,13.0,13.0,12.0,12.0,13.0,12.0,12.0,8.0,23.0,0.0,0.0,10.0,2.0,182.0,78.0,2.0,2.0,3.0,3.0,3.0,3.0,1.0,1.0,3.0,3.0,3.0,13.0,12.0,14.0,11.0,10.0,11.0,11.0,10.0,8.0,8.0,11.0,9.0,8.0,14.0,11.0,12.0,10.0,9.0,11.0,12.0,10.0,10.0,11.0,10.0,12.0,8.0,8.0,11.0,13.0,12.0,10.0,7.0,20.0,9.0,13.0,13.0,12.0,10.0,11.0,8.0,10.0,6.0,9.0,8.0,13.0,12.0,10.0,11.0,10.0,10.0,8.0,28.0,0.0,0.0,0.0,0.0,186.0,72.0,3.0,1.0,1.0,3.0,1.0,3.0,1.0,2.0,1.0,3.0,1.0,10.0,7.0,11.0,8.0,11.0,11.0,12.0,12.0,10.0,11.0,13.0,12.0,12.0,11.0,13.0,12.0,13.0,12.0,13.0,9.0,12.0,13.0,8.0,15.0,12.0,13.0,14.0,13.0,12.0,10.0,12.0,11.0,13.0,12.0,12.0,20.0,13.0,13.0,14.0,9.0,10.0,7.0,17.0,12.0,12.0,12.0,10.0,11.0,11.0,12.0,9.0,24.0,0.0,0.0,0.0,0.0,181.0,76.0,1.0,3.0,3.0,3.0,3.0,3.0,1.0,1.0,2.0,2.0,2.0,12.0,13.0,9.0,4.0,11.0,10.0,12.0,16.0,9.0,12.0,12.0,10.0,13.0,8.0,9.0,12.0,11.0,12.0,12.0,11.0,12.0,13.0,9.0,10.0,10.0,13.0,11.0,12.0,13.0,12.0,11.0,10.0,20.0,11.0,13.0,9.0,12.0,11.0,11.0,10.0,10.0,7.0,9.0,9.0,12.0,11.0,12.0,12.0,12.0,11.0,8.0,24.0,0.0,0.0,4.0,0.0,182.0,76.0,2.0,3.0,2.0,1.0,1.0,1.0,2.0,2.0,3.0,3.0,2.0,10.0,12.0,12.0,10.0,11.0,7.0,10.0,9.0,7.0,4.0,10.0,10.0,8.0,11.0,14.0,12.0,12.0,11.0,10.0,10.0,10.0,13.0,11.0,12.0,13.0,8.0,12.0,14.0,14.0,13.0,14.0,8.0,8.0,12.0,14.0,20.0,12.0,14.0,13.0,8.0,13.0,6.0,9.0,11.0,11.0,12.0,10.0,11.0,12.0,10.0,8.0,23.0,0.0,0.0,0.0,0.0,192.0,84.0,14.0,12.0,8.0,10.0,13.0,13.0,11.0,12.0,13.0,14.0,12.0,1.0,3.0,3.0,1.0,8.0,3.0,3.0,3.0,2.0,3.0,12.0,4.0,1.0,10.0,11.0,11.0,13.0,11.0,8.0,11.0,12.0,14.0,3.0,12.0,3.0,13.0,12.0,13.0,12.0,13.0,13.0,15.0,6.0,12.0,13.0,20.0,14.0,13.0,12.0,5.0,4.0,9.0,11.0,10.0,10.0,10.0,11.0,10.0,1.0,14.0,6.0,24.0,3.0,0.0,18.0,0.0,176.0,74.0,2.0,1.0,2.0,3.0,1.0,2.0,2.0,2.0,2.0,2.0,3.0,7.0,13.0,13.0,6.0,14.0,5.0,12.0,7.0,13.0,12.0,13.0,7.0,14.0,13.0,13.0,11.0,15.0,8.0,11.0,12.0,10.0,14.0,5.0,5.0,12.0,14.0,14.0,14.0,13.0,9.0,12.0,11.0,10.0,9.0,14.0,20.0,15.0,13.0,12.0,9.0,6.0,7.0,8.0,20.0,13.0,17.0,12.0,15.0,15.0,15.0,5.0,28.0,0.0,0.0,0.0,0.0,188.0,81.0,2.0,3.0,4.0,1.0,4.0,3.0,1.0,1.0,2.0,3.0,3.0,8.0,11.0,7.0,6.0,13.0,7.0,12.0,6.0,11.0,14.0,11.0,7.0,13.0,12.0,12.0,12.0,13.0,12.0,13.0,12.0,12.0,11.0,10.0,14.0,8.0,13.0,14.0,14.0,12.0,12.0,13.0,13.0,8.0,10.0,12.0,20.0,14.0,12.0,12.0,10.0,12.0,5.0,11.0,11.0,12.0,11.0,8.0,14.0,11.0,15.0,1.0,31.0,32.0,1.0,15.0,0.0,189.0,85.0,2.0,3.0,2.0,1.0,1.0,3.0,1.0,1.0,3.0,1.0,1.0,6.0,8.0,8.0,4.0,12.0,12.0,15.0,9.0,11.0,12.0,12.0,12.0,16.0,11.0,13.0,15.0,17.0,14.0,15.0,10.0,15.0,17.0,5.0,18.0,10.0,15.0,12.0,15.0,10.0,10.0,16.0,15.0,7.0,13.0,11.0,20.0,15.0,16.0,16.0,7.0,16.0,14.0,10.0,13.0,16.0,16.0,12.0,14.0,15.0,13.0,6.0,23.0,0.0,0.0,0.0,0.0,175.0,74.0,3.0,1.0,3.0,1.0,2.0,1.0,3.0,3.0,2.0,3.0,2.0,12.0,10.0,14.0,11.0,11.0,7.0,6.0,9.0,11.0,10.0,10.0,8.0,12.0,13.0,9.0,12.0,12.0,11.0,13.0,11.0,10.0,13.0,11.0,7.0,13.0,11.0,13.0,15.0,15.0,12.0,13.0,5.0,20.0,14.0,14.0,10.0,14.0,12.0,13.0,11.0,11.0,8.0,11.0,15.0,12.0,11.0,9.0,10.0,11.0,19.0,2.0,22.0,22.0,3.0,17.0,11.0,180.0,78.0,1.0,2.0,2.0,3.0,1.0,3.0,1.0,3.0,2.0,3.0,3.0,13.0,14.0,13.0,12.0,13.0,13.0,10.0,13.0,7.0,4.0,13.0,12.0,4.0,14.0,10.0,11.0,13.0,12.0,10.0,11.0,11.0,14.0,16.0,7.0,15.0,5.0,13.0,14.0,14.0,15.0,13.0,11.0,12.0,10.0,13.0,20.0,13.0,11.0,10.0,7.0,12.0,7.0,13.0,12.0,18.0,16.0,12.0,15.0,14.0,10.0,8.0,23.0,26.0,2.0,12.0,2.0,187.0,85.0,3.0,3.0,3.0,3.0,1.0,1.0,2.0,1.0,1.0,3.0,1.0,11.0,9.0,12.0,13.0,15.0,11.0,10.0,14.0,6.0,9.0,15.0,11.0,6.0,15.0,14.0,15.0,12.0,15.0,12.0,14.0,14.0,12.0,10.0,8.0,16.0,11.0,15.0,15.0,10.0,14.0,12.0,10.0,8.0,13.0,10.0,20.0,15.0,13.0,13.0,8.0,12.0,5.0,10.0,10.0,16.0,12.0,13.0,18.0,11.0,20.0,2.0,20.0,0.0,0.0,0.0,0.0,186.0,83.0,3.0,1.0,2.0,1.0,3.0,2.0,2.0,1.0,2.0,4.0,1.0,11.0,8.0,10.0,9.0,13.0,16.0,12.0,11.0,10.0,12.0,11.0,10.0,10.0,13.0,13.0,9.0,13.0,11.0,11.0,12.0,11.0,7.0,8.0,9.0,12.0,12.0,11.0,13.0,13.0,12.0,12.0,12.0,10.0,12.0,13.0,20.0,12.0,14.0,12.0,8.0,11.0,4.0,11.0,16.0,17.0,8.0,10.0,14.0,10.0,11.0,8.0,21.0,0.0,0.0,0.0,0.0,187.0,90.0,1.0,3.0,3.0,3.0,2.0,1.0,3.0,3.0,2.0,2.0,3.0,6.0,8.0,12.0,13.0,13.0,8.0,11.0,12.0,12.0,7.0,10.0,10.0,5.0,13.0,10.0,12.0,13.0,11.0,12.0,11.0,9.0,13.0,13.0,6.0,12.0,7.0,11.0,8.0,12.0,12.0,14.0,15.0,13.0,17.0,14.0,20.0,12.0,17.0,13.0,8.0,13.0,6.0,5.0,15.0,16.0,9.0,12.0,18.0,13.0,11.0,8.0,18.0,5.0,2.0,7.0,0.0,179.0,72.0,3.0,1.0,1.0,2.0,1.0,3.0,2.0,1.0,2.0,1.0,2.0,13.0,10.0,14.0,9.0,13.0,11.0,7.0,8.0,6.0,4.0,10.0,8.0,4.0,13.0,5.0,7.0,12.0,11.0,11.0,14.0,8.0,8.0,16.0,4.0,12.0,5.0,13.0,12.0,15.0,13.0,11.0,11.0,20.0,14.0,15.0,13.0,7.0,10.0,8.0,8.0,4.0,11.0,10.0,20.0,14.0,8.0,9.0,10.0,11.0,16.0,3.0,26.0,0.0,0.0,4.0,0.0,183.0,74.0,1.0,2.0,3.0,2.0,1.0,4.0,3.0,1.0,2.0,1.0,4.0,12.0,10.0,11.0,7.0,13.0,15.0,13.0,12.0,8.0,11.0,13.0,6.0,13.0,12.0,10.0,13.0,12.0,12.0,13.0,13.0,12.0,14.0,13.0,14.0,14.0,10.0,14.0,14.0,11.0,12.0,13.0,12.0,20.0,15.0,11.0,7.0,14.0,12.0,13.0,8.0,13.0,17.0,11.0,12.0,14.0,11.0,12.0,14.0,11.0,12.0,4.0
3,1,25.0,0.0,0.0,7.0,0.0,193.0,85.0,12.0,11.0,11.0,5.0,12.0,12.0,14.0,14.0,12.0,5.0,13.0,3.0,3.0,1.0,2.0,10.0,5.0,8.0,1.0,2.0,3.0,12.0,3.0,1.0,10.0,9.0,10.0,13.0,9.0,11.0,8.0,12.0,12.0,10.0,12.0,3.0,13.0,10.0,12.0,11.0,12.0,14.0,13.0,8.0,13.0,10.0,20.0,10.0,14.0,11.0,9.0,14.0,5.0,11.0,6.0,12.0,8.0,15.0,15.0,13.0,15.0,7.0,23.0,0.0,0.0,9.0,0.0,186.0,78.0,2.0,2.0,3.0,1.0,4.0,1.0,3.0,3.0,1.0,3.0,3.0,6.0,11.0,10.0,10.0,13.0,12.0,14.0,8.0,9.0,13.0,15.0,12.0,13.0,11.0,7.0,11.0,7.0,9.0,12.0,8.0,10.0,10.0,13.0,10.0,13.0,14.0,14.0,8.0,15.0,10.0,14.0,14.0,11.0,15.0,15.0,20.0,16.0,14.0,12.0,10.0,12.0,6.0,5.0,9.0,14.0,12.0,8.0,11.0,11.0,10.0,6.0,21.0,0.0,0.0,1.0,0.0,182.0,75.0,4.0,1.0,2.0,3.0,1.0,2.0,1.0,3.0,1.0,1.0,1.0,9.0,10.0,10.0,7.0,11.0,9.0,12.0,14.0,11.0,13.0,10.0,10.0,13.0,11.0,11.0,11.0,12.0,11.0,12.0,9.0,13.0,13.0,7.0,11.0,10.0,13.0,12.0,13.0,12.0,11.0,12.0,11.0,20.0,12.0,13.0,10.0,13.0,13.0,13.0,8.0,11.0,9.0,9.0,10.0,10.0,14.0,10.0,11.0,11.0,10.0,9.0,23.0,8.0,0.0,10.0,0.0,192.0,80.0,3.0,2.0,1.0,3.0,1.0,2.0,3.0,1.0,1.0,3.0,1.0,6.0,8.0,7.0,6.0,9.0,6.0,14.0,7.0,9.0,13.0,10.0,6.0,14.0,9.0,14.0,11.0,14.0,8.0,11.0,8.0,11.0,12.0,6.0,11.0,10.0,13.0,12.0,13.0,12.0,11.0,15.0,15.0,20.0,13.0,14.0,8.0,13.0,15.0,12.0,12.0,12.0,8.0,10.0,14.0,14.0,7.0,12.0,10.0,12.0,12.0,11.0,21.0,0.0,0.0,0.0,0.0,181.0,78.0,2.0,3.0,3.0,4.0,4.0,2.0,1.0,1.0,1.0,3.0,2.0,10.0,10.0,11.0,8.0,12.0,8.0,10.0,8.0,8.0,13.0,13.0,4.0,12.0,11.0,12.0,10.0,11.0,11.0,13.0,8.0,12.0,14.0,14.0,12.0,11.0,11.0,14.0,14.0,14.0,10.0,8.0,11.0,7.0,17.0,15.0,20.0,10.0,9.0,12.0,8.0,12.0,7.0,13.0,10.0,15.0,12.0,14.0,14.0,12.0,11.0,1.0,24.0,12.0,2.0,18.0,9.0,177.0,73.0,2.0,3.0,1.0,2.0,2.0,2.0,3.0,1.0,3.0,1.0,2.0,6.0,11.0,10.0,13.0,13.0,6.0,13.0,13.0,7.0,12.0,10.0,12.0,9.0,10.0,16.0,12.0,14.0,13.0,9.0,12.0,8.0,16.0,13.0,8.0,15.0,9.0,11.0,17.0,16.0,14.0,13.0,10.0,20.0,13.0,15.0,8.0,12.0,15.0,10.0,10.0,14.0,6.0,10.0,12.0,15.0,10.0,13.0,16.0,12.0,14.0,7.0,24.0,8.0,0.0,0.0,0.0,186.0,78.0,2.0,4.0,1.0,4.0,1.0,2.0,3.0,3.0,1.0,3.0,1.0,10.0,11.0,14.0,11.0,14.0,10.0,7.0,13.0,3.0,8.0,15.0,16.0,11.0,14.0,14.0,15.0,12.0,13.0,11.0,14.0,8.0,14.0,15.0,6.0,11.0,11.0,10.0,14.0,8.0,12.0,14.0,12.0,20.0,13.0,9.0,14.0,14.0,14.0,8.0,12.0,10.0,12.0,12.0,6.0,15.0,12.0,10.0,14.0,7.0,8.0,10.0,35.0,35.0,6.0,2.0,0.0,175.0,68.0,2.0,1.0,1.0,1.0,1.0,1.0,2.0,2.0,3.0,1.0,2.0,12.0,14.0,13.0,11.0,14.0,5.0,11.0,11.0,6.0,4.0,14.0,12.0,3.0,14.0,10.0,15.0,13.0,14.0,14.0,16.0,15.0,13.0,13.0,19.0,12.0,10.0,15.0,14.0,10.0,10.0,9.0,9.0,11.0,13.0,11.0,20.0,14.0,8.0,17.0,8.0,14.0,15.0,15.0,8.0,11.0,12.0,16.0,14.0,13.0,15.0,9.0,24.0,0.0,0.0,0.0,0.0,172.0,70.0,1.0,1.0,4.0,1.0,3.0,1.0,3.0,4.0,1.0,2.0,1.0,10.0,12.0,13.0,10.0,13.0,7.0,8.0,10.0,5.0,7.0,16.0,10.0,8.0,15.0,12.0,13.0,13.0,14.0,14.0,14.0,15.0,15.0,16.0,8.0,14.0,6.0,14.0,14.0,12.0,15.0,12.0,6.0,20.0,13.0,14.0,10.0,12.0,10.0,15.0,9.0,16.0,6.0,13.0,11.0,15.0,13.0,13.0,14.0,7.0,13.0,5.0,19.0,3.0,0.0,3.0,0.0,186.0,78.0,1.0,2.0,3.0,1.0,3.0,2.0,3.0,2.0,2.0,1.0,2.0,10.0,10.0,12.0,7.0,13.0,10.0,14.0,13.0,7.0,12.0,11.0,8.0,15.0,11.0,14.0,16.0,13.0,14.0,14.0,11.0,11.0,15.0,11.0,10.0,11.0,11.0,14.0,15.0,13.0,13.0,11.0,15.0,8.0,16.0,13.0,20.0,16.0,13.0,14.0,10.0,13.0,6.0,12.0,14.0,16.0,14.0,14.0,14.0,12.0,14.0,5.0,18.0,0.0,0.0,0.0,0.0,180.0,75.0,3.0,1.0,2.0,3.0,1.0,1.0,2.0,3.0,3.0,2.0,3.0,14.0,14.0,16.0,12.0,13.0,10.0,8.0,14.0,6.0,4.0,10.0,12.0,7.0,15.0,13.0,10.0,10.0,12.0,9.0,13.0,8.0,15.0,17.0,6.0,11.0,5.0,9.0,12.0,18.0,16.0,10.0,12.0,20.0,14.0,16.0,10.0,12.0,7.0,10.0,6.0,15.0,3.0,13.0,16.0,18.0,5.0,12.0,10.0,10.0,7.0,18.0,29.0,0.0,0.0,24.0,0.0,189.0,79.0,14.0,14.0,12.0,5.0,14.0,13.0,15.0,17.0,11.0,15.0,12.0,1.0,1.0,1.0,1.0,5.0,1.0,4.0,1.0,1.0,1.0,7.0,1.0,1.0,6.0,8.0,14.0,14.0,10.0,12.0,8.0,12.0,15.0,5.0,11.0,1.0,15.0,9.0,14.0,11.0,17.0,13.0,15.0,5.0,14.0,12.0,20.0,13.0,13.0,14.0,3.0,11.0,4.0,1.0,10.0,13.0,18.0,7.0,17.0,15.0,18.0,4.0,31.0,0.0,0.0,0.0,0.0,182.0,80.0,4.0,2.0,3.0,2.0,1.0,2.0,3.0,2.0,3.0,2.0,3.0,6.0,10.0,7.0,6.0,14.0,7.0,9.0,15.0,8.0,14.0,15.0,9.0,15.0,13.0,17.0,16.0,13.0,13.0,15.0,12.0,16.0,15.0,9.0,16.0,13.0,13.0,13.0,13.0,11.0,9.0,14.0,9.0,13.0,10.0,10.0,20.0,15.0,15.0,16.0,10.0,15.0,5.0,11.0,10.0,13.0,13.0,12.0,14.0,13.0,11.0,4.0,20.0,0.0,0.0,1.0,0.0,186.0,82.0,1.0,3.0,1.0,1.0,2.0,1.0,3.0,4.0,2.0,2.0,2.0,8.0,10.0,13.0,11.0,13.0,5.0,12.0,14.0,7.0,13.0,13.0,8.0,12.0,14.0,12.0,13.0,12.0,12.0,13.0,13.0,13.0,14.0,13.0,8.0,13.0,12.0,11.0,11.0,12.0,12.0,11.0,12.0,14.0,14.0,13.0,20.0,13.0,13.0,14.0,11.0,10.0,11.0,14.0,11.0,15.0,13.0,13.0,13.0,13.0,12.0,3.0,33.0,2.0,0.0,2.0,0.0,180.0,76.0,3.0,3.0,3.0,1.0,1.0,1.0,1.0,2.0,3.0,2.0,2.0,6.0,12.0,7.0,6.0,9.0,9.0,11.0,10.0,11.0,13.0,10.0,8.0,14.0,10.0,17.0,16.0,18.0,13.0,13.0,11.0,11.0,15.0,5.0,13.0,12.0,13.0,17.0,16.0,13.0,13.0,17.0,10.0,11.0,17.0,12.0,20.0,16.0,16.0,13.0,13.0,11.0,5.0,16.0,16.0,11.0,12.0,11.0,12.0,12.0,15.0,5.0,25.0,0.0,0.0,0.0,0.0,179.0,77.0,3.0,3.0,4.0,1.0,1.0,3.0,1.0,1.0,2.0,1.0,4.0,6.0,11.0,14.0,13.0,11.0,6.0,8.0,13.0,4.0,7.0,12.0,8.0,8.0,15.0,9.0,12.0,14.0,12.0,13.0,11.0,13.0,13.0,14.0,6.0,14.0,9.0,14.0,15.0,17.0,15.0,11.0,9.0,20.0,12.0,15.0,8.0,14.0,11.0,14.0,12.0,12.0,5.0,13.0,12.0,14.0,12.0,13.0,13.0,13.0,12.0,9.0,32.0,3.0,1.0,0.0,0.0,188.0,77.0,3.0,3.0,3.0,2.0,3.0,2.0,1.0,3.0,2.0,1.0,1.0,6.0,15.0,11.0,5.0,12.0,2.0,14.0,7.0,15.0,14.0,12.0,8.0,14.0,11.0,13.0,14.0,13.0,9.0,14.0,9.0,12.0,14.0,5.0,10.0,13.0,15.0,14.0,14.0,14.0,12.0,14.0,13.0,20.0,13.0,15.0,9.0,16.0,15.0,9.0,15.0,12.0,8.0,15.0,12.0,12.0,12.0,11.0,16.0,12.0,13.0,6.0,28.0,2.0,0.0,0.0,0.0,192.0,89.0,1.0,3.0,2.0,2.0,2.0,2.0,2.0,3.0,1.0,1.0,1.0,6.0,6.0,10.0,6.0,11.0,4.0,14.0,9.0,8.0,16.0,12.0,4.0,15.0,12.0,12.0,17.0,14.0,12.0,16.0,12.0,14.0,18.0,10.0,13.0,7.0,15.0,14.0,14.0,10.0,10.0,15.0,16.0,20.0,14.0,13.0,10.0,15.0,16.0,14.0,9.0,15.0,12.0,7.0,10.0,15.0,15.0,12.0,14.0,12.0,10.0,2.0,22.0,0.0,0.0,2.0,0.0,171.0,68.0,1.0,1.0,4.0,2.0,2.0,3.0,1.0,3.0,2.0,3.0,3.0,14.0,14.0,14.0,11.0,13.0,11.0,7.0,13.0,7.0,6.0,12.0,12.0,6.0,14.0,11.0,10.0,12.0,11.0,12.0,12.0,12.0,13.0,14.0,11.0,14.0,7.0,15.0,13.0,15.0,15.0,12.0,7.0,20.0,10.0,15.0,9.0,14.0,13.0,13.0,6.0,13.0,5.0,15.0,10.0,12.0,12.0,13.0,14.0,14.0,12.0,2.0,18.0,0.0,0.0,0.0,0.0,175.0,70.0,2.0,2.0,3.0,2.0,1.0,1.0,3.0,1.0,2.0,1.0,2.0,10.0,13.0,9.0,7.0,9.0,10.0,11.0,10.0,11.0,13.0,10.0,8.0,11.0,11.0,12.0,13.0,11.0,13.0,13.0,12.0,11.0,11.0,11.0,8.0,11.0,10.0,11.0,10.0,12.0,13.0,12.0,10.0,12.0,13.0,14.0,20.0,14.0,14.0,12.0,8.0,9.0,7.0,10.0,16.0,11.0,11.0,12.0,9.0,14.0,11.0,7.0,22.0,0.0,0.0,2.0,0.0,175.0,63.0,3.0,2.0,2.0,2.0,3.0,1.0,3.0,4.0,4.0,1.0,1.0,10.0,13.0,15.0,12.0,16.0,9.0,6.0,13.0,3.0,3.0,15.0,12.0,4.0,16.0,5.0,13.0,7.0,11.0,10.0,14.0,12.0,11.0,16.0,5.0,14.0,4.0,11.0,12.0,15.0,16.0,9.0,6.0,20.0,13.0,13.0,13.0,11.0,5.0,12.0,8.0,9.0,5.0,15.0,9.0,14.0,14.0,9.0,13.0,13.0,11.0,3.0,23.0,0.0,0.0,3.0,0.0,188.0,84.0,3.0,3.0,2.0,3.0,2.0,2.0,1.0,4.0,1.0,2.0,2.0,14.0,11.0,11.0,5.0,12.0,16.0,14.0,9.0,8.0,12.0,12.0,5.0,12.0,11.0,18.0,13.0,15.0,12.0,13.0,16.0,12.0,15.0,14.0,15.0,15.0,13.0,14.0,12.0,11.0,10.0,13.0,14.0,9.0,13.0,12.0,20.0,11.0,13.0,13.0,11.0,13.0,8.0,13.0,17.0,14.0,2.0,10.0,12.0,11.0,15.0,15.0
3,0,16.0,0.0,0.0,0.0,0.0,179.0,0.0,1.0,3.0,1.0,2.0,3.0,2.0,3.0,1.0,2.0,3.0,1.0,1.0,1.0,2.0,1.0,2.0,1.0,3.0,1.0,1.0,5.0,1.0,1.0,10.0,4.0,11.0,3.0,4.0,1.0,6.0,1.0,10.0,14.0,7.0,10.0,1.0,9.0,11.0,11.0,9.0,5.0,8.0,6.0,20.0,12.0,8.0,8.0,6.0,4.0,6.0,8.0,12.0,8.0,5.0,8.0,7.0,8.0,19.0,16.0,5.0,8.0,2.0,22.0,14.0,0.0,0.0,0.0,187.0,77.0,1.0,2.0,2.0,1.0,3.0,2.0,1.0,2.0,2.0,3.0,2.0,7.0,8.0,8.0,6.0,12.0,7.0,13.0,6.0,9.0,15.0,11.0,7.0,17.0,12.0,16.0,17.0,17.0,13.0,14.0,7.0,13.0,15.0,8.0,8.0,6.0,15.0,14.0,14.0,15.0,14.0,14.0,14.0,11.0,17.0,16.0,20.0,13.0,15.0,14.0,9.0,16.0,9.0,12.0,11.0,10.0,11.0,14.0,12.0,13.0,13.0,5.0,23.0,38.0,6.0,13.0,4.0,191.0,84.0,3.0,2.0,1.0,3.0,1.0,3.0,3.0,1.0,1.0,4.0,2.0,7.0,12.0,17.0,15.0,19.0,15.0,13.0,18.0,4.0,11.0,16.0,12.0,13.0,18.0,13.0,14.0,13.0,15.0,14.0,16.0,12.0,17.0,19.0,12.0,15.0,12.0,13.0,15.0,13.0,15.0,18.0,16.0,15.0,17.0,16.0,20.0,17.0,17.0,16.0,14.0,12.0,5.0,10.0,17.0,19.0,12.0,14.0,14.0,14.0,13.0,8.0,28.0,39.0,11.0,25.0,8.0,171.0,65.0,4.0,3.0,2.0,1.0,1.0,3.0,3.0,2.0,2.0,1.0,3.0,14.0,14.0,16.0,16.0,19.0,16.0,4.0,12.0,3.0,2.0,18.0,15.0,4.0,19.0,11.0,18.0,8.0,16.0,14.0,18.0,16.0,15.0,17.0,6.0,17.0,4.0,16.0,13.0,13.0,16.0,13.0,6.0,20.0,13.0,12.0,12.0,15.0,8.0,16.0,10.0,16.0,7.0,12.0,18.0,18.0,12.0,15.0,17.0,13.0,19.0,2.0,34.0,116.0,62.0,7.0,6.0,195.0,95.0,1.0,1.0,3.0,1.0,1.0,3.0,4.0,1.0,2.0,3.0,2.0,5.0,12.0,15.0,16.0,18.0,14.0,14.0,16.0,8.0,6.0,15.0,18.0,6.0,18.0,16.0,16.0,15.0,13.0,13.0,16.0,14.0,14.0,19.0,16.0,15.0,4.0,13.0,8.0,12.0,15.0,20.0,18.0,16.0,16.0,14.0,20.0,15.0,18.0,16.0,13.0,11.0,11.0,8.0,15.0,20.0,11.0,15.0,14.0,7.0,7.0,13.0,20.0,12.0,0.0,12.0,4.0,181.0,76.0,4.0,4.0,3.0,2.0,2.0,3.0,3.0,3.0,3.0,3.0,4.0,5.0,10.0,17.0,15.0,15.0,7.0,10.0,11.0,2.0,2.0,12.0,14.0,3.0,15.0,8.0,12.0,12.0,13.0,11.0,10.0,12.0,15.0,14.0,5.0,15.0,5.0,12.0,14.0,18.0,16.0,14.0,10.0,11.0,14.0,17.0,20.0,14.0,14.0,12.0,8.0,13.0,8.0,11.0,12.0,18.0,12.0,15.0,16.0,15.0,18.0,7.0,26.0,29.0,1.0,14.0,1.0,194.0,90.0,1.0,2.0,3.0,4.0,1.0,2.0,3.0,3.0,3.0,2.0,2.0,4.0,4.0,7.0,7.0,11.0,2.0,17.0,2.0,8.0,15.0,8.0,4.0,16.0,12.0,14.0,16.0,15.0,11.0,13.0,3.0,14.0,14.0,5.0,12.0,4.0,16.0,15.0,14.0,13.0,12.0,14.0,16.0,9.0,12.0,14.0,20.0,16.0,17.0,14.0,8.0,13.0,11.0,8.0,17.0,14.0,13.0,13.0,15.0,16.0,17.0,6.0,26.0,36.0,2.0,23.0,0.0,180.0,72.0,3.0,2.0,2.0,1.0,2.0,3.0,2.0,1.0,4.0,2.0,2.0,11.0,11.0,8.0,6.0,15.0,8.0,12.0,8.0,10.0,14.0,16.0,9.0,14.0,14.0,12.0,16.0,14.0,16.0,15.0,14.0,16.0,17.0,10.0,13.0,11.0,14.0,17.0,16.0,9.0,11.0,13.0,11.0,20.0,17.0,11.0,8.0,17.0,12.0,17.0,12.0,15.0,4.0,20.0,16.0,14.0,16.0,18.0,18.0,16.0,15.0,8.0,26.0,0.0,0.0,15.0,4.0,182.0,73.0,1.0,2.0,2.0,4.0,1.0,3.0,3.0,3.0,3.0,3.0,3.0,10.0,11.0,12.0,11.0,17.0,11.0,5.0,12.0,3.0,7.0,16.0,14.0,13.0,17.0,14.0,16.0,14.0,14.0,15.0,15.0,14.0,16.0,14.0,15.0,15.0,14.0,16.0,17.0,14.0,16.0,12.0,9.0,11.0,15.0,13.0,20.0,16.0,11.0,15.0,15.0,15.0,6.0,13.0,14.0,16.0,15.0,13.0,18.0,10.0,12.0,8.0,30.0,84.0,9.0,0.0,0.0,181.0,78.0,1.0,2.0,3.0,2.0,1.0,2.0,1.0,1.0,2.0,4.0,3.0,10.0,12.0,12.0,9.0,12.0,5.0,7.0,8.0,8.0,11.0,12.0,4.0,14.0,13.0,11.0,11.0,12.0,8.0,12.0,7.0,11.0,17.0,15.0,5.0,12.0,13.0,16.0,18.0,16.0,13.0,18.0,8.0,7.0,16.0,15.0,20.0,17.0,18.0,14.0,7.0,14.0,6.0,8.0,18.0,15.0,12.0,12.0,18.0,16.0,16.0,4.0,28.0,72.0,15.0,7.0,0.0,194.0,85.0,1.0,3.0,3.0,3.0,2.0,3.0,1.0,3.0,3.0,1.0,2.0,9.0,9.0,9.0,13.0,14.0,8.0,17.0,10.0,13.0,12.0,13.0,12.0,15.0,15.0,17.0,14.0,16.0,11.0,13.0,10.0,14.0,15.0,12.0,7.0,15.0,13.0,18.0,16.0,9.0,12.0,19.0,17.0,12.0,16.0,13.0,20.0,17.0,17.0,14.0,19.0,12.0,5.0,12.0,14.0,16.0,11.0,12.0,14.0,5.0,8.0,9.0,29.0,3.0,0.0,3.0,0.0,188.0,89.0,13.0,13.0,15.0,9.0,14.0,12.0,15.0,17.0,14.0,15.0,8.0,6.0,3.0,3.0,2.0,7.0,10.0,3.0,2.0,1.0,3.0,8.0,1.0,1.0,9.0,12.0,14.0,16.0,13.0,14.0,9.0,13.0,18.0,6.0,13.0,2.0,15.0,12.0,8.0,12.0,14.0,16.0,14.0,6.0,16.0,11.0,20.0,14.0,16.0,16.0,12.0,13.0,3.0,1.0,10.0,15.0,17.0,13.0,16.0,12.0,8.0,10.0,26.0,0.0,0.0,1.0,0.0,180.0,77.0,1.0,1.0,1.0,3.0,2.0,1.0,3.0,3.0,3.0,3.0,2.0,7.0,12.0,12.0,6.0,11.0,7.0,13.0,11.0,11.0,13.0,10.0,7.0,12.0,11.0,12.0,13.0,14.0,12.0,11.0,10.0,11.0,15.0,9.0,8.0,8.0,13.0,13.0,14.0,16.0,12.0,14.0,12.0,8.0,14.0,14.0,20.0,15.0,14.0,13.0,12.0,13.0,5.0,14.0,11.0,8.0,14.0,9.0,12.0,13.0,14.0,6.0,25.0,0.0,0.0,15.0,1.0,176.0,64.0,2.0,2.0,3.0,3.0,1.0,1.0,3.0,3.0,2.0,1.0,3.0,9.0,9.0,11.0,7.0,13.0,11.0,14.0,9.0,6.0,12.0,14.0,6.0,13.0,13.0,13.0,14.0,15.0,14.0,14.0,13.0,13.0,15.0,8.0,11.0,9.0,12.0,15.0,18.0,14.0,14.0,12.0,10.0,5.0,15.0,11.0,20.0,16.0,10.0,15.0,13.0,15.0,5.0,10.0,11.0,14.0,14.0,14.0,17.0,13.0,13.0,5.0,25.0,9.0,0.0,0.0,0.0,173.0,70.0,1.0,2.0,1.0,2.0,3.0,2.0,1.0,2.0,1.0,4.0,3.0,6.0,8.0,13.0,10.0,14.0,13.0,13.0,13.0,5.0,10.0,13.0,11.0,9.0,15.0,7.0,13.0,13.0,12.0,12.0,12.0,13.0,13.0,15.0,12.0,13.0,7.0,14.0,15.0,13.0,13.0,12.0,10.0,12.0,11.0,13.0,20.0,14.0,13.0,13.0,7.0,13.0,13.0,13.0,8.0,15.0,13.0,12.0,13.0,15.0,15.0,6.0,23.0,0.0,0.0,9.0,0.0,177.0,70.0,1.0,2.0,4.0,1.0,3.0,3.0,1.0,3.0,1.0,1.0,2.0,13.0,13.0,11.0,7.0,13.0,11.0,6.0,12.0,5.0,10.0,13.0,6.0,9.0,13.0,11.0,13.0,13.0,13.0,12.0,12.0,13.0,13.0,9.0,8.0,12.0,12.0,16.0,16.0,14.0,14.0,12.0,9.0,12.0,14.0,12.0,20.0,13.0,10.0,14.0,11.0,14.0,10.0,8.0,14.0,13.0,12.0,15.0,14.0,14.0,14.0,10.0,25.0,13.0,0.0,0.0,0.0,188.0,87.0,4.0,1.0,3.0,2.0,1.0,3.0,1.0,1.0,3.0,2.0,1.0,5.0,13.0,9.0,8.0,12.0,12.0,15.0,10.0,8.0,12.0,9.0,6.0,11.0,12.0,11.0,12.0,14.0,11.0,12.0,11.0,10.0,15.0,7.0,7.0,10.0,12.0,13.0,14.0,15.0,12.0,16.0,14.0,20.0,14.0,14.0,6.0,14.0,16.0,13.0,11.0,13.0,7.0,10.0,11.0,14.0,12.0,13.0,12.0,14.0,14.0,7.0,29.0,0.0,0.0,0.0,0.0,177.0,74.0,1.0,2.0,3.0,2.0,2.0,2.0,2.0,1.0,3.0,2.0,1.0,12.0,13.0,14.0,12.0,15.0,11.0,6.0,11.0,4.0,3.0,12.0,8.0,4.0,15.0,9.0,11.0,11.0,12.0,11.0,13.0,12.0,14.0,14.0,7.0,14.0,6.0,10.0,12.0,16.0,14.0,12.0,8.0,10.0,14.0,15.0,20.0,14.0,11.0,11.0,9.0,14.0,8.0,10.0,9.0,13.0,14.0,14.0,13.0,15.0,15.0,6.0,27.0,0.0,0.0,6.0,0.0,183.0,73.0,2.0,1.0,1.0,1.0,1.0,1.0,2.0,1.0,2.0,3.0,3.0,10.0,11.0,14.0,9.0,14.0,10.0,7.0,11.0,5.0,4.0,12.0,12.0,5.0,14.0,8.0,12.0,12.0,10.0,12.0,9.0,10.0,11.0,13.0,6.0,13.0,7.0,11.0,13.0,17.0,13.0,12.0,10.0,5.0,15.0,15.0,20.0,15.0,12.0,12.0,8.0,14.0,6.0,9.0,13.0,14.0,16.0,8.0,14.0,15.0,15.0,8.0,30.0,0.0,0.0,0.0,0.0,180.0,76.0,1.0,2.0,2.0,2.0,3.0,2.0,2.0,1.0,2.0,3.0,3.0,5.0,12.0,10.0,8.0,12.0,9.0,14.0,11.0,10.0,14.0,12.0,7.0,15.0,11.0,11.0,14.0,13.0,15.0,14.0,12.0,13.0,14.0,6.0,16.0,7.0,15.0,16.0,15.0,12.0,12.0,14.0,11.0,8.0,14.0,10.0,20.0,15.0,13.0,15.0,8.0,14.0,11.0,17.0,18.0,14.0,19.0,13.0,16.0,15.0,15.0,5.0,24.0,0.0,0.0,0.0,0.0,181.0,73.0,3.0,3.0,3.0,2.0,3.0,2.0,1.0,3.0,1.0,3.0,2.0,6.0,12.0,13.0,9.0,12.0,6.0,9.0,9.0,5.0,11.0,12.0,9.0,12.0,13.0,13.0,11.0,14.0,10.0,11.0,8.0,10.0,14.0,13.0,6.0,12.0,8.0,10.0,13.0,16.0,13.0,13.0,12.0,5.0,14.0,17.0,20.0,13.0,14.0,12.0,9.0,13.0,12.0,12.0,19.0,14.0,13.0,12.0,11.0,15.0,15.0,8.0,28.0,0.0,0.0,0.0,0.0,181.0,75.0,2.0,1.0,3.0,3.0,2.0,1.0,2.0,1.0,1.0,4.0,3.0,5.0,11.0,12.0,13.0,11.0,8.0,10.0,8.0,8.0,7.0,11.0,12.0,7.0,12.0,10.0,11.0,11.0,12.0,13.0,12.0,12.0,10.0,12.0,11.0,12.0,13.0,13.0,14.0,11.0,12.0,11.0,10.0,9.0,12.0,12.0,20.0,12.0,12.0,11.0,9.0,12.0,9.0,12.0,11.0,11.0,12.0,9.0,11.0,9.0,8.0,5.0
1,4,28.0,8.0,0.0,12.0,0.0,194.0,83.0,15.0,13.0,14.0,8.0,13.0,9.0,15.0,15.0,15.0,12.0,12.0,1.0,1.0,3.0,2.0,8.0,4.0,5.0,1.0,2.0,2.0,8.0,4.0,3.0,8.0,11.0,12.0,14.0,12.0,13.0,5.0,12.0,14.0,2.0,12.0,2.0,15.0,10.0,13.0,11.0,12.0,14.0,17.0,20.0,13.0,8.0,6.0,14.0,10.0,12.0,6.0,13.0,13.0,11.0,16.0,11.0,15.0,14.0,16.0,3.0,11.0,3.0,28.0,0.0,0.0,0.0,0.0,188.0,81.0,2.0,3.0,4.0,1.0,4.0,3.0,1.0,1.0,2.0,3.0,3.0,8.0,11.0,7.0,6.0,13.0,7.0,12.0,6.0,11.0,14.0,11.0,7.0,13.0,12.0,12.0,12.0,13.0,12.0,13.0,12.0,12.0,11.0,10.0,14.0,8.0,13.0,14.0,14.0,12.0,12.0,13.0,13.0,8.0,10.0,12.0,20.0,14.0,12.0,12.0,10.0,12.0,5.0,11.0,11.0,12.0,11.0,8.0,14.0,11.0,15.0,1.0,23.0,0.0,0.0,0.0,0.0,175.0,74.0,3.0,1.0,3.0,1.0,2.0,1.0,3.0,3.0,2.0,3.0,2.0,12.0,10.0,14.0,11.0,11.0,7.0,6.0,9.0,11.0,10.0,10.0,8.0,12.0,13.0,9.0,12.0,12.0,11.0,13.0,11.0,10.0,13.0,11.0,7.0,13.0,11.0,13.0,15.0,15.0,12.0,13.0,5.0,20.0,14.0,14.0,10.0,14.0,12.0,13.0,11.0,11.0,8.0,11.0,15.0,12.0,11.0,9.0,10.0,11.0,19.0,2.0,26.0,0.0,0.0,0.0,0.0,184.0,78.0,2.0,1.0,1.0,2.0,4.0,1.0,1.0,2.0,3.0,2.0,2.0,4.0,10.0,9.0,9.0,12.0,10.0,13.0,10.0,6.0,15.0,15.0,7.0,12.0,13.0,9.0,13.0,12.0,13.0,13.0,14.0,14.0,4.0,9.0,12.0,14.0,13.0,14.0,14.0,12.0,11.0,11.0,10.0,10.0,13.0,12.0,20.0,13.0,12.0,13.0,6.0,10.0,8.0,15.0,8.0,10.0,10.0,10.0,12.0,9.0,17.0,4.0,22.0,22.0,3.0,17.0,11.0,180.0,78.0,1.0,2.0,2.0,3.0,1.0,3.0,1.0,3.0,2.0,3.0,3.0,13.0,14.0,13.0,12.0,13.0,13.0,10.0,13.0,7.0,4.0,13.0,12.0,4.0,14.0,10.0,11.0,13.0,12.0,10.0,11.0,11.0,14.0,16.0,7.0,15.0,5.0,13.0,14.0,14.0,15.0,13.0,11.0,12.0,10.0,13.0,20.0,13.0,11.0,10.0,7.0,12.0,7.0,13.0,12.0,18.0,16.0,12.0,15.0,14.0,10.0,8.0,23.0,0.0,0.0,0.0,0.0,197.0,84.0,2.0,3.0,3.0,2.0,4.0,2.0,3.0,1.0,1.0,3.0,3.0,5.0,7.0,8.0,14.0,14.0,11.0,16.0,11.0,7.0,4.0,11.0,12.0,4.0,13.0,16.0,14.0,15.0,15.0,14.0,11.0,13.0,15.0,12.0,7.0,13.0,6.0,15.0,17.0,9.0,13.0,16.0,15.0,10.0,12.0,10.0,20.0,14.0,15.0,14.0,11.0,13.0,6.0,8.0,9.0,14.0,12.0,16.0,14.0,6.0,7.0,1.0,21.0,1.0,0.0,9.0,1.0,179.0,75.0,3.0,2.0,3.0,2.0,1.0,1.0,3.0,2.0,3.0,2.0,2.0,10.0,9.0,14.0,11.0,14.0,12.0,4.0,10.0,2.0,3.0,12.0,17.0,3.0,13.0,6.0,8.0,6.0,12.0,8.0,13.0,11.0,12.0,18.0,12.0,14.0,7.0,10.0,8.0,13.0,13.0,10.0,6.0,12.0,11.0,12.0,20.0,10.0,7.0,10.0,5.0,10.0,10.0,11.0,10.0,10.0,10.0,11.0,10.0,14.0,18.0,2.0,23.0,0.0,0.0,0.0,0.0,173.0,72.0,1.0,2.0,2.0,2.0,2.0,3.0,1.0,2.0,3.0,1.0,2.0,14.0,14.0,13.0,11.0,13.0,14.0,5.0,12.0,3.0,4.0,14.0,11.0,4.0,17.0,12.0,12.0,12.0,13.0,13.0,16.0,11.0,13.0,16.0,9.0,15.0,6.0,12.0,12.0,12.0,15.0,11.0,8.0,20.0,9.0,12.0,10.0,12.0,7.0,9.0,12.0,11.0,5.0,12.0,13.0,16.0,12.0,13.0,9.0,9.0,7.0,13.0,24.0,0.0,0.0,0.0,0.0,187.0,84.0,4.0,1.0,1.0,3.0,4.0,1.0,2.0,2.0,3.0,1.0,1.0,6.0,10.0,13.0,9.0,13.0,11.0,13.0,11.0,7.0,7.0,12.0,6.0,6.0,13.0,6.0,12.0,14.0,12.0,11.0,14.0,12.0,11.0,14.0,8.0,14.0,6.0,13.0,14.0,13.0,12.0,14.0,13.0,9.0,12.0,12.0,20.0,15.0,13.0,12.0,9.0,11.0,11.0,11.0,9.0,11.0,12.0,9.0,10.0,11.0,14.0,5.0,20.0,0.0,0.0,0.0,0.0,186.0,83.0,3.0,1.0,2.0,1.0,3.0,2.0,2.0,1.0,2.0,4.0,1.0,11.0,8.0,10.0,9.0,13.0,16.0,12.0,11.0,10.0,12.0,11.0,10.0,10.0,13.0,13.0,9.0,13.0,11.0,11.0,12.0,11.0,7.0,8.0,9.0,12.0,12.0,11.0,13.0,13.0,12.0,12.0,12.0,10.0,12.0,13.0,20.0,12.0,14.0,12.0,8.0,11.0,4.0,11.0,16.0,17.0,8.0,10.0,14.0,10.0,11.0,8.0,26.0,0.0,0.0,4.0,0.0,183.0,74.0,1.0,2.0,3.0,2.0,1.0,4.0,3.0,1.0,2.0,1.0,4.0,12.0,10.0,11.0,7.0,13.0,15.0,13.0,12.0,8.0,11.0,13.0,6.0,13.0,12.0,10.0,13.0,12.0,12.0,13.0,13.0,12.0,14.0,13.0,14.0,14.0,10.0,14.0,14.0,11.0,12.0,13.0,12.0,20.0,15.0,11.0,7.0,14.0,12.0,13.0,8.0,13.0,17.0,11.0,12.0,14.0,11.0,12.0,14.0,11.0,12.0,4.0,25.0,4.0,0.0,11.0,0.0,184.0,81.0,14.0,14.0,13.0,9.0,15.0,12.0,16.0,16.0,13.0,7.0,11.0,8.0,1.0,2.0,1.0,11.0,12.0,6.0,1.0,3.0,3.0,11.0,5.0,3.0,11.0,8.0,15.0,15.0,13.0,14.0,10.0,11.0,14.0,8.0,13.0,5.0,13.0,10.0,10.0,14.0,16.0,14.0,13.0,20.0,14.0,12.0,5.0,14.0,14.0,15.0,9.0,16.0,6.0,1.0,17.0,11.0,15.0,13.0,14.0,12.0,12.0,4.0,20.0,1.0,0.0,10.0,0.0,183.0,73.0,2.0,4.0,4.0,2.0,1.0,2.0,2.0,3.0,3.0,3.0,3.0,8.0,9.0,10.0,6.0,14.0,7.0,12.0,5.0,9.0,14.0,12.0,9.0,15.0,13.0,11.0,15.0,13.0,14.0,13.0,12.0,10.0,16.0,13.0,11.0,9.0,14.0,13.0,13.0,12.0,12.0,13.0,13.0,10.0,13.0,13.0,20.0,13.0,12.0,12.0,11.0,8.0,7.0,10.0,17.0,14.0,8.0,14.0,14.0,5.0,15.0,7.0,19.0,0.0,0.0,0.0,0.0,193.0,89.0,3.0,2.0,2.0,3.0,1.0,3.0,1.0,4.0,2.0,2.0,3.0,8.0,10.0,5.0,4.0,10.0,10.0,14.0,12.0,6.0,12.0,10.0,4.0,12.0,9.0,11.0,11.0,14.0,11.0,12.0,8.0,14.0,13.0,8.0,8.0,11.0,11.0,13.0,13.0,10.0,9.0,14.0,16.0,6.0,14.0,10.0,20.0,12.0,14.0,11.0,7.0,6.0,6.0,8.0,16.0,10.0,10.0,12.0,13.0,16.0,16.0,5.0,21.0,0.0,0.0,15.0,3.0,181.0,78.0,3.0,3.0,4.0,2.0,1.0,2.0,2.0,4.0,2.0,1.0,1.0,5.0,7.0,11.0,10.0,14.0,5.0,14.0,10.0,6.0,13.0,14.0,8.0,14.0,14.0,12.0,14.0,12.0,11.0,10.0,12.0,11.0,16.0,11.0,12.0,14.0,14.0,14.0,14.0,14.0,13.0,14.0,13.0,10.0,16.0,14.0,20.0,16.0,14.0,12.0,10.0,11.0,5.0,19.0,8.0,11.0,14.0,11.0,16.0,13.0,13.0,10.0,25.0,10.0,1.0,11.0,4.0,175.0,73.0,1.0,3.0,3.0,3.0,3.0,3.0,3.0,1.0,2.0,3.0,1.0,5.0,10.0,15.0,17.0,15.0,10.0,11.0,12.0,5.0,5.0,14.0,15.0,5.0,16.0,8.0,15.0,12.0,15.0,14.0,13.0,15.0,15.0,15.0,14.0,14.0,10.0,10.0,12.0,16.0,16.0,15.0,9.0,10.0,15.0,16.0,20.0,13.0,15.0,14.0,8.0,14.0,7.0,10.0,8.0,16.0,17.0,13.0,15.0,15.0,14.0,5.0,32.0,11.0,1.0,0.0,0.0,176.0,68.0,2.0,1.0,3.0,2.0,2.0,2.0,2.0,3.0,3.0,2.0,2.0,8.0,10.0,10.0,7.0,11.0,8.0,10.0,11.0,12.0,11.0,13.0,12.0,14.0,12.0,9.0,14.0,15.0,13.0,12.0,11.0,12.0,17.0,8.0,14.0,14.0,11.0,18.0,18.0,14.0,14.0,12.0,10.0,10.0,14.0,13.0,20.0,17.0,13.0,15.0,9.0,13.0,8.0,13.0,17.0,13.0,15.0,16.0,16.0,16.0,18.0,5.0,22.0,0.0,0.0,4.0,0.0,180.0,80.0,4.0,1.0,1.0,3.0,2.0,3.0,1.0,3.0,3.0,3.0,4.0,7.0,10.0,11.0,8.0,15.0,11.0,10.0,14.0,5.0,14.0,15.0,10.0,15.0,15.0,13.0,14.0,13.0,12.0,14.0,15.0,13.0,16.0,12.0,8.0,15.0,13.0,13.0,13.0,13.0,13.0,12.0,10.0,12.0,12.0,12.0,20.0,13.0,12.0,13.0,10.0,12.0,7.0,11.0,12.0,15.0,12.0,16.0,15.0,10.0,10.0,7.0,22.0,5.0,1.0,1.0,0.0,173.0,72.0,1.0,3.0,1.0,3.0,3.0,3.0,3.0,3.0,3.0,2.0,2.0,14.0,13.0,16.0,14.0,16.0,14.0,5.0,11.0,5.0,5.0,15.0,11.0,5.0,16.0,8.0,13.0,9.0,14.0,13.0,15.0,13.0,15.0,16.0,5.0,13.0,5.0,9.0,10.0,15.0,16.0,14.0,5.0,20.0,14.0,15.0,5.0,12.0,14.0,13.0,11.0,13.0,8.0,14.0,10.0,15.0,14.0,10.0,13.0,10.0,10.0,13.0,27.0,8.0,0.0,6.0,0.0,187.0,76.0,3.0,2.0,3.0,2.0,2.0,1.0,1.0,3.0,3.0,1.0,2.0,5.0,7.0,11.0,5.0,14.0,5.0,14.0,9.0,5.0,15.0,15.0,8.0,14.0,13.0,15.0,16.0,15.0,14.0,12.0,14.0,14.0,18.0,8.0,17.0,9.0,12.0,18.0,15.0,13.0,14.0,15.0,14.0,10.0,17.0,12.0,20.0,17.0,15.0,14.0,13.0,16.0,4.0,12.0,10.0,14.0,17.0,12.0,15.0,13.0,13.0,6.0,19.0,0.0,0.0,0.0,0.0,185.0,82.0,4.0,2.0,3.0,1.0,3.0,2.0,1.0,2.0,1.0,2.0,3.0,7.0,7.0,10.0,6.0,13.0,7.0,14.0,7.0,6.0,12.0,13.0,7.0,13.0,13.0,13.0,13.0,13.0,11.0,12.0,11.0,12.0,14.0,9.0,14.0,11.0,11.0,15.0,15.0,12.0,12.0,14.0,13.0,5.0,14.0,12.0,20.0,14.0,13.0,10.0,11.0,11.0,6.0,10.0,10.0,12.0,12.0,14.0,14.0,11.0,16.0,6.0,26.0,41.0,2.0,13.0,1.0,173.0,73.0,1.0,2.0,3.0,1.0,1.0,1.0,3.0,2.0,1.0,1.0,3.0,14.0,14.0,10.0,9.0,13.0,14.0,10.0,13.0,6.0,8.0,14.0,10.0,11.0,14.0,10.0,9.0,11.0,11.0,12.0,13.0,13.0,8.0,13.0,10.0,12.0,8.0,12.0,10.0,14.0,14.0,12.0,7.0,20.0,13.0,14.0,8.0,13.0,8.0,13.0,10.0,13.0,8.0,13.0,13.0,12.0,12.0,12.0,12.0,9.0,12.0,6.0
7,1,25.0,4.0,0.0,11.0,0.0,184.0,81.0,14.0,14.0,13.0,9.0,15.0,12.0,16.0,16.0,13.0,7.0,11.0,8.0,1.0,2.0,1.0,11.0,12.0,6.0,1.0,3.0,3.0,11.0,5.0,3.0,11.0,8.0,15.0,15.0,13.0,14.0,10.0,11.0,14.0,8.0,13.0,5.0,13.0,10.0,10.0,14.0,16.0,14.0,13.0,20.0,14.0,12.0,5.0,14.0,14.0,15.0,9.0,16.0,6.0,1.0,17.0,11.0,15.0,13.0,14.0,12.0,12.0,4.0,27.0,4.0,0.0,5.0,1.0,184.0,83.0,2.0,4.0,3.0,1.0,1.0,2.0,1.0,2.0,4.0,2.0,3.0,4.0,8.0,11.0,4.0,10.0,4.0,14.0,4.0,4.0,15.0,12.0,5.0,16.0,11.0,14.0,14.0,16.0,14.0,10.0,11.0,12.0,17.0,7.0,10.0,9.0,13.0,14.0,15.0,14.0,13.0,16.0,13.0,10.0,15.0,13.0,20.0,15.0,16.0,12.0,12.0,14.0,6.0,12.0,11.0,13.0,12.0,12.0,16.0,15.0,14.0,6.0,19.0,0.0,0.0,0.0,0.0,193.0,89.0,3.0,2.0,2.0,3.0,1.0,3.0,1.0,4.0,2.0,2.0,3.0,8.0,10.0,5.0,4.0,10.0,10.0,14.0,12.0,6.0,12.0,10.0,4.0,12.0,9.0,11.0,11.0,14.0,11.0,12.0,8.0,14.0,13.0,8.0,8.0,11.0,11.0,13.0,13.0,10.0,9.0,14.0,16.0,6.0,14.0,10.0,20.0,12.0,14.0,11.0,7.0,6.0,6.0,8.0,16.0,10.0,10.0,12.0,13.0,16.0,16.0,5.0,24.0,6.0,1.0,0.0,0.0,183.0,66.0,1.0,1.0,2.0,2.0,1.0,2.0,1.0,2.0,3.0,2.0,1.0,14.0,14.0,14.0,10.0,14.0,14.0,9.0,10.0,8.0,8.0,14.0,10.0,8.0,15.0,9.0,11.0,13.0,11.0,11.0,13.0,10.0,14.0,13.0,5.0,12.0,9.0,14.0,13.0,14.0,16.0,12.0,9.0,20.0,13.0,14.0,5.0,15.0,9.0,12.0,10.0,12.0,8.0,9.0,16.0,9.0,16.0,13.0,11.0,12.0,13.0,9.0,24.0,0.0,0.0,6.0,1.0,172.0,70.0,3.0,1.0,1.0,3.0,1.0,2.0,3.0,1.0,1.0,3.0,3.0,11.0,12.0,11.0,8.0,12.0,10.0,6.0,14.0,7.0,11.0,15.0,8.0,12.0,13.0,14.0,14.0,18.0,13.0,12.0,13.0,13.0,15.0,12.0,12.0,12.0,11.0,18.0,18.0,13.0,14.0,13.0,7.0,10.0,16.0,12.0,20.0,14.0,12.0,14.0,14.0,15.0,4.0,8.0,7.0,14.0,14.0,13.0,14.0,12.0,10.0,6.0,32.0,11.0,1.0,0.0,0.0,176.0,68.0,2.0,1.0,3.0,2.0,2.0,2.0,2.0,3.0,3.0,2.0,2.0,8.0,10.0,10.0,7.0,11.0,8.0,10.0,11.0,12.0,11.0,13.0,12.0,14.0,12.0,9.0,14.0,15.0,13.0,12.0,11.0,12.0,17.0,8.0,14.0,14.0,11.0,18.0,18.0,14.0,14.0,12.0,10.0,10.0,14.0,13.0,20.0,17.0,13.0,15.0,9.0,13.0,8.0,13.0,17.0,13.0,15.0,16.0,16.0,16.0,18.0,5.0,22.0,0.0,0.0,4.0,0.0,180.0,80.0,4.0,1.0,1.0,3.0,2.0,3.0,1.0,3.0,3.0,3.0,4.0,7.0,10.0,11.0,8.0,15.0,11.0,10.0,14.0,5.0,14.0,15.0,10.0,15.0,15.0,13.0,14.0,13.0,12.0,14.0,15.0,13.0,16.0,12.0,8.0,15.0,13.0,13.0,13.0,13.0,13.0,12.0,10.0,12.0,12.0,12.0,20.0,13.0,12.0,13.0,10.0,12.0,7.0,11.0,12.0,15.0,12.0,16.0,15.0,10.0,10.0,7.0,22.0,5.0,1.0,1.0,0.0,173.0,72.0,1.0,3.0,1.0,3.0,3.0,3.0,3.0,3.0,3.0,2.0,2.0,14.0,13.0,16.0,14.0,16.0,14.0,5.0,11.0,5.0,5.0,15.0,11.0,5.0,16.0,8.0,13.0,9.0,14.0,13.0,15.0,13.0,15.0,16.0,5.0,13.0,5.0,9.0,10.0,15.0,16.0,14.0,5.0,20.0,14.0,15.0,5.0,12.0,14.0,13.0,11.0,13.0,8.0,14.0,10.0,15.0,14.0,10.0,13.0,10.0,10.0,13.0,37.0,0.0,0.0,0.0,0.0,185.0,83.0,1.0,1.0,2.0,1.0,3.0,2.0,3.0,1.0,1.0,3.0,1.0,6.0,8.0,9.0,12.0,10.0,8.0,13.0,9.0,4.0,5.0,10.0,14.0,4.0,11.0,11.0,10.0,11.0,13.0,12.0,12.0,13.0,15.0,14.0,12.0,11.0,7.0,12.0,8.0,7.0,7.0,12.0,12.0,11.0,11.0,7.0,20.0,8.0,14.0,12.0,8.0,13.0,9.0,12.0,12.0,12.0,19.0,14.0,15.0,14.0,8.0,8.0,19.0,0.0,0.0,3.0,1.0,181.0,69.0,3.0,2.0,3.0,3.0,2.0,1.0,1.0,1.0,3.0,3.0,4.0,10.0,10.0,12.0,12.0,12.0,7.0,8.0,11.0,5.0,7.0,10.0,10.0,7.0,11.0,8.0,10.0,10.0,12.0,8.0,11.0,8.0,14.0,13.0,6.0,14.0,8.0,13.0,13.0,16.0,14.0,13.0,9.0,20.0,15.0,16.0,10.0,15.0,13.0,12.0,8.0,11.0,7.0,12.0,11.0,11.0,15.0,10.0,12.0,14.0,14.0,1.0,19.0,0.0,0.0,0.0,0.0,185.0,82.0,4.0,2.0,3.0,1.0,3.0,2.0,1.0,2.0,1.0,2.0,3.0,7.0,7.0,10.0,6.0,13.0,7.0,14.0,7.0,6.0,12.0,13.0,7.0,13.0,13.0,13.0,13.0,13.0,11.0,12.0,11.0,12.0,14.0,9.0,14.0,11.0,11.0,15.0,15.0,12.0,12.0,14.0,13.0,5.0,14.0,12.0,20.0,14.0,13.0,10.0,11.0,11.0,6.0,10.0,10.0,12.0,12.0,14.0,14.0,11.0,16.0,6.0,28.0,8.0,0.0,12.0,0.0,194.0,83.0,15.0,13.0,14.0,8.0,13.0,9.0,15.0,15.0,15.0,12.0,12.0,1.0,1.0,3.0,2.0,8.0,4.0,5.0,1.0,2.0,2.0,8.0,4.0,3.0,8.0,11.0,12.0,14.0,12.0,13.0,5.0,12.0,14.0,2.0,12.0,2.0,15.0,10.0,13.0,11.0,12.0,14.0,17.0,20.0,13.0,8.0,6.0,14.0,10.0,12.0,6.0,13.0,13.0,11.0,16.0,11.0,15.0,14.0,16.0,3.0,11.0,3.0,24.0,3.0,0.0,18.0,0.0,176.0,74.0,2.0,1.0,2.0,3.0,1.0,2.0,2.0,2.0,2.0,2.0,3.0,7.0,13.0,13.0,6.0,14.0,5.0,12.0,7.0,13.0,12.0,13.0,7.0,14.0,13.0,13.0,11.0,15.0,8.0,11.0,12.0,10.0,14.0,5.0,5.0,12.0,14.0,14.0,14.0,13.0,9.0,12.0,11.0,10.0,9.0,14.0,20.0,15.0,13.0,12.0,9.0,6.0,7.0,8.0,20.0,13.0,17.0,12.0,15.0,15.0,15.0,5.0,31.0,32.0,1.0,15.0,0.0,189.0,85.0,2.0,3.0,2.0,1.0,1.0,3.0,1.0,1.0,3.0,1.0,1.0,6.0,8.0,8.0,4.0,12.0,12.0,15.0,9.0,11.0,12.0,12.0,12.0,16.0,11.0,13.0,15.0,17.0,14.0,15.0,10.0,15.0,17.0,5.0,18.0,10.0,15.0,12.0,15.0,10.0,10.0,16.0,15.0,7.0,13.0,11.0,20.0,15.0,16.0,16.0,7.0,16.0,14.0,10.0,13.0,16.0,16.0,12.0,14.0,15.0,13.0,6.0,23.0,0.0,0.0,0.0,0.0,175.0,74.0,3.0,1.0,3.0,1.0,2.0,1.0,3.0,3.0,2.0,3.0,2.0,12.0,10.0,14.0,11.0,11.0,7.0,6.0,9.0,11.0,10.0,10.0,8.0,12.0,13.0,9.0,12.0,12.0,11.0,13.0,11.0,10.0,13.0,11.0,7.0,13.0,11.0,13.0,15.0,15.0,12.0,13.0,5.0,20.0,14.0,14.0,10.0,14.0,12.0,13.0,11.0,11.0,8.0,11.0,15.0,12.0,11.0,9.0,10.0,11.0,19.0,2.0,26.0,0.0,0.0,0.0,0.0,184.0,78.0,2.0,1.0,1.0,2.0,4.0,1.0,1.0,2.0,3.0,2.0,2.0,4.0,10.0,9.0,9.0,12.0,10.0,13.0,10.0,6.0,15.0,15.0,7.0,12.0,13.0,9.0,13.0,12.0,13.0,13.0,14.0,14.0,4.0,9.0,12.0,14.0,13.0,14.0,14.0,12.0,11.0,11.0,10.0,10.0,13.0,12.0,20.0,13.0,12.0,13.0,6.0,10.0,8.0,15.0,8.0,10.0,10.0,10.0,12.0,9.0,17.0,4.0,22.0,22.0,3.0,17.0,11.0,180.0,78.0,1.0,2.0,2.0,3.0,1.0,3.0,1.0,3.0,2.0,3.0,3.0,13.0,14.0,13.0,12.0,13.0,13.0,10.0,13.0,7.0,4.0,13.0,12.0,4.0,14.0,10.0,11.0,13.0,12.0,10.0,11.0,11.0,14.0,16.0,7.0,15.0,5.0,13.0,14.0,14.0,15.0,13.0,11.0,12.0,10.0,13.0,20.0,13.0,11.0,10.0,7.0,12.0,7.0,13.0,12.0,18.0,16.0,12.0,15.0,14.0,10.0,8.0,23.0,0.0,0.0,0.0,0.0,173.0,72.0,1.0,2.0,2.0,2.0,2.0,3.0,1.0,2.0,3.0,1.0,2.0,14.0,14.0,13.0,11.0,13.0,14.0,5.0,12.0,3.0,4.0,14.0,11.0,4.0,17.0,12.0,12.0,12.0,13.0,13.0,16.0,11.0,13.0,16.0,9.0,15.0,6.0,12.0,12.0,12.0,15.0,11.0,8.0,20.0,9.0,12.0,10.0,12.0,7.0,9.0,12.0,11.0,5.0,12.0,13.0,16.0,12.0,13.0,9.0,9.0,7.0,13.0,20.0,0.0,0.0,0.0,0.0,186.0,83.0,3.0,1.0,2.0,1.0,3.0,2.0,2.0,1.0,2.0,4.0,1.0,11.0,8.0,10.0,9.0,13.0,16.0,12.0,11.0,10.0,12.0,11.0,10.0,10.0,13.0,13.0,9.0,13.0,11.0,11.0,12.0,11.0,7.0,8.0,9.0,12.0,12.0,11.0,13.0,13.0,12.0,12.0,12.0,10.0,12.0,13.0,20.0,12.0,14.0,12.0,8.0,11.0,4.0,11.0,16.0,17.0,8.0,10.0,14.0,10.0,11.0,8.0,21.0,0.0,0.0,0.0,0.0,187.0,90.0,1.0,3.0,3.0,3.0,2.0,1.0,3.0,3.0,2.0,2.0,3.0,6.0,8.0,12.0,13.0,13.0,8.0,11.0,12.0,12.0,7.0,10.0,10.0,5.0,13.0,10.0,12.0,13.0,11.0,12.0,11.0,9.0,13.0,13.0,6.0,12.0,7.0,11.0,8.0,12.0,12.0,14.0,15.0,13.0,17.0,14.0,20.0,12.0,17.0,13.0,8.0,13.0,6.0,5.0,15.0,16.0,9.0,12.0,18.0,13.0,11.0,8.0,18.0,5.0,2.0,7.0,0.0,179.0,72.0,3.0,1.0,1.0,2.0,1.0,3.0,2.0,1.0,2.0,1.0,2.0,13.0,10.0,14.0,9.0,13.0,11.0,7.0,8.0,6.0,4.0,10.0,8.0,4.0,13.0,5.0,7.0,12.0,11.0,11.0,14.0,8.0,8.0,16.0,4.0,12.0,5.0,13.0,12.0,15.0,13.0,11.0,11.0,20.0,14.0,15.0,13.0,7.0,10.0,8.0,8.0,4.0,11.0,10.0,20.0,14.0,8.0,9.0,10.0,11.0,16.0,3.0,26.0,0.0,0.0,4.0,0.0,183.0,74.0,1.0,2.0,3.0,2.0,1.0,4.0,3.0,1.0,2.0,1.0,4.0,12.0,10.0,11.0,7.0,13.0,15.0,13.0,12.0,8.0,11.0,13.0,6.0,13.0,12.0,10.0,13.0,12.0,12.0,13.0,13.0,12.0,14.0,13.0,14.0,14.0,10.0,14.0,14.0,11.0,12.0,13.0,12.0,20.0,15.0,11.0,7.0,14.0,12.0,13.0,8.0,13.0,17.0,11.0,12.0,14.0,11.0,12.0,14.0,11.0,12.0,4.0
1,1,27.0,0.0,0.0,1.0,0.0,196.0,93.0,16.0,11.0,9.0,10.0,13.0,12.0,17.0,17.0,14.0,10.0,11.0,9.0,2.0,2.0,2.0,10.0,12.0,7.0,2.0,1.0,3.0,8.0,2.0,2.0,10.0,7.0,12.0,16.0,15.0,14.0,7.0,12.0,12.0,1.0,9.0,2.0,14.0,18.0,10.0,12.0,17.0,15.0,16.0,8.0,12.0,10.0,20.0,13.0,18.0,17.0,5.0,17.0,14.0,11.0,7.0,14.0,16.0,10.0,18.0,16.0,18.0,3.0,27.0,0.0,0.0,0.0,0.0,182.0,79.0,1.0,2.0,1.0,1.0,2.0,3.0,1.0,2.0,3.0,1.0,4.0,10.0,12.0,14.0,13.0,12.0,10.0,8.0,14.0,11.0,7.0,11.0,14.0,9.0,13.0,16.0,11.0,13.0,9.0,12.0,10.0,10.0,12.0,14.0,7.0,12.0,9.0,14.0,16.0,15.0,13.0,15.0,9.0,9.0,14.0,17.0,20.0,14.0,12.0,13.0,8.0,13.0,8.0,15.0,9.0,14.0,12.0,11.0,15.0,13.0,10.0,8.0,28.0,40.0,2.0,22.0,3.0,187.0,82.0,1.0,1.0,3.0,1.0,3.0,1.0,1.0,1.0,2.0,1.0,1.0,4.0,8.0,6.0,8.0,10.0,4.0,16.0,5.0,12.0,18.0,10.0,8.0,18.0,9.0,16.0,14.0,17.0,10.0,18.0,8.0,12.0,17.0,3.0,14.0,8.0,15.0,18.0,12.0,11.0,10.0,15.0,15.0,12.0,16.0,13.0,20.0,16.0,14.0,17.0,10.0,17.0,12.0,14.0,10.0,13.0,17.0,15.0,18.0,16.0,13.0,3.0,22.0,0.0,0.0,12.0,0.0,182.0,82.0,2.0,2.0,3.0,3.0,1.0,2.0,2.0,2.0,2.0,3.0,1.0,16.0,14.0,10.0,10.0,13.0,15.0,8.0,17.0,10.0,9.0,17.0,12.0,11.0,14.0,10.0,12.0,13.0,16.0,10.0,16.0,14.0,11.0,11.0,10.0,9.0,11.0,14.0,10.0,10.0,11.0,14.0,11.0,16.0,11.0,12.0,20.0,15.0,12.0,15.0,12.0,15.0,4.0,16.0,8.0,17.0,9.0,16.0,8.0,13.0,13.0,14.0,23.0,13.0,0.0,0.0,0.0,183.0,82.0,2.0,1.0,1.0,3.0,3.0,2.0,1.0,3.0,1.0,3.0,3.0,6.0,10.0,12.0,7.0,12.0,6.0,13.0,8.0,15.0,16.0,11.0,9.0,17.0,11.0,17.0,10.0,18.0,8.0,13.0,9.0,10.0,17.0,9.0,10.0,12.0,11.0,12.0,17.0,14.0,13.0,18.0,12.0,20.0,18.0,17.0,9.0,17.0,15.0,15.0,14.0,15.0,5.0,14.0,12.0,16.0,10.0,15.0,12.0,10.0,8.0,13.0,21.0,1.0,0.0,9.0,1.0,189.0,79.0,3.0,2.0,3.0,1.0,3.0,2.0,2.0,4.0,2.0,3.0,3.0,11.0,12.0,11.0,13.0,14.0,10.0,13.0,11.0,9.0,9.0,15.0,12.0,11.0,15.0,17.0,12.0,14.0,16.0,12.0,13.0,13.0,16.0,10.0,13.0,15.0,10.0,16.0,17.0,11.0,11.0,15.0,14.0,10.0,14.0,16.0,20.0,16.0,13.0,14.0,8.0,15.0,12.0,16.0,12.0,18.0,10.0,14.0,15.0,13.0,8.0,8.0,25.0,0.0,0.0,14.0,0.0,180.0,82.0,1.0,3.0,3.0,1.0,3.0,2.0,3.0,1.0,1.0,3.0,1.0,5.0,10.0,10.0,7.0,13.0,7.0,12.0,8.0,10.0,14.0,12.0,8.0,17.0,13.0,13.0,16.0,16.0,14.0,15.0,10.0,12.0,15.0,8.0,13.0,10.0,14.0,18.0,15.0,10.0,12.0,16.0,11.0,10.0,15.0,12.0,20.0,16.0,15.0,17.0,10.0,16.0,6.0,10.0,12.0,16.0,12.0,13.0,17.0,14.0,14.0,5.0,27.0,9.0,0.0,11.0,0.0,187.0,80.0,3.0,3.0,2.0,3.0,3.0,1.0,2.0,1.0,1.0,3.0,1.0,8.0,12.0,11.0,13.0,10.0,8.0,13.0,10.0,8.0,6.0,9.0,11.0,7.0,11.0,17.0,14.0,16.0,12.0,12.0,9.0,9.0,16.0,15.0,11.0,16.0,8.0,12.0,17.0,12.0,10.0,16.0,13.0,16.0,17.0,15.0,20.0,15.0,14.0,14.0,10.0,14.0,5.0,15.0,12.0,14.0,8.0,15.0,12.0,8.0,10.0,10.0,19.0,0.0,0.0,0.0,0.0,185.0,73.0,1.0,1.0,4.0,3.0,3.0,4.0,3.0,2.0,2.0,1.0,1.0,6.0,9.0,10.0,6.0,12.0,5.0,14.0,7.0,10.0,12.0,13.0,7.0,15.0,13.0,11.0,14.0,13.0,15.0,8.0,12.0,10.0,10.0,9.0,11.0,7.0,11.0,14.0,9.0,13.0,12.0,14.0,14.0,12.0,16.0,17.0,20.0,13.0,11.0,11.0,9.0,14.0,5.0,17.0,10.0,17.0,5.0,12.0,9.0,14.0,12.0,15.0,22.0,7.0,2.0,19.0,8.0,178.0,75.0,3.0,3.0,3.0,2.0,1.0,4.0,1.0,2.0,3.0,2.0,2.0,12.0,11.0,15.0,13.0,14.0,10.0,8.0,15.0,7.0,7.0,13.0,12.0,10.0,14.0,16.0,13.0,10.0,12.0,9.0,12.0,10.0,11.0,15.0,10.0,15.0,9.0,13.0,16.0,14.0,15.0,10.0,8.0,15.0,16.0,12.0,20.0,16.0,8.0,11.0,6.0,11.0,5.0,17.0,12.0,16.0,10.0,11.0,15.0,13.0,17.0,4.0,23.0,19.0,0.0,8.0,1.0,188.0,83.0,1.0,3.0,3.0,2.0,3.0,1.0,2.0,2.0,2.0,2.0,2.0,7.0,10.0,9.0,6.0,12.0,5.0,12.0,6.0,10.0,15.0,13.0,7.0,15.0,13.0,12.0,17.0,13.0,16.0,16.0,12.0,15.0,12.0,8.0,10.0,7.0,16.0,17.0,10.0,12.0,11.0,13.0,14.0,20.0,12.0,15.0,10.0,12.0,14.0,15.0,6.0,13.0,10.0,10.0,17.0,16.0,10.0,14.0,15.0,13.0,16.0,8.0,27.0,22.0,0.0,31.0,0.0,183.0,79.0,11.0,15.0,10.0,13.0,12.0,16.0,17.0,16.0,18.0,8.0,15.0,8.0,1.0,2.0,3.0,11.0,10.0,7.0,3.0,2.0,3.0,12.0,7.0,3.0,12.0,10.0,17.0,12.0,18.0,13.0,10.0,15.0,14.0,2.0,11.0,2.0,14.0,17.0,10.0,14.0,11.0,14.0,9.0,15.0,17.0,10.0,20.0,13.0,12.0,16.0,5.0,15.0,5.0,12.0,10.0,12.0,14.0,17.0,17.0,12.0,16.0,6.0,24.0,0.0,0.0,3.0,0.0,185.0,75.0,3.0,3.0,1.0,3.0,1.0,4.0,1.0,3.0,4.0,2.0,4.0,5.0,11.0,9.0,7.0,10.0,5.0,13.0,7.0,14.0,16.0,12.0,9.0,15.0,11.0,15.0,12.0,18.0,10.0,10.0,9.0,12.0,16.0,8.0,11.0,10.0,13.0,13.0,15.0,13.0,12.0,16.0,13.0,20.0,17.0,16.0,6.0,18.0,15.0,14.0,10.0,14.0,7.0,10.0,14.0,17.0,10.0,13.0,13.0,14.0,14.0,7.0,23.0,8.0,1.0,28.0,4.0,197.0,96.0,3.0,3.0,3.0,4.0,4.0,3.0,2.0,3.0,2.0,2.0,1.0,5.0,6.0,9.0,7.0,8.0,11.0,13.0,10.0,12.0,15.0,10.0,7.0,15.0,8.0,8.0,13.0,16.0,15.0,12.0,8.0,13.0,13.0,6.0,14.0,5.0,14.0,16.0,10.0,8.0,7.0,16.0,18.0,15.0,13.0,14.0,20.0,12.0,18.0,15.0,6.0,13.0,7.0,10.0,13.0,15.0,11.0,14.0,16.0,15.0,11.0,4.0,26.0,0.0,0.0,0.0,0.0,188.0,80.0,1.0,2.0,3.0,3.0,1.0,2.0,2.0,2.0,2.0,1.0,1.0,6.0,11.0,6.0,7.0,10.0,8.0,12.0,11.0,15.0,14.0,12.0,7.0,16.0,10.0,14.0,14.0,16.0,12.0,16.0,9.0,12.0,14.0,6.0,13.0,8.0,13.0,18.0,14.0,10.0,8.0,15.0,15.0,9.0,16.0,11.0,20.0,15.0,16.0,17.0,12.0,15.0,4.0,17.0,11.0,14.0,12.0,15.0,16.0,12.0,16.0,5.0,20.0,0.0,0.0,2.0,0.0,176.0,76.0,1.0,2.0,1.0,3.0,1.0,1.0,2.0,1.0,2.0,1.0,3.0,9.0,11.0,13.0,10.0,16.0,9.0,6.0,12.0,5.0,8.0,14.0,10.0,11.0,16.0,17.0,12.0,10.0,16.0,10.0,16.0,12.0,11.0,14.0,9.0,13.0,10.0,14.0,17.0,12.0,17.0,9.0,8.0,12.0,14.0,11.0,20.0,16.0,8.0,11.0,6.0,12.0,13.0,9.0,11.0,15.0,8.0,14.0,12.0,14.0,17.0,12.0,31.0,0.0,0.0,0.0,0.0,174.0,69.0,1.0,3.0,2.0,2.0,3.0,2.0,2.0,2.0,1.0,2.0,1.0,11.0,12.0,17.0,13.0,18.0,13.0,9.0,12.0,4.0,6.0,14.0,14.0,9.0,17.0,14.0,12.0,6.0,12.0,10.0,14.0,14.0,8.0,18.0,4.0,17.0,9.0,15.0,16.0,14.0,17.0,8.0,7.0,16.0,12.0,12.0,20.0,14.0,7.0,13.0,4.0,11.0,4.0,10.0,12.0,10.0,15.0,9.0,13.0,13.0,18.0,5.0,27.0,0.0,0.0,1.0,0.0,180.0,73.0,3.0,1.0,1.0,3.0,2.0,3.0,2.0,2.0,4.0,2.0,3.0,13.0,15.0,12.0,13.0,15.0,11.0,10.0,14.0,10.0,8.0,14.0,13.0,11.0,15.0,17.0,15.0,13.0,11.0,14.0,14.0,12.0,14.0,10.0,12.0,16.0,11.0,18.0,17.0,11.0,14.0,11.0,10.0,10.0,17.0,12.0,20.0,16.0,10.0,15.0,7.0,14.0,5.0,17.0,9.0,12.0,14.0,12.0,17.0,15.0,13.0,7.0,30.0,25.0,0.0,14.0,1.0,181.0,83.0,1.0,2.0,3.0,3.0,3.0,2.0,1.0,1.0,2.0,1.0,3.0,11.0,12.0,11.0,10.0,14.0,10.0,8.0,12.0,15.0,10.0,13.0,9.0,11.0,13.0,10.0,13.0,9.0,15.0,14.0,12.0,15.0,11.0,11.0,9.0,14.0,11.0,16.0,12.0,11.0,13.0,11.0,10.0,20.0,14.0,13.0,12.0,16.0,12.0,14.0,5.0,13.0,5.0,14.0,12.0,15.0,13.0,13.0,16.0,14.0,17.0,5.0,28.0,49.0,2.0,0.0,0.0,183.0,70.0,2.0,1.0,3.0,1.0,3.0,3.0,1.0,1.0,1.0,2.0,2.0,10.0,13.0,12.0,11.0,12.0,10.0,8.0,11.0,16.0,9.0,10.0,9.0,10.0,11.0,16.0,9.0,13.0,10.0,12.0,10.0,9.0,13.0,11.0,8.0,14.0,8.0,13.0,16.0,15.0,13.0,11.0,11.0,20.0,17.0,17.0,15.0,16.0,9.0,12.0,9.0,13.0,5.0,18.0,10.0,15.0,12.0,12.0,15.0,16.0,18.0,5.0,23.0,0.0,0.0,10.0,5.0,176.0,65.0,3.0,2.0,1.0,2.0,4.0,3.0,3.0,3.0,3.0,1.0,2.0,13.0,13.0,12.0,10.0,14.0,11.0,6.0,9.0,15.0,8.0,12.0,11.0,9.0,13.0,17.0,14.0,8.0,12.0,12.0,14.0,10.0,16.0,13.0,7.0,16.0,10.0,16.0,17.0,14.0,14.0,8.0,8.0,8.0,13.0,16.0,20.0,15.0,7.0,13.0,6.0,13.0,12.0,16.0,8.0,13.0,10.0,13.0,15.0,9.0,14.0,6.0,26.0,0.0,0.0,18.0,0.0,177.0,72.0,1.0,2.0,2.0,1.0,2.0,3.0,3.0,4.0,2.0,3.0,3.0,5.0,9.0,7.0,5.0,11.0,5.0,12.0,5.0,10.0,14.0,12.0,6.0,16.0,11.0,10.0,17.0,12.0,14.0,17.0,9.0,14.0,12.0,4.0,10.0,7.0,16.0,18.0,11.0,11.0,13.0,12.0,11.0,12.0,14.0,12.0,20.0,15.0,10.0,16.0,5.0,14.0,8.0,16.0,6.0,11.0,17.0,12.0,16.0,16.0,18.0,3.0
2,0,20.0,0.0,0.0,0.0,0.0,190.0,83.0,15.0,9.0,12.0,8.0,13.0,13.0,13.0,15.0,13.0,12.0,11.0,9.0,3.0,2.0,1.0,10.0,11.0,4.0,1.0,3.0,3.0,13.0,1.0,1.0,11.0,9.0,9.0,15.0,13.0,8.0,6.0,11.0,9.0,6.0,7.0,1.0,13.0,8.0,12.0,13.0,15.0,12.0,14.0,6.0,16.0,13.0,20.0,11.0,12.0,12.0,8.0,15.0,6.0,11.0,12.0,10.0,4.0,10.0,8.0,12.0,13.0,6.0,24.0,12.0,0.0,8.0,0.0,184.0,75.0,4.0,2.0,2.0,2.0,2.0,2.0,4.0,1.0,1.0,3.0,3.0,7.0,5.0,12.0,8.0,13.0,4.0,13.0,5.0,9.0,14.0,12.0,7.0,16.0,11.0,13.0,15.0,12.0,15.0,13.0,11.0,13.0,16.0,9.0,13.0,12.0,16.0,14.0,13.0,12.0,13.0,12.0,14.0,11.0,15.0,13.0,20.0,14.0,12.0,13.0,6.0,12.0,8.0,8.0,18.0,9.0,18.0,15.0,18.0,14.0,16.0,4.0,20.0,0.0,0.0,17.0,0.0,187.0,78.0,2.0,1.0,3.0,3.0,1.0,3.0,3.0,3.0,1.0,2.0,1.0,9.0,6.0,10.0,7.0,11.0,11.0,13.0,9.0,6.0,13.0,11.0,7.0,16.0,14.0,13.0,12.0,12.0,12.0,12.0,10.0,12.0,12.0,9.0,8.0,10.0,13.0,10.0,13.0,11.0,14.0,13.0,13.0,10.0,13.0,12.0,20.0,13.0,13.0,13.0,6.0,8.0,11.0,10.0,11.0,11.0,12.0,11.0,12.0,11.0,12.0,9.0,20.0,0.0,0.0,0.0,0.0,178.0,65.0,2.0,2.0,1.0,1.0,2.0,1.0,1.0,1.0,2.0,1.0,1.0,12.0,12.0,13.0,7.0,14.0,12.0,9.0,8.0,7.0,6.0,14.0,8.0,6.0,16.0,10.0,12.0,12.0,13.0,10.0,13.0,12.0,11.0,14.0,10.0,15.0,7.0,15.0,14.0,13.0,15.0,11.0,9.0,20.0,14.0,13.0,10.0,11.0,8.0,8.0,3.0,12.0,8.0,16.0,8.0,14.0,9.0,8.0,13.0,15.0,11.0,4.0,20.0,29.0,2.0,0.0,0.0,181.0,75.0,1.0,1.0,2.0,2.0,2.0,3.0,2.0,1.0,1.0,3.0,2.0,5.0,9.0,15.0,10.0,11.0,9.0,10.0,8.0,7.0,3.0,10.0,10.0,5.0,15.0,7.0,10.0,9.0,12.0,10.0,8.0,11.0,14.0,12.0,5.0,13.0,5.0,11.0,12.0,16.0,12.0,9.0,12.0,20.0,14.0,16.0,7.0,12.0,10.0,9.0,10.0,10.0,11.0,6.0,10.0,15.0,9.0,13.0,11.0,14.0,18.0,7.0,23.0,5.0,1.0,4.0,0.0,181.0,75.0,2.0,1.0,3.0,2.0,3.0,3.0,2.0,4.0,3.0,3.0,1.0,7.0,8.0,12.0,13.0,14.0,9.0,12.0,10.0,8.0,6.0,14.0,13.0,8.0,12.0,18.0,15.0,16.0,15.0,13.0,13.0,16.0,17.0,10.0,15.0,16.0,10.0,16.0,16.0,12.0,13.0,14.0,12.0,10.0,15.0,13.0,20.0,16.0,12.0,14.0,7.0,14.0,9.0,11.0,19.0,12.0,17.0,14.0,17.0,11.0,13.0,4.0,22.0,0.0,0.0,18.0,3.0,170.0,66.0,3.0,2.0,3.0,2.0,3.0,2.0,1.0,1.0,1.0,2.0,2.0,10.0,12.0,16.0,8.0,16.0,11.0,5.0,8.0,6.0,5.0,12.0,9.0,5.0,15.0,8.0,11.0,10.0,11.0,8.0,12.0,9.0,9.0,17.0,6.0,12.0,6.0,10.0,8.0,16.0,18.0,12.0,4.0,7.0,12.0,14.0,20.0,12.0,5.0,11.0,5.0,12.0,7.0,12.0,12.0,15.0,8.0,11.0,10.0,9.0,11.0,13.0,23.0,7.0,2.0,0.0,0.0,183.0,67.0,3.0,4.0,3.0,4.0,3.0,1.0,2.0,1.0,3.0,1.0,3.0,15.0,13.0,14.0,11.0,14.0,16.0,7.0,15.0,7.0,4.0,16.0,15.0,4.0,16.0,13.0,13.0,11.0,12.0,13.0,17.0,13.0,14.0,14.0,13.0,14.0,5.0,12.0,14.0,15.0,16.0,12.0,7.0,20.0,15.0,13.0,13.0,14.0,10.0,14.0,10.0,14.0,6.0,13.0,12.0,14.0,11.0,12.0,14.0,14.0,12.0,12.0,26.0,1.0,0.0,5.0,0.0,183.0,78.0,1.0,3.0,1.0,1.0,4.0,1.0,2.0,1.0,1.0,1.0,2.0,7.0,9.0,8.0,6.0,12.0,9.0,13.0,9.0,13.0,14.0,12.0,8.0,13.0,11.0,11.0,13.0,12.0,11.0,12.0,10.0,11.0,13.0,9.0,13.0,12.0,14.0,14.0,14.0,11.0,12.0,13.0,11.0,20.0,16.0,13.0,7.0,12.0,13.0,13.0,12.0,14.0,7.0,17.0,10.0,16.0,8.0,12.0,15.0,14.0,12.0,6.0,19.0,0.0,0.0,0.0,0.0,181.0,67.0,1.0,2.0,3.0,1.0,1.0,2.0,2.0,2.0,2.0,1.0,2.0,12.0,8.0,13.0,7.0,13.0,12.0,10.0,9.0,8.0,10.0,13.0,10.0,11.0,13.0,12.0,12.0,12.0,11.0,10.0,14.0,11.0,15.0,10.0,10.0,12.0,10.0,15.0,15.0,11.0,13.0,12.0,11.0,11.0,15.0,12.0,20.0,12.0,9.0,11.0,6.0,11.0,3.0,13.0,11.0,10.0,14.0,12.0,15.0,12.0,10.0,4.0,17.0,0.0,0.0,0.0,0.0,176.0,0.0,3.0,1.0,2.0,2.0,3.0,3.0,2.0,3.0,3.0,3.0,1.0,10.0,9.0,15.0,9.0,14.0,10.0,7.0,8.0,4.0,3.0,11.0,11.0,5.0,13.0,9.0,11.0,12.0,10.0,9.0,11.0,9.0,9.0,13.0,7.0,11.0,4.0,10.0,8.0,13.0,12.0,6.0,7.0,16.0,11.0,13.0,20.0,8.0,4.0,10.0,10.0,9.0,4.0,10.0,11.0,11.0,10.0,10.0,10.0,13.0,11.0,4.0,27.0,0.0,0.0,1.0,0.0,196.0,93.0,16.0,11.0,9.0,10.0,13.0,12.0,17.0,17.0,14.0,10.0,11.0,9.0,2.0,2.0,2.0,10.0,12.0,7.0,2.0,1.0,3.0,8.0,2.0,2.0,10.0,7.0,12.0,16.0,15.0,14.0,7.0,12.0,12.0,1.0,9.0,2.0,14.0,18.0,10.0,12.0,17.0,15.0,16.0,8.0,12.0,10.0,20.0,13.0,18.0,17.0,5.0,17.0,14.0,11.0,7.0,14.0,16.0,10.0,18.0,16.0,18.0,3.0,27.0,0.0,0.0,0.0,0.0,182.0,79.0,1.0,2.0,1.0,1.0,2.0,3.0,1.0,2.0,3.0,1.0,4.0,10.0,12.0,14.0,13.0,12.0,10.0,8.0,14.0,11.0,7.0,11.0,14.0,9.0,13.0,16.0,11.0,13.0,9.0,12.0,10.0,10.0,12.0,14.0,7.0,12.0,9.0,14.0,16.0,15.0,13.0,15.0,9.0,9.0,14.0,17.0,20.0,14.0,12.0,13.0,8.0,13.0,8.0,15.0,9.0,14.0,12.0,11.0,15.0,13.0,10.0,8.0,28.0,40.0,2.0,22.0,3.0,187.0,82.0,1.0,1.0,3.0,1.0,3.0,1.0,1.0,1.0,2.0,1.0,1.0,4.0,8.0,6.0,8.0,10.0,4.0,16.0,5.0,12.0,18.0,10.0,8.0,18.0,9.0,16.0,14.0,17.0,10.0,18.0,8.0,12.0,17.0,3.0,14.0,8.0,15.0,18.0,12.0,11.0,10.0,15.0,15.0,12.0,16.0,13.0,20.0,16.0,14.0,17.0,10.0,17.0,12.0,14.0,10.0,13.0,17.0,15.0,18.0,16.0,13.0,3.0,20.0,1.0,0.0,17.0,6.0,169.0,68.0,3.0,2.0,2.0,1.0,1.0,1.0,3.0,3.0,2.0,4.0,2.0,11.0,12.0,17.0,11.0,18.0,9.0,6.0,12.0,4.0,5.0,14.0,10.0,6.0,18.0,10.0,14.0,8.0,13.0,10.0,17.0,13.0,9.0,17.0,5.0,15.0,7.0,14.0,10.0,14.0,17.0,9.0,5.0,15.0,12.0,11.0,20.0,12.0,7.0,12.0,4.0,12.0,5.0,14.0,10.0,16.0,12.0,12.0,11.0,13.0,15.0,13.0,21.0,1.0,0.0,9.0,1.0,189.0,79.0,3.0,2.0,3.0,1.0,3.0,2.0,2.0,4.0,2.0,3.0,3.0,11.0,12.0,11.0,13.0,14.0,10.0,13.0,11.0,9.0,9.0,15.0,12.0,11.0,15.0,17.0,12.0,14.0,16.0,12.0,13.0,13.0,16.0,10.0,13.0,15.0,10.0,16.0,17.0,11.0,11.0,15.0,14.0,10.0,14.0,16.0,20.0,16.0,13.0,14.0,8.0,15.0,12.0,16.0,12.0,18.0,10.0,14.0,15.0,13.0,8.0,8.0,21.0,19.0,3.0,0.0,0.0,187.0,78.0,3.0,2.0,3.0,1.0,1.0,1.0,1.0,1.0,1.0,2.0,3.0,9.0,12.0,13.0,10.0,15.0,10.0,9.0,12.0,9.0,11.0,14.0,10.0,13.0,16.0,17.0,14.0,16.0,16.0,11.0,14.0,11.0,17.0,13.0,10.0,14.0,12.0,12.0,17.0,12.0,13.0,15.0,14.0,20.0,14.0,12.0,12.0,17.0,13.0,12.0,13.0,13.0,11.0,8.0,14.0,16.0,10.0,13.0,12.0,14.0,10.0,12.0,29.0,12.0,0.0,25.0,4.0,184.0,84.0,4.0,1.0,3.0,1.0,1.0,2.0,3.0,3.0,2.0,1.0,3.0,12.0,16.0,11.0,8.0,13.0,12.0,8.0,11.0,13.0,10.0,14.0,15.0,11.0,14.0,8.0,12.0,10.0,15.0,11.0,13.0,12.0,9.0,14.0,8.0,11.0,10.0,13.0,10.0,12.0,14.0,12.0,11.0,20.0,15.0,14.0,10.0,15.0,13.0,13.0,8.0,13.0,5.0,17.0,8.0,12.0,14.0,12.0,13.0,13.0,10.0,10.0,27.0,9.0,0.0,11.0,0.0,187.0,80.0,3.0,3.0,2.0,3.0,3.0,1.0,2.0,1.0,1.0,3.0,1.0,8.0,12.0,11.0,13.0,10.0,8.0,13.0,10.0,8.0,6.0,9.0,11.0,7.0,11.0,17.0,14.0,16.0,12.0,12.0,9.0,9.0,16.0,15.0,11.0,16.0,8.0,12.0,17.0,12.0,10.0,16.0,13.0,16.0,17.0,15.0,20.0,15.0,14.0,14.0,10.0,14.0,5.0,15.0,12.0,14.0,8.0,15.0,12.0,8.0,10.0,10.0,19.0,0.0,0.0,0.0,0.0,185.0,73.0,1.0,1.0,4.0,3.0,3.0,4.0,3.0,2.0,2.0,1.0,1.0,6.0,9.0,10.0,6.0,12.0,5.0,14.0,7.0,10.0,12.0,13.0,7.0,15.0,13.0,11.0,14.0,13.0,15.0,8.0,12.0,10.0,10.0,9.0,11.0,7.0,11.0,14.0,9.0,13.0,12.0,14.0,14.0,12.0,16.0,17.0,20.0,13.0,11.0,11.0,9.0,14.0,5.0,17.0,10.0,17.0,5.0,12.0,9.0,14.0,12.0,15.0,22.0,7.0,2.0,19.0,8.0,178.0,75.0,3.0,3.0,3.0,2.0,1.0,4.0,1.0,2.0,3.0,2.0,2.0,12.0,11.0,15.0,13.0,14.0,10.0,8.0,15.0,7.0,7.0,13.0,12.0,10.0,14.0,16.0,13.0,10.0,12.0,9.0,12.0,10.0,11.0,15.0,10.0,15.0,9.0,13.0,16.0,14.0,15.0,10.0,8.0,15.0,16.0,12.0,20.0,16.0,8.0,11.0,6.0,11.0,5.0,17.0,12.0,16.0,10.0,11.0,15.0,13.0,17.0,4.0,23.0,19.0,0.0,8.0,1.0,188.0,83.0,1.0,3.0,3.0,2.0,3.0,1.0,2.0,2.0,2.0,2.0,2.0,7.0,10.0,9.0,6.0,12.0,5.0,12.0,6.0,10.0,15.0,13.0,7.0,15.0,13.0,12.0,17.0,13.0,16.0,16.0,12.0,15.0,12.0,8.0,10.0,7.0,16.0,17.0,10.0,12.0,11.0,13.0,14.0,20.0,12.0,15.0,10.0,12.0,14.0,15.0,6.0,13.0,10.0,10.0,17.0,16.0,10.0,14.0,15.0,13.0,16.0,8.0
3,2,27.0,0.0,0.0,1.0,0.0,196.0,93.0,16.0,11.0,9.0,10.0,13.0,12.0,17.0,17.0,14.0,10.0,11.0,9.0,2.0,2.0,2.0,10.0,12.0,7.0,2.0,1.0,3.0,8.0,2.0,2.0,10.0,7.0,12.0,16.0,15.0,14.0,7.0,12.0,12.0,1.0,9.0,2.0,14.0,18.0,10.0,12.0,17.0,15.0,16.0,8.0,12.0,10.0,20.0,13.0,18.0,17.0,5.0,17.0,14.0,11.0,7.0,14.0,16.0,10.0,18.0,16.0,18.0,3.0,27.0,0.0,0.0,0.0,0.0,182.0,79.0,1.0,2.0,1.0,1.0,2.0,3.0,1.0,2.0,3.0,1.0,4.0,10.0,12.0,14.0,13.0,12.0,10.0,8.0,14.0,11.0,7.0,11.0,14.0,9.0,13.0,16.0,11.0,13.0,9.0,12.0,10.0,10.0,12.0,14.0,7.0,12.0,9.0,14.0,16.0,15.0,13.0,15.0,9.0,9.0,14.0,17.0,20.0,14.0,12.0,13.0,8.0,13.0,8.0,15.0,9.0,14.0,12.0,11.0,15.0,13.0,10.0,8.0,28.0,40.0,2.0,22.0,3.0,187.0,82.0,1.0,1.0,3.0,1.0,3.0,1.0,1.0,1.0,2.0,1.0,1.0,4.0,8.0,6.0,8.0,10.0,4.0,16.0,5.0,12.0,18.0,10.0,8.0,18.0,9.0,16.0,14.0,17.0,10.0,18.0,8.0,12.0,17.0,3.0,14.0,8.0,15.0,18.0,12.0,11.0,10.0,15.0,15.0,12.0,16.0,13.0,20.0,16.0,14.0,17.0,10.0,17.0,12.0,14.0,10.0,13.0,17.0,15.0,18.0,16.0,13.0,3.0,23.0,13.0,0.0,0.0,0.0,183.0,82.0,2.0,1.0,1.0,3.0,3.0,2.0,1.0,3.0,1.0,3.0,3.0,6.0,10.0,12.0,7.0,12.0,6.0,13.0,8.0,15.0,16.0,11.0,9.0,17.0,11.0,17.0,10.0,18.0,8.0,13.0,9.0,10.0,17.0,9.0,10.0,12.0,11.0,12.0,17.0,14.0,13.0,18.0,12.0,20.0,18.0,17.0,9.0,17.0,15.0,15.0,14.0,15.0,5.0,14.0,12.0,16.0,10.0,15.0,12.0,10.0,8.0,13.0,20.0,1.0,0.0,17.0,6.0,169.0,68.0,3.0,2.0,2.0,1.0,1.0,1.0,3.0,3.0,2.0,4.0,2.0,11.0,12.0,17.0,11.0,18.0,9.0,6.0,12.0,4.0,5.0,14.0,10.0,6.0,18.0,10.0,14.0,8.0,13.0,10.0,17.0,13.0,9.0,17.0,5.0,15.0,7.0,14.0,10.0,14.0,17.0,9.0,5.0,15.0,12.0,11.0,20.0,12.0,7.0,12.0,4.0,12.0,5.0,14.0,10.0,16.0,12.0,12.0,11.0,13.0,15.0,13.0,21.0,1.0,0.0,9.0,1.0,189.0,79.0,3.0,2.0,3.0,1.0,3.0,2.0,2.0,4.0,2.0,3.0,3.0,11.0,12.0,11.0,13.0,14.0,10.0,13.0,11.0,9.0,9.0,15.0,12.0,11.0,15.0,17.0,12.0,14.0,16.0,12.0,13.0,13.0,16.0,10.0,13.0,15.0,10.0,16.0,17.0,11.0,11.0,15.0,14.0,10.0,14.0,16.0,20.0,16.0,13.0,14.0,8.0,15.0,12.0,16.0,12.0,18.0,10.0,14.0,15.0,13.0,8.0,8.0,21.0,19.0,3.0,0.0,0.0,187.0,78.0,3.0,2.0,3.0,1.0,1.0,1.0,1.0,1.0,1.0,2.0,3.0,9.0,12.0,13.0,10.0,15.0,10.0,9.0,12.0,9.0,11.0,14.0,10.0,13.0,16.0,17.0,14.0,16.0,16.0,11.0,14.0,11.0,17.0,13.0,10.0,14.0,12.0,12.0,17.0,12.0,13.0,15.0,14.0,20.0,14.0,12.0,12.0,17.0,13.0,12.0,13.0,13.0,11.0,8.0,14.0,16.0,10.0,13.0,12.0,14.0,10.0,12.0,25.0,0.0,0.0,14.0,0.0,180.0,82.0,1.0,3.0,3.0,1.0,3.0,2.0,3.0,1.0,1.0,3.0,1.0,5.0,10.0,10.0,7.0,13.0,7.0,12.0,8.0,10.0,14.0,12.0,8.0,17.0,13.0,13.0,16.0,16.0,14.0,15.0,10.0,12.0,15.0,8.0,13.0,10.0,14.0,18.0,15.0,10.0,12.0,16.0,11.0,10.0,15.0,12.0,20.0,16.0,15.0,17.0,10.0,16.0,6.0,10.0,12.0,16.0,12.0,13.0,17.0,14.0,14.0,5.0,27.0,9.0,0.0,11.0,0.0,187.0,80.0,3.0,3.0,2.0,3.0,3.0,1.0,2.0,1.0,1.0,3.0,1.0,8.0,12.0,11.0,13.0,10.0,8.0,13.0,10.0,8.0,6.0,9.0,11.0,7.0,11.0,17.0,14.0,16.0,12.0,12.0,9.0,9.0,16.0,15.0,11.0,16.0,8.0,12.0,17.0,12.0,10.0,16.0,13.0,16.0,17.0,15.0,20.0,15.0,14.0,14.0,10.0,14.0,5.0,15.0,12.0,14.0,8.0,15.0,12.0,8.0,10.0,10.0,33.0,2.0,0.0,20.0,0.0,174.0,71.0,2.0,1.0,2.0,3.0,3.0,1.0,2.0,4.0,2.0,4.0,3.0,9.0,11.0,10.0,6.0,13.0,7.0,10.0,6.0,14.0,13.0,12.0,9.0,14.0,12.0,11.0,16.0,12.0,14.0,16.0,8.0,14.0,16.0,7.0,13.0,10.0,12.0,18.0,12.0,12.0,13.0,12.0,8.0,10.0,17.0,15.0,20.0,13.0,9.0,17.0,6.0,17.0,9.0,17.0,11.0,11.0,15.0,13.0,18.0,15.0,13.0,4.0,23.0,19.0,0.0,8.0,1.0,188.0,83.0,1.0,3.0,3.0,2.0,3.0,1.0,2.0,2.0,2.0,2.0,2.0,7.0,10.0,9.0,6.0,12.0,5.0,12.0,6.0,10.0,15.0,13.0,7.0,15.0,13.0,12.0,17.0,13.0,16.0,16.0,12.0,15.0,12.0,8.0,10.0,7.0,16.0,17.0,10.0,12.0,11.0,13.0,14.0,20.0,12.0,15.0,10.0,12.0,14.0,15.0,6.0,13.0,10.0,10.0,17.0,16.0,10.0,14.0,15.0,13.0,16.0,8.0,20.0,0.0,0.0,0.0,0.0,190.0,83.0,15.0,9.0,12.0,8.0,13.0,13.0,13.0,15.0,13.0,12.0,11.0,9.0,3.0,2.0,1.0,10.0,11.0,4.0,1.0,3.0,3.0,13.0,1.0,1.0,11.0,9.0,9.0,15.0,13.0,8.0,6.0,11.0,9.0,6.0,7.0,1.0,13.0,8.0,12.0,13.0,15.0,12.0,14.0,6.0,16.0,13.0,20.0,11.0,12.0,12.0,8.0,15.0,6.0,11.0,12.0,10.0,4.0,10.0,8.0,12.0,13.0,6.0,24.0,12.0,0.0,8.0,0.0,184.0,75.0,4.0,2.0,2.0,2.0,2.0,2.0,4.0,1.0,1.0,3.0,3.0,7.0,5.0,12.0,8.0,13.0,4.0,13.0,5.0,9.0,14.0,12.0,7.0,16.0,11.0,13.0,15.0,12.0,15.0,13.0,11.0,13.0,16.0,9.0,13.0,12.0,16.0,14.0,13.0,12.0,13.0,12.0,14.0,11.0,15.0,13.0,20.0,14.0,12.0,13.0,6.0,12.0,8.0,8.0,18.0,9.0,18.0,15.0,18.0,14.0,16.0,4.0,20.0,0.0,0.0,17.0,0.0,187.0,78.0,2.0,1.0,3.0,3.0,1.0,3.0,3.0,3.0,1.0,2.0,1.0,9.0,6.0,10.0,7.0,11.0,11.0,13.0,9.0,6.0,13.0,11.0,7.0,16.0,14.0,13.0,12.0,12.0,12.0,12.0,10.0,12.0,12.0,9.0,8.0,10.0,13.0,10.0,13.0,11.0,14.0,13.0,13.0,10.0,13.0,12.0,20.0,13.0,13.0,13.0,6.0,8.0,11.0,10.0,11.0,11.0,12.0,11.0,12.0,11.0,12.0,9.0,20.0,29.0,2.0,0.0,0.0,181.0,75.0,1.0,1.0,2.0,2.0,2.0,3.0,2.0,1.0,1.0,3.0,2.0,5.0,9.0,15.0,10.0,11.0,9.0,10.0,8.0,7.0,3.0,10.0,10.0,5.0,15.0,7.0,10.0,9.0,12.0,10.0,8.0,11.0,14.0,12.0,5.0,13.0,5.0,11.0,12.0,16.0,12.0,9.0,12.0,20.0,14.0,16.0,7.0,12.0,10.0,9.0,10.0,10.0,11.0,6.0,10.0,15.0,9.0,13.0,11.0,14.0,18.0,7.0,23.0,5.0,1.0,4.0,0.0,181.0,75.0,2.0,1.0,3.0,2.0,3.0,3.0,2.0,4.0,3.0,3.0,1.0,7.0,8.0,12.0,13.0,14.0,9.0,12.0,10.0,8.0,6.0,14.0,13.0,8.0,12.0,18.0,15.0,16.0,15.0,13.0,13.0,16.0,17.0,10.0,15.0,16.0,10.0,16.0,16.0,12.0,13.0,14.0,12.0,10.0,15.0,13.0,20.0,16.0,12.0,14.0,7.0,14.0,9.0,11.0,19.0,12.0,17.0,14.0,17.0,11.0,13.0,4.0,22.0,0.0,0.0,18.0,3.0,170.0,66.0,3.0,2.0,3.0,2.0,3.0,2.0,1.0,1.0,1.0,2.0,2.0,10.0,12.0,16.0,8.0,16.0,11.0,5.0,8.0,6.0,5.0,12.0,9.0,5.0,15.0,8.0,11.0,10.0,11.0,8.0,12.0,9.0,9.0,17.0,6.0,12.0,6.0,10.0,8.0,16.0,18.0,12.0,4.0,7.0,12.0,14.0,20.0,12.0,5.0,11.0,5.0,12.0,7.0,12.0,12.0,15.0,8.0,11.0,10.0,9.0,11.0,13.0,30.0,26.0,3.0,9.0,1.0,177.0,76.0,1.0,1.0,3.0,2.0,2.0,3.0,3.0,1.0,1.0,1.0,3.0,15.0,10.0,12.0,10.0,14.0,15.0,9.0,13.0,8.0,9.0,15.0,15.0,7.0,13.0,8.0,14.0,12.0,14.0,13.0,15.0,14.0,15.0,12.0,15.0,14.0,11.0,15.0,13.0,9.0,13.0,12.0,10.0,10.0,17.0,10.0,20.0,11.0,10.0,17.0,2.0,15.0,2.0,15.0,17.0,15.0,15.0,14.0,17.0,18.0,16.0,8.0,23.0,7.0,2.0,0.0,0.0,183.0,67.0,3.0,4.0,3.0,4.0,3.0,1.0,2.0,1.0,3.0,1.0,3.0,15.0,13.0,14.0,11.0,14.0,16.0,7.0,15.0,7.0,4.0,16.0,15.0,4.0,16.0,13.0,13.0,11.0,12.0,13.0,17.0,13.0,14.0,14.0,13.0,14.0,5.0,12.0,14.0,15.0,16.0,12.0,7.0,20.0,15.0,13.0,13.0,14.0,10.0,14.0,10.0,14.0,6.0,13.0,12.0,14.0,11.0,12.0,14.0,14.0,12.0,12.0,26.0,1.0,0.0,5.0,0.0,183.0,78.0,1.0,3.0,1.0,1.0,4.0,1.0,2.0,1.0,1.0,1.0,2.0,7.0,9.0,8.0,6.0,12.0,9.0,13.0,9.0,13.0,14.0,12.0,8.0,13.0,11.0,11.0,13.0,12.0,11.0,12.0,10.0,11.0,13.0,9.0,13.0,12.0,14.0,14.0,14.0,11.0,12.0,13.0,11.0,20.0,16.0,13.0,7.0,12.0,13.0,13.0,12.0,14.0,7.0,17.0,10.0,16.0,8.0,12.0,15.0,14.0,12.0,6.0,16.0,0.0,0.0,0.0,0.0,188.0,82.0,1.0,2.0,1.0,2.0,1.0,1.0,3.0,3.0,2.0,3.0,2.0,6.0,7.0,9.0,4.0,12.0,6.0,10.0,9.0,7.0,11.0,14.0,8.0,13.0,11.0,10.0,12.0,13.0,12.0,12.0,12.0,11.0,14.0,10.0,8.0,10.0,13.0,12.0,13.0,10.0,12.0,12.0,15.0,14.0,13.0,11.0,20.0,11.0,12.0,13.0,1.0,5.0,4.0,12.0,16.0,8.0,12.0,14.0,10.0,12.0,10.0,3.0,17.0,0.0,0.0,0.0,0.0,176.0,0.0,3.0,1.0,2.0,2.0,3.0,3.0,2.0,3.0,3.0,3.0,1.0,10.0,9.0,15.0,9.0,14.0,10.0,7.0,8.0,4.0,3.0,11.0,11.0,5.0,13.0,9.0,11.0,12.0,10.0,9.0,11.0,9.0,9.0,13.0,7.0,11.0,4.0,10.0,8.0,13.0,12.0,6.0,7.0,16.0,11.0,13.0,20.0,8.0,4.0,10.0,10.0,9.0,4.0,10.0,11.0,11.0,10.0,10.0,10.0,13.0,11.0,4.0
3,1,25.0,4.0,0.0,11.0,0.0,184.0,81.0,14.0,14.0,13.0,9.0,15.0,12.0,16.0,16.0,13.0,7.0,11.0,8.0,1.0,2.0,1.0,11.0,12.0,6.0,1.0,3.0,3.0,11.0,5.0,3.0,11.0,8.0,15.0,15.0,13.0,14.0,10.0,11.0,14.0,8.0,13.0,5.0,13.0,10.0,10.0,14.0,16.0,14.0,13.0,20.0,14.0,12.0,5.0,14.0,14.0,15.0,9.0,16.0,6.0,1.0,17.0,11.0,15.0,13.0,14.0,12.0,12.0,4.0,26.0,69.0,1.0,3.0,0.0,180.0,77.0,1.0,2.0,2.0,1.0,2.0,2.0,3.0,1.0,3.0,2.0,1.0,5.0,8.0,10.0,6.0,13.0,6.0,14.0,9.0,8.0,14.0,12.0,7.0,14.0,12.0,12.0,15.0,15.0,14.0,13.0,11.0,13.0,15.0,9.0,14.0,7.0,14.0,15.0,13.0,14.0,13.0,16.0,11.0,8.0,12.0,14.0,20.0,13.0,14.0,13.0,14.0,14.0,9.0,12.0,9.0,15.0,15.0,13.0,16.0,9.0,15.0,7.0,19.0,0.0,0.0,0.0,0.0,193.0,89.0,3.0,2.0,2.0,3.0,1.0,3.0,1.0,4.0,2.0,2.0,3.0,8.0,10.0,5.0,4.0,10.0,10.0,14.0,12.0,6.0,12.0,10.0,4.0,12.0,9.0,11.0,11.0,14.0,11.0,12.0,8.0,14.0,13.0,8.0,8.0,11.0,11.0,13.0,13.0,10.0,9.0,14.0,16.0,6.0,14.0,10.0,20.0,12.0,14.0,11.0,7.0,6.0,6.0,8.0,16.0,10.0,10.0,12.0,13.0,16.0,16.0,5.0,21.0,0.0,0.0,15.0,3.0,181.0,78.0,3.0,3.0,4.0,2.0,1.0,2.0,2.0,4.0,2.0,1.0,1.0,5.0,7.0,11.0,10.0,14.0,5.0,14.0,10.0,6.0,13.0,14.0,8.0,14.0,14.0,12.0,14.0,12.0,11.0,10.0,12.0,11.0,16.0,11.0,12.0,14.0,14.0,14.0,14.0,14.0,13.0,14.0,13.0,10.0,16.0,14.0,20.0,16.0,14.0,12.0,10.0,11.0,5.0,19.0,8.0,11.0,14.0,11.0,16.0,13.0,13.0,10.0,25.0,10.0,1.0,11.0,4.0,175.0,73.0,1.0,3.0,3.0,3.0,3.0,3.0,3.0,1.0,2.0,3.0,1.0,5.0,10.0,15.0,17.0,15.0,10.0,11.0,12.0,5.0,5.0,14.0,15.0,5.0,16.0,8.0,15.0,12.0,15.0,14.0,13.0,15.0,15.0,15.0,14.0,14.0,10.0,10.0,12.0,16.0,16.0,15.0,9.0,10.0,15.0,16.0,20.0,13.0,15.0,14.0,8.0,14.0,7.0,10.0,8.0,16.0,17.0,13.0,15.0,15.0,14.0,5.0,32.0,0.0,0.0,0.0,0.0,172.0,71.0,2.0,1.0,3.0,1.0,2.0,3.0,2.0,3.0,2.0,2.0,2.0,8.0,9.0,7.0,6.0,10.0,6.0,10.0,9.0,10.0,14.0,11.0,6.0,14.0,11.0,10.0,16.0,15.0,12.0,12.0,7.0,12.0,15.0,9.0,13.0,8.0,14.0,15.0,15.0,14.0,14.0,14.0,10.0,20.0,14.0,14.0,8.0,15.0,13.0,13.0,11.0,13.0,7.0,13.0,17.0,14.0,17.0,8.0,13.0,15.0,15.0,6.0,22.0,5.0,1.0,1.0,0.0,173.0,72.0,1.0,3.0,1.0,3.0,3.0,3.0,3.0,3.0,3.0,2.0,2.0,14.0,13.0,16.0,14.0,16.0,14.0,5.0,11.0,5.0,5.0,15.0,11.0,5.0,16.0,8.0,13.0,9.0,14.0,13.0,15.0,13.0,15.0,16.0,5.0,13.0,5.0,9.0,10.0,15.0,16.0,14.0,5.0,20.0,14.0,15.0,5.0,12.0,14.0,13.0,11.0,13.0,8.0,14.0,10.0,15.0,14.0,10.0,13.0,10.0,10.0,13.0,37.0,0.0,0.0,0.0,0.0,185.0,83.0,1.0,1.0,2.0,1.0,3.0,2.0,3.0,1.0,1.0,3.0,1.0,6.0,8.0,9.0,12.0,10.0,8.0,13.0,9.0,4.0,5.0,10.0,14.0,4.0,11.0,11.0,10.0,11.0,13.0,12.0,12.0,13.0,15.0,14.0,12.0,11.0,7.0,12.0,8.0,7.0,7.0,12.0,12.0,11.0,11.0,7.0,20.0,8.0,14.0,12.0,8.0,13.0,9.0,12.0,12.0,12.0,19.0,14.0,15.0,14.0,8.0,8.0,27.0,8.0,0.0,6.0,0.0,187.0,76.0,3.0,2.0,3.0,2.0,2.0,1.0,1.0,3.0,3.0,1.0,2.0,5.0,7.0,11.0,5.0,14.0,5.0,14.0,9.0,5.0,15.0,15.0,8.0,14.0,13.0,15.0,16.0,15.0,14.0,12.0,14.0,14.0,18.0,8.0,17.0,9.0,12.0,18.0,15.0,13.0,14.0,15.0,14.0,10.0,17.0,12.0,20.0,17.0,15.0,14.0,13.0,16.0,4.0,12.0,10.0,14.0,17.0,12.0,15.0,13.0,13.0,6.0,19.0,0.0,0.0,3.0,1.0,181.0,69.0,3.0,2.0,3.0,3.0,2.0,1.0,1.0,1.0,3.0,3.0,4.0,10.0,10.0,12.0,12.0,12.0,7.0,8.0,11.0,5.0,7.0,10.0,10.0,7.0,11.0,8.0,10.0,10.0,12.0,8.0,11.0,8.0,14.0,13.0,6.0,14.0,8.0,13.0,13.0,16.0,14.0,13.0,9.0,20.0,15.0,16.0,10.0,15.0,13.0,12.0,8.0,11.0,7.0,12.0,11.0,11.0,15.0,10.0,12.0,14.0,14.0,1.0,31.0,52.0,8.0,0.0,0.0,167.0,58.0,1.0,2.0,2.0,1.0,3.0,2.0,4.0,2.0,1.0,2.0,3.0,15.0,15.0,14.0,7.0,15.0,15.0,6.0,11.0,3.0,4.0,15.0,14.0,7.0,15.0,13.0,12.0,15.0,13.0,14.0,16.0,11.0,17.0,14.0,11.0,12.0,10.0,12.0,14.0,15.0,18.0,10.0,5.0,10.0,16.0,14.0,20.0,13.0,7.0,14.0,13.0,16.0,8.0,12.0,13.0,16.0,14.0,15.0,13.0,9.0,11.0,14.0,20.0,0.0,0.0,0.0,0.0,190.0,83.0,15.0,9.0,12.0,8.0,13.0,13.0,13.0,15.0,13.0,12.0,11.0,9.0,3.0,2.0,1.0,10.0,11.0,4.0,1.0,3.0,3.0,13.0,1.0,1.0,11.0,9.0,9.0,15.0,13.0,8.0,6.0,11.0,9.0,6.0,7.0,1.0,13.0,8.0,12.0,13.0,15.0,12.0,14.0,6.0,16.0,13.0,20.0,11.0,12.0,12.0,8.0,15.0,6.0,11.0,12.0,10.0,4.0,10.0,8.0,12.0,13.0,6.0,24.0,12.0,0.0,8.0,0.0,184.0,75.0,4.0,2.0,2.0,2.0,2.0,2.0,4.0,1.0,1.0,3.0,3.0,7.0,5.0,12.0,8.0,13.0,4.0,13.0,5.0,9.0,14.0,12.0,7.0,16.0,11.0,13.0,15.0,12.0,15.0,13.0,11.0,13.0,16.0,9.0,13.0,12.0,16.0,14.0,13.0,12.0,13.0,12.0,14.0,11.0,15.0,13.0,20.0,14.0,12.0,13.0,6.0,12.0,8.0,8.0,18.0,9.0,18.0,15.0,18.0,14.0,16.0,4.0,20.0,0.0,0.0,17.0,0.0,187.0,78.0,2.0,1.0,3.0,3.0,1.0,3.0,3.0,3.0,1.0,2.0,1.0,9.0,6.0,10.0,7.0,11.0,11.0,13.0,9.0,6.0,13.0,11.0,7.0,16.0,14.0,13.0,12.0,12.0,12.0,12.0,10.0,12.0,12.0,9.0,8.0,10.0,13.0,10.0,13.0,11.0,14.0,13.0,13.0,10.0,13.0,12.0,20.0,13.0,13.0,13.0,6.0,8.0,11.0,10.0,11.0,11.0,12.0,11.0,12.0,11.0,12.0,9.0,20.0,29.0,2.0,0.0,0.0,181.0,75.0,1.0,1.0,2.0,2.0,2.0,3.0,2.0,1.0,1.0,3.0,2.0,5.0,9.0,15.0,10.0,11.0,9.0,10.0,8.0,7.0,3.0,10.0,10.0,5.0,15.0,7.0,10.0,9.0,12.0,10.0,8.0,11.0,14.0,12.0,5.0,13.0,5.0,11.0,12.0,16.0,12.0,9.0,12.0,20.0,14.0,16.0,7.0,12.0,10.0,9.0,10.0,10.0,11.0,6.0,10.0,15.0,9.0,13.0,11.0,14.0,18.0,7.0,23.0,5.0,1.0,4.0,0.0,181.0,75.0,2.0,1.0,3.0,2.0,3.0,3.0,2.0,4.0,3.0,3.0,1.0,7.0,8.0,12.0,13.0,14.0,9.0,12.0,10.0,8.0,6.0,14.0,13.0,8.0,12.0,18.0,15.0,16.0,15.0,13.0,13.0,16.0,17.0,10.0,15.0,16.0,10.0,16.0,16.0,12.0,13.0,14.0,12.0,10.0,15.0,13.0,20.0,16.0,12.0,14.0,7.0,14.0,9.0,11.0,19.0,12.0,17.0,14.0,17.0,11.0,13.0,4.0,22.0,0.0,0.0,18.0,3.0,170.0,66.0,3.0,2.0,3.0,2.0,3.0,2.0,1.0,1.0,1.0,2.0,2.0,10.0,12.0,16.0,8.0,16.0,11.0,5.0,8.0,6.0,5.0,12.0,9.0,5.0,15.0,8.0,11.0,10.0,11.0,8.0,12.0,9.0,9.0,17.0,6.0,12.0,6.0,10.0,8.0,16.0,18.0,12.0,4.0,7.0,12.0,14.0,20.0,12.0,5.0,11.0,5.0,12.0,7.0,12.0,12.0,15.0,8.0,11.0,10.0,9.0,11.0,13.0,30.0,26.0,3.0,9.0,1.0,177.0,76.0,1.0,1.0,3.0,2.0,2.0,3.0,3.0,1.0,1.0,1.0,3.0,15.0,10.0,12.0,10.0,14.0,15.0,9.0,13.0,8.0,9.0,15.0,15.0,7.0,13.0,8.0,14.0,12.0,14.0,13.0,15.0,14.0,15.0,12.0,15.0,14.0,11.0,15.0,13.0,9.0,13.0,12.0,10.0,10.0,17.0,10.0,20.0,11.0,10.0,17.0,2.0,15.0,2.0,15.0,17.0,15.0,15.0,14.0,17.0,18.0,16.0,8.0,23.0,7.0,2.0,0.0,0.0,183.0,67.0,3.0,4.0,3.0,4.0,3.0,1.0,2.0,1.0,3.0,1.0,3.0,15.0,13.0,14.0,11.0,14.0,16.0,7.0,15.0,7.0,4.0,16.0,15.0,4.0,16.0,13.0,13.0,11.0,12.0,13.0,17.0,13.0,14.0,14.0,13.0,14.0,5.0,12.0,14.0,15.0,16.0,12.0,7.0,20.0,15.0,13.0,13.0,14.0,10.0,14.0,10.0,14.0,6.0,13.0,12.0,14.0,11.0,12.0,14.0,14.0,12.0,12.0,18.0,0.0,0.0,0.0,0.0,187.0,77.0,2.0,3.0,3.0,1.0,2.0,2.0,1.0,2.0,3.0,1.0,1.0,8.0,11.0,13.0,12.0,14.0,13.0,13.0,13.0,7.0,3.0,11.0,9.0,4.0,14.0,10.0,12.0,11.0,13.0,12.0,11.0,11.0,12.0,13.0,4.0,12.0,4.0,14.0,15.0,14.0,15.0,12.0,13.0,11.0,15.0,14.0,20.0,11.0,11.0,13.0,4.0,13.0,12.0,11.0,15.0,11.0,14.0,13.0,13.0,16.0,16.0,5.0,26.0,1.0,0.0,5.0,0.0,183.0,78.0,1.0,3.0,1.0,1.0,4.0,1.0,2.0,1.0,1.0,1.0,2.0,7.0,9.0,8.0,6.0,12.0,9.0,13.0,9.0,13.0,14.0,12.0,8.0,13.0,11.0,11.0,13.0,12.0,11.0,12.0,10.0,11.0,13.0,9.0,13.0,12.0,14.0,14.0,14.0,11.0,12.0,13.0,11.0,20.0,16.0,13.0,7.0,12.0,13.0,13.0,12.0,14.0,7.0,17.0,10.0,16.0,8.0,12.0,15.0,14.0,12.0,6.0,16.0,0.0,0.0,0.0,0.0,188.0,82.0,1.0,2.0,1.0,2.0,1.0,1.0,3.0,3.0,2.0,3.0,2.0,6.0,7.0,9.0,4.0,12.0,6.0,10.0,9.0,7.0,11.0,14.0,8.0,13.0,11.0,10.0,12.0,13.0,12.0,12.0,12.0,11.0,14.0,10.0,8.0,10.0,13.0,12.0,13.0,10.0,12.0,12.0,15.0,14.0,13.0,11.0,20.0,11.0,12.0,13.0,1.0,5.0,4.0,12.0,16.0,8.0,12.0,14.0,10.0,12.0,10.0,3.0
0,2,20.0,0.0,0.0,0.0,0.0,190.0,83.0,15.0,9.0,12.0,8.0,13.0,13.0,13.0,15.0,13.0,12.0,11.0,9.0,3.0,2.0,1.0,10.0,11.0,4.0,1.0,3.0,3.0,13.0,1.0,1.0,11.0,9.0,9.0,15.0,13.0,8.0,6.0,11.0,9.0,6.0,7.0,1.0,13.0,8.0,12.0,13.0,15.0,12.0,14.0,6.0,16.0,13.0,20.0,11.0,12.0,12.0,8.0,15.0,6.0,11.0,12.0,10.0,4.0,10.0,8.0,12.0,13.0,6.0,24.0,12.0,0.0,8.0,0.0,184.0,75.0,4.0,2.0,2.0,2.0,2.0,2.0,4.0,1.0,1.0,3.0,3.0,7.0,5.0,12.0,8.0,13.0,4.0,13.0,5.0,9.0,14.0,12.0,7.0,16.0,11.0,13.0,15.0,12.0,15.0,13.0,11.0,13.0,16.0,9.0,13.0,12.0,16.0,14.0,13.0,12.0,13.0,12.0,14.0,11.0,15.0,13.0,20.0,14.0,12.0,13.0,6.0,12.0,8.0,8.0,18.0,9.0,18.0,15.0,18.0,14.0,16.0,4.0,19.0,3.0,0.0,0.0,0.0,188.0,78.0,1.0,2.0,3.0,3.0,3.0,1.0,2.0,2.0,1.0,2.0,1.0,8.0,9.0,9.0,7.0,13.0,8.0,11.0,6.0,8.0,13.0,15.0,8.0,13.0,13.0,12.0,13.0,14.0,13.0,13.0,15.0,14.0,13.0,10.0,10.0,12.0,14.0,14.0,13.0,12.0,13.0,14.0,13.0,20.0,15.0,14.0,8.0,14.0,11.0,13.0,6.0,11.0,5.0,8.0,15.0,12.0,8.0,11.0,13.0,10.0,9.0,3.0,20.0,0.0,0.0,17.0,0.0,187.0,78.0,2.0,1.0,3.0,3.0,1.0,3.0,3.0,3.0,1.0,2.0,1.0,9.0,6.0,10.0,7.0,11.0,11.0,13.0,9.0,6.0,13.0,11.0,7.0,16.0,14.0,13.0,12.0,12.0,12.0,12.0,10.0,12.0,12.0,9.0,8.0,10.0,13.0,10.0,13.0,11.0,14.0,13.0,13.0,10.0,13.0,12.0,20.0,13.0,13.0,13.0,6.0,8.0,11.0,10.0,11.0,11.0,12.0,11.0,12.0,11.0,12.0,9.0,20.0,29.0,2.0,0.0,0.0,181.0,75.0,1.0,1.0,2.0,2.0,2.0,3.0,2.0,1.0,1.0,3.0,2.0,5.0,9.0,15.0,10.0,11.0,9.0,10.0,8.0,7.0,3.0,10.0,10.0,5.0,15.0,7.0,10.0,9.0,12.0,10.0,8.0,11.0,14.0,12.0,5.0,13.0,5.0,11.0,12.0,16.0,12.0,9.0,12.0,20.0,14.0,16.0,7.0,12.0,10.0,9.0,10.0,10.0,11.0,6.0,10.0,15.0,9.0,13.0,11.0,14.0,18.0,7.0,23.0,5.0,1.0,4.0,0.0,181.0,75.0,2.0,1.0,3.0,2.0,3.0,3.0,2.0,4.0,3.0,3.0,1.0,7.0,8.0,12.0,13.0,14.0,9.0,12.0,10.0,8.0,6.0,14.0,13.0,8.0,12.0,18.0,15.0,16.0,15.0,13.0,13.0,16.0,17.0,10.0,15.0,16.0,10.0,16.0,16.0,12.0,13.0,14.0,12.0,10.0,15.0,13.0,20.0,16.0,12.0,14.0,7.0,14.0,9.0,11.0,19.0,12.0,17.0,14.0,17.0,11.0,13.0,4.0,22.0,0.0,0.0,18.0,3.0,170.0,66.0,3.0,2.0,3.0,2.0,3.0,2.0,1.0,1.0,1.0,2.0,2.0,10.0,12.0,16.0,8.0,16.0,11.0,5.0,8.0,6.0,5.0,12.0,9.0,5.0,15.0,8.0,11.0,10.0,11.0,8.0,12.0,9.0,9.0,17.0,6.0,12.0,6.0,10.0,8.0,16.0,18.0,12.0,4.0,7.0,12.0,14.0,20.0,12.0,5.0,11.0,5.0,12.0,7.0,12.0,12.0,15.0,8.0,11.0,10.0,9.0,11.0,13.0,30.0,26.0,3.0,9.0,1.0,177.0,76.0,1.0,1.0,3.0,2.0,2.0,3.0,3.0,1.0,1.0,1.0,3.0,15.0,10.0,12.0,10.0,14.0,15.0,9.0,13.0,8.0,9.0,15.0,15.0,7.0,13.0,8.0,14.0,12.0,14.0,13.0,15.0,14.0,15.0,12.0,15.0,14.0,11.0,15.0,13.0,9.0,13.0,12.0,10.0,10.0,17.0,10.0,20.0,11.0,10.0,17.0,2.0,15.0,2.0,15.0,17.0,15.0,15.0,14.0,17.0,18.0,16.0,8.0,23.0,7.0,2.0,0.0,0.0,183.0,67.0,3.0,4.0,3.0,4.0,3.0,1.0,2.0,1.0,3.0,1.0,3.0,15.0,13.0,14.0,11.0,14.0,16.0,7.0,15.0,7.0,4.0,16.0,15.0,4.0,16.0,13.0,13.0,11.0,12.0,13.0,17.0,13.0,14.0,14.0,13.0,14.0,5.0,12.0,14.0,15.0,16.0,12.0,7.0,20.0,15.0,13.0,13.0,14.0,10.0,14.0,10.0,14.0,6.0,13.0,12.0,14.0,11.0,12.0,14.0,14.0,12.0,12.0,18.0,0.0,0.0,0.0,0.0,187.0,77.0,2.0,3.0,3.0,1.0,2.0,2.0,1.0,2.0,3.0,1.0,1.0,8.0,11.0,13.0,12.0,14.0,13.0,13.0,13.0,7.0,3.0,11.0,9.0,4.0,14.0,10.0,12.0,11.0,13.0,12.0,11.0,11.0,12.0,13.0,4.0,12.0,4.0,14.0,15.0,14.0,15.0,12.0,13.0,11.0,15.0,14.0,20.0,11.0,11.0,13.0,4.0,13.0,12.0,11.0,15.0,11.0,14.0,13.0,13.0,16.0,16.0,5.0,16.0,0.0,0.0,0.0,0.0,188.0,82.0,1.0,2.0,1.0,2.0,1.0,1.0,3.0,3.0,2.0,3.0,2.0,6.0,7.0,9.0,4.0,12.0,6.0,10.0,9.0,7.0,11.0,14.0,8.0,13.0,11.0,10.0,12.0,13.0,12.0,12.0,12.0,11.0,14.0,10.0,8.0,10.0,13.0,12.0,13.0,10.0,12.0,12.0,15.0,14.0,13.0,11.0,20.0,11.0,12.0,13.0,1.0,5.0,4.0,12.0,16.0,8.0,12.0,14.0,10.0,12.0,10.0,3.0,16.0,0.0,0.0,0.0,0.0,179.0,0.0,1.0,3.0,1.0,2.0,3.0,2.0,3.0,1.0,2.0,3.0,1.0,1.0,1.0,2.0,1.0,2.0,1.0,3.0,1.0,1.0,5.0,1.0,1.0,10.0,4.0,11.0,3.0,4.0,1.0,6.0,1.0,10.0,14.0,7.0,10.0,1.0,9.0,11.0,11.0,9.0,5.0,8.0,6.0,20.0,12.0,8.0,8.0,6.0,4.0,6.0,8.0,12.0,8.0,5.0,8.0,7.0,8.0,19.0,16.0,5.0,8.0,2.0,23.0,38.0,6.0,13.0,4.0,191.0,84.0,3.0,2.0,1.0,3.0,1.0,3.0,3.0,1.0,1.0,4.0,2.0,7.0,12.0,17.0,15.0,19.0,15.0,13.0,18.0,4.0,11.0,16.0,12.0,13.0,18.0,13.0,14.0,13.0,15.0,14.0,16.0,12.0,17.0,19.0,12.0,15.0,12.0,13.0,15.0,13.0,15.0,18.0,16.0,15.0,17.0,16.0,20.0,17.0,17.0,16.0,14.0,12.0,5.0,10.0,17.0,19.0,12.0,14.0,14.0,14.0,13.0,8.0,28.0,39.0,11.0,25.0,8.0,171.0,65.0,4.0,3.0,2.0,1.0,1.0,3.0,3.0,2.0,2.0,1.0,3.0,14.0,14.0,16.0,16.0,19.0,16.0,4.0,12.0,3.0,2.0,18.0,15.0,4.0,19.0,11.0,18.0,8.0,16.0,14.0,18.0,16.0,15.0,17.0,6.0,17.0,4.0,16.0,13.0,13.0,16.0,13.0,6.0,20.0,13.0,12.0,12.0,15.0,8.0,16.0,10.0,16.0,7.0,12.0,18.0,18.0,12.0,15.0,17.0,13.0,19.0,2.0,26.0,29.0,1.0,14.0,1.0,194.0,90.0,1.0,2.0,3.0,4.0,1.0,2.0,3.0,3.0,3.0,2.0,2.0,4.0,4.0,7.0,7.0,11.0,2.0,17.0,2.0,8.0,15.0,8.0,4.0,16.0,12.0,14.0,16.0,15.0,11.0,13.0,3.0,14.0,14.0,5.0,12.0,4.0,16.0,15.0,14.0,13.0,12.0,14.0,16.0,9.0,12.0,14.0,20.0,16.0,17.0,14.0,8.0,13.0,11.0,8.0,17.0,14.0,13.0,13.0,15.0,16.0,17.0,6.0,26.0,36.0,2.0,23.0,0.0,180.0,72.0,3.0,2.0,2.0,1.0,2.0,3.0,2.0,1.0,4.0,2.0,2.0,11.0,11.0,8.0,6.0,15.0,8.0,12.0,8.0,10.0,14.0,16.0,9.0,14.0,14.0,12.0,16.0,14.0,16.0,15.0,14.0,16.0,17.0,10.0,13.0,11.0,14.0,17.0,16.0,9.0,11.0,13.0,11.0,20.0,17.0,11.0,8.0,17.0,12.0,17.0,12.0,15.0,4.0,20.0,16.0,14.0,16.0,18.0,18.0,16.0,15.0,8.0,18.0,3.0,1.0,0.0,0.0,181.0,73.0,3.0,1.0,1.0,1.0,1.0,1.0,4.0,2.0,2.0,2.0,3.0,5.0,8.0,14.0,14.0,13.0,11.0,8.0,11.0,3.0,2.0,11.0,13.0,5.0,14.0,14.0,12.0,8.0,13.0,11.0,9.0,12.0,12.0,17.0,4.0,14.0,4.0,12.0,15.0,18.0,16.0,13.0,8.0,12.0,16.0,17.0,20.0,14.0,11.0,12.0,7.0,12.0,4.0,10.0,20.0,10.0,9.0,17.0,11.0,13.0,18.0,4.0,26.0,0.0,0.0,15.0,4.0,182.0,73.0,1.0,2.0,2.0,4.0,1.0,3.0,3.0,3.0,3.0,3.0,3.0,10.0,11.0,12.0,11.0,17.0,11.0,5.0,12.0,3.0,7.0,16.0,14.0,13.0,17.0,14.0,16.0,14.0,14.0,15.0,15.0,14.0,16.0,14.0,15.0,15.0,14.0,16.0,17.0,14.0,16.0,12.0,9.0,11.0,15.0,13.0,20.0,16.0,11.0,15.0,15.0,15.0,6.0,13.0,14.0,16.0,15.0,13.0,18.0,10.0,12.0,8.0,27.0,59.0,19.0,13.0,9.0,178.0,72.0,2.0,1.0,1.0,1.0,3.0,2.0,2.0,3.0,1.0,2.0,1.0,15.0,12.0,14.0,13.0,15.0,10.0,10.0,13.0,6.0,7.0,13.0,11.0,11.0,14.0,17.0,16.0,10.0,11.0,10.0,14.0,12.0,12.0,14.0,9.0,17.0,10.0,16.0,17.0,16.0,16.0,12.0,8.0,16.0,18.0,15.0,20.0,17.0,8.0,13.0,6.0,12.0,3.0,17.0,15.0,17.0,6.0,8.0,18.0,12.0,14.0,10.0,30.0,84.0,9.0,0.0,0.0,181.0,78.0,1.0,2.0,3.0,2.0,1.0,2.0,1.0,1.0,2.0,4.0,3.0,10.0,12.0,12.0,9.0,12.0,5.0,7.0,8.0,8.0,11.0,12.0,4.0,14.0,13.0,11.0,11.0,12.0,8.0,12.0,7.0,11.0,17.0,15.0,5.0,12.0,13.0,16.0,18.0,16.0,13.0,18.0,8.0,7.0,16.0,15.0,20.0,17.0,18.0,14.0,7.0,14.0,6.0,8.0,18.0,15.0,12.0,12.0,18.0,16.0,16.0,4.0,28.0,72.0,15.0,7.0,0.0,194.0,85.0,1.0,3.0,3.0,3.0,2.0,3.0,1.0,3.0,3.0,1.0,2.0,9.0,9.0,9.0,13.0,14.0,8.0,17.0,10.0,13.0,12.0,13.0,12.0,15.0,15.0,17.0,14.0,16.0,11.0,13.0,10.0,14.0,15.0,12.0,7.0,15.0,13.0,18.0,16.0,9.0,12.0,19.0,17.0,12.0,16.0,13.0,20.0,17.0,17.0,14.0,19.0,12.0,5.0,12.0,14.0,16.0,11.0,12.0,14.0,5.0,8.0,9.0,26.0,26.0,1.0,1.0,0.0,183.0,70.0,3.0,2.0,3.0,2.0,1.0,1.0,1.0,2.0,3.0,3.0,2.0,4.0,10.0,10.0,7.0,13.0,4.0,14.0,4.0,10.0,14.0,13.0,4.0,17.0,13.0,12.0,13.0,14.0,13.0,13.0,9.0,13.0,13.0,5.0,10.0,10.0,13.0,14.0,15.0,13.0,14.0,14.0,11.0,11.0,17.0,14.0,20.0,15.0,14.0,15.0,13.0,13.0,7.0,18.0,10.0,14.0,15.0,15.0,15.0,18.0,18.0,8.0
2,3,31.0,1.0,0.0,0.0,0.0,190.0,84.0,8.0,11.0,12.0,12.0,8.0,14.0,13.0,13.0,9.0,7.0,13.0,5.0,2.0,1.0,1.0,7.0,8.0,8.0,1.0,3.0,7.0,5.0,4.0,2.0,6.0,7.0,10.0,14.0,12.0,10.0,9.0,12.0,11.0,6.0,15.0,1.0,11.0,12.0,10.0,12.0,12.0,14.0,13.0,5.0,14.0,9.0,20.0,12.0,14.0,11.0,9.0,10.0,9.0,10.0,14.0,11.0,10.0,12.0,12.0,16.0,14.0,8.0,22.0,0.0,0.0,0.0,0.0,183.0,77.0,2.0,2.0,1.0,2.0,3.0,3.0,1.0,4.0,3.0,3.0,2.0,5.0,10.0,9.0,5.0,9.0,5.0,12.0,7.0,10.0,11.0,10.0,5.0,11.0,10.0,11.0,9.0,11.0,9.0,8.0,8.0,7.0,14.0,8.0,6.0,9.0,11.0,10.0,11.0,13.0,12.0,12.0,10.0,20.0,14.0,13.0,6.0,14.0,7.0,12.0,9.0,13.0,6.0,9.0,19.0,13.0,12.0,10.0,11.0,11.0,19.0,4.0,26.0,0.0,0.0,0.0,0.0,191.0,77.0,2.0,3.0,1.0,4.0,4.0,1.0,1.0,2.0,3.0,4.0,1.0,3.0,6.0,5.0,6.0,6.0,4.0,13.0,6.0,6.0,13.0,7.0,6.0,13.0,5.0,12.0,9.0,14.0,6.0,8.0,6.0,8.0,14.0,3.0,14.0,6.0,13.0,12.0,13.0,9.0,8.0,6.0,12.0,4.0,10.0,11.0,20.0,9.0,14.0,13.0,10.0,9.0,11.0,11.0,2.0,12.0,17.0,17.0,18.0,17.0,14.0,6.0,32.0,0.0,0.0,0.0,0.0,181.0,80.0,3.0,2.0,4.0,1.0,3.0,1.0,1.0,1.0,2.0,2.0,2.0,5.0,7.0,8.0,7.0,9.0,5.0,8.0,8.0,9.0,12.0,9.0,8.0,12.0,8.0,14.0,11.0,14.0,10.0,12.0,10.0,10.0,13.0,11.0,11.0,11.0,11.0,12.0,12.0,11.0,12.0,9.0,11.0,9.0,12.0,13.0,20.0,13.0,14.0,10.0,12.0,10.0,8.0,7.0,15.0,12.0,11.0,11.0,14.0,10.0,10.0,6.0,24.0,0.0,0.0,0.0,0.0,173.0,75.0,1.0,2.0,3.0,3.0,3.0,2.0,1.0,1.0,3.0,1.0,3.0,13.0,11.0,10.0,7.0,13.0,12.0,7.0,8.0,2.0,3.0,12.0,7.0,5.0,11.0,8.0,8.0,8.0,11.0,8.0,14.0,11.0,13.0,14.0,13.0,11.0,8.0,7.0,12.0,12.0,10.0,13.0,8.0,20.0,14.0,11.0,6.0,12.0,8.0,9.0,3.0,14.0,4.0,9.0,6.0,14.0,16.0,13.0,14.0,13.0,5.0,4.0,28.0,0.0,0.0,0.0,0.0,183.0,76.0,2.0,3.0,1.0,2.0,3.0,3.0,3.0,4.0,1.0,1.0,3.0,11.0,11.0,12.0,8.0,12.0,8.0,7.0,9.0,5.0,8.0,13.0,10.0,9.0,13.0,7.0,9.0,8.0,11.0,8.0,12.0,10.0,14.0,13.0,7.0,10.0,6.0,10.0,11.0,11.0,13.0,11.0,8.0,10.0,15.0,12.0,20.0,12.0,9.0,11.0,6.0,13.0,6.0,7.0,10.0,14.0,10.0,14.0,16.0,13.0,11.0,9.0,21.0,0.0,0.0,0.0,0.0,171.0,78.0,3.0,3.0,1.0,1.0,2.0,1.0,2.0,2.0,1.0,1.0,2.0,5.0,11.0,15.0,12.0,13.0,13.0,8.0,12.0,1.0,4.0,12.0,8.0,4.0,13.0,5.0,8.0,8.0,11.0,7.0,12.0,8.0,14.0,15.0,5.0,10.0,3.0,12.0,7.0,13.0,11.0,12.0,9.0,9.0,12.0,14.0,20.0,11.0,7.0,10.0,4.0,9.0,7.0,12.0,16.0,15.0,18.0,16.0,14.0,15.0,17.0,4.0,24.0,0.0,0.0,0.0,0.0,191.0,82.0,2.0,2.0,1.0,4.0,1.0,1.0,3.0,2.0,2.0,2.0,1.0,3.0,7.0,11.0,9.0,12.0,7.0,13.0,9.0,5.0,6.0,10.0,12.0,6.0,11.0,6.0,8.0,10.0,8.0,9.0,10.0,8.0,5.0,12.0,4.0,12.0,5.0,12.0,14.0,13.0,9.0,10.0,14.0,3.0,12.0,12.0,20.0,10.0,13.0,13.0,3.0,8.0,7.0,8.0,19.0,12.0,9.0,13.0,11.0,13.0,16.0,1.0,28.0,0.0,0.0,3.0,0.0,173.0,76.0,3.0,3.0,3.0,1.0,1.0,2.0,2.0,3.0,3.0,3.0,2.0,7.0,13.0,12.0,5.0,12.0,6.0,10.0,5.0,8.0,10.0,12.0,5.0,10.0,12.0,10.0,10.0,12.0,12.0,10.0,12.0,11.0,18.0,12.0,6.0,14.0,14.0,8.0,13.0,13.0,10.0,10.0,9.0,2.0,10.0,14.0,20.0,10.0,10.0,17.0,5.0,13.0,3.0,10.0,16.0,13.0,16.0,12.0,15.0,16.0,16.0,10.0,18.0,0.0,0.0,0.0,0.0,175.0,69.0,3.0,3.0,2.0,3.0,2.0,4.0,4.0,3.0,2.0,3.0,2.0,5.0,8.0,9.0,7.0,8.0,5.0,4.0,5.0,3.0,1.0,7.0,3.0,6.0,8.0,8.0,7.0,6.0,5.0,2.0,4.0,10.0,4.0,8.0,1.0,3.0,5.0,7.0,11.0,13.0,10.0,3.0,6.0,20.0,8.0,13.0,9.0,10.0,6.0,8.0,5.0,8.0,8.0,8.0,9.0,10.0,12.0,11.0,11.0,11.0,13.0,3.0,22.0,0.0,0.0,2.0,0.0,180.0,75.0,2.0,2.0,3.0,3.0,2.0,3.0,3.0,2.0,1.0,1.0,2.0,9.0,11.0,10.0,9.0,10.0,12.0,8.0,9.0,6.0,6.0,10.0,10.0,5.0,10.0,4.0,7.0,8.0,11.0,8.0,11.0,8.0,11.0,13.0,4.0,11.0,5.0,8.0,9.0,13.0,10.0,7.0,6.0,20.0,13.0,12.0,6.0,10.0,6.0,9.0,5.0,11.0,8.0,13.0,12.0,8.0,3.0,9.0,12.0,13.0,10.0,10.0,29.0,0.0,0.0,3.0,0.0,195.0,90.0,14.0,11.0,14.0,8.0,13.0,8.0,15.0,14.0,10.0,11.0,13.0,1.0,1.0,2.0,1.0,8.0,2.0,5.0,2.0,3.0,2.0,10.0,2.0,3.0,4.0,9.0,13.0,13.0,12.0,10.0,10.0,11.0,14.0,6.0,11.0,6.0,13.0,13.0,13.0,9.0,11.0,14.0,13.0,1.0,15.0,9.0,20.0,6.0,15.0,14.0,9.0,14.0,9.0,2.0,14.0,13.0,10.0,12.0,12.0,10.0,10.0,10.0,31.0,1.0,0.0,0.0,0.0,184.0,76.0,2.0,2.0,3.0,1.0,1.0,2.0,3.0,3.0,3.0,2.0,3.0,12.0,13.0,11.0,10.0,10.0,11.0,12.0,16.0,13.0,14.0,11.0,13.0,13.0,7.0,17.0,10.0,14.0,10.0,14.0,7.0,10.0,16.0,7.0,14.0,10.0,12.0,10.0,16.0,13.0,12.0,16.0,12.0,20.0,13.0,13.0,10.0,16.0,14.0,16.0,13.0,12.0,6.0,10.0,10.0,12.0,15.0,12.0,14.0,8.0,6.0,12.0,34.0,15.0,1.0,0.0,0.0,181.0,77.0,1.0,3.0,1.0,3.0,1.0,1.0,3.0,1.0,3.0,3.0,3.0,13.0,13.0,12.0,7.0,16.0,15.0,4.0,13.0,5.0,5.0,17.0,15.0,10.0,15.0,12.0,17.0,5.0,16.0,7.0,17.0,16.0,12.0,16.0,4.0,12.0,15.0,7.0,7.0,10.0,9.0,15.0,8.0,14.0,10.0,8.0,20.0,9.0,10.0,9.0,13.0,13.0,14.0,5.0,10.0,12.0,14.0,14.0,11.0,9.0,4.0,10.0,23.0,0.0,0.0,7.0,1.0,178.0,73.0,3.0,2.0,2.0,1.0,1.0,2.0,2.0,2.0,2.0,3.0,2.0,13.0,14.0,15.0,11.0,16.0,14.0,5.0,8.0,5.0,4.0,10.0,13.0,5.0,13.0,9.0,7.0,7.0,8.0,8.0,8.0,8.0,12.0,17.0,7.0,8.0,4.0,10.0,8.0,16.0,15.0,7.0,6.0,15.0,7.0,15.0,20.0,11.0,6.0,11.0,13.0,14.0,9.0,11.0,7.0,13.0,11.0,10.0,12.0,10.0,8.0,8.0,21.0,0.0,0.0,0.0,0.0,190.0,86.0,3.0,3.0,2.0,2.0,3.0,1.0,2.0,1.0,2.0,3.0,3.0,8.0,6.0,8.0,2.0,8.0,7.0,12.0,8.0,6.0,12.0,10.0,9.0,16.0,10.0,10.0,8.0,14.0,10.0,14.0,5.0,9.0,10.0,10.0,5.0,9.0,11.0,12.0,13.0,12.0,7.0,12.0,14.0,20.0,12.0,12.0,7.0,14.0,15.0,10.0,5.0,4.0,8.0,10.0,19.0,13.0,10.0,12.0,9.0,10.0,17.0,4.0,25.0,0.0,0.0,0.0,0.0,183.0,79.0,2.0,3.0,2.0,2.0,3.0,1.0,1.0,3.0,1.0,1.0,2.0,9.0,12.0,11.0,9.0,12.0,7.0,13.0,12.0,11.0,9.0,8.0,9.0,10.0,12.0,13.0,12.0,14.0,11.0,14.0,11.0,9.0,11.0,11.0,10.0,12.0,12.0,10.0,12.0,9.0,12.0,14.0,9.0,20.0,14.0,13.0,10.0,13.0,10.0,14.0,10.0,9.0,13.0,8.0,6.0,7.0,11.0,11.0,11.0,10.0,10.0,7.0,25.0,0.0,0.0,12.0,12.0,180.0,69.0,3.0,3.0,1.0,3.0,1.0,2.0,2.0,3.0,1.0,3.0,3.0,9.0,12.0,15.0,11.0,13.0,10.0,6.0,12.0,6.0,4.0,12.0,13.0,3.0,15.0,10.0,12.0,10.0,13.0,8.0,8.0,11.0,13.0,18.0,8.0,12.0,5.0,9.0,14.0,16.0,16.0,13.0,8.0,14.0,5.0,17.0,20.0,13.0,7.0,12.0,10.0,10.0,12.0,8.0,9.0,14.0,17.0,14.0,13.0,10.0,10.0,10.0,23.0,4.0,0.0,26.0,2.0,178.0,71.0,3.0,2.0,2.0,3.0,3.0,1.0,3.0,3.0,1.0,1.0,3.0,10.0,12.0,13.0,7.0,13.0,7.0,11.0,5.0,9.0,12.0,12.0,8.0,13.0,8.0,10.0,8.0,13.0,14.0,10.0,13.0,14.0,8.0,12.0,7.0,12.0,13.0,13.0,14.0,12.0,12.0,11.0,10.0,7.0,13.0,11.0,20.0,10.0,10.0,10.0,10.0,7.0,10.0,7.0,6.0,11.0,10.0,5.0,8.0,10.0,12.0,10.0,26.0,0.0,0.0,0.0,0.0,188.0,87.0,2.0,2.0,2.0,3.0,1.0,2.0,3.0,3.0,2.0,3.0,4.0,5.0,7.0,9.0,6.0,11.0,7.0,16.0,8.0,7.0,15.0,11.0,8.0,15.0,8.0,14.0,10.0,15.0,11.0,9.0,8.0,11.0,15.0,7.0,11.0,11.0,13.0,12.0,14.0,11.0,8.0,12.0,13.0,7.0,15.0,8.0,20.0,11.0,14.0,10.0,14.0,12.0,6.0,11.0,11.0,12.0,10.0,11.0,11.0,10.0,14.0,14.0,29.0,2.0,0.0,0.0,0.0,185.0,84.0,1.0,1.0,3.0,2.0,1.0,2.0,1.0,2.0,3.0,4.0,2.0,9.0,10.0,15.0,11.0,11.0,10.0,12.0,12.0,10.0,13.0,14.0,12.0,13.0,11.0,13.0,13.0,16.0,12.0,12.0,12.0,12.0,12.0,13.0,12.0,12.0,14.0,10.0,8.0,13.0,11.0,12.0,11.0,8.0,13.0,12.0,20.0,10.0,14.0,16.0,12.0,12.0,11.0,12.0,10.0,8.0,14.0,10.0,12.0,10.0,10.0,8.0,26.0,0.0,0.0,0.0,0.0,185.0,78.0,2.0,3.0,3.0,3.0,3.0,2.0,1.0,2.0,2.0,2.0,1.0,10.0,8.0,12.0,9.0,10.0,11.0,6.0,11.0,5.0,4.0,8.0,9.0,4.0,12.0,7.0,8.0,8.0,7.0,7.0,8.0,8.0,10.0,14.0,6.0,11.0,5.0,8.0,12.0,15.0,12.0,9.0,13.0,6.0,16.0,15.0,20.0,12.0,10.0,6.0,6.0,10.0,7.0,10.0,20.0,11.0,12.0,11.0,12.0,12.0,19.0,7.0
2,0,22.0,0.0,0.0,0.0,0.0,191.0,84.0,13.0,10.0,9.0,1.0,13.0,7.0,13.0,14.0,10.0,10.0,8.0,5.0,2.0,2.0,1.0,3.0,8.0,1.0,3.0,2.0,1.0,2.0,3.0,1.0,1.0,10.0,7.0,14.0,8.0,6.0,8.0,10.0,7.0,2.0,10.0,3.0,12.0,9.0,8.0,12.0,13.0,8.0,15.0,6.0,12.0,13.0,20.0,5.0,11.0,10.0,7.0,8.0,6.0,10.0,19.0,11.0,9.0,10.0,14.0,10.0,10.0,7.0,23.0,0.0,0.0,0.0,0.0,186.0,80.0,3.0,2.0,1.0,4.0,1.0,1.0,2.0,1.0,1.0,2.0,3.0,14.0,17.0,9.0,8.0,8.0,13.0,8.0,11.0,13.0,8.0,10.0,4.0,11.0,9.0,14.0,10.0,12.0,10.0,10.0,10.0,10.0,7.0,6.0,5.0,12.0,9.0,12.0,15.0,14.0,11.0,11.0,12.0,20.0,12.0,13.0,8.0,14.0,12.0,12.0,8.0,2.0,10.0,10.0,8.0,15.0,4.0,12.0,13.0,9.0,10.0,14.0,21.0,0.0,0.0,0.0,0.0,190.0,82.0,1.0,2.0,3.0,2.0,1.0,2.0,3.0,3.0,1.0,1.0,3.0,4.0,8.0,6.0,6.0,11.0,1.0,14.0,9.0,2.0,12.0,7.0,4.0,13.0,7.0,10.0,13.0,11.0,10.0,9.0,3.0,15.0,14.0,4.0,14.0,7.0,12.0,9.0,11.0,7.0,8.0,14.0,16.0,10.0,11.0,8.0,20.0,7.0,15.0,11.0,3.0,4.0,4.0,10.0,10.0,11.0,9.0,11.0,12.0,6.0,16.0,6.0,21.0,0.0,0.0,0.0,0.0,168.0,62.0,1.0,3.0,1.0,3.0,4.0,3.0,2.0,1.0,2.0,2.0,2.0,11.0,12.0,13.0,10.0,10.0,8.0,15.0,11.0,7.0,8.0,13.0,12.0,10.0,12.0,14.0,8.0,7.0,6.0,8.0,13.0,14.0,14.0,10.0,13.0,14.0,7.0,14.0,15.0,12.0,13.0,8.0,6.0,6.0,16.0,13.0,20.0,14.0,6.0,10.0,5.0,6.0,10.0,10.0,12.0,17.0,11.0,8.0,17.0,1.0,11.0,4.0,27.0,1.0,0.0,1.0,0.0,185.0,82.0,4.0,1.0,1.0,2.0,1.0,3.0,2.0,2.0,3.0,3.0,1.0,6.0,7.0,12.0,14.0,12.0,10.0,13.0,12.0,4.0,3.0,11.0,16.0,7.0,13.0,12.0,14.0,13.0,13.0,11.0,10.0,11.0,11.0,10.0,8.0,14.0,5.0,8.0,13.0,12.0,11.0,14.0,13.0,9.0,12.0,13.0,20.0,13.0,14.0,12.0,8.0,9.0,4.0,11.0,16.0,12.0,9.0,12.0,17.0,4.0,11.0,6.0,21.0,0.0,0.0,1.0,0.0,182.0,77.0,2.0,2.0,3.0,1.0,2.0,3.0,3.0,2.0,2.0,3.0,2.0,11.0,15.0,10.0,12.0,10.0,10.0,10.0,12.0,7.0,9.0,10.0,8.0,9.0,11.0,14.0,10.0,10.0,10.0,10.0,10.0,10.0,3.0,10.0,13.0,11.0,10.0,10.0,13.0,13.0,12.0,11.0,12.0,9.0,12.0,13.0,20.0,11.0,11.0,12.0,11.0,10.0,8.0,10.0,14.0,13.0,11.0,12.0,11.0,8.0,13.0,2.0,19.0,0.0,0.0,0.0,0.0,180.0,75.0,2.0,1.0,3.0,2.0,2.0,2.0,3.0,1.0,4.0,1.0,2.0,6.0,12.0,14.0,7.0,11.0,6.0,7.0,8.0,10.0,8.0,9.0,9.0,10.0,11.0,15.0,10.0,13.0,7.0,8.0,10.0,8.0,4.0,14.0,5.0,12.0,10.0,11.0,14.0,14.0,12.0,8.0,10.0,20.0,13.0,14.0,8.0,14.0,12.0,10.0,9.0,10.0,7.0,10.0,8.0,9.0,10.0,11.0,8.0,7.0,15.0,2.0,27.0,0.0,0.0,0.0,0.0,174.0,72.0,1.0,2.0,2.0,3.0,1.0,1.0,1.0,1.0,2.0,3.0,1.0,9.0,12.0,13.0,8.0,12.0,7.0,9.0,9.0,9.0,7.0,11.0,10.0,8.0,13.0,14.0,11.0,9.0,9.0,9.0,13.0,11.0,12.0,13.0,13.0,11.0,7.0,11.0,15.0,16.0,13.0,8.0,8.0,5.0,11.0,13.0,20.0,14.0,8.0,14.0,7.0,8.0,16.0,15.0,12.0,12.0,13.0,10.0,14.0,14.0,14.0,5.0,19.0,0.0,0.0,0.0,0.0,172.0,58.0,2.0,3.0,3.0,3.0,2.0,2.0,2.0,3.0,1.0,1.0,1.0,9.0,7.0,10.0,5.0,12.0,9.0,9.0,10.0,9.0,10.0,9.0,7.0,12.0,11.0,9.0,9.0,9.0,11.0,9.0,10.0,11.0,2.0,9.0,3.0,9.0,10.0,11.0,11.0,7.0,12.0,11.0,9.0,20.0,12.0,11.0,9.0,8.0,8.0,8.0,6.0,9.0,6.0,9.0,20.0,10.0,11.0,13.0,13.0,7.0,11.0,8.0,25.0,0.0,0.0,0.0,0.0,187.0,81.0,3.0,1.0,1.0,4.0,2.0,1.0,1.0,3.0,3.0,3.0,4.0,10.0,10.0,11.0,9.0,14.0,7.0,10.0,13.0,10.0,9.0,12.0,13.0,11.0,13.0,11.0,10.0,15.0,7.0,8.0,13.0,10.0,15.0,12.0,11.0,10.0,10.0,13.0,10.0,11.0,10.0,11.0,13.0,10.0,10.0,11.0,20.0,13.0,12.0,9.0,6.0,5.0,10.0,15.0,7.0,12.0,11.0,9.0,16.0,9.0,10.0,4.0,27.0,0.0,0.0,11.0,2.0,165.0,60.0,1.0,3.0,4.0,3.0,1.0,1.0,1.0,3.0,2.0,1.0,1.0,10.0,11.0,12.0,9.0,11.0,13.0,7.0,13.0,4.0,7.0,11.0,11.0,6.0,11.0,15.0,9.0,10.0,11.0,8.0,12.0,11.0,5.0,11.0,10.0,10.0,11.0,12.0,11.0,12.0,11.0,9.0,6.0,15.0,10.0,13.0,20.0,10.0,7.0,10.0,12.0,13.0,8.0,15.0,15.0,12.0,7.0,11.0,11.0,11.0,12.0,6.0,22.0,0.0,0.0,0.0,0.0,189.0,80.0,14.0,11.0,6.0,3.0,14.0,13.0,8.0,14.0,13.0,4.0,9.0,4.0,2.0,1.0,3.0,3.0,6.0,1.0,2.0,1.0,1.0,3.0,5.0,2.0,3.0,9.0,8.0,11.0,9.0,13.0,8.0,14.0,5.0,1.0,11.0,3.0,12.0,9.0,8.0,10.0,15.0,7.0,10.0,12.0,12.0,9.0,20.0,4.0,11.0,10.0,10.0,6.0,8.0,10.0,13.0,10.0,8.0,10.0,9.0,13.0,16.0,5.0,19.0,0.0,0.0,0.0,0.0,190.0,87.0,3.0,3.0,1.0,1.0,3.0,1.0,2.0,2.0,1.0,1.0,3.0,5.0,7.0,8.0,4.0,11.0,8.0,14.0,9.0,11.0,13.0,11.0,5.0,13.0,11.0,11.0,9.0,13.0,10.0,13.0,10.0,12.0,3.0,6.0,10.0,10.0,13.0,14.0,13.0,10.0,11.0,13.0,14.0,16.0,10.0,11.0,20.0,13.0,13.0,11.0,8.0,11.0,11.0,11.0,20.0,10.0,12.0,11.0,12.0,14.0,10.0,3.0,29.0,0.0,0.0,5.0,1.0,182.0,72.0,1.0,1.0,2.0,3.0,1.0,1.0,3.0,1.0,3.0,2.0,4.0,11.0,11.0,9.0,4.0,11.0,8.0,12.0,10.0,13.0,13.0,12.0,5.0,13.0,12.0,13.0,12.0,15.0,13.0,15.0,10.0,12.0,11.0,6.0,15.0,10.0,12.0,15.0,15.0,11.0,10.0,13.0,10.0,12.0,12.0,12.0,20.0,14.0,9.0,12.0,5.0,9.0,4.0,11.0,20.0,12.0,8.0,10.0,12.0,12.0,11.0,6.0,21.0,0.0,0.0,1.0,0.0,179.0,74.0,2.0,3.0,1.0,1.0,3.0,4.0,1.0,1.0,1.0,1.0,3.0,16.0,13.0,10.0,7.0,13.0,15.0,7.0,10.0,5.0,8.0,15.0,8.0,10.0,13.0,14.0,12.0,9.0,11.0,8.0,15.0,13.0,15.0,13.0,14.0,11.0,9.0,15.0,12.0,10.0,12.0,9.0,7.0,10.0,14.0,11.0,20.0,14.0,7.0,12.0,13.0,10.0,6.0,11.0,7.0,12.0,17.0,8.0,14.0,8.0,11.0,7.0,26.0,0.0,0.0,5.0,1.0,190.0,83.0,2.0,3.0,3.0,1.0,2.0,3.0,2.0,1.0,3.0,2.0,1.0,10.0,11.0,8.0,11.0,10.0,5.0,13.0,10.0,10.0,6.0,11.0,6.0,10.0,11.0,7.0,11.0,13.0,12.0,10.0,10.0,13.0,7.0,8.0,10.0,13.0,8.0,14.0,12.0,13.0,9.0,14.0,15.0,12.0,9.0,13.0,20.0,13.0,15.0,12.0,5.0,10.0,11.0,11.0,9.0,11.0,9.0,8.0,11.0,9.0,13.0,5.0,32.0,0.0,0.0,6.0,0.0,173.0,71.0,4.0,2.0,3.0,3.0,1.0,3.0,1.0,2.0,2.0,3.0,2.0,10.0,6.0,11.0,7.0,12.0,7.0,11.0,10.0,20.0,13.0,14.0,9.0,14.0,12.0,10.0,12.0,13.0,11.0,11.0,10.0,10.0,12.0,9.0,7.0,14.0,14.0,13.0,14.0,13.0,14.0,13.0,8.0,15.0,12.0,12.0,20.0,14.0,12.0,13.0,8.0,12.0,7.0,12.0,16.0,7.0,12.0,13.0,12.0,13.0,15.0,5.0,19.0,0.0,0.0,0.0,0.0,189.0,85.0,4.0,2.0,3.0,4.0,3.0,2.0,3.0,2.0,2.0,2.0,4.0,7.0,9.0,10.0,12.0,12.0,7.0,12.0,8.0,4.0,6.0,11.0,6.0,9.0,12.0,14.0,9.0,16.0,13.0,12.0,9.0,9.0,17.0,11.0,7.0,13.0,10.0,14.0,15.0,12.0,11.0,15.0,14.0,9.0,13.0,12.0,20.0,13.0,13.0,10.0,8.0,10.0,9.0,10.0,15.0,12.0,10.0,13.0,12.0,11.0,16.0,6.0,23.0,1.0,0.0,0.0,0.0,179.0,70.0,1.0,2.0,2.0,2.0,1.0,2.0,2.0,2.0,3.0,3.0,3.0,8.0,8.0,9.0,5.0,12.0,7.0,12.0,9.0,10.0,13.0,12.0,2.0,14.0,13.0,14.0,11.0,16.0,11.0,14.0,10.0,12.0,11.0,8.0,9.0,11.0,13.0,16.0,16.0,11.0,12.0,14.0,8.0,12.0,11.0,11.0,20.0,16.0,10.0,12.0,9.0,12.0,5.0,11.0,9.0,12.0,13.0,13.0,9.0,9.0,19.0,2.0,19.0,0.0,0.0,0.0,0.0,187.0,79.0,1.0,4.0,2.0,2.0,1.0,2.0,3.0,1.0,2.0,3.0,1.0,4.0,2.0,1.0,6.0,9.0,1.0,11.0,6.0,1.0,7.0,9.0,7.0,12.0,8.0,9.0,12.0,9.0,6.0,12.0,3.0,14.0,6.0,1.0,9.0,5.0,12.0,7.0,9.0,12.0,13.0,8.0,12.0,16.0,9.0,11.0,20.0,5.0,9.0,9.0,7.0,9.0,9.0,9.0,18.0,11.0,10.0,9.0,12.0,10.0,13.0,8.0,17.0,0.0,0.0,0.0,0.0,185.0,74.0,1.0,1.0,2.0,2.0,1.0,2.0,3.0,2.0,1.0,1.0,1.0,9.0,12.0,11.0,7.0,13.0,12.0,4.0,11.0,6.0,8.0,13.0,8.0,11.0,13.0,8.0,7.0,10.0,7.0,10.0,13.0,13.0,11.0,10.0,5.0,9.0,8.0,10.0,14.0,12.0,13.0,10.0,11.0,14.0,15.0,12.0,20.0,10.0,11.0,9.0,7.0,5.0,10.0,10.0,17.0,9.0,12.0,14.0,14.0,12.0,11.0,5.0,21.0,0.0,0.0,0.0,0.0,181.0,71.0,1.0,4.0,3.0,3.0,3.0,2.0,3.0,3.0,1.0,1.0,2.0,3.0,1.0,1.0,5.0,6.0,1.0,11.0,5.0,4.0,13.0,7.0,3.0,13.0,5.0,9.0,8.0,9.0,4.0,7.0,2.0,14.0,4.0,3.0,1.0,6.0,13.0,7.0,7.0,13.0,13.0,7.0,6.0,1.0,14.0,14.0,20.0,10.0,6.0,9.0,6.0,9.0,9.0,9.0,16.0,12.0,13.0,11.0,11.0,10.0,12.0,7.0
1,0,24.0,0.0,0.0,0.0,0.0,189.0,83.0,10.0,10.0,14.0,8.0,12.0,13.0,15.0,15.0,11.0,10.0,13.0,3.0,2.0,1.0,1.0,11.0,6.0,7.0,3.0,1.0,2.0,10.0,4.0,1.0,11.0,8.0,11.0,10.0,15.0,14.0,9.0,13.0,11.0,1.0,9.0,1.0,10.0,15.0,12.0,13.0,12.0,10.0,11.0,14.0,14.0,10.0,20.0,14.0,12.0,17.0,6.0,16.0,6.0,11.0,9.0,12.0,14.0,10.0,16.0,14.0,17.0,4.0,19.0,0.0,0.0,9.0,0.0,185.0,78.0,1.0,3.0,2.0,1.0,3.0,3.0,1.0,2.0,1.0,1.0,4.0,9.0,7.0,6.0,7.0,12.0,8.0,14.0,9.0,5.0,10.0,12.0,4.0,13.0,11.0,7.0,12.0,10.0,10.0,13.0,10.0,12.0,11.0,5.0,10.0,11.0,11.0,15.0,14.0,12.0,15.0,12.0,11.0,7.0,13.0,16.0,20.0,12.0,13.0,11.0,11.0,11.0,8.0,11.0,8.0,13.0,10.0,12.0,11.0,10.0,19.0,3.0,20.0,1.0,0.0,1.0,0.0,187.0,84.0,1.0,1.0,1.0,2.0,1.0,2.0,2.0,2.0,2.0,3.0,2.0,4.0,7.0,9.0,7.0,12.0,5.0,12.0,8.0,6.0,15.0,12.0,8.0,16.0,11.0,14.0,12.0,17.0,12.0,10.0,9.0,10.0,16.0,9.0,12.0,7.0,11.0,13.0,14.0,12.0,12.0,15.0,16.0,14.0,13.0,15.0,20.0,11.0,14.0,13.0,10.0,14.0,6.0,7.0,13.0,15.0,8.0,14.0,12.0,12.0,10.0,5.0,26.0,21.0,0.0,0.0,0.0,172.0,70.0,3.0,3.0,1.0,1.0,1.0,4.0,3.0,2.0,3.0,2.0,3.0,9.0,10.0,10.0,8.0,11.0,11.0,5.0,14.0,8.0,14.0,12.0,9.0,15.0,12.0,17.0,12.0,17.0,10.0,14.0,10.0,10.0,17.0,8.0,13.0,9.0,12.0,15.0,17.0,12.0,15.0,14.0,9.0,12.0,15.0,12.0,20.0,16.0,10.0,15.0,14.0,14.0,7.0,13.0,10.0,13.0,14.0,9.0,15.0,8.0,7.0,7.0,25.0,0.0,0.0,0.0,0.0,186.0,86.0,3.0,2.0,2.0,2.0,1.0,3.0,1.0,2.0,1.0,3.0,3.0,6.0,9.0,12.0,13.0,14.0,8.0,13.0,11.0,5.0,6.0,11.0,12.0,7.0,13.0,16.0,13.0,16.0,10.0,12.0,13.0,14.0,15.0,11.0,7.0,12.0,8.0,15.0,16.0,11.0,13.0,16.0,12.0,14.0,14.0,13.0,20.0,14.0,15.0,15.0,8.0,15.0,5.0,5.0,7.0,13.0,10.0,11.0,14.0,12.0,10.0,6.0,29.0,0.0,0.0,0.0,0.0,180.0,77.0,3.0,2.0,1.0,1.0,1.0,1.0,2.0,1.0,3.0,2.0,3.0,10.0,12.0,13.0,9.0,11.0,10.0,9.0,11.0,11.0,9.0,12.0,9.0,11.0,13.0,17.0,10.0,15.0,8.0,13.0,10.0,10.0,17.0,11.0,12.0,13.0,9.0,13.0,17.0,13.0,12.0,16.0,9.0,15.0,15.0,13.0,20.0,16.0,14.0,16.0,10.0,15.0,10.0,18.0,6.0,16.0,14.0,14.0,13.0,8.0,10.0,10.0,20.0,0.0,0.0,0.0,0.0,180.0,70.0,2.0,2.0,2.0,1.0,2.0,1.0,2.0,3.0,2.0,1.0,1.0,6.0,10.0,8.0,9.0,12.0,8.0,10.0,11.0,12.0,11.0,13.0,11.0,11.0,13.0,12.0,14.0,16.0,15.0,13.0,10.0,14.0,15.0,6.0,12.0,10.0,12.0,18.0,13.0,10.0,11.0,10.0,10.0,10.0,16.0,12.0,20.0,15.0,9.0,14.0,8.0,13.0,10.0,15.0,10.0,14.0,10.0,12.0,15.0,13.0,13.0,5.0,27.0,0.0,0.0,2.0,0.0,188.0,79.0,3.0,1.0,3.0,3.0,1.0,2.0,3.0,2.0,2.0,3.0,1.0,6.0,8.0,9.0,16.0,10.0,8.0,15.0,11.0,5.0,5.0,9.0,16.0,6.0,10.0,11.0,17.0,13.0,14.0,15.0,8.0,9.0,13.0,8.0,9.0,15.0,7.0,10.0,13.0,11.0,11.0,12.0,15.0,15.0,13.0,13.0,20.0,15.0,14.0,14.0,5.0,14.0,9.0,5.0,9.0,15.0,13.0,11.0,16.0,14.0,16.0,5.0,26.0,0.0,0.0,0.0,0.0,181.0,77.0,1.0,2.0,1.0,3.0,3.0,3.0,1.0,3.0,2.0,1.0,3.0,8.0,10.0,9.0,7.0,13.0,6.0,9.0,8.0,10.0,11.0,14.0,7.0,13.0,14.0,16.0,14.0,12.0,15.0,14.0,12.0,13.0,12.0,8.0,10.0,9.0,12.0,18.0,16.0,11.0,13.0,10.0,9.0,10.0,15.0,11.0,20.0,16.0,12.0,16.0,8.0,15.0,3.0,16.0,7.0,10.0,15.0,10.0,16.0,14.0,18.0,3.0,24.0,1.0,0.0,9.0,0.0,184.0,81.0,2.0,3.0,1.0,2.0,4.0,3.0,3.0,2.0,2.0,3.0,4.0,11.0,13.0,13.0,7.0,11.0,10.0,9.0,12.0,16.0,12.0,10.0,8.0,12.0,11.0,16.0,10.0,14.0,9.0,12.0,8.0,9.0,13.0,11.0,10.0,12.0,9.0,13.0,16.0,14.0,11.0,14.0,10.0,20.0,16.0,17.0,10.0,16.0,12.0,13.0,10.0,12.0,4.0,14.0,8.0,12.0,15.0,9.0,17.0,14.0,10.0,4.0,20.0,0.0,0.0,0.0,0.0,194.0,82.0,1.0,1.0,1.0,3.0,2.0,1.0,1.0,1.0,1.0,2.0,2.0,6.0,9.0,11.0,12.0,13.0,7.0,15.0,8.0,6.0,5.0,10.0,11.0,6.0,12.0,16.0,13.0,15.0,12.0,10.0,10.0,12.0,14.0,10.0,8.0,12.0,7.0,14.0,16.0,10.0,13.0,11.0,18.0,14.0,14.0,12.0,20.0,14.0,12.0,16.0,10.0,16.0,7.0,8.0,10.0,15.0,10.0,12.0,14.0,10.0,12.0,6.0,32.0,0.0,0.0,0.0,0.0,193.0,80.0,13.0,11.0,11.0,3.0,12.0,12.0,13.0,13.0,15.0,11.0,8.0,8.0,3.0,1.0,2.0,7.0,10.0,5.0,1.0,2.0,3.0,9.0,3.0,1.0,5.0,14.0,9.0,7.0,10.0,12.0,6.0,12.0,13.0,11.0,9.0,3.0,13.0,10.0,10.0,11.0,12.0,11.0,14.0,5.0,10.0,10.0,20.0,11.0,10.0,15.0,12.0,10.0,7.0,10.0,14.0,13.0,14.0,10.0,14.0,13.0,14.0,5.0,25.0,0.0,0.0,0.0,0.0,181.0,76.0,3.0,1.0,3.0,3.0,2.0,2.0,2.0,3.0,3.0,3.0,1.0,10.0,9.0,12.0,11.0,12.0,9.0,10.0,13.0,9.0,5.0,12.0,7.0,8.0,12.0,13.0,12.0,8.0,13.0,10.0,13.0,12.0,10.0,9.0,8.0,13.0,15.0,14.0,14.0,11.0,11.0,10.0,11.0,11.0,10.0,11.0,20.0,11.0,12.0,11.0,8.0,10.0,6.0,9.0,10.0,10.0,13.0,9.0,12.0,11.0,13.0,8.0,31.0,1.0,0.0,0.0,0.0,188.0,81.0,2.0,3.0,2.0,3.0,1.0,1.0,2.0,3.0,3.0,3.0,1.0,12.0,11.0,12.0,12.0,10.0,14.0,14.0,11.0,10.0,7.0,10.0,4.0,10.0,12.0,12.0,11.0,10.0,10.0,12.0,13.0,12.0,13.0,10.0,10.0,13.0,7.0,11.0,13.0,12.0,12.0,10.0,15.0,12.0,10.0,12.0,20.0,13.0,12.0,14.0,12.0,10.0,8.0,9.0,11.0,12.0,14.0,9.0,14.0,13.0,20.0,7.0,25.0,0.0,0.0,4.0,0.0,177.0,76.0,3.0,1.0,1.0,1.0,2.0,3.0,3.0,2.0,2.0,1.0,2.0,12.0,13.0,10.0,9.0,11.0,8.0,13.0,13.0,9.0,11.0,11.0,7.0,13.0,10.0,12.0,12.0,10.0,10.0,11.0,10.0,11.0,14.0,9.0,8.0,7.0,12.0,10.0,10.0,13.0,12.0,12.0,12.0,12.0,10.0,12.0,20.0,13.0,12.0,12.0,8.0,10.0,9.0,9.0,11.0,8.0,13.0,6.0,12.0,11.0,12.0,6.0,22.0,0.0,0.0,0.0,0.0,181.0,76.0,2.0,2.0,1.0,1.0,1.0,3.0,1.0,3.0,2.0,3.0,3.0,9.0,12.0,12.0,13.0,12.0,6.0,12.0,10.0,7.0,9.0,10.0,6.0,6.0,11.0,10.0,11.0,10.0,12.0,12.0,11.0,12.0,3.0,13.0,9.0,12.0,9.0,9.0,11.0,13.0,11.0,11.0,11.0,9.0,10.0,12.0,20.0,10.0,10.0,13.0,10.0,1.0,10.0,10.0,17.0,9.0,12.0,9.0,9.0,1.0,11.0,2.0,19.0,0.0,0.0,0.0,0.0,171.0,70.0,2.0,3.0,2.0,1.0,1.0,1.0,2.0,1.0,2.0,3.0,1.0,11.0,11.0,12.0,11.0,11.0,11.0,9.0,11.0,7.0,9.0,13.0,4.0,9.0,13.0,4.0,10.0,10.0,11.0,11.0,14.0,12.0,13.0,13.0,14.0,11.0,11.0,12.0,12.0,12.0,11.0,11.0,9.0,20.0,10.0,12.0,10.0,11.0,11.0,13.0,8.0,12.0,9.0,10.0,10.0,13.0,14.0,12.0,11.0,12.0,12.0,9.0,30.0,44.0,4.0,12.0,8.0,181.0,81.0,4.0,3.0,3.0,2.0,1.0,3.0,3.0,3.0,3.0,3.0,1.0,12.0,11.0,10.0,13.0,14.0,14.0,11.0,13.0,5.0,7.0,14.0,14.0,8.0,14.0,12.0,13.0,11.0,12.0,9.0,13.0,13.0,10.0,16.0,9.0,11.0,9.0,11.0,7.0,8.0,10.0,10.0,7.0,14.0,9.0,9.0,20.0,9.0,9.0,10.0,8.0,15.0,8.0,11.0,9.0,9.0,15.0,13.0,12.0,8.0,12.0,7.0,23.0,0.0,0.0,7.0,0.0,185.0,78.0,1.0,2.0,2.0,3.0,3.0,2.0,3.0,3.0,3.0,2.0,1.0,7.0,9.0,7.0,4.0,11.0,10.0,16.0,7.0,9.0,14.0,7.0,4.0,14.0,4.0,13.0,9.0,10.0,10.0,11.0,10.0,11.0,12.0,3.0,11.0,10.0,12.0,9.0,13.0,11.0,11.0,13.0,10.0,8.0,11.0,9.0,20.0,11.0,11.0,14.0,10.0,9.0,10.0,8.0,11.0,12.0,13.0,12.0,13.0,12.0,11.0,7.0,23.0,0.0,0.0,5.0,1.0,183.0,79.0,3.0,1.0,2.0,1.0,3.0,3.0,4.0,2.0,2.0,1.0,1.0,10.0,5.0,6.0,4.0,11.0,6.0,15.0,4.0,8.0,13.0,12.0,2.0,12.0,7.0,9.0,12.0,11.0,11.0,13.0,6.0,13.0,10.0,6.0,8.0,10.0,14.0,9.0,11.0,10.0,10.0,8.0,8.0,11.0,9.0,9.0,20.0,13.0,13.0,11.0,8.0,11.0,4.0,9.0,10.0,10.0,11.0,10.0,11.0,10.0,10.0,9.0,21.0,0.0,0.0,6.0,0.0,185.0,77.0,1.0,3.0,4.0,3.0,3.0,1.0,2.0,2.0,3.0,2.0,3.0,12.0,13.0,11.0,8.0,12.0,13.0,11.0,15.0,11.0,13.0,13.0,7.0,11.0,12.0,11.0,12.0,12.0,12.0,14.0,12.0,12.0,13.0,1.0,5.0,12.0,12.0,13.0,13.0,13.0,12.0,11.0,10.0,20.0,11.0,13.0,8.0,12.0,12.0,13.0,10.0,6.0,9.0,11.0,10.0,12.0,12.0,11.0,12.0,12.0,12.0,1.0,25.0,0.0,0.0,10.0,0.0,174.0,68.0,2.0,3.0,1.0,1.0,2.0,2.0,1.0,1.0,2.0,4.0,2.0,9.0,10.0,11.0,10.0,10.0,11.0,8.0,12.0,5.0,10.0,13.0,7.0,12.0,11.0,15.0,12.0,14.0,10.0,10.0,11.0,11.0,16.0,10.0,12.0,11.0,12.0,13.0,17.0,11.0,12.0,14.0,7.0,20.0,16.0,13.0,8.0,13.0,10.0,14.0,8.0,9.0,6.0,10.0,20.0,10.0,13.0,13.0,8.0,8.0,17.0,7.0
4,2,31.0,22.0,0.0,17.0,0.0,185.0,82.0,12.0,12.0,13.0,6.0,14.0,11.0,15.0,18.0,14.0,10.0,13.0,7.0,3.0,8.0,5.0,9.0,10.0,8.0,12.0,2.0,2.0,9.0,6.0,3.0,10.0,6.0,12.0,15.0,16.0,12.0,8.0,12.0,14.0,8.0,15.0,3.0,13.0,13.0,8.0,13.0,17.0,14.0,13.0,7.0,12.0,11.0,20.0,15.0,14.0,13.0,6.0,16.0,3.0,1.0,8.0,16.0,12.0,13.0,16.0,16.0,16.0,7.0,26.0,27.0,0.0,0.0,0.0,183.0,70.0,1.0,3.0,1.0,3.0,4.0,1.0,3.0,3.0,2.0,1.0,3.0,9.0,14.0,12.0,8.0,10.0,8.0,12.0,13.0,14.0,9.0,12.0,7.0,13.0,11.0,14.0,9.0,15.0,10.0,12.0,9.0,10.0,16.0,10.0,9.0,12.0,8.0,12.0,17.0,14.0,11.0,13.0,12.0,10.0,16.0,16.0,20.0,16.0,13.0,13.0,10.0,14.0,6.0,15.0,10.0,15.0,14.0,10.0,16.0,13.0,13.0,4.0,30.0,19.0,0.0,7.0,0.0,189.0,77.0,3.0,2.0,3.0,2.0,3.0,3.0,1.0,3.0,3.0,1.0,2.0,5.0,8.0,7.0,10.0,10.0,9.0,15.0,9.0,8.0,14.0,12.0,10.0,15.0,10.0,15.0,14.0,13.0,13.0,14.0,10.0,12.0,14.0,10.0,14.0,11.0,12.0,14.0,14.0,8.0,10.0,12.0,16.0,10.0,16.0,10.0,20.0,13.0,16.0,13.0,11.0,13.0,7.0,10.0,6.0,14.0,12.0,13.0,14.0,13.0,13.0,7.0,21.0,0.0,0.0,11.0,2.0,180.0,72.0,2.0,3.0,3.0,3.0,3.0,2.0,2.0,1.0,3.0,2.0,3.0,12.0,13.0,14.0,9.0,14.0,13.0,8.0,12.0,5.0,8.0,14.0,10.0,9.0,14.0,12.0,12.0,9.0,13.0,12.0,15.0,13.0,14.0,15.0,8.0,13.0,10.0,16.0,14.0,15.0,14.0,12.0,9.0,8.0,15.0,14.0,20.0,13.0,12.0,12.0,8.0,11.0,10.0,11.0,10.0,14.0,16.0,14.0,15.0,15.0,15.0,6.0,29.0,26.0,6.0,12.0,4.0,175.0,77.0,1.0,2.0,1.0,3.0,3.0,2.0,1.0,2.0,1.0,2.0,2.0,16.0,14.0,16.0,15.0,15.0,18.0,6.0,15.0,6.0,6.0,18.0,11.0,5.0,17.0,9.0,12.0,10.0,16.0,12.0,16.0,14.0,14.0,16.0,6.0,16.0,6.0,10.0,10.0,13.0,15.0,14.0,8.0,15.0,15.0,14.0,20.0,13.0,12.0,11.0,9.0,16.0,7.0,8.0,8.0,11.0,8.0,13.0,12.0,13.0,11.0,10.0,28.0,41.0,2.0,0.0,0.0,187.0,80.0,3.0,2.0,3.0,2.0,1.0,1.0,2.0,3.0,1.0,4.0,2.0,7.0,10.0,11.0,7.0,12.0,7.0,10.0,12.0,13.0,15.0,13.0,8.0,18.0,12.0,18.0,13.0,17.0,12.0,14.0,10.0,12.0,17.0,7.0,13.0,9.0,14.0,17.0,18.0,14.0,13.0,16.0,14.0,20.0,18.0,13.0,12.0,18.0,14.0,15.0,16.0,15.0,6.0,15.0,14.0,13.0,10.0,14.0,12.0,8.0,7.0,8.0,35.0,80.0,0.0,11.0,0.0,174.0,74.0,3.0,4.0,2.0,2.0,2.0,2.0,1.0,2.0,2.0,3.0,2.0,8.0,14.0,13.0,7.0,15.0,8.0,14.0,4.0,14.0,14.0,13.0,9.0,16.0,15.0,15.0,15.0,16.0,17.0,13.0,11.0,15.0,19.0,14.0,18.0,14.0,17.0,16.0,14.0,12.0,13.0,15.0,9.0,20.0,17.0,12.0,9.0,13.0,11.0,16.0,14.0,16.0,4.0,10.0,18.0,14.0,17.0,17.0,14.0,14.0,14.0,12.0,30.0,32.0,1.0,0.0,0.0,190.0,88.0,1.0,2.0,2.0,2.0,3.0,1.0,1.0,3.0,3.0,2.0,2.0,5.0,7.0,9.0,8.0,10.0,7.0,16.0,11.0,9.0,15.0,13.0,5.0,16.0,12.0,17.0,16.0,17.0,13.0,13.0,11.0,12.0,16.0,7.0,14.0,10.0,14.0,15.0,15.0,14.0,12.0,17.0,16.0,9.0,15.0,14.0,20.0,16.0,18.0,15.0,15.0,14.0,10.0,12.0,14.0,15.0,12.0,14.0,12.0,13.0,11.0,15.0,23.0,0.0,0.0,10.0,7.0,179.0,70.0,1.0,1.0,2.0,2.0,1.0,3.0,3.0,2.0,1.0,4.0,3.0,10.0,13.0,14.0,12.0,15.0,11.0,10.0,13.0,6.0,3.0,13.0,12.0,4.0,16.0,11.0,12.0,11.0,13.0,11.0,13.0,12.0,12.0,16.0,6.0,14.0,6.0,10.0,12.0,16.0,14.0,12.0,9.0,20.0,13.0,14.0,10.0,13.0,10.0,12.0,7.0,12.0,6.0,8.0,12.0,13.0,5.0,10.0,8.0,14.0,12.0,8.0,18.0,0.0,0.0,0.0,0.0,167.0,60.0,2.0,1.0,2.0,2.0,2.0,1.0,2.0,1.0,1.0,1.0,1.0,10.0,11.0,12.0,8.0,13.0,10.0,3.0,10.0,5.0,6.0,13.0,12.0,8.0,15.0,8.0,11.0,8.0,12.0,11.0,13.0,12.0,13.0,12.0,6.0,11.0,11.0,12.0,13.0,15.0,14.0,8.0,5.0,8.0,15.0,12.0,20.0,12.0,7.0,8.0,8.0,14.0,7.0,8.0,18.0,11.0,12.0,11.0,12.0,15.0,15.0,7.0,26.0,0.0,0.0,4.0,0.0,180.0,73.0,2.0,3.0,1.0,4.0,2.0,3.0,3.0,1.0,1.0,4.0,1.0,11.0,13.0,13.0,14.0,14.0,11.0,15.0,12.0,3.0,7.0,14.0,14.0,8.0,13.0,12.0,14.0,17.0,13.0,15.0,14.0,14.0,16.0,12.0,15.0,16.0,12.0,18.0,16.0,13.0,14.0,13.0,12.0,8.0,14.0,13.0,20.0,15.0,12.0,15.0,8.0,14.0,7.0,15.0,19.0,14.0,17.0,14.0,18.0,16.0,16.0,5.0,33.0,12.0,0.0,9.0,0.0,187.0,79.0,13.0,9.0,9.0,13.0,12.0,14.0,13.0,13.0,14.0,1.0,13.0,6.0,2.0,1.0,3.0,11.0,11.0,14.0,1.0,2.0,3.0,11.0,7.0,1.0,10.0,13.0,12.0,14.0,16.0,14.0,15.0,12.0,14.0,11.0,13.0,3.0,13.0,12.0,12.0,13.0,15.0,10.0,12.0,5.0,5.0,14.0,20.0,14.0,11.0,14.0,8.0,10.0,14.0,11.0,7.0,14.0,6.0,14.0,15.0,10.0,6.0,16.0,29.0,0.0,0.0,0.0,0.0,175.0,76.0,3.0,1.0,2.0,2.0,1.0,2.0,3.0,2.0,1.0,2.0,1.0,10.0,10.0,13.0,11.0,13.0,7.0,8.0,7.0,9.0,5.0,11.0,18.0,10.0,14.0,14.0,10.0,13.0,9.0,12.0,8.0,13.0,15.0,11.0,16.0,14.0,6.0,14.0,16.0,16.0,14.0,10.0,7.0,10.0,14.0,15.0,20.0,15.0,13.0,16.0,11.0,7.0,7.0,11.0,8.0,11.0,11.0,12.0,8.0,10.0,15.0,2.0,32.0,0.0,0.0,0.0,0.0,173.0,67.0,1.0,3.0,2.0,2.0,3.0,3.0,3.0,3.0,3.0,3.0,2.0,12.0,16.0,14.0,10.0,14.0,13.0,4.0,11.0,4.0,3.0,15.0,11.0,3.0,14.0,7.0,12.0,14.0,14.0,10.0,15.0,15.0,12.0,14.0,10.0,14.0,6.0,16.0,16.0,13.0,12.0,6.0,6.0,8.0,15.0,14.0,20.0,12.0,7.0,11.0,7.0,11.0,5.0,16.0,12.0,15.0,12.0,11.0,14.0,14.0,14.0,7.0,26.0,36.0,15.0,0.0,0.0,174.0,68.0,1.0,2.0,3.0,1.0,3.0,1.0,1.0,3.0,4.0,3.0,1.0,9.0,11.0,14.0,12.0,13.0,8.0,8.0,13.0,5.0,8.0,10.0,12.0,6.0,13.0,12.0,10.0,13.0,14.0,12.0,9.0,9.0,14.0,14.0,7.0,13.0,6.0,10.0,10.0,14.0,13.0,9.0,6.0,10.0,12.0,14.0,20.0,12.0,7.0,11.0,8.0,14.0,5.0,14.0,8.0,16.0,11.0,11.0,10.0,9.0,11.0,6.0,26.0,27.0,1.0,11.0,0.0,172.0,66.0,2.0,2.0,2.0,2.0,3.0,2.0,1.0,3.0,1.0,1.0,2.0,8.0,8.0,12.0,10.0,13.0,9.0,9.0,12.0,6.0,15.0,15.0,14.0,12.0,12.0,11.0,12.0,13.0,10.0,12.0,12.0,11.0,16.0,10.0,10.0,13.0,12.0,14.0,15.0,13.0,11.0,10.0,7.0,7.0,16.0,14.0,20.0,14.0,10.0,13.0,4.0,13.0,4.0,10.0,11.0,18.0,18.0,12.0,12.0,8.0,9.0,3.0,29.0,9.0,1.0,0.0,0.0,185.0,81.0,1.0,3.0,1.0,2.0,3.0,3.0,2.0,2.0,3.0,1.0,2.0,6.0,7.0,10.0,10.0,8.0,6.0,13.0,7.0,6.0,5.0,8.0,10.0,6.0,10.0,13.0,13.0,13.0,8.0,14.0,9.0,11.0,17.0,13.0,10.0,13.0,7.0,16.0,16.0,15.0,13.0,16.0,14.0,9.0,14.0,14.0,20.0,15.0,15.0,15.0,7.0,12.0,12.0,5.0,14.0,13.0,12.0,12.0,17.0,14.0,16.0,5.0,35.0,60.0,1.0,8.0,1.0,191.0,81.0,3.0,2.0,2.0,2.0,3.0,1.0,1.0,3.0,1.0,3.0,3.0,4.0,8.0,8.0,5.0,11.0,6.0,14.0,8.0,11.0,13.0,10.0,12.0,13.0,11.0,9.0,15.0,9.0,15.0,12.0,10.0,13.0,13.0,5.0,17.0,6.0,15.0,14.0,10.0,8.0,12.0,15.0,15.0,10.0,14.0,7.0,20.0,12.0,13.0,10.0,9.0,14.0,7.0,10.0,17.0,12.0,12.0,12.0,16.0,18.0,18.0,5.0,26.0,0.0,0.0,7.0,1.0,185.0,0.0,2.0,3.0,2.0,1.0,3.0,1.0,1.0,4.0,3.0,1.0,1.0,10.0,9.0,12.0,9.0,12.0,10.0,8.0,10.0,8.0,12.0,7.0,5.0,13.0,12.0,11.0,11.0,11.0,9.0,11.0,11.0,13.0,1.0,9.0,6.0,10.0,12.0,11.0,9.0,15.0,15.0,11.0,12.0,10.0,15.0,15.0,20.0,14.0,10.0,11.0,9.0,7.0,11.0,11.0,8.0,12.0,12.0,11.0,11.0,10.0,18.0,6.0,28.0,0.0,0.0,10.0,0.0,180.0,73.0,2.0,4.0,4.0,1.0,1.0,2.0,1.0,2.0,2.0,3.0,2.0,11.0,11.0,11.0,9.0,12.0,10.0,6.0,11.0,8.0,5.0,10.0,15.0,10.0,11.0,8.0,12.0,12.0,13.0,15.0,8.0,10.0,14.0,11.0,8.0,11.0,10.0,14.0,16.0,13.0,11.0,9.0,9.0,6.0,13.0,12.0,20.0,15.0,8.0,16.0,11.0,11.0,16.0,11.0,14.0,10.0,18.0,10.0,16.0,14.0,15.0,8.0,26.0,17.0,2.0,14.0,0.0,190.0,85.0,3.0,1.0,2.0,1.0,2.0,2.0,2.0,3.0,3.0,3.0,2.0,8.0,9.0,7.0,8.0,9.0,8.0,13.0,7.0,10.0,14.0,9.0,10.0,14.0,9.0,13.0,13.0,12.0,13.0,14.0,9.0,9.0,13.0,9.0,12.0,9.0,13.0,14.0,14.0,11.0,11.0,14.0,16.0,20.0,14.0,11.0,9.0,14.0,15.0,14.0,9.0,10.0,8.0,12.0,13.0,12.0,13.0,14.0,14.0,14.0,14.0,5.0,22.0,0.0,0.0,15.0,3.0,191.0,81.0,4.0,1.0,3.0,2.0,1.0,3.0,2.0,3.0,2.0,2.0,2.0,9.0,8.0,10.0,9.0,11.0,10.0,12.0,10.0,9.0,11.0,11.0,5.0,13.0,12.0,13.0,11.0,14.0,9.0,10.0,10.0,10.0,12.0,7.0,10.0,11.0,12.0,14.0,14.0,12.0,13.0,11.0,15.0,20.0,13.0,12.0,10.0,13.0,14.0,13.0,7.0,13.0,8.0,16.0,11.0,12.0,13.0,8.0,13.0,10.0,12.0,7.0
2,0,28.0,23.0,0.0,0.0,0.0,195.0,80.0,13.0,15.0,14.0,7.0,13.0,10.0,13.0,15.0,11.0,8.0,13.0,4.0,3.0,2.0,3.0,7.0,7.0,7.0,3.0,3.0,1.0,4.0,2.0,2.0,3.0,11.0,12.0,16.0,12.0,11.0,5.0,10.0,15.0,3.0,13.0,4.0,13.0,11.0,10.0,10.0,13.0,14.0,16.0,1.0,15.0,9.0,20.0,10.0,14.0,13.0,15.0,13.0,8.0,11.0,12.0,13.0,10.0,11.0,12.0,13.0,5.0,9.0,23.0,0.0,0.0,0.0,0.0,179.0,74.0,3.0,1.0,3.0,1.0,3.0,2.0,3.0,3.0,3.0,2.0,3.0,9.0,10.0,9.0,11.0,12.0,12.0,10.0,14.0,7.0,10.0,12.0,4.0,10.0,11.0,11.0,13.0,11.0,12.0,12.0,11.0,12.0,15.0,9.0,11.0,10.0,11.0,12.0,13.0,12.0,13.0,11.0,9.0,10.0,6.0,12.0,20.0,11.0,9.0,9.0,5.0,11.0,9.0,8.0,13.0,12.0,14.0,12.0,13.0,13.0,13.0,9.0,26.0,0.0,0.0,4.0,0.0,184.0,74.0,3.0,3.0,4.0,2.0,3.0,3.0,3.0,3.0,2.0,3.0,2.0,5.0,8.0,12.0,11.0,13.0,9.0,15.0,11.0,5.0,12.0,12.0,11.0,13.0,13.0,14.0,12.0,13.0,11.0,12.0,12.0,11.0,13.0,12.0,10.0,13.0,12.0,13.0,13.0,11.0,12.0,15.0,13.0,9.0,12.0,11.0,20.0,14.0,12.0,13.0,14.0,14.0,9.0,16.0,15.0,14.0,8.0,9.0,9.0,11.0,11.0,11.0,25.0,28.0,1.0,0.0,0.0,167.0,63.0,4.0,1.0,4.0,2.0,2.0,3.0,1.0,3.0,1.0,3.0,1.0,13.0,11.0,12.0,10.0,12.0,13.0,6.0,13.0,3.0,9.0,15.0,12.0,10.0,14.0,16.0,10.0,12.0,10.0,10.0,15.0,10.0,14.0,14.0,12.0,14.0,9.0,11.0,11.0,15.0,16.0,12.0,5.0,9.0,15.0,14.0,20.0,13.0,5.0,10.0,15.0,13.0,5.0,12.0,11.0,14.0,11.0,8.0,7.0,8.0,6.0,12.0,23.0,10.0,3.0,6.0,2.0,187.0,80.0,3.0,2.0,1.0,2.0,3.0,3.0,2.0,4.0,2.0,3.0,1.0,4.0,9.0,11.0,11.0,12.0,5.0,13.0,13.0,4.0,8.0,11.0,13.0,5.0,12.0,9.0,11.0,12.0,11.0,12.0,10.0,11.0,12.0,15.0,11.0,15.0,5.0,14.0,14.0,14.0,12.0,9.0,13.0,6.0,11.0,14.0,20.0,13.0,14.0,9.0,8.0,12.0,5.0,10.0,4.0,12.0,13.0,13.0,14.0,11.0,10.0,2.0,26.0,0.0,0.0,3.0,0.0,186.0,80.0,3.0,2.0,3.0,1.0,2.0,3.0,3.0,4.0,1.0,1.0,2.0,8.0,9.0,12.0,12.0,9.0,8.0,14.0,8.0,8.0,6.0,11.0,8.0,8.0,14.0,14.0,10.0,14.0,8.0,11.0,10.0,14.0,12.0,12.0,8.0,10.0,8.0,11.0,10.0,13.0,12.0,9.0,12.0,11.0,13.0,14.0,20.0,12.0,13.0,12.0,9.0,10.0,8.0,8.0,11.0,14.0,13.0,12.0,12.0,12.0,10.0,7.0,27.0,0.0,0.0,0.0,0.0,184.0,85.0,1.0,2.0,3.0,2.0,2.0,3.0,3.0,1.0,3.0,1.0,2.0,12.0,11.0,12.0,10.0,14.0,11.0,12.0,14.0,13.0,11.0,13.0,14.0,12.0,13.0,13.0,13.0,12.0,12.0,12.0,12.0,12.0,12.0,11.0,8.0,13.0,13.0,11.0,12.0,12.0,13.0,14.0,12.0,8.0,12.0,12.0,20.0,13.0,14.0,13.0,10.0,12.0,14.0,13.0,11.0,16.0,9.0,10.0,9.0,9.0,11.0,13.0,25.0,0.0,0.0,8.0,0.0,180.0,73.0,1.0,2.0,3.0,3.0,2.0,1.0,2.0,2.0,1.0,3.0,3.0,12.0,13.0,10.0,10.0,10.0,9.0,12.0,9.0,10.0,12.0,11.0,10.0,9.0,10.0,12.0,13.0,11.0,12.0,11.0,9.0,10.0,14.0,9.0,12.0,11.0,13.0,13.0,12.0,13.0,13.0,13.0,9.0,20.0,14.0,12.0,11.0,13.0,9.0,14.0,9.0,10.0,9.0,8.0,12.0,10.0,13.0,12.0,12.0,12.0,10.0,7.0,23.0,1.0,0.0,0.0,0.0,180.0,79.0,2.0,3.0,3.0,2.0,3.0,1.0,3.0,2.0,2.0,3.0,1.0,13.0,13.0,11.0,6.0,11.0,8.0,8.0,9.0,14.0,12.0,12.0,10.0,12.0,12.0,11.0,12.0,9.0,12.0,12.0,10.0,13.0,9.0,11.0,11.0,14.0,12.0,12.0,12.0,13.0,12.0,11.0,8.0,8.0,11.0,13.0,20.0,14.0,11.0,15.0,8.0,14.0,8.0,9.0,11.0,11.0,6.0,13.0,9.0,10.0,11.0,15.0,26.0,0.0,0.0,0.0,0.0,175.0,69.0,2.0,4.0,1.0,1.0,3.0,3.0,3.0,3.0,3.0,1.0,2.0,10.0,12.0,13.0,12.0,11.0,10.0,9.0,12.0,8.0,5.0,11.0,10.0,5.0,13.0,8.0,9.0,9.0,8.0,10.0,14.0,10.0,14.0,15.0,10.0,13.0,8.0,10.0,11.0,13.0,12.0,11.0,9.0,20.0,10.0,13.0,10.0,12.0,10.0,12.0,8.0,13.0,7.0,10.0,15.0,12.0,8.0,13.0,12.0,12.0,10.0,10.0,26.0,0.0,0.0,11.0,4.0,194.0,82.0,2.0,1.0,3.0,3.0,3.0,4.0,2.0,3.0,2.0,3.0,3.0,3.0,6.0,7.0,5.0,11.0,6.0,14.0,7.0,7.0,12.0,10.0,9.0,12.0,9.0,11.0,13.0,14.0,11.0,7.0,10.0,6.0,10.0,7.0,8.0,7.0,12.0,10.0,13.0,9.0,7.0,11.0,14.0,9.0,12.0,10.0,20.0,12.0,14.0,10.0,10.0,9.0,12.0,8.0,7.0,12.0,9.0,10.0,6.0,9.0,12.0,14.0,27.0,1.0,0.0,13.0,0.0,190.0,83.0,12.0,9.0,12.0,5.0,11.0,14.0,14.0,14.0,12.0,11.0,13.0,6.0,1.0,3.0,1.0,7.0,9.0,3.0,3.0,1.0,2.0,11.0,3.0,1.0,10.0,6.0,13.0,8.0,12.0,13.0,12.0,9.0,11.0,2.0,12.0,2.0,15.0,14.0,10.0,10.0,11.0,11.0,15.0,10.0,10.0,9.0,20.0,10.0,12.0,9.0,8.0,1.0,10.0,10.0,7.0,14.0,9.0,12.0,15.0,16.0,12.0,4.0,25.0,23.0,0.0,4.0,0.0,184.0,66.0,3.0,2.0,3.0,1.0,2.0,3.0,3.0,3.0,3.0,2.0,4.0,3.0,7.0,8.0,3.0,9.0,2.0,11.0,4.0,8.0,14.0,9.0,7.0,15.0,9.0,12.0,15.0,17.0,15.0,10.0,7.0,13.0,10.0,5.0,10.0,7.0,15.0,13.0,11.0,14.0,13.0,12.0,13.0,10.0,10.0,13.0,20.0,12.0,12.0,12.0,10.0,15.0,14.0,10.0,14.0,12.0,18.0,11.0,12.0,17.0,16.0,5.0,26.0,3.0,0.0,4.0,0.0,184.0,69.0,1.0,3.0,1.0,2.0,2.0,2.0,1.0,2.0,1.0,1.0,1.0,12.0,12.0,9.0,10.0,11.0,10.0,9.0,12.0,7.0,12.0,14.0,12.0,12.0,12.0,11.0,13.0,13.0,13.0,15.0,11.0,13.0,12.0,14.0,9.0,10.0,14.0,15.0,15.0,13.0,12.0,11.0,11.0,11.0,13.0,12.0,20.0,15.0,11.0,12.0,14.0,13.0,10.0,13.0,7.0,11.0,11.0,10.0,12.0,10.0,9.0,10.0,27.0,27.0,1.0,2.0,1.0,183.0,72.0,2.0,2.0,2.0,1.0,2.0,1.0,3.0,1.0,2.0,2.0,4.0,5.0,8.0,10.0,6.0,11.0,10.0,14.0,11.0,5.0,14.0,12.0,10.0,15.0,11.0,14.0,13.0,16.0,11.0,11.0,9.0,10.0,12.0,8.0,12.0,8.0,13.0,14.0,14.0,14.0,12.0,16.0,11.0,8.0,12.0,13.0,20.0,15.0,15.0,10.0,14.0,11.0,7.0,11.0,13.0,13.0,9.0,9.0,11.0,10.0,10.0,8.0,24.0,3.0,0.0,5.0,0.0,180.0,73.0,1.0,1.0,1.0,1.0,2.0,3.0,3.0,3.0,1.0,1.0,1.0,11.0,10.0,11.0,10.0,11.0,12.0,7.0,11.0,17.0,11.0,11.0,13.0,11.0,12.0,17.0,9.0,17.0,9.0,14.0,10.0,11.0,13.0,13.0,10.0,7.0,8.0,10.0,13.0,14.0,10.0,12.0,11.0,20.0,12.0,14.0,8.0,12.0,11.0,10.0,14.0,17.0,7.0,18.0,10.0,12.0,19.0,16.0,13.0,10.0,13.0,6.0,24.0,1.0,0.0,21.0,3.0,185.0,85.0,2.0,2.0,1.0,3.0,3.0,1.0,2.0,3.0,2.0,3.0,2.0,8.0,7.0,8.0,7.0,9.0,6.0,14.0,10.0,13.0,12.0,12.0,10.0,11.0,10.0,12.0,11.0,13.0,14.0,14.0,10.0,10.0,14.0,13.0,13.0,12.0,13.0,13.0,9.0,13.0,14.0,17.0,15.0,7.0,16.0,12.0,20.0,14.0,16.0,15.0,10.0,13.0,6.0,9.0,11.0,13.0,10.0,14.0,12.0,10.0,10.0,10.0,20.0,0.0,0.0,5.0,0.0,167.0,57.0,3.0,2.0,2.0,1.0,4.0,2.0,3.0,3.0,3.0,2.0,1.0,11.0,12.0,12.0,8.0,13.0,10.0,5.0,11.0,4.0,7.0,13.0,14.0,8.0,13.0,12.0,10.0,13.0,11.0,9.0,12.0,9.0,14.0,14.0,9.0,13.0,9.0,13.0,15.0,14.0,14.0,11.0,5.0,20.0,14.0,13.0,8.0,14.0,9.0,14.0,9.0,12.0,9.0,10.0,12.0,13.0,12.0,12.0,11.0,12.0,13.0,9.0,21.0,0.0,0.0,2.0,0.0,184.0,76.0,2.0,1.0,1.0,2.0,2.0,1.0,1.0,1.0,1.0,2.0,1.0,6.0,7.0,10.0,14.0,13.0,6.0,14.0,9.0,4.0,8.0,13.0,13.0,6.0,13.0,11.0,11.0,11.0,10.0,14.0,10.0,10.0,13.0,14.0,8.0,15.0,11.0,10.0,13.0,14.0,15.0,14.0,8.0,9.0,14.0,14.0,20.0,14.0,13.0,13.0,10.0,13.0,8.0,11.0,10.0,12.0,12.0,13.0,12.0,12.0,10.0,7.0,21.0,0.0,0.0,16.0,1.0,176.0,64.0,1.0,1.0,3.0,1.0,1.0,2.0,3.0,4.0,2.0,2.0,3.0,10.0,12.0,10.0,9.0,11.0,9.0,11.0,8.0,11.0,13.0,13.0,10.0,15.0,10.0,13.0,13.0,14.0,14.0,13.0,8.0,13.0,15.0,13.0,11.0,10.0,13.0,14.0,13.0,13.0,12.0,9.0,11.0,10.0,13.0,13.0,20.0,14.0,10.0,12.0,7.0,12.0,7.0,16.0,14.0,13.0,15.0,15.0,15.0,12.0,13.0,7.0,33.0,56.0,26.0,3.0,2.0,196.0,93.0,1.0,3.0,4.0,2.0,3.0,1.0,2.0,3.0,4.0,3.0,2.0,5.0,7.0,7.0,17.0,15.0,7.0,17.0,9.0,4.0,5.0,12.0,14.0,5.0,14.0,7.0,15.0,10.0,14.0,10.0,12.0,13.0,13.0,10.0,11.0,16.0,5.0,13.0,9.0,8.0,9.0,14.0,15.0,20.0,8.0,11.0,14.0,11.0,15.0,9.0,5.0,12.0,15.0,10.0,14.0,12.0,10.0,9.0,12.0,12.0,10.0,11.0,23.0,2.0,0.0,0.0,0.0,171.0,65.0,2.0,3.0,1.0,3.0,1.0,1.0,2.0,1.0,2.0,3.0,3.0,12.0,14.0,11.0,9.0,11.0,12.0,13.0,13.0,10.0,13.0,11.0,13.0,12.0,12.0,8.0,12.0,13.0,12.0,13.0,11.0,11.0,12.0,12.0,15.0,13.0,12.0,13.0,13.0,14.0,13.0,11.0,10.0,20.0,13.0,13.0,5.0,12.0,12.0,11.0,5.0,14.0,5.0,12.0,19.0,12.0,17.0,8.0,12.0,13.0,11.0,5.0
2,1,28.0,0.0,0.0,0.0,0.0,188.0,86.0,14.0,13.0,15.0,8.0,14.0,11.0,14.0,16.0,13.0,12.0,8.0,6.0,2.0,1.0,3.0,8.0,8.0,1.0,1.0,3.0,1.0,8.0,4.0,1.0,8.0,8.0,13.0,13.0,14.0,14.0,11.0,12.0,15.0,7.0,10.0,2.0,14.0,12.0,11.0,13.0,14.0,16.0,13.0,5.0,16.0,12.0,20.0,14.0,15.0,14.0,8.0,15.0,5.0,1.0,11.0,15.0,14.0,14.0,16.0,14.0,11.0,6.0,26.0,0.0,0.0,0.0,0.0,176.0,70.0,2.0,1.0,4.0,3.0,3.0,3.0,1.0,3.0,3.0,2.0,1.0,10.0,11.0,11.0,6.0,13.0,9.0,5.0,12.0,11.0,13.0,13.0,7.0,14.0,13.0,15.0,11.0,14.0,12.0,11.0,9.0,12.0,13.0,9.0,9.0,13.0,12.0,15.0,14.0,12.0,16.0,12.0,7.0,20.0,13.0,13.0,10.0,15.0,11.0,13.0,14.0,13.0,11.0,9.0,8.0,9.0,17.0,12.0,14.0,14.0,15.0,3.0,31.0,2.0,0.0,0.0,0.0,187.0,83.0,3.0,1.0,3.0,1.0,3.0,2.0,1.0,3.0,3.0,1.0,1.0,8.0,11.0,10.0,8.0,11.0,8.0,15.0,8.0,13.0,14.0,11.0,11.0,14.0,8.0,16.0,13.0,15.0,14.0,12.0,5.0,12.0,13.0,9.0,9.0,11.0,14.0,12.0,13.0,13.0,8.0,16.0,14.0,5.0,14.0,13.0,20.0,12.0,14.0,14.0,15.0,12.0,5.0,8.0,12.0,14.0,11.0,11.0,14.0,12.0,13.0,5.0,19.0,0.0,0.0,11.0,1.0,171.0,65.0,2.0,2.0,2.0,2.0,2.0,3.0,3.0,3.0,1.0,1.0,3.0,14.0,13.0,13.0,11.0,14.0,15.0,8.0,12.0,6.0,4.0,13.0,12.0,4.0,15.0,8.0,12.0,10.0,12.0,8.0,13.0,13.0,14.0,15.0,8.0,14.0,6.0,13.0,12.0,15.0,16.0,10.0,7.0,20.0,13.0,15.0,10.0,12.0,7.0,11.0,6.0,11.0,8.0,11.0,12.0,13.0,11.0,12.0,12.0,6.0,12.0,5.0,20.0,0.0,0.0,18.0,3.0,174.0,71.0,1.0,2.0,3.0,1.0,3.0,2.0,2.0,1.0,4.0,2.0,3.0,8.0,10.0,12.0,10.0,13.0,11.0,8.0,11.0,4.0,11.0,13.0,6.0,8.0,13.0,13.0,11.0,13.0,12.0,13.0,12.0,12.0,13.0,11.0,8.0,11.0,11.0,15.0,13.0,11.0,11.0,12.0,6.0,10.0,12.0,11.0,20.0,13.0,11.0,11.0,11.0,12.0,10.0,12.0,8.0,10.0,10.0,9.0,14.0,13.0,8.0,8.0,20.0,7.0,1.0,0.0,0.0,182.0,75.0,2.0,1.0,3.0,2.0,2.0,1.0,3.0,1.0,3.0,2.0,1.0,11.0,11.0,13.0,12.0,13.0,11.0,12.0,10.0,5.0,4.0,12.0,8.0,5.0,13.0,11.0,12.0,11.0,11.0,8.0,10.0,10.0,3.0,10.0,1.0,13.0,8.0,12.0,12.0,15.0,14.0,13.0,11.0,6.0,14.0,13.0,20.0,12.0,13.0,12.0,9.0,11.0,9.0,11.0,9.0,9.0,9.0,12.0,11.0,9.0,17.0,7.0,26.0,0.0,0.0,0.0,0.0,184.0,76.0,3.0,1.0,3.0,1.0,3.0,2.0,3.0,2.0,1.0,1.0,3.0,10.0,11.0,13.0,9.0,13.0,12.0,13.0,10.0,6.0,11.0,13.0,9.0,14.0,12.0,12.0,13.0,12.0,12.0,11.0,13.0,12.0,13.0,13.0,10.0,12.0,13.0,12.0,16.0,15.0,13.0,15.0,13.0,20.0,15.0,14.0,5.0,16.0,15.0,13.0,12.0,14.0,5.0,12.0,18.0,14.0,10.0,7.0,11.0,11.0,13.0,10.0,32.0,36.0,0.0,12.0,2.0,183.0,77.0,1.0,3.0,2.0,1.0,3.0,1.0,1.0,2.0,1.0,1.0,3.0,6.0,11.0,8.0,6.0,13.0,11.0,13.0,10.0,6.0,15.0,14.0,10.0,17.0,12.0,15.0,16.0,18.0,14.0,17.0,12.0,15.0,17.0,11.0,17.0,7.0,17.0,20.0,16.0,9.0,11.0,15.0,11.0,8.0,15.0,10.0,20.0,14.0,14.0,17.0,10.0,16.0,10.0,13.0,15.0,15.0,15.0,14.0,18.0,15.0,13.0,6.0,22.0,0.0,0.0,1.0,0.0,181.0,73.0,3.0,2.0,4.0,1.0,3.0,3.0,3.0,2.0,3.0,3.0,2.0,10.0,11.0,9.0,8.0,12.0,9.0,12.0,8.0,10.0,14.0,13.0,6.0,14.0,8.0,15.0,13.0,16.0,13.0,14.0,8.0,14.0,15.0,5.0,12.0,11.0,13.0,16.0,16.0,10.0,10.0,12.0,11.0,8.0,14.0,12.0,20.0,16.0,10.0,13.0,12.0,11.0,6.0,11.0,12.0,15.0,16.0,14.0,13.0,13.0,8.0,5.0,23.0,0.0,0.0,0.0,0.0,174.0,64.0,4.0,3.0,1.0,1.0,3.0,3.0,2.0,3.0,3.0,2.0,3.0,8.0,12.0,10.0,8.0,11.0,7.0,10.0,9.0,12.0,14.0,9.0,10.0,13.0,12.0,12.0,12.0,12.0,11.0,12.0,10.0,12.0,13.0,8.0,9.0,12.0,11.0,13.0,14.0,15.0,14.0,11.0,10.0,10.0,14.0,14.0,20.0,15.0,10.0,14.0,12.0,12.0,8.0,13.0,10.0,12.0,15.0,12.0,13.0,10.0,17.0,6.0,22.0,0.0,0.0,0.0,0.0,181.0,81.0,2.0,3.0,2.0,1.0,3.0,3.0,4.0,2.0,1.0,1.0,2.0,5.0,11.0,12.0,14.0,12.0,6.0,13.0,10.0,5.0,4.0,12.0,12.0,4.0,13.0,8.0,12.0,13.0,12.0,12.0,11.0,11.0,15.0,14.0,5.0,14.0,10.0,13.0,15.0,13.0,12.0,14.0,10.0,20.0,15.0,12.0,14.0,13.0,14.0,13.0,8.0,12.0,5.0,14.0,8.0,12.0,12.0,9.0,13.0,12.0,14.0,7.0,25.0,0.0,0.0,0.0,0.0,192.0,81.0,14.0,14.0,12.0,5.0,12.0,12.0,13.0,14.0,9.0,6.0,13.0,4.0,3.0,1.0,3.0,8.0,8.0,5.0,1.0,3.0,3.0,6.0,1.0,2.0,8.0,7.0,10.0,8.0,8.0,9.0,9.0,9.0,12.0,2.0,7.0,2.0,12.0,11.0,13.0,13.0,14.0,15.0,17.0,5.0,12.0,8.0,20.0,12.0,14.0,12.0,7.0,11.0,8.0,10.0,14.0,14.0,11.0,13.0,15.0,13.0,12.0,3.0,27.0,0.0,0.0,0.0,0.0,187.0,80.0,3.0,3.0,4.0,1.0,1.0,3.0,2.0,2.0,1.0,3.0,3.0,7.0,9.0,8.0,1.0,7.0,7.0,7.0,2.0,7.0,9.0,6.0,3.0,10.0,8.0,9.0,8.0,8.0,9.0,8.0,7.0,12.0,9.0,2.0,14.0,8.0,9.0,8.0,9.0,13.0,14.0,8.0,10.0,20.0,16.0,14.0,8.0,14.0,9.0,9.0,5.0,3.0,9.0,9.0,11.0,12.0,11.0,9.0,12.0,7.0,10.0,7.0,33.0,47.0,11.0,26.0,14.0,184.0,81.0,1.0,1.0,3.0,1.0,2.0,1.0,3.0,3.0,2.0,3.0,3.0,13.0,13.0,12.0,13.0,14.0,13.0,9.0,12.0,10.0,7.0,13.0,15.0,8.0,15.0,12.0,13.0,13.0,13.0,11.0,12.0,12.0,15.0,11.0,11.0,14.0,7.0,13.0,10.0,10.0,12.0,11.0,11.0,8.0,13.0,11.0,20.0,11.0,11.0,10.0,10.0,10.0,12.0,15.0,15.0,13.0,10.0,10.0,10.0,7.0,12.0,15.0,26.0,13.0,0.0,2.0,0.0,184.0,73.0,2.0,2.0,2.0,1.0,1.0,1.0,1.0,2.0,2.0,2.0,1.0,10.0,11.0,10.0,9.0,10.0,13.0,13.0,13.0,5.0,8.0,15.0,15.0,12.0,13.0,13.0,11.0,13.0,8.0,14.0,15.0,13.0,13.0,8.0,10.0,12.0,15.0,14.0,13.0,12.0,12.0,13.0,13.0,7.0,14.0,12.0,20.0,14.0,13.0,8.0,11.0,8.0,4.0,11.0,14.0,14.0,10.0,10.0,10.0,7.0,10.0,10.0,25.0,0.0,0.0,20.0,0.0,180.0,64.0,1.0,2.0,1.0,1.0,1.0,2.0,1.0,2.0,2.0,2.0,4.0,8.0,12.0,12.0,7.0,13.0,8.0,10.0,10.0,9.0,10.0,13.0,11.0,10.0,13.0,8.0,12.0,12.0,11.0,11.0,13.0,10.0,13.0,11.0,6.0,13.0,11.0,13.0,15.0,15.0,14.0,13.0,9.0,8.0,14.0,14.0,20.0,16.0,8.0,10.0,8.0,14.0,5.0,14.0,18.0,16.0,10.0,11.0,9.0,14.0,14.0,8.0,28.0,5.0,0.0,0.0,0.0,172.0,64.0,2.0,2.0,1.0,4.0,2.0,2.0,3.0,3.0,2.0,2.0,2.0,4.0,7.0,11.0,12.0,12.0,8.0,8.0,11.0,5.0,11.0,14.0,10.0,12.0,10.0,11.0,14.0,8.0,12.0,14.0,9.0,14.0,13.0,7.0,9.0,11.0,12.0,14.0,13.0,11.0,13.0,13.0,9.0,7.0,16.0,13.0,20.0,15.0,11.0,10.0,8.0,12.0,3.0,10.0,17.0,8.0,16.0,13.0,11.0,11.0,8.0,6.0,28.0,18.0,0.0,0.0,0.0,180.0,76.0,2.0,2.0,3.0,2.0,3.0,1.0,2.0,2.0,1.0,3.0,4.0,12.0,12.0,9.0,9.0,12.0,11.0,11.0,10.0,13.0,12.0,11.0,11.0,12.0,12.0,11.0,12.0,10.0,13.0,12.0,10.0,11.0,13.0,9.0,10.0,15.0,11.0,12.0,12.0,14.0,14.0,13.0,13.0,20.0,13.0,14.0,4.0,13.0,13.0,12.0,10.0,10.0,7.0,10.0,14.0,14.0,9.0,11.0,10.0,12.0,12.0,7.0,33.0,94.0,6.0,0.0,0.0,194.0,96.0,3.0,2.0,1.0,3.0,3.0,3.0,1.0,3.0,1.0,4.0,1.0,9.0,7.0,7.0,12.0,9.0,9.0,16.0,8.0,11.0,15.0,10.0,4.0,14.0,10.0,6.0,13.0,6.0,11.0,13.0,9.0,12.0,17.0,9.0,11.0,13.0,13.0,15.0,15.0,8.0,9.0,18.0,17.0,5.0,12.0,8.0,20.0,15.0,17.0,16.0,6.0,13.0,8.0,10.0,9.0,14.0,16.0,12.0,16.0,13.0,8.0,8.0,28.0,18.0,0.0,7.0,0.0,175.0,71.0,1.0,1.0,2.0,3.0,1.0,1.0,2.0,4.0,2.0,3.0,3.0,7.0,7.0,10.0,9.0,10.0,7.0,11.0,12.0,7.0,12.0,12.0,7.0,14.0,11.0,15.0,10.0,14.0,12.0,11.0,9.0,10.0,18.0,8.0,6.0,12.0,12.0,14.0,17.0,12.0,14.0,13.0,10.0,10.0,17.0,13.0,20.0,16.0,14.0,12.0,9.0,20.0,7.0,15.0,14.0,14.0,12.0,9.0,16.0,9.0,12.0,6.0,25.0,5.0,0.0,2.0,1.0,191.0,86.0,3.0,3.0,3.0,2.0,2.0,1.0,1.0,3.0,3.0,1.0,3.0,9.0,8.0,13.0,14.0,12.0,10.0,12.0,13.0,10.0,6.0,13.0,9.0,8.0,13.0,12.0,11.0,9.0,12.0,10.0,13.0,11.0,10.0,12.0,9.0,13.0,6.0,12.0,8.0,10.0,10.0,13.0,15.0,12.0,12.0,13.0,20.0,12.0,14.0,10.0,8.0,7.0,7.0,9.0,9.0,14.0,13.0,8.0,9.0,10.0,9.0,14.0,24.0,0.0,0.0,1.0,0.0,172.0,61.0,1.0,3.0,2.0,1.0,1.0,1.0,1.0,3.0,3.0,3.0,2.0,11.0,14.0,14.0,11.0,14.0,8.0,4.0,6.0,11.0,10.0,12.0,6.0,9.0,11.0,13.0,12.0,6.0,12.0,9.0,13.0,10.0,15.0,13.0,8.0,12.0,10.0,11.0,9.0,14.0,14.0,11.0,10.0,8.0,12.0,12.0,20.0,11.0,8.0,12.0,12.0,15.0,6.0,15.0,12.0,14.0,16.0,15.0,14.0,7.0,6.0,11.0
2,0,32.0,0.0,0.0,0.0,0.0,193.0,80.0,13.0,11.0,11.0,3.0,12.0,12.0,13.0,13.0,15.0,11.0,8.0,8.0,3.0,1.0,2.0,7.0,10.0,5.0,1.0,2.0,3.0,9.0,3.0,1.0,5.0,14.0,9.0,7.0,10.0,12.0,6.0,12.0,13.0,11.0,9.0,3.0,13.0,10.0,10.0,11.0,12.0,11.0,14.0,5.0,10.0,10.0,20.0,11.0,10.0,15.0,12.0,10.0,7.0,10.0,14.0,13.0,14.0,10.0,14.0,13.0,14.0,5.0,25.0,0.0,0.0,0.0,0.0,181.0,76.0,3.0,1.0,3.0,3.0,2.0,2.0,2.0,3.0,3.0,3.0,1.0,10.0,9.0,12.0,11.0,12.0,9.0,10.0,13.0,9.0,5.0,12.0,7.0,8.0,12.0,13.0,12.0,8.0,13.0,10.0,13.0,12.0,10.0,9.0,8.0,13.0,15.0,14.0,14.0,11.0,11.0,10.0,11.0,11.0,10.0,11.0,20.0,11.0,12.0,11.0,8.0,10.0,6.0,9.0,10.0,10.0,13.0,9.0,12.0,11.0,13.0,8.0,20.0,0.0,0.0,0.0,0.0,179.0,70.0,1.0,1.0,1.0,3.0,3.0,3.0,3.0,3.0,3.0,3.0,1.0,9.0,9.0,8.0,5.0,10.0,7.0,13.0,8.0,11.0,13.0,10.0,9.0,13.0,10.0,6.0,12.0,11.0,11.0,12.0,10.0,12.0,15.0,10.0,11.0,9.0,14.0,14.0,14.0,11.0,12.0,13.0,13.0,10.0,17.0,11.0,20.0,12.0,12.0,14.0,9.0,12.0,4.0,10.0,12.0,11.0,12.0,12.0,11.0,1.0,15.0,4.0,31.0,1.0,0.0,0.0,0.0,188.0,81.0,2.0,3.0,2.0,3.0,1.0,1.0,2.0,3.0,3.0,3.0,1.0,12.0,11.0,12.0,12.0,10.0,14.0,14.0,11.0,10.0,7.0,10.0,4.0,10.0,12.0,12.0,11.0,10.0,10.0,12.0,13.0,12.0,13.0,10.0,10.0,13.0,7.0,11.0,13.0,12.0,12.0,10.0,15.0,12.0,10.0,12.0,20.0,13.0,12.0,14.0,12.0,10.0,8.0,9.0,11.0,12.0,14.0,9.0,14.0,13.0,20.0,7.0,25.0,0.0,0.0,4.0,0.0,177.0,76.0,3.0,1.0,1.0,1.0,2.0,3.0,3.0,2.0,2.0,1.0,2.0,12.0,13.0,10.0,9.0,11.0,8.0,13.0,13.0,9.0,11.0,11.0,7.0,13.0,10.0,12.0,12.0,10.0,10.0,11.0,10.0,11.0,14.0,9.0,8.0,7.0,12.0,10.0,10.0,13.0,12.0,12.0,12.0,12.0,10.0,12.0,20.0,13.0,12.0,12.0,8.0,10.0,9.0,9.0,11.0,8.0,13.0,6.0,12.0,11.0,12.0,6.0,22.0,0.0,0.0,0.0,0.0,181.0,76.0,2.0,2.0,1.0,1.0,1.0,3.0,1.0,3.0,2.0,3.0,3.0,9.0,12.0,12.0,13.0,12.0,6.0,12.0,10.0,7.0,9.0,10.0,6.0,6.0,11.0,10.0,11.0,10.0,12.0,12.0,11.0,12.0,3.0,13.0,9.0,12.0,9.0,9.0,11.0,13.0,11.0,11.0,11.0,9.0,10.0,12.0,20.0,10.0,10.0,13.0,10.0,1.0,10.0,10.0,17.0,9.0,12.0,9.0,9.0,1.0,11.0,2.0,30.0,44.0,4.0,12.0,8.0,181.0,81.0,4.0,3.0,3.0,2.0,1.0,3.0,3.0,3.0,3.0,3.0,1.0,12.0,11.0,10.0,13.0,14.0,14.0,11.0,13.0,5.0,7.0,14.0,14.0,8.0,14.0,12.0,13.0,11.0,12.0,9.0,13.0,13.0,10.0,16.0,9.0,11.0,9.0,11.0,7.0,8.0,10.0,10.0,7.0,14.0,9.0,9.0,20.0,9.0,9.0,10.0,8.0,15.0,8.0,11.0,9.0,9.0,15.0,13.0,12.0,8.0,12.0,7.0,23.0,0.0,0.0,7.0,0.0,185.0,78.0,1.0,2.0,2.0,3.0,3.0,2.0,3.0,3.0,3.0,2.0,1.0,7.0,9.0,7.0,4.0,11.0,10.0,16.0,7.0,9.0,14.0,7.0,4.0,14.0,4.0,13.0,9.0,10.0,10.0,11.0,10.0,11.0,12.0,3.0,11.0,10.0,12.0,9.0,13.0,11.0,11.0,13.0,10.0,8.0,11.0,9.0,20.0,11.0,11.0,14.0,10.0,9.0,10.0,8.0,11.0,12.0,13.0,12.0,13.0,12.0,11.0,7.0,23.0,0.0,0.0,5.0,1.0,183.0,79.0,3.0,1.0,2.0,1.0,3.0,3.0,4.0,2.0,2.0,1.0,1.0,10.0,5.0,6.0,4.0,11.0,6.0,15.0,4.0,8.0,13.0,12.0,2.0,12.0,7.0,9.0,12.0,11.0,11.0,13.0,6.0,13.0,10.0,6.0,8.0,10.0,14.0,9.0,11.0,10.0,10.0,8.0,8.0,11.0,9.0,9.0,20.0,13.0,13.0,11.0,8.0,11.0,4.0,9.0,10.0,10.0,11.0,10.0,11.0,10.0,10.0,9.0,21.0,0.0,0.0,6.0,0.0,185.0,77.0,1.0,3.0,4.0,3.0,3.0,1.0,2.0,2.0,3.0,2.0,3.0,12.0,13.0,11.0,8.0,12.0,13.0,11.0,15.0,11.0,13.0,13.0,7.0,11.0,12.0,11.0,12.0,12.0,12.0,14.0,12.0,12.0,13.0,1.0,5.0,12.0,12.0,13.0,13.0,13.0,12.0,11.0,10.0,20.0,11.0,13.0,8.0,12.0,12.0,13.0,10.0,6.0,9.0,11.0,10.0,12.0,12.0,11.0,12.0,12.0,12.0,1.0,25.0,0.0,0.0,10.0,0.0,174.0,68.0,2.0,3.0,1.0,1.0,2.0,2.0,1.0,1.0,2.0,4.0,2.0,9.0,10.0,11.0,10.0,10.0,11.0,8.0,12.0,5.0,10.0,13.0,7.0,12.0,11.0,15.0,12.0,14.0,10.0,10.0,11.0,11.0,16.0,10.0,12.0,11.0,12.0,13.0,17.0,11.0,12.0,14.0,7.0,20.0,16.0,13.0,8.0,13.0,10.0,14.0,8.0,9.0,6.0,10.0,20.0,10.0,13.0,13.0,8.0,8.0,17.0,7.0,24.0,0.0,0.0,0.0,0.0,189.0,83.0,10.0,10.0,14.0,8.0,12.0,13.0,15.0,15.0,11.0,10.0,13.0,3.0,2.0,1.0,1.0,11.0,6.0,7.0,3.0,1.0,2.0,10.0,4.0,1.0,11.0,8.0,11.0,10.0,15.0,14.0,9.0,13.0,11.0,1.0,9.0,1.0,10.0,15.0,12.0,13.0,12.0,10.0,11.0,14.0,14.0,10.0,20.0,14.0,12.0,17.0,6.0,16.0,6.0,11.0,9.0,12.0,14.0,10.0,16.0,14.0,17.0,4.0,25.0,11.0,0.0,10.0,1.0,175.0,68.0,3.0,3.0,1.0,3.0,3.0,1.0,3.0,2.0,2.0,2.0,2.0,8.0,11.0,12.0,6.0,10.0,6.0,8.0,7.0,12.0,14.0,11.0,10.0,15.0,10.0,18.0,10.0,16.0,8.0,12.0,9.0,8.0,18.0,6.0,11.0,10.0,11.0,14.0,18.0,14.0,15.0,12.0,8.0,14.0,16.0,13.0,20.0,16.0,7.0,13.0,14.0,11.0,4.0,19.0,14.0,16.0,12.0,14.0,17.0,12.0,10.0,5.0,19.0,0.0,0.0,9.0,0.0,185.0,78.0,1.0,3.0,2.0,1.0,3.0,3.0,1.0,2.0,1.0,1.0,4.0,9.0,7.0,6.0,7.0,12.0,8.0,14.0,9.0,5.0,10.0,12.0,4.0,13.0,11.0,7.0,12.0,10.0,10.0,13.0,10.0,12.0,11.0,5.0,10.0,11.0,11.0,15.0,14.0,12.0,15.0,12.0,11.0,7.0,13.0,16.0,20.0,12.0,13.0,11.0,11.0,11.0,8.0,11.0,8.0,13.0,10.0,12.0,11.0,10.0,19.0,3.0,20.0,1.0,0.0,1.0,0.0,187.0,84.0,1.0,1.0,1.0,2.0,1.0,2.0,2.0,2.0,2.0,3.0,2.0,4.0,7.0,9.0,7.0,12.0,5.0,12.0,8.0,6.0,15.0,12.0,8.0,16.0,11.0,14.0,12.0,17.0,12.0,10.0,9.0,10.0,16.0,9.0,12.0,7.0,11.0,13.0,14.0,12.0,12.0,15.0,16.0,14.0,13.0,15.0,20.0,11.0,14.0,13.0,10.0,14.0,6.0,7.0,13.0,15.0,8.0,14.0,12.0,12.0,10.0,5.0,26.0,21.0,0.0,0.0,0.0,172.0,70.0,3.0,3.0,1.0,1.0,1.0,4.0,3.0,2.0,3.0,2.0,3.0,9.0,10.0,10.0,8.0,11.0,11.0,5.0,14.0,8.0,14.0,12.0,9.0,15.0,12.0,17.0,12.0,17.0,10.0,14.0,10.0,10.0,17.0,8.0,13.0,9.0,12.0,15.0,17.0,12.0,15.0,14.0,9.0,12.0,15.0,12.0,20.0,16.0,10.0,15.0,14.0,14.0,7.0,13.0,10.0,13.0,14.0,9.0,15.0,8.0,7.0,7.0,25.0,0.0,0.0,0.0,0.0,186.0,86.0,3.0,2.0,2.0,2.0,1.0,3.0,1.0,2.0,1.0,3.0,3.0,6.0,9.0,12.0,13.0,14.0,8.0,13.0,11.0,5.0,6.0,11.0,12.0,7.0,13.0,16.0,13.0,16.0,10.0,12.0,13.0,14.0,15.0,11.0,7.0,12.0,8.0,15.0,16.0,11.0,13.0,16.0,12.0,14.0,14.0,13.0,20.0,14.0,15.0,15.0,8.0,15.0,5.0,5.0,7.0,13.0,10.0,11.0,14.0,12.0,10.0,6.0,29.0,0.0,0.0,0.0,0.0,180.0,77.0,3.0,2.0,1.0,1.0,1.0,1.0,2.0,1.0,3.0,2.0,3.0,10.0,12.0,13.0,9.0,11.0,10.0,9.0,11.0,11.0,9.0,12.0,9.0,11.0,13.0,17.0,10.0,15.0,8.0,13.0,10.0,10.0,17.0,11.0,12.0,13.0,9.0,13.0,17.0,13.0,12.0,16.0,9.0,15.0,15.0,13.0,20.0,16.0,14.0,16.0,10.0,15.0,10.0,18.0,6.0,16.0,14.0,14.0,13.0,8.0,10.0,10.0,20.0,0.0,0.0,0.0,0.0,180.0,70.0,2.0,2.0,2.0,1.0,2.0,1.0,2.0,3.0,2.0,1.0,1.0,6.0,10.0,8.0,9.0,12.0,8.0,10.0,11.0,12.0,11.0,13.0,11.0,11.0,13.0,12.0,14.0,16.0,15.0,13.0,10.0,14.0,15.0,6.0,12.0,10.0,12.0,18.0,13.0,10.0,11.0,10.0,10.0,10.0,16.0,12.0,20.0,15.0,9.0,14.0,8.0,13.0,10.0,15.0,10.0,14.0,10.0,12.0,15.0,13.0,13.0,5.0,27.0,0.0,0.0,2.0,0.0,188.0,79.0,3.0,1.0,3.0,3.0,1.0,2.0,3.0,2.0,2.0,3.0,1.0,6.0,8.0,9.0,16.0,10.0,8.0,15.0,11.0,5.0,5.0,9.0,16.0,6.0,10.0,11.0,17.0,13.0,14.0,15.0,8.0,9.0,13.0,8.0,9.0,15.0,7.0,10.0,13.0,11.0,11.0,12.0,15.0,15.0,13.0,13.0,20.0,15.0,14.0,14.0,5.0,14.0,9.0,5.0,9.0,15.0,13.0,11.0,16.0,14.0,16.0,5.0,26.0,0.0,0.0,0.0,0.0,181.0,77.0,1.0,2.0,1.0,3.0,3.0,3.0,1.0,3.0,2.0,1.0,3.0,8.0,10.0,9.0,7.0,13.0,6.0,9.0,8.0,10.0,11.0,14.0,7.0,13.0,14.0,16.0,14.0,12.0,15.0,14.0,12.0,13.0,12.0,8.0,10.0,9.0,12.0,18.0,16.0,11.0,13.0,10.0,9.0,10.0,15.0,11.0,20.0,16.0,12.0,16.0,8.0,15.0,3.0,16.0,7.0,10.0,15.0,10.0,16.0,14.0,18.0,3.0,24.0,1.0,0.0,9.0,0.0,184.0,81.0,2.0,3.0,1.0,2.0,4.0,3.0,3.0,2.0,2.0,3.0,4.0,11.0,13.0,13.0,7.0,11.0,10.0,9.0,12.0,16.0,12.0,10.0,8.0,12.0,11.0,16.0,10.0,14.0,9.0,12.0,8.0,9.0,13.0,11.0,10.0,12.0,9.0,13.0,16.0,14.0,11.0,14.0,10.0,20.0,16.0,17.0,10.0,16.0,12.0,13.0,10.0,12.0,4.0,14.0,8.0,12.0,15.0,9.0,17.0,14.0,10.0,4.0
0,0,33.0,12.0,0.0,9.0,0.0,187.0,79.0,13.0,9.0,9.0,13.0,12.0,14.0,13.0,13.0,14.0,1.0,13.0,6.0,2.0,1.0,3.0,11.0,11.0,14.0,1.0,2.0,3.0,11.0,7.0,1.0,10.0,13.0,12.0,14.0,16.0,14.0,15.0,12.0,14.0,11.0,13.0,3.0,13.0,12.0,12.0,13.0,15.0,10.0,12.0,5.0,5.0,14.0,20.0,14.0,11.0,14.0,8.0,10.0,14.0,11.0,7.0,14.0,6.0,14.0,15.0,10.0,6.0,16.0,29.0,0.0,0.0,0.0,0.0,175.0,76.0,3.0,1.0,2.0,2.0,1.0,2.0,3.0,2.0,1.0,2.0,1.0,10.0,10.0,13.0,11.0,13.0,7.0,8.0,7.0,9.0,5.0,11.0,18.0,10.0,14.0,14.0,10.0,13.0,9.0,12.0,8.0,13.0,15.0,11.0,16.0,14.0,6.0,14.0,16.0,16.0,14.0,10.0,7.0,10.0,14.0,15.0,20.0,15.0,13.0,16.0,11.0,7.0,7.0,11.0,8.0,11.0,11.0,12.0,8.0,10.0,15.0,2.0,32.0,0.0,0.0,0.0,0.0,173.0,67.0,1.0,3.0,2.0,2.0,3.0,3.0,3.0,3.0,3.0,3.0,2.0,12.0,16.0,14.0,10.0,14.0,13.0,4.0,11.0,4.0,3.0,15.0,11.0,3.0,14.0,7.0,12.0,14.0,14.0,10.0,15.0,15.0,12.0,14.0,10.0,14.0,6.0,16.0,16.0,13.0,12.0,6.0,6.0,8.0,15.0,14.0,20.0,12.0,7.0,11.0,7.0,11.0,5.0,16.0,12.0,15.0,12.0,11.0,14.0,14.0,14.0,7.0,26.0,36.0,15.0,0.0,0.0,174.0,68.0,1.0,2.0,3.0,1.0,3.0,1.0,1.0,3.0,4.0,3.0,1.0,9.0,11.0,14.0,12.0,13.0,8.0,8.0,13.0,5.0,8.0,10.0,12.0,6.0,13.0,12.0,10.0,13.0,14.0,12.0,9.0,9.0,14.0,14.0,7.0,13.0,6.0,10.0,10.0,14.0,13.0,9.0,6.0,10.0,12.0,14.0,20.0,12.0,7.0,11.0,8.0,14.0,5.0,14.0,8.0,16.0,11.0,11.0,10.0,9.0,11.0,6.0,26.0,27.0,1.0,11.0,0.0,172.0,66.0,2.0,2.0,2.0,2.0,3.0,2.0,1.0,3.0,1.0,1.0,2.0,8.0,8.0,12.0,10.0,13.0,9.0,9.0,12.0,6.0,15.0,15.0,14.0,12.0,12.0,11.0,12.0,13.0,10.0,12.0,12.0,11.0,16.0,10.0,10.0,13.0,12.0,14.0,15.0,13.0,11.0,10.0,7.0,7.0,16.0,14.0,20.0,14.0,10.0,13.0,4.0,13.0,4.0,10.0,11.0,18.0,18.0,12.0,12.0,8.0,9.0,3.0,29.0,9.0,1.0,0.0,0.0,185.0,81.0,1.0,3.0,1.0,2.0,3.0,3.0,2.0,2.0,3.0,1.0,2.0,6.0,7.0,10.0,10.0,8.0,6.0,13.0,7.0,6.0,5.0,8.0,10.0,6.0,10.0,13.0,13.0,13.0,8.0,14.0,9.0,11.0,17.0,13.0,10.0,13.0,7.0,16.0,16.0,15.0,13.0,16.0,14.0,9.0,14.0,14.0,20.0,15.0,15.0,15.0,7.0,12.0,12.0,5.0,14.0,13.0,12.0,12.0,17.0,14.0,16.0,5.0,35.0,60.0,1.0,8.0,1.0,191.0,81.0,3.0,2.0,2.0,2.0,3.0,1.0,1.0,3.0,1.0,3.0,3.0,4.0,8.0,8.0,5.0,11.0,6.0,14.0,8.0,11.0,13.0,10.0,12.0,13.0,11.0,9.0,15.0,9.0,15.0,12.0,10.0,13.0,13.0,5.0,17.0,6.0,15.0,14.0,10.0,8.0,12.0,15.0,15.0,10.0,14.0,7.0,20.0,12.0,13.0,10.0,9.0,14.0,7.0,10.0,17.0,12.0,12.0,12.0,16.0,18.0,18.0,5.0,26.0,0.0,0.0,7.0,1.0,185.0,0.0,2.0,3.0,2.0,1.0,3.0,1.0,1.0,4.0,3.0,1.0,1.0,10.0,9.0,12.0,9.0,12.0,10.0,8.0,10.0,8.0,12.0,7.0,5.0,13.0,12.0,11.0,11.0,11.0,9.0,11.0,11.0,13.0,1.0,9.0,6.0,10.0,12.0,11.0,9.0,15.0,15.0,11.0,12.0,10.0,15.0,15.0,20.0,14.0,10.0,11.0,9.0,7.0,11.0,11.0,8.0,12.0,12.0,11.0,11.0,10.0,18.0,6.0,28.0,0.0,0.0,10.0,0.0,180.0,73.0,2.0,4.0,4.0,1.0,1.0,2.0,1.0,2.0,2.0,3.0,2.0,11.0,11.0,11.0,9.0,12.0,10.0,6.0,11.0,8.0,5.0,10.0,15.0,10.0,11.0,8.0,12.0,12.0,13.0,15.0,8.0,10.0,14.0,11.0,8.0,11.0,10.0,14.0,16.0,13.0,11.0,9.0,9.0,6.0,13.0,12.0,20.0,15.0,8.0,16.0,11.0,11.0,16.0,11.0,14.0,10.0,18.0,10.0,16.0,14.0,15.0,8.0,26.0,17.0,2.0,14.0,0.0,190.0,85.0,3.0,1.0,2.0,1.0,2.0,2.0,2.0,3.0,3.0,3.0,2.0,8.0,9.0,7.0,8.0,9.0,8.0,13.0,7.0,10.0,14.0,9.0,10.0,14.0,9.0,13.0,13.0,12.0,13.0,14.0,9.0,9.0,13.0,9.0,12.0,9.0,13.0,14.0,14.0,11.0,11.0,14.0,16.0,20.0,14.0,11.0,9.0,14.0,15.0,14.0,9.0,10.0,8.0,12.0,13.0,12.0,13.0,14.0,14.0,14.0,14.0,5.0,22.0,0.0,0.0,15.0,3.0,191.0,81.0,4.0,1.0,3.0,2.0,1.0,3.0,2.0,3.0,2.0,2.0,2.0,9.0,8.0,10.0,9.0,11.0,10.0,12.0,10.0,9.0,11.0,11.0,5.0,13.0,12.0,13.0,11.0,14.0,9.0,10.0,10.0,10.0,12.0,7.0,10.0,11.0,12.0,14.0,14.0,12.0,13.0,11.0,15.0,20.0,13.0,12.0,10.0,13.0,14.0,13.0,7.0,13.0,8.0,16.0,11.0,12.0,13.0,8.0,13.0,10.0,12.0,7.0,31.0,22.0,0.0,17.0,0.0,185.0,82.0,12.0,12.0,13.0,6.0,14.0,11.0,15.0,18.0,14.0,10.0,13.0,7.0,3.0,8.0,5.0,9.0,10.0,8.0,12.0,2.0,2.0,9.0,6.0,3.0,10.0,6.0,12.0,15.0,16.0,12.0,8.0,12.0,14.0,8.0,15.0,3.0,13.0,13.0,8.0,13.0,17.0,14.0,13.0,7.0,12.0,11.0,20.0,15.0,14.0,13.0,6.0,16.0,3.0,1.0,8.0,16.0,12.0,13.0,16.0,16.0,16.0,7.0,26.0,27.0,0.0,0.0,0.0,183.0,70.0,1.0,3.0,1.0,3.0,4.0,1.0,3.0,3.0,2.0,1.0,3.0,9.0,14.0,12.0,8.0,10.0,8.0,12.0,13.0,14.0,9.0,12.0,7.0,13.0,11.0,14.0,9.0,15.0,10.0,12.0,9.0,10.0,16.0,10.0,9.0,12.0,8.0,12.0,17.0,14.0,11.0,13.0,12.0,10.0,16.0,16.0,20.0,16.0,13.0,13.0,10.0,14.0,6.0,15.0,10.0,15.0,14.0,10.0,16.0,13.0,13.0,4.0,21.0,0.0,0.0,0.0,0.0,187.0,84.0,4.0,2.0,1.0,2.0,3.0,1.0,2.0,3.0,1.0,1.0,2.0,11.0,13.0,15.0,12.0,14.0,11.0,13.0,14.0,4.0,5.0,12.0,14.0,5.0,16.0,12.0,12.0,14.0,12.0,10.0,10.0,9.0,14.0,17.0,10.0,12.0,7.0,10.0,14.0,14.0,16.0,14.0,15.0,9.0,13.0,14.0,20.0,14.0,14.0,14.0,8.0,15.0,5.0,14.0,11.0,16.0,13.0,14.0,13.0,15.0,15.0,6.0,30.0,19.0,0.0,7.0,0.0,189.0,77.0,3.0,2.0,3.0,2.0,3.0,3.0,1.0,3.0,3.0,1.0,2.0,5.0,8.0,7.0,10.0,10.0,9.0,15.0,9.0,8.0,14.0,12.0,10.0,15.0,10.0,15.0,14.0,13.0,13.0,14.0,10.0,12.0,14.0,10.0,14.0,11.0,12.0,14.0,14.0,8.0,10.0,12.0,16.0,10.0,16.0,10.0,20.0,13.0,16.0,13.0,11.0,13.0,7.0,10.0,6.0,14.0,12.0,13.0,14.0,13.0,13.0,7.0,21.0,0.0,0.0,11.0,2.0,180.0,72.0,2.0,3.0,3.0,3.0,3.0,2.0,2.0,1.0,3.0,2.0,3.0,12.0,13.0,14.0,9.0,14.0,13.0,8.0,12.0,5.0,8.0,14.0,10.0,9.0,14.0,12.0,12.0,9.0,13.0,12.0,15.0,13.0,14.0,15.0,8.0,13.0,10.0,16.0,14.0,15.0,14.0,12.0,9.0,8.0,15.0,14.0,20.0,13.0,12.0,12.0,8.0,11.0,10.0,11.0,10.0,14.0,16.0,14.0,15.0,15.0,15.0,6.0,29.0,26.0,6.0,12.0,4.0,175.0,77.0,1.0,2.0,1.0,3.0,3.0,2.0,1.0,2.0,1.0,2.0,2.0,16.0,14.0,16.0,15.0,15.0,18.0,6.0,15.0,6.0,6.0,18.0,11.0,5.0,17.0,9.0,12.0,10.0,16.0,12.0,16.0,14.0,14.0,16.0,6.0,16.0,6.0,10.0,10.0,13.0,15.0,14.0,8.0,15.0,15.0,14.0,20.0,13.0,12.0,11.0,9.0,16.0,7.0,8.0,8.0,11.0,8.0,13.0,12.0,13.0,11.0,10.0,30.0,46.0,0.0,0.0,0.0,184.0,74.0,2.0,3.0,1.0,1.0,2.0,2.0,1.0,2.0,3.0,2.0,2.0,5.0,7.0,9.0,6.0,11.0,6.0,14.0,8.0,12.0,14.0,11.0,7.0,14.0,10.0,12.0,14.0,16.0,14.0,14.0,11.0,13.0,13.0,7.0,7.0,11.0,14.0,15.0,16.0,11.0,12.0,14.0,12.0,10.0,17.0,13.0,20.0,14.0,11.0,16.0,9.0,14.0,12.0,11.0,15.0,12.0,14.0,11.0,16.0,14.0,16.0,7.0,28.0,41.0,2.0,0.0,0.0,187.0,80.0,3.0,2.0,3.0,2.0,1.0,1.0,2.0,3.0,1.0,4.0,2.0,7.0,10.0,11.0,7.0,12.0,7.0,10.0,12.0,13.0,15.0,13.0,8.0,18.0,12.0,18.0,13.0,17.0,12.0,14.0,10.0,12.0,17.0,7.0,13.0,9.0,14.0,17.0,18.0,14.0,13.0,16.0,14.0,20.0,18.0,13.0,12.0,18.0,14.0,15.0,16.0,15.0,6.0,15.0,14.0,13.0,10.0,14.0,12.0,8.0,7.0,8.0,30.0,32.0,1.0,0.0,0.0,190.0,88.0,1.0,2.0,2.0,2.0,3.0,1.0,1.0,3.0,3.0,2.0,2.0,5.0,7.0,9.0,8.0,10.0,7.0,16.0,11.0,9.0,15.0,13.0,5.0,16.0,12.0,17.0,16.0,17.0,13.0,13.0,11.0,12.0,16.0,7.0,14.0,10.0,14.0,15.0,15.0,14.0,12.0,17.0,16.0,9.0,15.0,14.0,20.0,16.0,18.0,15.0,15.0,14.0,10.0,12.0,14.0,15.0,12.0,14.0,12.0,13.0,11.0,15.0,18.0,0.0,0.0,0.0,0.0,167.0,60.0,2.0,1.0,2.0,2.0,2.0,1.0,2.0,1.0,1.0,1.0,1.0,10.0,11.0,12.0,8.0,13.0,10.0,3.0,10.0,5.0,6.0,13.0,12.0,8.0,15.0,8.0,11.0,8.0,12.0,11.0,13.0,12.0,13.0,12.0,6.0,11.0,11.0,12.0,13.0,15.0,14.0,8.0,5.0,8.0,15.0,12.0,20.0,12.0,7.0,8.0,8.0,14.0,7.0,8.0,18.0,11.0,12.0,11.0,12.0,15.0,15.0,7.0,26.0,0.0,0.0,4.0,0.0,180.0,73.0,2.0,3.0,1.0,4.0,2.0,3.0,3.0,1.0,1.0,4.0,1.0,11.0,13.0,13.0,14.0,14.0,11.0,15.0,12.0,3.0,7.0,14.0,14.0,8.0,13.0,12.0,14.0,17.0,13.0,15.0,14.0,14.0,16.0,12.0,15.0,16.0,12.0,18.0,16.0,13.0,14.0,13.0,12.0,8.0,14.0,13.0,20.0,15.0,12.0,15.0,8.0,14.0,7.0,15.0,19.0,14.0,17.0,14.0,18.0,16.0,16.0,5.0
1,0,22.0,0.0,0.0,0.0,0.0,191.0,84.0,13.0,10.0,9.0,1.0,13.0,7.0,13.0,14.0,10.0,10.0,8.0,5.0,2.0,2.0,1.0,3.0,8.0,1.0,3.0,2.0,1.0,2.0,3.0,1.0,1.0,10.0,7.0,14.0,8.0,6.0,8.0,10.0,7.0,2.0,10.0,3.0,12.0,9.0,8.0,12.0,13.0,8.0,15.0,6.0,12.0,13.0,20.0,5.0,11.0,10.0,7.0,8.0,6.0,10.0,19.0,11.0,9.0,10.0,14.0,10.0,10.0,7.0,23.0,0.0,0.0,0.0,0.0,186.0,80.0,3.0,2.0,1.0,4.0,1.0,1.0,2.0,1.0,1.0,2.0,3.0,14.0,17.0,9.0,8.0,8.0,13.0,8.0,11.0,13.0,8.0,10.0,4.0,11.0,9.0,14.0,10.0,12.0,10.0,10.0,10.0,10.0,7.0,6.0,5.0,12.0,9.0,12.0,15.0,14.0,11.0,11.0,12.0,20.0,12.0,13.0,8.0,14.0,12.0,12.0,8.0,2.0,10.0,10.0,8.0,15.0,4.0,12.0,13.0,9.0,10.0,14.0,21.0,0.0,0.0,0.0,0.0,190.0,82.0,1.0,2.0,3.0,2.0,1.0,2.0,3.0,3.0,1.0,1.0,3.0,4.0,8.0,6.0,6.0,11.0,1.0,14.0,9.0,2.0,12.0,7.0,4.0,13.0,7.0,10.0,13.0,11.0,10.0,9.0,3.0,15.0,14.0,4.0,14.0,7.0,12.0,9.0,11.0,7.0,8.0,14.0,16.0,10.0,11.0,8.0,20.0,7.0,15.0,11.0,3.0,4.0,4.0,10.0,10.0,11.0,9.0,11.0,12.0,6.0,16.0,6.0,21.0,0.0,0.0,0.0,0.0,168.0,62.0,1.0,3.0,1.0,3.0,4.0,3.0,2.0,1.0,2.0,2.0,2.0,11.0,12.0,13.0,10.0,10.0,8.0,15.0,11.0,7.0,8.0,13.0,12.0,10.0,12.0,14.0,8.0,7.0,6.0,8.0,13.0,14.0,14.0,10.0,13.0,14.0,7.0,14.0,15.0,12.0,13.0,8.0,6.0,6.0,16.0,13.0,20.0,14.0,6.0,10.0,5.0,6.0,10.0,10.0,12.0,17.0,11.0,8.0,17.0,1.0,11.0,4.0,27.0,1.0,0.0,1.0,0.0,185.0,82.0,4.0,1.0,1.0,2.0,1.0,3.0,2.0,2.0,3.0,3.0,1.0,6.0,7.0,12.0,14.0,12.0,10.0,13.0,12.0,4.0,3.0,11.0,16.0,7.0,13.0,12.0,14.0,13.0,13.0,11.0,10.0,11.0,11.0,10.0,8.0,14.0,5.0,8.0,13.0,12.0,11.0,14.0,13.0,9.0,12.0,13.0,20.0,13.0,14.0,12.0,8.0,9.0,4.0,11.0,16.0,12.0,9.0,12.0,17.0,4.0,11.0,6.0,21.0,0.0,0.0,1.0,0.0,182.0,77.0,2.0,2.0,3.0,1.0,2.0,3.0,3.0,2.0,2.0,3.0,2.0,11.0,15.0,10.0,12.0,10.0,10.0,10.0,12.0,7.0,9.0,10.0,8.0,9.0,11.0,14.0,10.0,10.0,10.0,10.0,10.0,10.0,3.0,10.0,13.0,11.0,10.0,10.0,13.0,13.0,12.0,11.0,12.0,9.0,12.0,13.0,20.0,11.0,11.0,12.0,11.0,10.0,8.0,10.0,14.0,13.0,11.0,12.0,11.0,8.0,13.0,2.0,19.0,0.0,0.0,0.0,0.0,180.0,75.0,2.0,1.0,3.0,2.0,2.0,2.0,3.0,1.0,4.0,1.0,2.0,6.0,12.0,14.0,7.0,11.0,6.0,7.0,8.0,10.0,8.0,9.0,9.0,10.0,11.0,15.0,10.0,13.0,7.0,8.0,10.0,8.0,4.0,14.0,5.0,12.0,10.0,11.0,14.0,14.0,12.0,8.0,10.0,20.0,13.0,14.0,8.0,14.0,12.0,10.0,9.0,10.0,7.0,10.0,8.0,9.0,10.0,11.0,8.0,7.0,15.0,2.0,27.0,0.0,0.0,0.0,0.0,174.0,72.0,1.0,2.0,2.0,3.0,1.0,1.0,1.0,1.0,2.0,3.0,1.0,9.0,12.0,13.0,8.0,12.0,7.0,9.0,9.0,9.0,7.0,11.0,10.0,8.0,13.0,14.0,11.0,9.0,9.0,9.0,13.0,11.0,12.0,13.0,13.0,11.0,7.0,11.0,15.0,16.0,13.0,8.0,8.0,5.0,11.0,13.0,20.0,14.0,8.0,14.0,7.0,8.0,16.0,15.0,12.0,12.0,13.0,10.0,14.0,14.0,14.0,5.0,19.0,0.0,0.0,0.0,0.0,172.0,58.0,2.0,3.0,3.0,3.0,2.0,2.0,2.0,3.0,1.0,1.0,1.0,9.0,7.0,10.0,5.0,12.0,9.0,9.0,10.0,9.0,10.0,9.0,7.0,12.0,11.0,9.0,9.0,9.0,11.0,9.0,10.0,11.0,2.0,9.0,3.0,9.0,10.0,11.0,11.0,7.0,12.0,11.0,9.0,20.0,12.0,11.0,9.0,8.0,8.0,8.0,6.0,9.0,6.0,9.0,20.0,10.0,11.0,13.0,13.0,7.0,11.0,8.0,25.0,0.0,0.0,0.0,0.0,187.0,81.0,3.0,1.0,1.0,4.0,2.0,1.0,1.0,3.0,3.0,3.0,4.0,10.0,10.0,11.0,9.0,14.0,7.0,10.0,13.0,10.0,9.0,12.0,13.0,11.0,13.0,11.0,10.0,15.0,7.0,8.0,13.0,10.0,15.0,12.0,11.0,10.0,10.0,13.0,10.0,11.0,10.0,11.0,13.0,10.0,10.0,11.0,20.0,13.0,12.0,9.0,6.0,5.0,10.0,15.0,7.0,12.0,11.0,9.0,16.0,9.0,10.0,4.0,27.0,0.0,0.0,11.0,2.0,165.0,60.0,1.0,3.0,4.0,3.0,1.0,1.0,1.0,3.0,2.0,1.0,1.0,10.0,11.0,12.0,9.0,11.0,13.0,7.0,13.0,4.0,7.0,11.0,11.0,6.0,11.0,15.0,9.0,10.0,11.0,8.0,12.0,11.0,5.0,11.0,10.0,10.0,11.0,12.0,11.0,12.0,11.0,9.0,6.0,15.0,10.0,13.0,20.0,10.0,7.0,10.0,12.0,13.0,8.0,15.0,15.0,12.0,7.0,11.0,11.0,11.0,12.0,6.0,25.0,4.0,0.0,20.0,0.0,189.0,85.0,13.0,14.0,15.0,6.0,15.0,13.0,14.0,16.0,13.0,10.0,12.0,1.0,2.0,2.0,1.0,7.0,5.0,1.0,3.0,2.0,1.0,10.0,3.0,3.0,11.0,8.0,14.0,12.0,15.0,14.0,14.0,15.0,18.0,4.0,12.0,2.0,14.0,13.0,17.0,9.0,14.0,14.0,13.0,5.0,15.0,10.0,20.0,14.0,12.0,13.0,7.0,15.0,7.0,12.0,17.0,17.0,17.0,16.0,18.0,15.0,14.0,8.0,24.0,0.0,0.0,8.0,0.0,187.0,80.0,2.0,2.0,1.0,3.0,1.0,3.0,1.0,3.0,3.0,1.0,3.0,4.0,6.0,8.0,6.0,11.0,6.0,16.0,7.0,10.0,14.0,9.0,6.0,12.0,11.0,12.0,14.0,13.0,11.0,12.0,12.0,11.0,15.0,7.0,8.0,7.0,13.0,16.0,16.0,15.0,13.0,15.0,14.0,8.0,13.0,15.0,20.0,14.0,16.0,13.0,12.0,14.0,7.0,8.0,17.0,13.0,14.0,11.0,17.0,15.0,15.0,6.0,20.0,0.0,0.0,0.0,0.0,186.0,83.0,3.0,1.0,2.0,1.0,3.0,2.0,2.0,1.0,2.0,4.0,1.0,11.0,8.0,10.0,9.0,13.0,16.0,12.0,11.0,10.0,12.0,11.0,10.0,10.0,13.0,13.0,9.0,13.0,11.0,11.0,12.0,11.0,7.0,8.0,9.0,12.0,12.0,11.0,13.0,13.0,12.0,12.0,12.0,10.0,12.0,13.0,20.0,12.0,14.0,12.0,8.0,11.0,4.0,11.0,16.0,17.0,8.0,10.0,14.0,10.0,11.0,8.0,24.0,27.0,0.0,4.0,0.0,177.0,68.0,1.0,1.0,3.0,2.0,2.0,2.0,3.0,3.0,3.0,2.0,1.0,9.0,13.0,12.0,6.0,12.0,11.0,8.0,11.0,12.0,12.0,14.0,5.0,12.0,14.0,15.0,12.0,12.0,10.0,10.0,12.0,11.0,16.0,12.0,8.0,13.0,14.0,13.0,13.0,14.0,14.0,13.0,8.0,10.0,16.0,15.0,20.0,15.0,12.0,11.0,14.0,13.0,4.0,13.0,13.0,12.0,13.0,11.0,14.0,13.0,13.0,6.0,24.0,1.0,0.0,5.0,1.0,185.0,72.0,3.0,3.0,1.0,1.0,2.0,1.0,3.0,3.0,1.0,3.0,1.0,11.0,11.0,13.0,11.0,16.0,12.0,10.0,15.0,6.0,8.0,16.0,8.0,5.0,15.0,13.0,14.0,12.0,13.0,15.0,16.0,15.0,14.0,14.0,12.0,15.0,11.0,15.0,15.0,12.0,12.0,14.0,9.0,10.0,13.0,13.0,20.0,16.0,11.0,15.0,11.0,14.0,9.0,15.0,9.0,14.0,14.0,6.0,11.0,12.0,18.0,5.0,21.0,0.0,0.0,0.0,0.0,182.0,70.0,3.0,3.0,4.0,1.0,2.0,1.0,1.0,1.0,3.0,1.0,1.0,10.0,8.0,12.0,7.0,12.0,12.0,12.0,9.0,10.0,13.0,14.0,10.0,12.0,13.0,10.0,14.0,15.0,16.0,14.0,14.0,13.0,17.0,10.0,13.0,14.0,12.0,14.0,15.0,11.0,12.0,14.0,12.0,20.0,12.0,11.0,10.0,15.0,12.0,14.0,8.0,14.0,9.0,12.0,12.0,15.0,16.0,17.0,16.0,17.0,14.0,7.0,23.0,6.0,0.0,20.0,4.0,186.0,82.0,3.0,3.0,3.0,1.0,3.0,2.0,4.0,2.0,3.0,4.0,1.0,8.0,11.0,12.0,9.0,13.0,9.0,11.0,13.0,8.0,12.0,15.0,8.0,10.0,15.0,12.0,13.0,11.0,14.0,14.0,14.0,13.0,17.0,9.0,8.0,14.0,12.0,15.0,16.0,12.0,14.0,13.0,13.0,11.0,15.0,12.0,20.0,16.0,13.0,16.0,12.0,11.0,12.0,12.0,12.0,15.0,14.0,14.0,19.0,15.0,6.0,5.0,20.0,13.0,1.0,0.0,0.0,177.0,70.0,2.0,3.0,2.0,2.0,3.0,1.0,3.0,2.0,1.0,3.0,2.0,9.0,13.0,14.0,14.0,13.0,8.0,8.0,13.0,11.0,6.0,12.0,11.0,7.0,14.0,6.0,13.0,11.0,13.0,12.0,13.0,14.0,20.0,16.0,7.0,15.0,7.0,12.0,12.0,16.0,15.0,11.0,8.0,13.0,14.0,14.0,20.0,15.0,7.0,14.0,6.0,13.0,5.0,12.0,20.0,17.0,14.0,13.0,18.0,10.0,13.0,6.0,18.0,0.0,0.0,0.0,0.0,178.0,64.0,3.0,3.0,1.0,1.0,3.0,2.0,2.0,3.0,1.0,1.0,2.0,9.0,11.0,12.0,10.0,11.0,9.0,5.0,13.0,5.0,4.0,10.0,7.0,4.0,11.0,7.0,12.0,10.0,9.0,12.0,13.0,11.0,12.0,12.0,5.0,13.0,7.0,10.0,11.0,15.0,13.0,12.0,7.0,14.0,7.0,14.0,20.0,9.0,12.0,10.0,7.0,10.0,11.0,11.0,15.0,13.0,12.0,11.0,10.0,9.0,17.0,3.0,22.0,0.0,0.0,0.0,0.0,191.0,79.0,2.0,2.0,1.0,1.0,2.0,1.0,3.0,1.0,3.0,4.0,3.0,11.0,7.0,13.0,13.0,13.0,11.0,13.0,11.0,12.0,4.0,10.0,13.0,4.0,12.0,3.0,14.0,12.0,11.0,9.0,13.0,12.0,11.0,14.0,7.0,14.0,5.0,10.0,11.0,12.0,15.0,13.0,13.0,14.0,12.0,13.0,20.0,13.0,15.0,12.0,5.0,8.0,6.0,14.0,10.0,14.0,7.0,12.0,8.0,13.0,11.0,8.0,22.0,0.0,0.0,0.0,0.0,181.0,79.0,3.0,1.0,3.0,2.0,2.0,3.0,4.0,3.0,2.0,3.0,3.0,11.0,9.0,10.0,5.0,12.0,6.0,8.0,5.0,11.0,12.0,11.0,9.0,11.0,12.0,12.0,13.0,12.0,12.0,12.0,11.0,12.0,14.0,11.0,7.0,14.0,11.0,13.0,14.0,15.0,15.0,14.0,13.0,8.0,11.0,14.0,20.0,14.0,14.0,13.0,7.0,11.0,8.0,13.0,9.0,13.0,14.0,15.0,13.0,11.0,15.0,1.0
2,0,22.0,0.0,0.0,9.0,0.0,187.0,77.0,14.0,14.0,14.0,9.0,13.0,17.0,13.0,16.0,12.0,9.0,12.0,5.0,2.0,2.0,2.0,11.0,9.0,8.0,1.0,2.0,2.0,14.0,3.0,1.0,13.0,10.0,13.0,13.0,11.0,12.0,13.0,12.0,14.0,3.0,9.0,3.0,14.0,10.0,11.0,8.0,14.0,12.0,14.0,20.0,12.0,8.0,10.0,13.0,13.0,13.0,6.0,12.0,11.0,12.0,15.0,12.0,13.0,11.0,12.0,10.0,5.0,5.0,26.0,15.0,0.0,3.0,1.0,181.0,75.0,1.0,2.0,2.0,4.0,1.0,2.0,2.0,2.0,1.0,1.0,2.0,10.0,8.0,9.0,8.0,14.0,7.0,12.0,5.0,8.0,12.0,15.0,12.0,16.0,15.0,15.0,15.0,16.0,10.0,13.0,15.0,14.0,14.0,14.0,12.0,9.0,15.0,18.0,18.0,12.0,12.0,14.0,11.0,11.0,18.0,12.0,20.0,18.0,13.0,15.0,13.0,14.0,6.0,13.0,17.0,16.0,12.0,15.0,15.0,13.0,14.0,6.0,31.0,30.0,1.0,16.0,1.0,170.0,74.0,3.0,2.0,2.0,2.0,1.0,2.0,1.0,1.0,1.0,1.0,3.0,13.0,14.0,12.0,8.0,14.0,15.0,10.0,12.0,9.0,14.0,14.0,18.0,14.0,15.0,7.0,14.0,12.0,16.0,14.0,14.0,15.0,15.0,12.0,11.0,15.0,13.0,15.0,14.0,11.0,13.0,13.0,6.0,20.0,15.0,14.0,10.0,14.0,11.0,13.0,6.0,13.0,9.0,12.0,1.0,15.0,17.0,16.0,17.0,17.0,17.0,1.0,23.0,0.0,0.0,16.0,3.0,186.0,83.0,3.0,2.0,1.0,2.0,3.0,1.0,1.0,1.0,3.0,1.0,3.0,5.0,8.0,8.0,8.0,12.0,5.0,15.0,5.0,12.0,14.0,13.0,5.0,14.0,13.0,13.0,14.0,15.0,15.0,13.0,10.0,12.0,17.0,8.0,11.0,10.0,14.0,14.0,14.0,16.0,13.0,11.0,14.0,12.0,14.0,16.0,20.0,13.0,14.0,14.0,8.0,14.0,12.0,10.0,10.0,15.0,12.0,14.0,16.0,16.0,14.0,5.0,31.0,65.0,2.0,0.0,0.0,182.0,91.0,2.0,2.0,1.0,2.0,1.0,2.0,2.0,3.0,3.0,1.0,2.0,3.0,4.0,7.0,4.0,10.0,3.0,15.0,4.0,6.0,13.0,12.0,4.0,15.0,10.0,16.0,16.0,18.0,11.0,14.0,9.0,12.0,15.0,8.0,18.0,7.0,17.0,13.0,10.0,10.0,11.0,9.0,12.0,14.0,13.0,11.0,20.0,16.0,17.0,15.0,14.0,16.0,1.0,6.0,10.0,16.0,16.0,14.0,14.0,8.0,8.0,16.0,30.0,115.0,53.0,0.0,0.0,178.0,78.0,4.0,1.0,1.0,4.0,2.0,3.0,2.0,2.0,2.0,3.0,2.0,14.0,15.0,12.0,15.0,11.0,14.0,14.0,14.0,7.0,7.0,15.0,16.0,9.0,15.0,17.0,14.0,18.0,13.0,12.0,14.0,14.0,15.0,14.0,15.0,15.0,9.0,17.0,14.0,12.0,11.0,15.0,11.0,14.0,12.0,13.0,20.0,14.0,15.0,10.0,15.0,16.0,12.0,12.0,15.0,18.0,6.0,12.0,7.0,8.0,10.0,16.0,28.0,50.0,9.0,5.0,2.0,182.0,69.0,3.0,4.0,3.0,1.0,3.0,2.0,1.0,3.0,3.0,1.0,2.0,12.0,13.0,14.0,13.0,14.0,16.0,8.0,12.0,4.0,5.0,13.0,10.0,5.0,14.0,13.0,14.0,11.0,13.0,13.0,13.0,10.0,12.0,13.0,6.0,15.0,5.0,7.0,11.0,16.0,14.0,13.0,8.0,12.0,13.0,14.0,20.0,12.0,11.0,10.0,15.0,12.0,5.0,6.0,12.0,18.0,11.0,11.0,10.0,8.0,12.0,12.0,26.0,24.0,0.0,0.0,0.0,183.0,78.0,1.0,2.0,3.0,3.0,2.0,3.0,3.0,3.0,2.0,3.0,1.0,10.0,12.0,9.0,6.0,11.0,9.0,12.0,9.0,12.0,13.0,10.0,10.0,13.0,12.0,9.0,11.0,13.0,11.0,11.0,11.0,12.0,11.0,9.0,10.0,12.0,13.0,12.0,13.0,11.0,15.0,10.0,13.0,10.0,12.0,11.0,20.0,14.0,13.0,13.0,11.0,9.0,7.0,13.0,13.0,11.0,8.0,12.0,13.0,12.0,20.0,8.0,27.0,32.0,0.0,0.0,0.0,174.0,64.0,1.0,1.0,1.0,4.0,3.0,3.0,1.0,1.0,1.0,3.0,2.0,8.0,9.0,10.0,6.0,14.0,7.0,11.0,13.0,9.0,13.0,14.0,8.0,16.0,13.0,13.0,18.0,15.0,13.0,13.0,14.0,13.0,16.0,8.0,10.0,9.0,14.0,17.0,18.0,14.0,15.0,12.0,8.0,9.0,15.0,14.0,20.0,16.0,13.0,15.0,12.0,15.0,9.0,8.0,14.0,16.0,10.0,13.0,15.0,15.0,15.0,6.0,23.0,5.0,1.0,4.0,0.0,181.0,75.0,2.0,1.0,3.0,2.0,3.0,3.0,2.0,4.0,3.0,3.0,1.0,7.0,8.0,12.0,13.0,14.0,9.0,12.0,10.0,8.0,6.0,14.0,13.0,8.0,12.0,18.0,15.0,16.0,15.0,13.0,13.0,16.0,17.0,10.0,15.0,16.0,10.0,16.0,16.0,12.0,13.0,14.0,12.0,10.0,15.0,13.0,20.0,16.0,12.0,14.0,7.0,14.0,9.0,11.0,19.0,12.0,17.0,14.0,17.0,11.0,13.0,4.0,18.0,0.0,0.0,0.0,0.0,174.0,78.0,2.0,1.0,1.0,3.0,1.0,3.0,2.0,1.0,3.0,2.0,2.0,9.0,8.0,14.0,13.0,13.0,11.0,4.0,12.0,8.0,3.0,9.0,10.0,5.0,14.0,7.0,12.0,8.0,14.0,8.0,10.0,8.0,13.0,14.0,4.0,12.0,6.0,6.0,11.0,16.0,15.0,13.0,5.0,15.0,14.0,15.0,20.0,12.0,6.0,11.0,2.0,5.0,4.0,5.0,14.0,15.0,16.0,14.0,15.0,13.0,15.0,3.0,25.0,0.0,0.0,0.0,0.0,189.0,79.0,11.0,11.0,8.0,16.0,12.0,7.0,12.0,14.0,12.0,12.0,8.0,3.0,1.0,3.0,3.0,9.0,5.0,8.0,2.0,1.0,1.0,10.0,1.0,2.0,8.0,14.0,10.0,16.0,9.0,11.0,6.0,7.0,13.0,2.0,11.0,1.0,10.0,12.0,13.0,14.0,15.0,12.0,14.0,6.0,12.0,14.0,20.0,15.0,9.0,12.0,10.0,6.0,10.0,10.0,20.0,10.0,15.0,12.0,14.0,11.0,10.0,6.0,24.0,0.0,0.0,0.0,0.0,190.0,76.0,2.0,2.0,2.0,1.0,1.0,2.0,3.0,2.0,2.0,3.0,2.0,3.0,2.0,3.0,1.0,9.0,5.0,14.0,6.0,7.0,9.0,9.0,2.0,14.0,5.0,10.0,10.0,10.0,8.0,10.0,5.0,11.0,10.0,4.0,14.0,7.0,14.0,8.0,8.0,14.0,14.0,9.0,16.0,5.0,12.0,14.0,20.0,6.0,12.0,10.0,6.0,10.0,4.0,10.0,15.0,10.0,12.0,11.0,10.0,7.0,8.0,2.0,21.0,13.0,0.0,7.0,0.0,181.0,75.0,2.0,3.0,1.0,1.0,3.0,1.0,1.0,4.0,3.0,4.0,2.0,8.0,8.0,12.0,12.0,12.0,9.0,5.0,13.0,12.0,8.0,12.0,6.0,11.0,12.0,8.0,11.0,13.0,10.0,10.0,12.0,7.0,11.0,10.0,6.0,8.0,6.0,5.0,13.0,13.0,12.0,9.0,8.0,14.0,15.0,12.0,20.0,14.0,11.0,8.0,6.0,6.0,5.0,12.0,15.0,13.0,5.0,10.0,9.0,11.0,12.0,6.0,18.0,0.0,0.0,0.0,0.0,178.0,79.0,2.0,2.0,3.0,2.0,3.0,2.0,2.0,3.0,2.0,1.0,3.0,10.0,11.0,13.0,7.0,10.0,8.0,7.0,8.0,6.0,4.0,10.0,12.0,6.0,12.0,13.0,8.0,10.0,7.0,9.0,10.0,8.0,16.0,14.0,10.0,10.0,6.0,8.0,13.0,14.0,14.0,15.0,9.0,8.0,17.0,14.0,20.0,13.0,12.0,12.0,10.0,9.0,6.0,10.0,14.0,13.0,14.0,15.0,18.0,7.0,14.0,5.0,24.0,0.0,0.0,12.0,10.0,179.0,80.0,1.0,1.0,1.0,1.0,1.0,3.0,3.0,3.0,3.0,3.0,3.0,4.0,10.0,12.0,14.0,13.0,4.0,12.0,8.0,5.0,4.0,11.0,12.0,10.0,13.0,12.0,13.0,10.0,13.0,12.0,13.0,14.0,10.0,17.0,11.0,14.0,8.0,12.0,8.0,12.0,11.0,15.0,9.0,13.0,12.0,12.0,20.0,8.0,14.0,12.0,10.0,10.0,15.0,11.0,10.0,13.0,8.0,14.0,14.0,8.0,10.0,10.0,22.0,1.0,0.0,14.0,4.0,180.0,74.0,3.0,3.0,1.0,3.0,2.0,3.0,1.0,3.0,1.0,1.0,1.0,4.0,7.0,7.0,7.0,11.0,11.0,9.0,13.0,5.0,13.0,12.0,10.0,13.0,12.0,17.0,14.0,17.0,13.0,15.0,10.0,10.0,13.0,10.0,13.0,8.0,15.0,12.0,16.0,12.0,10.0,13.0,10.0,9.0,17.0,10.0,20.0,16.0,15.0,13.0,13.0,13.0,4.0,13.0,10.0,12.0,10.0,11.0,12.0,6.0,15.0,10.0,20.0,0.0,0.0,0.0,0.0,170.0,64.0,1.0,2.0,1.0,2.0,1.0,3.0,3.0,3.0,3.0,3.0,3.0,12.0,10.0,11.0,9.0,12.0,13.0,7.0,12.0,4.0,6.0,11.0,13.0,13.0,12.0,14.0,10.0,14.0,9.0,10.0,10.0,10.0,14.0,13.0,9.0,10.0,10.0,11.0,16.0,12.0,13.0,11.0,6.0,10.0,13.0,11.0,20.0,16.0,8.0,12.0,8.0,13.0,10.0,15.0,16.0,12.0,12.0,11.0,12.0,12.0,14.0,6.0,22.0,1.0,0.0,0.0,0.0,180.0,76.0,3.0,3.0,2.0,1.0,1.0,3.0,2.0,3.0,3.0,2.0,4.0,14.0,10.0,13.0,12.0,14.0,12.0,6.0,15.0,3.0,8.0,13.0,5.0,7.0,12.0,9.0,12.0,13.0,14.0,12.0,12.0,10.0,14.0,13.0,8.0,13.0,12.0,12.0,15.0,13.0,13.0,11.0,10.0,14.0,18.0,11.0,20.0,14.0,8.0,16.0,7.0,10.0,4.0,11.0,10.0,8.0,14.0,10.0,13.0,5.0,12.0,4.0,26.0,0.0,0.0,0.0,0.0,195.0,86.0,2.0,3.0,2.0,1.0,3.0,1.0,1.0,2.0,3.0,3.0,3.0,3.0,7.0,10.0,6.0,10.0,5.0,13.0,7.0,7.0,10.0,10.0,7.0,12.0,11.0,11.0,13.0,14.0,12.0,11.0,8.0,11.0,13.0,7.0,8.0,8.0,12.0,13.0,14.0,13.0,11.0,12.0,17.0,7.0,15.0,12.0,20.0,14.0,13.0,12.0,5.0,11.0,11.0,11.0,12.0,12.0,14.0,8.0,14.0,12.0,15.0,5.0,23.0,0.0,0.0,0.0,0.0,187.0,79.0,1.0,1.0,3.0,1.0,1.0,1.0,2.0,2.0,3.0,2.0,2.0,8.0,11.0,7.0,10.0,11.0,5.0,10.0,7.0,11.0,12.0,10.0,5.0,11.0,10.0,12.0,10.0,11.0,11.0,11.0,10.0,11.0,10.0,8.0,10.0,12.0,12.0,12.0,14.0,12.0,12.0,11.0,10.0,20.0,11.0,12.0,5.0,14.0,12.0,12.0,9.0,10.0,7.0,13.0,10.0,12.0,13.0,10.0,10.0,12.0,8.0,8.0,25.0,0.0,0.0,14.0,0.0,185.0,82.0,2.0,3.0,3.0,1.0,1.0,2.0,1.0,2.0,1.0,2.0,2.0,6.0,9.0,12.0,7.0,12.0,7.0,12.0,8.0,8.0,13.0,11.0,8.0,14.0,12.0,11.0,11.0,12.0,11.0,12.0,11.0,10.0,11.0,10.0,9.0,8.0,12.0,13.0,14.0,10.0,11.0,14.0,14.0,8.0,13.0,12.0,20.0,14.0,13.0,12.0,8.0,12.0,7.0,11.0,13.0,16.0,10.0,11.0,10.0,12.0,12.0,14.0
0,0,19.0,0.0,0.0,0.0,0.0,192.0,83.0,14.0,10.0,8.0,12.0,12.0,10.0,10.0,13.0,10.0,12.0,11.0,1.0,2.0,2.0,2.0,7.0,6.0,3.0,1.0,2.0,3.0,6.0,4.0,1.0,7.0,10.0,11.0,10.0,12.0,10.0,7.0,9.0,10.0,1.0,7.0,1.0,14.0,10.0,12.0,11.0,14.0,11.0,14.0,5.0,4.0,10.0,20.0,12.0,12.0,8.0,4.0,1.0,7.0,10.0,9.0,13.0,10.0,12.0,9.0,7.0,11.0,7.0,26.0,0.0,0.0,0.0,0.0,189.0,88.0,1.0,4.0,2.0,1.0,2.0,3.0,3.0,3.0,2.0,2.0,3.0,9.0,6.0,8.0,14.0,12.0,9.0,14.0,8.0,2.0,4.0,11.0,6.0,3.0,10.0,9.0,13.0,12.0,10.0,11.0,11.0,12.0,4.0,9.0,10.0,13.0,6.0,9.0,11.0,10.0,14.0,15.0,11.0,10.0,9.0,12.0,20.0,13.0,16.0,15.0,9.0,12.0,10.0,10.0,19.0,10.0,11.0,12.0,14.0,9.0,15.0,3.0,31.0,3.0,0.0,0.0,0.0,177.0,72.0,1.0,2.0,4.0,2.0,1.0,1.0,4.0,1.0,2.0,3.0,1.0,11.0,13.0,10.0,9.0,12.0,8.0,10.0,8.0,10.0,12.0,11.0,12.0,13.0,11.0,13.0,12.0,13.0,11.0,11.0,11.0,11.0,13.0,12.0,16.0,12.0,13.0,14.0,14.0,13.0,12.0,12.0,10.0,8.0,14.0,13.0,20.0,12.0,12.0,11.0,8.0,13.0,6.0,9.0,11.0,13.0,14.0,11.0,15.0,14.0,12.0,7.0,27.0,0.0,0.0,0.0,0.0,186.0,80.0,1.0,3.0,4.0,3.0,1.0,3.0,2.0,2.0,3.0,1.0,3.0,9.0,9.0,10.0,5.0,11.0,10.0,10.0,10.0,9.0,11.0,12.0,10.0,11.0,11.0,15.0,11.0,11.0,11.0,11.0,10.0,11.0,13.0,10.0,11.0,11.0,10.0,11.0,11.0,10.0,11.0,11.0,11.0,12.0,12.0,10.0,20.0,10.0,9.0,11.0,15.0,10.0,7.0,8.0,10.0,11.0,12.0,11.0,8.0,7.0,5.0,8.0,25.0,6.0,1.0,0.0,0.0,161.0,64.0,3.0,1.0,2.0,1.0,4.0,2.0,1.0,1.0,2.0,3.0,2.0,12.0,14.0,17.0,12.0,16.0,6.0,8.0,11.0,6.0,6.0,15.0,5.0,8.0,18.0,13.0,6.0,8.0,5.0,8.0,16.0,12.0,13.0,15.0,6.0,12.0,8.0,7.0,9.0,13.0,13.0,9.0,7.0,12.0,11.0,14.0,20.0,10.0,9.0,10.0,5.0,12.0,8.0,13.0,11.0,15.0,11.0,10.0,13.0,13.0,5.0,3.0,22.0,0.0,0.0,0.0,0.0,192.0,82.0,3.0,1.0,3.0,4.0,4.0,1.0,1.0,2.0,1.0,3.0,1.0,9.0,10.0,10.0,9.0,10.0,12.0,12.0,12.0,6.0,12.0,12.0,15.0,13.0,12.0,14.0,12.0,10.0,13.0,13.0,11.0,12.0,11.0,12.0,10.0,11.0,12.0,12.0,12.0,11.0,12.0,12.0,14.0,9.0,10.0,11.0,20.0,13.0,12.0,13.0,9.0,13.0,9.0,7.0,11.0,12.0,13.0,11.0,10.0,10.0,10.0,9.0,32.0,0.0,0.0,0.0,0.0,186.0,83.0,2.0,1.0,2.0,1.0,1.0,3.0,3.0,4.0,1.0,2.0,3.0,9.0,9.0,10.0,7.0,11.0,11.0,13.0,11.0,10.0,13.0,11.0,11.0,13.0,10.0,12.0,10.0,13.0,12.0,11.0,11.0,12.0,12.0,10.0,16.0,9.0,13.0,11.0,12.0,10.0,10.0,11.0,13.0,8.0,12.0,11.0,20.0,13.0,13.0,13.0,7.0,10.0,7.0,15.0,9.0,12.0,13.0,13.0,9.0,10.0,12.0,8.0,24.0,0.0,0.0,0.0,0.0,181.0,76.0,1.0,3.0,3.0,3.0,3.0,3.0,1.0,1.0,2.0,2.0,2.0,12.0,13.0,9.0,4.0,11.0,10.0,12.0,16.0,9.0,12.0,12.0,10.0,13.0,8.0,9.0,12.0,11.0,12.0,12.0,11.0,12.0,13.0,9.0,10.0,10.0,13.0,11.0,12.0,13.0,12.0,11.0,10.0,20.0,11.0,13.0,9.0,12.0,11.0,11.0,10.0,10.0,7.0,9.0,9.0,12.0,11.0,12.0,12.0,12.0,11.0,8.0,25.0,0.0,0.0,0.0,0.0,173.0,66.0,2.0,3.0,2.0,1.0,3.0,1.0,2.0,3.0,2.0,4.0,3.0,10.0,10.0,12.0,9.0,13.0,9.0,12.0,12.0,7.0,13.0,13.0,7.0,12.0,12.0,7.0,11.0,9.0,12.0,12.0,12.0,11.0,10.0,10.0,12.0,12.0,14.0,12.0,6.0,11.0,11.0,11.0,9.0,10.0,11.0,11.0,20.0,13.0,13.0,16.0,6.0,12.0,10.0,14.0,10.0,10.0,9.0,11.0,10.0,10.0,9.0,15.0,22.0,0.0,0.0,19.0,8.0,181.0,78.0,3.0,3.0,2.0,2.0,2.0,3.0,1.0,2.0,3.0,3.0,1.0,7.0,8.0,11.0,13.0,12.0,7.0,13.0,10.0,6.0,3.0,11.0,10.0,5.0,11.0,15.0,11.0,15.0,12.0,12.0,12.0,12.0,16.0,14.0,9.0,14.0,6.0,11.0,16.0,15.0,13.0,14.0,11.0,8.0,15.0,14.0,20.0,15.0,15.0,12.0,5.0,11.0,5.0,9.0,15.0,13.0,12.0,11.0,14.0,14.0,18.0,9.0,24.0,0.0,0.0,0.0,0.0,181.0,76.0,1.0,3.0,3.0,3.0,3.0,3.0,1.0,1.0,2.0,2.0,2.0,12.0,13.0,9.0,4.0,11.0,10.0,12.0,16.0,9.0,12.0,12.0,10.0,13.0,8.0,9.0,12.0,11.0,12.0,12.0,11.0,12.0,13.0,9.0,10.0,10.0,13.0,11.0,12.0,13.0,12.0,11.0,10.0,20.0,11.0,13.0,9.0,12.0,11.0,11.0,10.0,10.0,7.0,9.0,9.0,12.0,11.0,12.0,12.0,12.0,11.0,8.0,25.0,0.0,0.0,0.0,0.0,192.0,81.0,14.0,14.0,12.0,5.0,12.0,12.0,13.0,14.0,9.0,6.0,13.0,4.0,3.0,1.0,3.0,8.0,8.0,5.0,1.0,3.0,3.0,6.0,1.0,2.0,8.0,7.0,10.0,8.0,8.0,9.0,9.0,9.0,12.0,2.0,7.0,2.0,12.0,11.0,13.0,13.0,14.0,15.0,17.0,5.0,12.0,8.0,20.0,12.0,14.0,12.0,7.0,11.0,8.0,10.0,14.0,14.0,11.0,13.0,15.0,13.0,12.0,3.0,26.0,16.0,0.0,11.0,1.0,182.0,70.0,1.0,3.0,2.0,2.0,3.0,2.0,3.0,1.0,2.0,1.0,2.0,6.0,7.0,9.0,5.0,9.0,2.0,10.0,8.0,9.0,9.0,11.0,8.0,13.0,9.0,11.0,13.0,11.0,10.0,12.0,9.0,14.0,7.0,9.0,9.0,9.0,12.0,10.0,10.0,14.0,13.0,10.0,9.0,10.0,12.0,11.0,20.0,11.0,10.0,10.0,10.0,4.0,11.0,11.0,18.0,9.0,11.0,11.0,9.0,11.0,20.0,2.0,33.0,47.0,11.0,26.0,14.0,184.0,81.0,1.0,1.0,3.0,1.0,2.0,1.0,3.0,3.0,2.0,3.0,3.0,13.0,13.0,12.0,13.0,14.0,13.0,9.0,12.0,10.0,7.0,13.0,15.0,8.0,15.0,12.0,13.0,13.0,13.0,11.0,12.0,12.0,15.0,11.0,11.0,14.0,7.0,13.0,10.0,10.0,12.0,11.0,11.0,8.0,13.0,11.0,20.0,11.0,11.0,10.0,10.0,10.0,12.0,15.0,15.0,13.0,10.0,10.0,10.0,7.0,12.0,15.0,26.0,13.0,0.0,2.0,0.0,184.0,73.0,2.0,2.0,2.0,1.0,1.0,1.0,1.0,2.0,2.0,2.0,1.0,10.0,11.0,10.0,9.0,10.0,13.0,13.0,13.0,5.0,8.0,15.0,15.0,12.0,13.0,13.0,11.0,13.0,8.0,14.0,15.0,13.0,13.0,8.0,10.0,12.0,15.0,14.0,13.0,12.0,12.0,13.0,13.0,7.0,14.0,12.0,20.0,14.0,13.0,8.0,11.0,8.0,4.0,11.0,14.0,14.0,10.0,10.0,10.0,7.0,10.0,10.0,25.0,0.0,0.0,20.0,0.0,180.0,64.0,1.0,2.0,1.0,1.0,1.0,2.0,1.0,2.0,2.0,2.0,4.0,8.0,12.0,12.0,7.0,13.0,8.0,10.0,10.0,9.0,10.0,13.0,11.0,10.0,13.0,8.0,12.0,12.0,11.0,11.0,13.0,10.0,13.0,11.0,6.0,13.0,11.0,13.0,15.0,15.0,14.0,13.0,9.0,8.0,14.0,14.0,20.0,16.0,8.0,10.0,8.0,14.0,5.0,14.0,18.0,16.0,10.0,11.0,9.0,14.0,14.0,8.0,28.0,5.0,0.0,0.0,0.0,172.0,64.0,2.0,2.0,1.0,4.0,2.0,2.0,3.0,3.0,2.0,2.0,2.0,4.0,7.0,11.0,12.0,12.0,8.0,8.0,11.0,5.0,11.0,14.0,10.0,12.0,10.0,11.0,14.0,8.0,12.0,14.0,9.0,14.0,13.0,7.0,9.0,11.0,12.0,14.0,13.0,11.0,13.0,13.0,9.0,7.0,16.0,13.0,20.0,15.0,11.0,10.0,8.0,12.0,3.0,10.0,17.0,8.0,16.0,13.0,11.0,11.0,8.0,6.0,23.0,0.0,0.0,0.0,0.0,184.0,88.0,2.0,2.0,3.0,3.0,3.0,1.0,2.0,1.0,3.0,1.0,1.0,7.0,6.0,9.0,12.0,7.0,3.0,9.0,8.0,4.0,4.0,11.0,10.0,7.0,9.0,10.0,9.0,10.0,9.0,11.0,12.0,9.0,10.0,8.0,4.0,9.0,6.0,7.0,7.0,17.0,15.0,15.0,12.0,9.0,15.0,16.0,20.0,15.0,15.0,8.0,10.0,13.0,12.0,10.0,14.0,9.0,10.0,11.0,12.0,9.0,11.0,8.0,28.0,18.0,0.0,0.0,0.0,180.0,76.0,2.0,2.0,3.0,2.0,3.0,1.0,2.0,2.0,1.0,3.0,4.0,12.0,12.0,9.0,9.0,12.0,11.0,11.0,10.0,13.0,12.0,11.0,11.0,12.0,12.0,11.0,12.0,10.0,13.0,12.0,10.0,11.0,13.0,9.0,10.0,15.0,11.0,12.0,12.0,14.0,14.0,13.0,13.0,20.0,13.0,14.0,4.0,13.0,13.0,12.0,10.0,10.0,7.0,10.0,14.0,14.0,9.0,11.0,10.0,12.0,12.0,7.0,33.0,94.0,6.0,0.0,0.0,194.0,96.0,3.0,2.0,1.0,3.0,3.0,3.0,1.0,3.0,1.0,4.0,1.0,9.0,7.0,7.0,12.0,9.0,9.0,16.0,8.0,11.0,15.0,10.0,4.0,14.0,10.0,6.0,13.0,6.0,11.0,13.0,9.0,12.0,17.0,9.0,11.0,13.0,13.0,15.0,15.0,8.0,9.0,18.0,17.0,5.0,12.0,8.0,20.0,15.0,17.0,16.0,6.0,13.0,8.0,10.0,9.0,14.0,16.0,12.0,16.0,13.0,8.0,8.0,24.0,0.0,0.0,11.0,0.0,177.0,73.0,1.0,1.0,2.0,2.0,3.0,1.0,4.0,4.0,3.0,3.0,3.0,6.0,5.0,10.0,8.0,11.0,3.0,6.0,9.0,8.0,11.0,8.0,6.0,9.0,11.0,7.0,10.0,10.0,11.0,11.0,11.0,14.0,4.0,10.0,10.0,9.0,9.0,10.0,11.0,15.0,14.0,9.0,5.0,20.0,7.0,13.0,12.0,15.0,9.0,10.0,7.0,10.0,9.0,10.0,20.0,11.0,10.0,10.0,9.0,12.0,12.0,4.0,25.0,5.0,0.0,2.0,1.0,191.0,86.0,3.0,3.0,3.0,2.0,2.0,1.0,1.0,3.0,3.0,1.0,3.0,9.0,8.0,13.0,14.0,12.0,10.0,12.0,13.0,10.0,6.0,13.0,9.0,8.0,13.0,12.0,11.0,9.0,12.0,10.0,13.0,11.0,10.0,12.0,9.0,13.0,6.0,12.0,8.0,10.0,10.0,13.0,15.0,12.0,12.0,13.0,20.0,12.0,14.0,10.0,8.0,7.0,7.0,9.0,9.0,14.0,13.0,8.0,9.0,10.0,9.0,14.0
1,1,32.0,0.0,0.0,0.0,0.0,193.0,80.0,13.0,11.0,11.0,3.0,12.0,12.0,13.0,13.0,15.0,11.0,8.0,8.0,3.0,1.0,2.0,7.0,10.0,5.0,1.0,2.0,3.0,9.0,3.0,1.0,5.0,14.0,9.0,7.0,10.0,12.0,6.0,12.0,13.0,11.0,9.0,3.0,13.0,10.0,10.0,11.0,12.0,11.0,14.0,5.0,10.0,10.0,20.0,11.0,10.0,15.0,12.0,10.0,7.0,10.0,14.0,13.0,14.0,10.0,14.0,13.0,14.0,5.0,25.0,0.0,0.0,0.0,0.0,181.0,76.0,3.0,1.0,3.0,3.0,2.0,2.0,2.0,3.0,3.0,3.0,1.0,10.0,9.0,12.0,11.0,12.0,9.0,10.0,13.0,9.0,5.0,12.0,7.0,8.0,12.0,13.0,12.0,8.0,13.0,10.0,13.0,12.0,10.0,9.0,8.0,13.0,15.0,14.0,14.0,11.0,11.0,10.0,11.0,11.0,10.0,11.0,20.0,11.0,12.0,11.0,8.0,10.0,6.0,9.0,10.0,10.0,13.0,9.0,12.0,11.0,13.0,8.0,20.0,0.0,0.0,0.0,0.0,179.0,70.0,1.0,1.0,1.0,3.0,3.0,3.0,3.0,3.0,3.0,3.0,1.0,9.0,9.0,8.0,5.0,10.0,7.0,13.0,8.0,11.0,13.0,10.0,9.0,13.0,10.0,6.0,12.0,11.0,11.0,12.0,10.0,12.0,15.0,10.0,11.0,9.0,14.0,14.0,14.0,11.0,12.0,13.0,13.0,10.0,17.0,11.0,20.0,12.0,12.0,14.0,9.0,12.0,4.0,10.0,12.0,11.0,12.0,12.0,11.0,1.0,15.0,4.0,31.0,1.0,0.0,0.0,0.0,188.0,81.0,2.0,3.0,2.0,3.0,1.0,1.0,2.0,3.0,3.0,3.0,1.0,12.0,11.0,12.0,12.0,10.0,14.0,14.0,11.0,10.0,7.0,10.0,4.0,10.0,12.0,12.0,11.0,10.0,10.0,12.0,13.0,12.0,13.0,10.0,10.0,13.0,7.0,11.0,13.0,12.0,12.0,10.0,15.0,12.0,10.0,12.0,20.0,13.0,12.0,14.0,12.0,10.0,8.0,9.0,11.0,12.0,14.0,9.0,14.0,13.0,20.0,7.0,25.0,0.0,0.0,4.0,0.0,177.0,76.0,3.0,1.0,1.0,1.0,2.0,3.0,3.0,2.0,2.0,1.0,2.0,12.0,13.0,10.0,9.0,11.0,8.0,13.0,13.0,9.0,11.0,11.0,7.0,13.0,10.0,12.0,12.0,10.0,10.0,11.0,10.0,11.0,14.0,9.0,8.0,7.0,12.0,10.0,10.0,13.0,12.0,12.0,12.0,12.0,10.0,12.0,20.0,13.0,12.0,12.0,8.0,10.0,9.0,9.0,11.0,8.0,13.0,6.0,12.0,11.0,12.0,6.0,22.0,0.0,0.0,0.0,0.0,181.0,76.0,2.0,2.0,1.0,1.0,1.0,3.0,1.0,3.0,2.0,3.0,3.0,9.0,12.0,12.0,13.0,12.0,6.0,12.0,10.0,7.0,9.0,10.0,6.0,6.0,11.0,10.0,11.0,10.0,12.0,12.0,11.0,12.0,3.0,13.0,9.0,12.0,9.0,9.0,11.0,13.0,11.0,11.0,11.0,9.0,10.0,12.0,20.0,10.0,10.0,13.0,10.0,1.0,10.0,10.0,17.0,9.0,12.0,9.0,9.0,1.0,11.0,2.0,19.0,0.0,0.0,0.0,0.0,171.0,70.0,2.0,3.0,2.0,1.0,1.0,1.0,2.0,1.0,2.0,3.0,1.0,11.0,11.0,12.0,11.0,11.0,11.0,9.0,11.0,7.0,9.0,13.0,4.0,9.0,13.0,4.0,10.0,10.0,11.0,11.0,14.0,12.0,13.0,13.0,14.0,11.0,11.0,12.0,12.0,12.0,11.0,11.0,9.0,20.0,10.0,12.0,10.0,11.0,11.0,13.0,8.0,12.0,9.0,10.0,10.0,13.0,14.0,12.0,11.0,12.0,12.0,9.0,30.0,44.0,4.0,12.0,8.0,181.0,81.0,4.0,3.0,3.0,2.0,1.0,3.0,3.0,3.0,3.0,3.0,1.0,12.0,11.0,10.0,13.0,14.0,14.0,11.0,13.0,5.0,7.0,14.0,14.0,8.0,14.0,12.0,13.0,11.0,12.0,9.0,13.0,13.0,10.0,16.0,9.0,11.0,9.0,11.0,7.0,8.0,10.0,10.0,7.0,14.0,9.0,9.0,20.0,9.0,9.0,10.0,8.0,15.0,8.0,11.0,9.0,9.0,15.0,13.0,12.0,8.0,12.0,7.0,23.0,0.0,0.0,7.0,0.0,185.0,78.0,1.0,2.0,2.0,3.0,3.0,2.0,3.0,3.0,3.0,2.0,1.0,7.0,9.0,7.0,4.0,11.0,10.0,16.0,7.0,9.0,14.0,7.0,4.0,14.0,4.0,13.0,9.0,10.0,10.0,11.0,10.0,11.0,12.0,3.0,11.0,10.0,12.0,9.0,13.0,11.0,11.0,13.0,10.0,8.0,11.0,9.0,20.0,11.0,11.0,14.0,10.0,9.0,10.0,8.0,11.0,12.0,13.0,12.0,13.0,12.0,11.0,7.0,21.0,0.0,0.0,6.0,0.0,185.0,77.0,1.0,3.0,4.0,3.0,3.0,1.0,2.0,2.0,3.0,2.0,3.0,12.0,13.0,11.0,8.0,12.0,13.0,11.0,15.0,11.0,13.0,13.0,7.0,11.0,12.0,11.0,12.0,12.0,12.0,14.0,12.0,12.0,13.0,1.0,5.0,12.0,12.0,13.0,13.0,13.0,12.0,11.0,10.0,20.0,11.0,13.0,8.0,12.0,12.0,13.0,10.0,6.0,9.0,11.0,10.0,12.0,12.0,11.0,12.0,12.0,12.0,1.0,25.0,0.0,0.0,10.0,0.0,174.0,68.0,2.0,3.0,1.0,1.0,2.0,2.0,1.0,1.0,2.0,4.0,2.0,9.0,10.0,11.0,10.0,10.0,11.0,8.0,12.0,5.0,10.0,13.0,7.0,12.0,11.0,15.0,12.0,14.0,10.0,10.0,11.0,11.0,16.0,10.0,12.0,11.0,12.0,13.0,17.0,11.0,12.0,14.0,7.0,20.0,16.0,13.0,8.0,13.0,10.0,14.0,8.0,9.0,6.0,10.0,20.0,10.0,13.0,13.0,8.0,8.0,17.0,7.0,31.0,22.0,0.0,17.0,0.0,185.0,82.0,12.0,12.0,13.0,6.0,14.0,11.0,15.0,18.0,14.0,10.0,13.0,7.0,3.0,8.0,5.0,9.0,10.0,8.0,12.0,2.0,2.0,9.0,6.0,3.0,10.0,6.0,12.0,15.0,16.0,12.0,8.0,12.0,14.0,8.0,15.0,3.0,13.0,13.0,8.0,13.0,17.0,14.0,13.0,7.0,12.0,11.0,20.0,15.0,14.0,13.0,6.0,16.0,3.0,1.0,8.0,16.0,12.0,13.0,16.0,16.0,16.0,7.0,26.0,27.0,0.0,0.0,0.0,183.0,70.0,1.0,3.0,1.0,3.0,4.0,1.0,3.0,3.0,2.0,1.0,3.0,9.0,14.0,12.0,8.0,10.0,8.0,12.0,13.0,14.0,9.0,12.0,7.0,13.0,11.0,14.0,9.0,15.0,10.0,12.0,9.0,10.0,16.0,10.0,9.0,12.0,8.0,12.0,17.0,14.0,11.0,13.0,12.0,10.0,16.0,16.0,20.0,16.0,13.0,13.0,10.0,14.0,6.0,15.0,10.0,15.0,14.0,10.0,16.0,13.0,13.0,4.0,21.0,0.0,0.0,0.0,0.0,187.0,84.0,4.0,2.0,1.0,2.0,3.0,1.0,2.0,3.0,1.0,1.0,2.0,11.0,13.0,15.0,12.0,14.0,11.0,13.0,14.0,4.0,5.0,12.0,14.0,5.0,16.0,12.0,12.0,14.0,12.0,10.0,10.0,9.0,14.0,17.0,10.0,12.0,7.0,10.0,14.0,14.0,16.0,14.0,15.0,9.0,13.0,14.0,20.0,14.0,14.0,14.0,8.0,15.0,5.0,14.0,11.0,16.0,13.0,14.0,13.0,15.0,15.0,6.0,21.0,0.0,0.0,11.0,2.0,180.0,72.0,2.0,3.0,3.0,3.0,3.0,2.0,2.0,1.0,3.0,2.0,3.0,12.0,13.0,14.0,9.0,14.0,13.0,8.0,12.0,5.0,8.0,14.0,10.0,9.0,14.0,12.0,12.0,9.0,13.0,12.0,15.0,13.0,14.0,15.0,8.0,13.0,10.0,16.0,14.0,15.0,14.0,12.0,9.0,8.0,15.0,14.0,20.0,13.0,12.0,12.0,8.0,11.0,10.0,11.0,10.0,14.0,16.0,14.0,15.0,15.0,15.0,6.0,28.0,41.0,2.0,0.0,0.0,187.0,80.0,3.0,2.0,3.0,2.0,1.0,1.0,2.0,3.0,1.0,4.0,2.0,7.0,10.0,11.0,7.0,12.0,7.0,10.0,12.0,13.0,15.0,13.0,8.0,18.0,12.0,18.0,13.0,17.0,12.0,14.0,10.0,12.0,17.0,7.0,13.0,9.0,14.0,17.0,18.0,14.0,13.0,16.0,14.0,20.0,18.0,13.0,12.0,18.0,14.0,15.0,16.0,15.0,6.0,15.0,14.0,13.0,10.0,14.0,12.0,8.0,7.0,8.0,35.0,80.0,0.0,11.0,0.0,174.0,74.0,3.0,4.0,2.0,2.0,2.0,2.0,1.0,2.0,2.0,3.0,2.0,8.0,14.0,13.0,7.0,15.0,8.0,14.0,4.0,14.0,14.0,13.0,9.0,16.0,15.0,15.0,15.0,16.0,17.0,13.0,11.0,15.0,19.0,14.0,18.0,14.0,17.0,16.0,14.0,12.0,13.0,15.0,9.0,20.0,17.0,12.0,9.0,13.0,11.0,16.0,14.0,16.0,4.0,10.0,18.0,14.0,17.0,17.0,14.0,14.0,14.0,12.0,26.0,0.0,0.0,0.0,0.0,183.0,76.0,2.0,2.0,1.0,1.0,1.0,2.0,3.0,1.0,3.0,1.0,1.0,13.0,12.0,12.0,7.0,14.0,14.0,12.0,14.0,5.0,10.0,14.0,12.0,10.0,14.0,6.0,13.0,14.0,13.0,13.0,13.0,12.0,15.0,10.0,13.0,12.0,12.0,13.0,14.0,11.0,13.0,14.0,9.0,12.0,11.0,12.0,20.0,14.0,13.0,13.0,7.0,13.0,8.0,15.0,18.0,14.0,12.0,11.0,14.0,13.0,13.0,6.0,30.0,32.0,1.0,0.0,0.0,190.0,88.0,1.0,2.0,2.0,2.0,3.0,1.0,1.0,3.0,3.0,2.0,2.0,5.0,7.0,9.0,8.0,10.0,7.0,16.0,11.0,9.0,15.0,13.0,5.0,16.0,12.0,17.0,16.0,17.0,13.0,13.0,11.0,12.0,16.0,7.0,14.0,10.0,14.0,15.0,15.0,14.0,12.0,17.0,16.0,9.0,15.0,14.0,20.0,16.0,18.0,15.0,15.0,14.0,10.0,12.0,14.0,15.0,12.0,14.0,12.0,13.0,11.0,15.0,23.0,0.0,0.0,10.0,7.0,179.0,70.0,1.0,1.0,2.0,2.0,1.0,3.0,3.0,2.0,1.0,4.0,3.0,10.0,13.0,14.0,12.0,15.0,11.0,10.0,13.0,6.0,3.0,13.0,12.0,4.0,16.0,11.0,12.0,11.0,13.0,11.0,13.0,12.0,12.0,16.0,6.0,14.0,6.0,10.0,12.0,16.0,14.0,12.0,9.0,20.0,13.0,14.0,10.0,13.0,10.0,12.0,7.0,12.0,6.0,8.0,12.0,13.0,5.0,10.0,8.0,14.0,12.0,8.0,18.0,0.0,0.0,0.0,0.0,167.0,60.0,2.0,1.0,2.0,2.0,2.0,1.0,2.0,1.0,1.0,1.0,1.0,10.0,11.0,12.0,8.0,13.0,10.0,3.0,10.0,5.0,6.0,13.0,12.0,8.0,15.0,8.0,11.0,8.0,12.0,11.0,13.0,12.0,13.0,12.0,6.0,11.0,11.0,12.0,13.0,15.0,14.0,8.0,5.0,8.0,15.0,12.0,20.0,12.0,7.0,8.0,8.0,14.0,7.0,8.0,18.0,11.0,12.0,11.0,12.0,15.0,15.0,7.0,26.0,0.0,0.0,4.0,0.0,180.0,73.0,2.0,3.0,1.0,4.0,2.0,3.0,3.0,1.0,1.0,4.0,1.0,11.0,13.0,13.0,14.0,14.0,11.0,15.0,12.0,3.0,7.0,14.0,14.0,8.0,13.0,12.0,14.0,17.0,13.0,15.0,14.0,14.0,16.0,12.0,15.0,16.0,12.0,18.0,16.0,13.0,14.0,13.0,12.0,8.0,14.0,13.0,20.0,15.0,12.0,15.0,8.0,14.0,7.0,15.0,19.0,14.0,17.0,14.0,18.0,16.0,16.0,5.0
3,0,31.0,22.0,0.0,17.0,0.0,185.0,82.0,12.0,12.0,13.0,6.0,14.0,11.0,15.0,18.0,14.0,10.0,13.0,7.0,3.0,8.0,5.0,9.0,10.0,8.0,12.0,2.0,2.0,9.0,6.0,3.0,10.0,6.0,12.0,15.0,16.0,12.0,8.0,12.0,14.0,8.0,15.0,3.0,13.0,13.0,8.0,13.0,17.0,14.0,13.0,7.0,12.0,11.0,20.0,15.0,14.0,13.0,6.0,16.0,3.0,1.0,8.0,16.0,12.0,13.0,16.0,16.0,16.0,7.0,26.0,27.0,0.0,0.0,0.0,183.0,70.0,1.0,3.0,1.0,3.0,4.0,1.0,3.0,3.0,2.0,1.0,3.0,9.0,14.0,12.0,8.0,10.0,8.0,12.0,13.0,14.0,9.0,12.0,7.0,13.0,11.0,14.0,9.0,15.0,10.0,12.0,9.0,10.0,16.0,10.0,9.0,12.0,8.0,12.0,17.0,14.0,11.0,13.0,12.0,10.0,16.0,16.0,20.0,16.0,13.0,13.0,10.0,14.0,6.0,15.0,10.0,15.0,14.0,10.0,16.0,13.0,13.0,4.0,21.0,0.0,0.0,0.0,0.0,187.0,84.0,4.0,2.0,1.0,2.0,3.0,1.0,2.0,3.0,1.0,1.0,2.0,11.0,13.0,15.0,12.0,14.0,11.0,13.0,14.0,4.0,5.0,12.0,14.0,5.0,16.0,12.0,12.0,14.0,12.0,10.0,10.0,9.0,14.0,17.0,10.0,12.0,7.0,10.0,14.0,14.0,16.0,14.0,15.0,9.0,13.0,14.0,20.0,14.0,14.0,14.0,8.0,15.0,5.0,14.0,11.0,16.0,13.0,14.0,13.0,15.0,15.0,6.0,30.0,19.0,0.0,7.0,0.0,189.0,77.0,3.0,2.0,3.0,2.0,3.0,3.0,1.0,3.0,3.0,1.0,2.0,5.0,8.0,7.0,10.0,10.0,9.0,15.0,9.0,8.0,14.0,12.0,10.0,15.0,10.0,15.0,14.0,13.0,13.0,14.0,10.0,12.0,14.0,10.0,14.0,11.0,12.0,14.0,14.0,8.0,10.0,12.0,16.0,10.0,16.0,10.0,20.0,13.0,16.0,13.0,11.0,13.0,7.0,10.0,6.0,14.0,12.0,13.0,14.0,13.0,13.0,7.0,21.0,0.0,0.0,11.0,2.0,180.0,72.0,2.0,3.0,3.0,3.0,3.0,2.0,2.0,1.0,3.0,2.0,3.0,12.0,13.0,14.0,9.0,14.0,13.0,8.0,12.0,5.0,8.0,14.0,10.0,9.0,14.0,12.0,12.0,9.0,13.0,12.0,15.0,13.0,14.0,15.0,8.0,13.0,10.0,16.0,14.0,15.0,14.0,12.0,9.0,8.0,15.0,14.0,20.0,13.0,12.0,12.0,8.0,11.0,10.0,11.0,10.0,14.0,16.0,14.0,15.0,15.0,15.0,6.0,28.0,41.0,2.0,0.0,0.0,187.0,80.0,3.0,2.0,3.0,2.0,1.0,1.0,2.0,3.0,1.0,4.0,2.0,7.0,10.0,11.0,7.0,12.0,7.0,10.0,12.0,13.0,15.0,13.0,8.0,18.0,12.0,18.0,13.0,17.0,12.0,14.0,10.0,12.0,17.0,7.0,13.0,9.0,14.0,17.0,18.0,14.0,13.0,16.0,14.0,20.0,18.0,13.0,12.0,18.0,14.0,15.0,16.0,15.0,6.0,15.0,14.0,13.0,10.0,14.0,12.0,8.0,7.0,8.0,35.0,80.0,0.0,11.0,0.0,174.0,74.0,3.0,4.0,2.0,2.0,2.0,2.0,1.0,2.0,2.0,3.0,2.0,8.0,14.0,13.0,7.0,15.0,8.0,14.0,4.0,14.0,14.0,13.0,9.0,16.0,15.0,15.0,15.0,16.0,17.0,13.0,11.0,15.0,19.0,14.0,18.0,14.0,17.0,16.0,14.0,12.0,13.0,15.0,9.0,20.0,17.0,12.0,9.0,13.0,11.0,16.0,14.0,16.0,4.0,10.0,18.0,14.0,17.0,17.0,14.0,14.0,14.0,12.0,30.0,32.0,1.0,0.0,0.0,190.0,88.0,1.0,2.0,2.0,2.0,3.0,1.0,1.0,3.0,3.0,2.0,2.0,5.0,7.0,9.0,8.0,10.0,7.0,16.0,11.0,9.0,15.0,13.0,5.0,16.0,12.0,17.0,16.0,17.0,13.0,13.0,11.0,12.0,16.0,7.0,14.0,10.0,14.0,15.0,15.0,14.0,12.0,17.0,16.0,9.0,15.0,14.0,20.0,16.0,18.0,15.0,15.0,14.0,10.0,12.0,14.0,15.0,12.0,14.0,12.0,13.0,11.0,15.0,23.0,0.0,0.0,10.0,7.0,179.0,70.0,1.0,1.0,2.0,2.0,1.0,3.0,3.0,2.0,1.0,4.0,3.0,10.0,13.0,14.0,12.0,15.0,11.0,10.0,13.0,6.0,3.0,13.0,12.0,4.0,16.0,11.0,12.0,11.0,13.0,11.0,13.0,12.0,12.0,16.0,6.0,14.0,6.0,10.0,12.0,16.0,14.0,12.0,9.0,20.0,13.0,14.0,10.0,13.0,10.0,12.0,7.0,12.0,6.0,8.0,12.0,13.0,5.0,10.0,8.0,14.0,12.0,8.0,18.0,0.0,0.0,0.0,0.0,167.0,60.0,2.0,1.0,2.0,2.0,2.0,1.0,2.0,1.0,1.0,1.0,1.0,10.0,11.0,12.0,8.0,13.0,10.0,3.0,10.0,5.0,6.0,13.0,12.0,8.0,15.0,8.0,11.0,8.0,12.0,11.0,13.0,12.0,13.0,12.0,6.0,11.0,11.0,12.0,13.0,15.0,14.0,8.0,5.0,8.0,15.0,12.0,20.0,12.0,7.0,8.0,8.0,14.0,7.0,8.0,18.0,11.0,12.0,11.0,12.0,15.0,15.0,7.0,26.0,0.0,0.0,4.0,0.0,180.0,73.0,2.0,3.0,1.0,4.0,2.0,3.0,3.0,1.0,1.0,4.0,1.0,11.0,13.0,13.0,14.0,14.0,11.0,15.0,12.0,3.0,7.0,14.0,14.0,8.0,13.0,12.0,14.0,17.0,13.0,15.0,14.0,14.0,16.0,12.0,15.0,16.0,12.0,18.0,16.0,13.0,14.0,13.0,12.0,8.0,14.0,13.0,20.0,15.0,12.0,15.0,8.0,14.0,7.0,15.0,19.0,14.0,17.0,14.0,18.0,16.0,16.0,5.0,32.0,0.0,0.0,0.0,0.0,193.0,80.0,13.0,11.0,11.0,3.0,12.0,12.0,13.0,13.0,15.0,11.0,8.0,8.0,3.0,1.0,2.0,7.0,10.0,5.0,1.0,2.0,3.0,9.0,3.0,1.0,5.0,14.0,9.0,7.0,10.0,12.0,6.0,12.0,13.0,11.0,9.0,3.0,13.0,10.0,10.0,11.0,12.0,11.0,14.0,5.0,10.0,10.0,20.0,11.0,10.0,15.0,12.0,10.0,7.0,10.0,14.0,13.0,14.0,10.0,14.0,13.0,14.0,5.0,25.0,0.0,0.0,0.0,0.0,181.0,76.0,3.0,1.0,3.0,3.0,2.0,2.0,2.0,3.0,3.0,3.0,1.0,10.0,9.0,12.0,11.0,12.0,9.0,10.0,13.0,9.0,5.0,12.0,7.0,8.0,12.0,13.0,12.0,8.0,13.0,10.0,13.0,12.0,10.0,9.0,8.0,13.0,15.0,14.0,14.0,11.0,11.0,10.0,11.0,11.0,10.0,11.0,20.0,11.0,12.0,11.0,8.0,10.0,6.0,9.0,10.0,10.0,13.0,9.0,12.0,11.0,13.0,8.0,20.0,0.0,0.0,0.0,0.0,179.0,70.0,1.0,1.0,1.0,3.0,3.0,3.0,3.0,3.0,3.0,3.0,1.0,9.0,9.0,8.0,5.0,10.0,7.0,13.0,8.0,11.0,13.0,10.0,9.0,13.0,10.0,6.0,12.0,11.0,11.0,12.0,10.0,12.0,15.0,10.0,11.0,9.0,14.0,14.0,14.0,11.0,12.0,13.0,13.0,10.0,17.0,11.0,20.0,12.0,12.0,14.0,9.0,12.0,4.0,10.0,12.0,11.0,12.0,12.0,11.0,1.0,15.0,4.0,31.0,1.0,0.0,0.0,0.0,188.0,81.0,2.0,3.0,2.0,3.0,1.0,1.0,2.0,3.0,3.0,3.0,1.0,12.0,11.0,12.0,12.0,10.0,14.0,14.0,11.0,10.0,7.0,10.0,4.0,10.0,12.0,12.0,11.0,10.0,10.0,12.0,13.0,12.0,13.0,10.0,10.0,13.0,7.0,11.0,13.0,12.0,12.0,10.0,15.0,12.0,10.0,12.0,20.0,13.0,12.0,14.0,12.0,10.0,8.0,9.0,11.0,12.0,14.0,9.0,14.0,13.0,20.0,7.0,25.0,0.0,0.0,4.0,0.0,177.0,76.0,3.0,1.0,1.0,1.0,2.0,3.0,3.0,2.0,2.0,1.0,2.0,12.0,13.0,10.0,9.0,11.0,8.0,13.0,13.0,9.0,11.0,11.0,7.0,13.0,10.0,12.0,12.0,10.0,10.0,11.0,10.0,11.0,14.0,9.0,8.0,7.0,12.0,10.0,10.0,13.0,12.0,12.0,12.0,12.0,10.0,12.0,20.0,13.0,12.0,12.0,8.0,10.0,9.0,9.0,11.0,8.0,13.0,6.0,12.0,11.0,12.0,6.0,22.0,0.0,0.0,0.0,0.0,181.0,76.0,2.0,2.0,1.0,1.0,1.0,3.0,1.0,3.0,2.0,3.0,3.0,9.0,12.0,12.0,13.0,12.0,6.0,12.0,10.0,7.0,9.0,10.0,6.0,6.0,11.0,10.0,11.0,10.0,12.0,12.0,11.0,12.0,3.0,13.0,9.0,12.0,9.0,9.0,11.0,13.0,11.0,11.0,11.0,9.0,10.0,12.0,20.0,10.0,10.0,13.0,10.0,1.0,10.0,10.0,17.0,9.0,12.0,9.0,9.0,1.0,11.0,2.0,19.0,0.0,0.0,0.0,0.0,171.0,70.0,2.0,3.0,2.0,1.0,1.0,1.0,2.0,1.0,2.0,3.0,1.0,11.0,11.0,12.0,11.0,11.0,11.0,9.0,11.0,7.0,9.0,13.0,4.0,9.0,13.0,4.0,10.0,10.0,11.0,11.0,14.0,12.0,13.0,13.0,14.0,11.0,11.0,12.0,12.0,12.0,11.0,11.0,9.0,20.0,10.0,12.0,10.0,11.0,11.0,13.0,8.0,12.0,9.0,10.0,10.0,13.0,14.0,12.0,11.0,12.0,12.0,9.0,30.0,44.0,4.0,12.0,8.0,181.0,81.0,4.0,3.0,3.0,2.0,1.0,3.0,3.0,3.0,3.0,3.0,1.0,12.0,11.0,10.0,13.0,14.0,14.0,11.0,13.0,5.0,7.0,14.0,14.0,8.0,14.0,12.0,13.0,11.0,12.0,9.0,13.0,13.0,10.0,16.0,9.0,11.0,9.0,11.0,7.0,8.0,10.0,10.0,7.0,14.0,9.0,9.0,20.0,9.0,9.0,10.0,8.0,15.0,8.0,11.0,9.0,9.0,15.0,13.0,12.0,8.0,12.0,7.0,23.0,0.0,0.0,7.0,0.0,185.0,78.0,1.0,2.0,2.0,3.0,3.0,2.0,3.0,3.0,3.0,2.0,1.0,7.0,9.0,7.0,4.0,11.0,10.0,16.0,7.0,9.0,14.0,7.0,4.0,14.0,4.0,13.0,9.0,10.0,10.0,11.0,10.0,11.0,12.0,3.0,11.0,10.0,12.0,9.0,13.0,11.0,11.0,13.0,10.0,8.0,11.0,9.0,20.0,11.0,11.0,14.0,10.0,9.0,10.0,8.0,11.0,12.0,13.0,12.0,13.0,12.0,11.0,7.0,21.0,0.0,0.0,6.0,0.0,185.0,77.0,1.0,3.0,4.0,3.0,3.0,1.0,2.0,2.0,3.0,2.0,3.0,12.0,13.0,11.0,8.0,12.0,13.0,11.0,15.0,11.0,13.0,13.0,7.0,11.0,12.0,11.0,12.0,12.0,12.0,14.0,12.0,12.0,13.0,1.0,5.0,12.0,12.0,13.0,13.0,13.0,12.0,11.0,10.0,20.0,11.0,13.0,8.0,12.0,12.0,13.0,10.0,6.0,9.0,11.0,10.0,12.0,12.0,11.0,12.0,12.0,12.0,1.0,25.0,0.0,0.0,10.0,0.0,174.0,68.0,2.0,3.0,1.0,1.0,2.0,2.0,1.0,1.0,2.0,4.0,2.0,9.0,10.0,11.0,10.0,10.0,11.0,8.0,12.0,5.0,10.0,13.0,7.0,12.0,11.0,15.0,12.0,14.0,10.0,10.0,11.0,11.0,16.0,10.0,12.0,11.0,12.0,13.0,17.0,11.0,12.0,14.0,7.0,20.0,16.0,13.0,8.0,13.0,10.0,14.0,8.0,9.0,6.0,10.0,20.0,10.0,13.0,13.0,8.0,8.0,17.0,7.0
3,1,16.0,0.0,0.0,0.0,0.0,172.0,0.0,2.0,1.0,2.0,3.0,2.0,1.0,2.0,1.0,2.0,3.0,3.0,5.0,3.0,5.0,5.0,8.0,4.0,4.0,8.0,3.0,6.0,10.0,3.0,7.0,6.0,5.0,10.0,9.0,9.0,6.0,7.0,10.0,8.0,4.0,5.0,6.0,8.0,12.0,7.0,7.0,7.0,11.0,7.0,9.0,14.0,9.0,20.0,8.0,6.0,7.0,7.0,15.0,6.0,15.0,6.0,3.0,11.0,12.0,8.0,14.0,13.0,1.0,31.0,104.0,4.0,3.0,0.0,198.0,90.0,1.0,2.0,2.0,2.0,2.0,1.0,1.0,3.0,1.0,1.0,2.0,3.0,3.0,5.0,6.0,13.0,3.0,16.0,3.0,5.0,18.0,11.0,5.0,18.0,9.0,8.0,19.0,12.0,19.0,17.0,9.0,17.0,14.0,4.0,15.0,4.0,18.0,19.0,10.0,7.0,4.0,15.0,20.0,9.0,14.0,9.0,20.0,14.0,16.0,17.0,4.0,15.0,8.0,1.0,16.0,10.0,16.0,17.0,19.0,19.0,20.0,1.0,27.0,91.0,31.0,12.0,2.0,169.0,70.0,3.0,1.0,2.0,3.0,2.0,3.0,2.0,3.0,2.0,1.0,1.0,12.0,13.0,17.0,16.0,14.0,14.0,14.0,14.0,2.0,7.0,15.0,12.0,11.0,17.0,16.0,14.0,19.0,14.0,14.0,16.0,14.0,19.0,18.0,10.0,17.0,7.0,15.0,19.0,17.0,16.0,16.0,9.0,8.0,16.0,16.0,20.0,16.0,11.0,16.0,8.0,15.0,10.0,14.0,18.0,14.0,14.0,17.0,17.0,15.0,18.0,4.0,29.0,55.0,20.0,0.0,0.0,192.0,88.0,1.0,3.0,1.0,2.0,3.0,2.0,1.0,3.0,2.0,2.0,2.0,4.0,8.0,12.0,16.0,14.0,12.0,18.0,14.0,3.0,8.0,11.0,14.0,7.0,15.0,14.0,16.0,17.0,14.0,14.0,14.0,14.0,16.0,13.0,9.0,16.0,9.0,19.0,18.0,11.0,10.0,19.0,17.0,20.0,15.0,13.0,10.0,15.0,19.0,15.0,10.0,16.0,8.0,3.0,15.0,14.0,14.0,15.0,16.0,14.0,14.0,8.0,27.0,43.0,8.0,21.0,6.0,176.0,71.0,3.0,1.0,3.0,3.0,1.0,1.0,1.0,3.0,1.0,1.0,1.0,13.0,11.0,14.0,14.0,12.0,10.0,5.0,7.0,3.0,6.0,12.0,10.0,7.0,13.0,9.0,12.0,10.0,13.0,12.0,11.0,12.0,13.0,13.0,3.0,14.0,8.0,13.0,14.0,19.0,16.0,12.0,7.0,9.0,13.0,18.0,20.0,14.0,9.0,12.0,4.0,13.0,13.0,14.0,12.0,17.0,15.0,11.0,15.0,18.0,17.0,7.0,20.0,0.0,0.0,2.0,0.0,188.0,83.0,1.0,3.0,1.0,4.0,3.0,1.0,1.0,2.0,3.0,2.0,2.0,5.0,8.0,10.0,5.0,12.0,9.0,14.0,5.0,11.0,13.0,12.0,5.0,14.0,12.0,12.0,12.0,14.0,15.0,14.0,13.0,12.0,9.0,10.0,11.0,5.0,14.0,15.0,15.0,12.0,12.0,13.0,14.0,8.0,14.0,13.0,20.0,14.0,13.0,13.0,5.0,12.0,4.0,10.0,17.0,9.0,10.0,8.0,12.0,13.0,19.0,1.0,20.0,4.0,0.0,0.0,0.0,183.0,75.0,2.0,2.0,2.0,2.0,1.0,1.0,2.0,1.0,2.0,4.0,1.0,7.0,11.0,15.0,12.0,13.0,7.0,11.0,11.0,4.0,7.0,13.0,12.0,8.0,15.0,12.0,12.0,13.0,12.0,11.0,13.0,12.0,16.0,15.0,9.0,14.0,5.0,16.0,15.0,14.0,14.0,14.0,12.0,11.0,14.0,15.0,20.0,15.0,13.0,12.0,8.0,13.0,7.0,15.0,14.0,13.0,12.0,13.0,15.0,14.0,15.0,7.0,30.0,16.0,0.0,9.0,0.0,178.0,72.0,1.0,3.0,3.0,2.0,3.0,3.0,3.0,1.0,3.0,1.0,1.0,7.0,12.0,12.0,7.0,12.0,7.0,15.0,7.0,14.0,16.0,13.0,7.0,16.0,13.0,14.0,15.0,15.0,15.0,16.0,10.0,15.0,15.0,6.0,8.0,12.0,15.0,16.0,15.0,14.0,13.0,14.0,12.0,20.0,14.0,14.0,8.0,16.0,12.0,16.0,10.0,18.0,9.0,8.0,15.0,12.0,14.0,14.0,16.0,14.0,16.0,6.0,21.0,3.0,0.0,0.0,0.0,177.0,72.0,3.0,2.0,3.0,1.0,3.0,3.0,1.0,1.0,3.0,1.0,2.0,8.0,13.0,13.0,9.0,12.0,5.0,10.0,11.0,12.0,13.0,11.0,8.0,15.0,14.0,12.0,12.0,15.0,13.0,13.0,10.0,12.0,15.0,12.0,4.0,14.0,13.0,14.0,16.0,20.0,15.0,13.0,9.0,8.0,16.0,20.0,20.0,16.0,9.0,17.0,8.0,15.0,5.0,14.0,15.0,15.0,14.0,15.0,15.0,15.0,15.0,5.0,18.0,0.0,0.0,0.0,0.0,177.0,0.0,1.0,1.0,2.0,2.0,1.0,1.0,1.0,3.0,2.0,2.0,3.0,12.0,9.0,12.0,7.0,13.0,8.0,6.0,12.0,6.0,8.0,13.0,5.0,11.0,12.0,10.0,13.0,7.0,12.0,9.0,12.0,10.0,14.0,15.0,7.0,12.0,10.0,12.0,14.0,15.0,13.0,13.0,8.0,9.0,13.0,13.0,20.0,13.0,11.0,10.0,9.0,11.0,7.0,13.0,15.0,15.0,9.0,8.0,6.0,11.0,12.0,12.0,23.0,37.0,2.0,5.0,1.0,180.0,77.0,2.0,2.0,3.0,3.0,4.0,2.0,1.0,3.0,4.0,2.0,3.0,8.0,7.0,11.0,6.0,14.0,8.0,12.0,14.0,8.0,13.0,14.0,14.0,15.0,15.0,12.0,14.0,14.0,16.0,15.0,13.0,14.0,14.0,8.0,11.0,10.0,13.0,17.0,18.0,12.0,12.0,15.0,13.0,8.0,18.0,13.0,20.0,18.0,15.0,13.0,8.0,12.0,6.0,8.0,14.0,14.0,14.0,15.0,15.0,14.0,18.0,4.0,23.0,0.0,0.0,4.0,0.0,192.0,90.0,12.0,11.0,10.0,10.0,14.0,13.0,16.0,16.0,13.0,12.0,15.0,7.0,3.0,3.0,1.0,11.0,9.0,7.0,2.0,3.0,1.0,10.0,4.0,2.0,10.0,10.0,16.0,12.0,17.0,15.0,8.0,14.0,14.0,1.0,10.0,1.0,15.0,13.0,10.0,13.0,14.0,15.0,15.0,20.0,17.0,10.0,8.0,11.0,16.0,17.0,5.0,15.0,10.0,12.0,10.0,15.0,13.0,14.0,17.0,15.0,18.0,5.0,22.0,0.0,0.0,8.0,1.0,190.0,85.0,1.0,4.0,2.0,2.0,2.0,3.0,1.0,2.0,3.0,4.0,4.0,5.0,10.0,7.0,5.0,11.0,6.0,12.0,6.0,13.0,15.0,13.0,9.0,15.0,11.0,10.0,13.0,13.0,15.0,13.0,12.0,15.0,10.0,5.0,10.0,7.0,14.0,16.0,10.0,10.0,8.0,16.0,15.0,20.0,12.0,15.0,9.0,13.0,15.0,13.0,6.0,13.0,5.0,9.0,7.0,13.0,13.0,11.0,14.0,15.0,17.0,5.0,26.0,0.0,0.0,0.0,0.0,186.0,78.0,2.0,2.0,3.0,3.0,2.0,1.0,2.0,1.0,1.0,1.0,2.0,9.0,11.0,9.0,10.0,12.0,11.0,10.0,14.0,10.0,12.0,13.0,15.0,12.0,13.0,16.0,14.0,17.0,15.0,12.0,10.0,14.0,11.0,9.0,10.0,9.0,11.0,17.0,16.0,11.0,12.0,15.0,11.0,15.0,14.0,11.0,20.0,15.0,13.0,14.0,12.0,14.0,11.0,17.0,7.0,14.0,12.0,14.0,13.0,14.0,16.0,6.0,25.0,0.0,0.0,0.0,0.0,179.0,70.0,3.0,1.0,2.0,2.0,1.0,2.0,3.0,3.0,2.0,2.0,1.0,6.0,9.0,13.0,13.0,11.0,7.0,14.0,10.0,5.0,6.0,10.0,11.0,6.0,12.0,12.0,15.0,10.0,14.0,12.0,11.0,10.0,11.0,13.0,7.0,14.0,8.0,12.0,14.0,16.0,15.0,10.0,10.0,10.0,12.0,13.0,20.0,13.0,9.0,11.0,6.0,11.0,3.0,13.0,10.0,15.0,7.0,9.0,12.0,12.0,10.0,7.0,26.0,20.0,1.0,0.0,0.0,185.0,75.0,1.0,1.0,1.0,3.0,2.0,3.0,1.0,1.0,1.0,2.0,1.0,11.0,12.0,11.0,8.0,12.0,10.0,8.0,10.0,14.0,10.0,13.0,11.0,15.0,12.0,12.0,16.0,12.0,16.0,16.0,12.0,15.0,12.0,9.0,10.0,13.0,13.0,18.0,14.0,12.0,10.0,13.0,11.0,20.0,18.0,15.0,12.0,16.0,11.0,17.0,6.0,17.0,5.0,16.0,7.0,10.0,16.0,15.0,17.0,17.0,19.0,3.0,23.0,0.0,0.0,17.0,6.0,188.0,85.0,3.0,3.0,1.0,1.0,3.0,3.0,2.0,2.0,4.0,4.0,1.0,7.0,9.0,13.0,11.0,14.0,8.0,12.0,9.0,5.0,6.0,10.0,11.0,7.0,12.0,17.0,11.0,18.0,9.0,10.0,12.0,13.0,15.0,13.0,9.0,15.0,7.0,15.0,17.0,14.0,13.0,18.0,16.0,12.0,14.0,17.0,20.0,15.0,16.0,11.0,9.0,11.0,5.0,5.0,12.0,15.0,10.0,11.0,12.0,9.0,7.0,10.0,22.0,0.0,0.0,20.0,3.0,171.0,60.0,1.0,2.0,1.0,3.0,2.0,3.0,1.0,1.0,3.0,3.0,2.0,13.0,14.0,15.0,12.0,13.0,10.0,8.0,11.0,5.0,7.0,12.0,10.0,8.0,13.0,16.0,10.0,14.0,10.0,10.0,12.0,10.0,15.0,15.0,7.0,13.0,7.0,12.0,15.0,16.0,16.0,10.0,6.0,14.0,14.0,15.0,20.0,12.0,6.0,11.0,9.0,12.0,6.0,17.0,11.0,16.0,10.0,12.0,13.0,10.0,8.0,9.0,19.0,0.0,0.0,1.0,0.0,182.0,77.0,2.0,4.0,2.0,3.0,1.0,1.0,3.0,1.0,1.0,2.0,3.0,6.0,7.0,11.0,7.0,12.0,7.0,13.0,7.0,8.0,15.0,14.0,6.0,14.0,14.0,8.0,14.0,13.0,14.0,13.0,12.0,12.0,12.0,12.0,14.0,11.0,14.0,15.0,16.0,12.0,14.0,9.0,9.0,11.0,16.0,13.0,20.0,17.0,16.0,15.0,12.0,14.0,5.0,4.0,19.0,10.0,10.0,11.0,12.0,11.0,14.0,3.0,20.0,0.0,0.0,0.0,0.0,184.0,73.0,2.0,3.0,3.0,1.0,2.0,2.0,1.0,1.0,2.0,3.0,1.0,7.0,11.0,10.0,9.0,9.0,7.0,12.0,9.0,13.0,12.0,10.0,9.0,13.0,10.0,13.0,9.0,13.0,10.0,10.0,9.0,9.0,12.0,7.0,8.0,10.0,10.0,15.0,12.0,15.0,10.0,13.0,13.0,10.0,12.0,14.0,20.0,12.0,11.0,14.0,8.0,13.0,7.0,15.0,8.0,13.0,13.0,12.0,14.0,16.0,14.0,5.0,33.0,0.0,0.0,16.0,2.0,179.0,75.0,2.0,2.0,2.0,2.0,3.0,4.0,1.0,2.0,3.0,2.0,2.0,10.0,8.0,8.0,10.0,9.0,12.0,11.0,14.0,13.0,13.0,12.0,15.0,16.0,10.0,16.0,14.0,18.0,13.0,17.0,9.0,12.0,13.0,7.0,15.0,10.0,13.0,18.0,16.0,9.0,11.0,14.0,10.0,12.0,15.0,11.0,20.0,15.0,13.0,14.0,10.0,14.0,8.0,13.0,6.0,12.0,13.0,15.0,17.0,12.0,12.0,8.0,26.0,0.0,0.0,8.0,1.0,182.0,76.0,3.0,1.0,2.0,1.0,3.0,1.0,3.0,1.0,3.0,3.0,2.0,16.0,14.0,10.0,12.0,9.0,15.0,10.0,13.0,15.0,8.0,11.0,12.0,10.0,10.0,14.0,8.0,14.0,8.0,12.0,10.0,9.0,13.0,11.0,10.0,14.0,8.0,13.0,16.0,13.0,11.0,14.0,11.0,20.0,17.0,16.0,12.0,15.0,12.0,11.0,8.0,13.0,7.0,14.0,8.0,12.0,14.0,10.0,17.0,15.0,17.0,3.0
3,0,28.0,0.0,0.0,0.0,0.0,184.0,76.0,10.0,12.0,12.0,7.0,11.0,12.0,12.0,13.0,12.0,12.0,12.0,2.0,4.0,3.0,2.0,10.0,3.0,10.0,2.0,2.0,5.0,12.0,3.0,5.0,10.0,10.0,12.0,13.0,12.0,14.0,10.0,12.0,12.0,2.0,7.0,5.0,13.0,12.0,10.0,12.0,13.0,13.0,13.0,5.0,14.0,10.0,20.0,15.0,14.0,12.0,3.0,11.0,3.0,1.0,12.0,10.0,12.0,15.0,14.0,14.0,12.0,5.0,24.0,1.0,0.0,10.0,1.0,177.0,79.0,2.0,3.0,1.0,2.0,3.0,1.0,1.0,2.0,3.0,2.0,4.0,8.0,16.0,13.0,8.0,11.0,12.0,12.0,15.0,11.0,12.0,14.0,12.0,13.0,12.0,9.0,11.0,13.0,11.0,10.0,13.0,12.0,14.0,11.0,14.0,14.0,12.0,15.0,15.0,13.0,12.0,10.0,11.0,5.0,12.0,13.0,20.0,13.0,12.0,12.0,4.0,12.0,5.0,11.0,10.0,11.0,14.0,12.0,14.0,12.0,12.0,11.0,21.0,0.0,0.0,9.0,2.0,185.0,77.0,2.0,2.0,2.0,2.0,2.0,2.0,2.0,2.0,2.0,2.0,2.0,7.0,9.0,8.0,7.0,9.0,8.0,15.0,8.0,10.0,14.0,10.0,9.0,14.0,10.0,13.0,10.0,14.0,10.0,11.0,9.0,11.0,11.0,8.0,10.0,9.0,12.0,15.0,15.0,10.0,10.0,11.0,13.0,6.0,14.0,11.0,20.0,13.0,14.0,10.0,8.0,10.0,4.0,10.0,10.0,9.0,12.0,11.0,11.0,12.0,12.0,13.0,31.0,34.0,1.0,0.0,0.0,180.0,78.0,1.0,3.0,4.0,1.0,1.0,2.0,2.0,3.0,2.0,2.0,2.0,11.0,9.0,10.0,8.0,11.0,11.0,13.0,12.0,9.0,14.0,12.0,9.0,14.0,10.0,11.0,13.0,14.0,14.0,14.0,12.0,14.0,15.0,10.0,17.0,12.0,15.0,14.0,13.0,11.0,12.0,15.0,12.0,5.0,12.0,12.0,20.0,12.0,12.0,14.0,9.0,13.0,8.0,11.0,11.0,15.0,11.0,14.0,14.0,13.0,14.0,5.0,19.0,0.0,0.0,2.0,0.0,188.0,81.0,2.0,3.0,1.0,3.0,3.0,3.0,3.0,2.0,3.0,1.0,2.0,7.0,9.0,11.0,9.0,11.0,9.0,12.0,11.0,7.0,12.0,13.0,8.0,12.0,12.0,12.0,12.0,14.0,11.0,12.0,11.0,11.0,15.0,10.0,12.0,12.0,12.0,14.0,14.0,12.0,12.0,12.0,12.0,5.0,13.0,12.0,20.0,13.0,11.0,10.0,10.0,9.0,8.0,12.0,16.0,15.0,14.0,13.0,15.0,11.0,17.0,6.0,25.0,6.0,1.0,5.0,3.0,187.0,77.0,1.0,3.0,1.0,2.0,1.0,3.0,2.0,3.0,2.0,2.0,3.0,10.0,12.0,12.0,14.0,14.0,11.0,12.0,12.0,5.0,5.0,12.0,11.0,7.0,14.0,14.0,13.0,13.0,13.0,13.0,12.0,12.0,15.0,15.0,12.0,14.0,8.0,11.0,10.0,13.0,13.0,15.0,14.0,20.0,14.0,14.0,5.0,14.0,15.0,14.0,10.0,13.0,10.0,8.0,13.0,17.0,9.0,14.0,13.0,12.0,14.0,16.0,27.0,6.0,2.0,0.0,0.0,186.0,80.0,4.0,2.0,2.0,2.0,1.0,3.0,2.0,2.0,3.0,2.0,3.0,10.0,8.0,11.0,14.0,14.0,15.0,13.0,15.0,6.0,6.0,15.0,15.0,10.0,15.0,13.0,14.0,12.0,14.0,14.0,14.0,13.0,14.0,15.0,14.0,13.0,10.0,10.0,11.0,11.0,14.0,13.0,13.0,7.0,13.0,11.0,20.0,13.0,13.0,14.0,14.0,12.0,4.0,14.0,13.0,13.0,11.0,14.0,14.0,12.0,14.0,11.0,29.0,0.0,0.0,0.0,0.0,176.0,73.0,3.0,2.0,1.0,3.0,1.0,3.0,2.0,2.0,3.0,2.0,1.0,13.0,14.0,11.0,10.0,12.0,12.0,6.0,14.0,12.0,12.0,13.0,12.0,12.0,15.0,10.0,10.0,10.0,12.0,10.0,12.0,12.0,12.0,15.0,7.0,15.0,12.0,14.0,14.0,13.0,13.0,14.0,8.0,20.0,13.0,12.0,5.0,13.0,13.0,14.0,8.0,15.0,7.0,12.0,14.0,11.0,13.0,13.0,13.0,10.0,11.0,8.0,24.0,0.0,0.0,1.0,0.0,191.0,84.0,2.0,1.0,3.0,2.0,3.0,4.0,3.0,3.0,3.0,3.0,3.0,10.0,11.0,5.0,5.0,11.0,8.0,14.0,8.0,8.0,14.0,10.0,8.0,13.0,7.0,13.0,10.0,10.0,10.0,12.0,6.0,12.0,13.0,9.0,16.0,10.0,12.0,10.0,11.0,10.0,12.0,11.0,15.0,15.0,9.0,10.0,20.0,12.0,13.0,13.0,10.0,12.0,13.0,9.0,11.0,13.0,12.0,12.0,12.0,12.0,12.0,9.0,18.0,0.0,0.0,0.0,0.0,182.0,75.0,1.0,3.0,3.0,2.0,2.0,3.0,2.0,2.0,2.0,2.0,1.0,9.0,9.0,11.0,12.0,11.0,12.0,9.0,11.0,5.0,5.0,12.0,10.0,5.0,12.0,10.0,12.0,13.0,11.0,11.0,11.0,11.0,12.0,12.0,8.0,13.0,10.0,11.0,11.0,12.0,12.0,11.0,8.0,5.0,13.0,13.0,20.0,11.0,10.0,10.0,7.0,9.0,7.0,11.0,11.0,13.0,12.0,15.0,15.0,11.0,10.0,10.0,26.0,0.0,0.0,0.0,0.0,175.0,73.0,2.0,3.0,2.0,3.0,1.0,1.0,3.0,1.0,3.0,1.0,3.0,9.0,10.0,12.0,13.0,8.0,10.0,7.0,12.0,9.0,9.0,11.0,10.0,10.0,11.0,13.0,12.0,14.0,13.0,9.0,10.0,11.0,8.0,8.0,8.0,12.0,11.0,10.0,12.0,10.0,11.0,10.0,8.0,5.0,12.0,13.0,20.0,11.0,12.0,12.0,8.0,11.0,10.0,9.0,20.0,12.0,10.0,10.0,9.0,4.0,19.0,5.0,30.0,0.0,0.0,0.0,0.0,193.0,86.0,11.0,14.0,14.0,9.0,14.0,11.0,15.0,13.0,9.0,12.0,10.0,2.0,2.0,2.0,3.0,8.0,4.0,1.0,3.0,3.0,4.0,10.0,6.0,8.0,7.0,7.0,14.0,13.0,15.0,11.0,9.0,13.0,15.0,9.0,9.0,4.0,12.0,10.0,2.0,12.0,12.0,8.0,15.0,7.0,9.0,11.0,20.0,12.0,13.0,17.0,11.0,14.0,9.0,4.0,11.0,10.0,19.0,14.0,12.0,12.0,11.0,6.0,26.0,1.0,0.0,6.0,0.0,188.0,83.0,3.0,3.0,1.0,3.0,2.0,2.0,1.0,3.0,2.0,3.0,1.0,7.0,6.0,9.0,5.0,8.0,5.0,17.0,6.0,9.0,14.0,9.0,8.0,13.0,8.0,9.0,9.0,12.0,9.0,12.0,7.0,8.0,15.0,12.0,8.0,12.0,12.0,11.0,10.0,16.0,9.0,17.0,16.0,8.0,18.0,15.0,20.0,18.0,16.0,14.0,10.0,9.0,10.0,17.0,8.0,12.0,12.0,15.0,12.0,12.0,10.0,4.0,32.0,29.0,0.0,11.0,1.0,179.0,79.0,3.0,2.0,3.0,3.0,1.0,2.0,1.0,3.0,3.0,1.0,1.0,12.0,14.0,15.0,10.0,13.0,12.0,7.0,15.0,8.0,13.0,13.0,13.0,15.0,14.0,12.0,12.0,15.0,13.0,9.0,10.0,13.0,16.0,14.0,12.0,7.0,12.0,10.0,16.0,13.0,16.0,13.0,8.0,10.0,14.0,16.0,20.0,18.0,7.0,15.0,12.0,15.0,10.0,17.0,4.0,12.0,20.0,8.0,14.0,10.0,10.0,15.0,26.0,2.0,1.0,11.0,0.0,177.0,73.0,1.0,3.0,3.0,1.0,3.0,2.0,1.0,1.0,2.0,3.0,2.0,12.0,11.0,14.0,13.0,13.0,10.0,8.0,14.0,9.0,8.0,13.0,13.0,10.0,13.0,15.0,11.0,14.0,11.0,10.0,11.0,11.0,10.0,16.0,7.0,12.0,8.0,8.0,11.0,14.0,14.0,12.0,8.0,10.0,8.0,16.0,20.0,12.0,8.0,11.0,13.0,11.0,9.0,7.0,10.0,13.0,19.0,9.0,11.0,8.0,6.0,12.0,33.0,17.0,0.0,14.0,0.0,171.0,65.0,3.0,3.0,3.0,1.0,3.0,2.0,3.0,1.0,2.0,3.0,2.0,11.0,10.0,15.0,8.0,13.0,8.0,5.0,6.0,11.0,5.0,14.0,11.0,11.0,13.0,11.0,8.0,12.0,8.0,12.0,11.0,10.0,12.0,13.0,7.0,11.0,4.0,10.0,14.0,17.0,17.0,8.0,5.0,8.0,12.0,17.0,20.0,12.0,5.0,13.0,13.0,12.0,12.0,8.0,7.0,16.0,6.0,8.0,10.0,10.0,10.0,10.0,27.0,1.0,0.0,11.0,0.0,181.0,74.0,2.0,1.0,1.0,2.0,1.0,2.0,1.0,3.0,2.0,3.0,4.0,13.0,14.0,12.0,8.0,12.0,9.0,12.0,12.0,14.0,13.0,13.0,14.0,12.0,11.0,13.0,12.0,12.0,15.0,15.0,9.0,13.0,16.0,14.0,11.0,12.0,11.0,10.0,14.0,14.0,11.0,16.0,13.0,7.0,15.0,13.0,20.0,14.0,12.0,16.0,14.0,16.0,7.0,10.0,10.0,12.0,16.0,17.0,14.0,12.0,10.0,6.0,24.0,14.0,0.0,21.0,1.0,177.0,67.0,2.0,3.0,3.0,2.0,2.0,3.0,2.0,3.0,2.0,1.0,4.0,11.0,11.0,13.0,13.0,13.0,12.0,5.0,13.0,6.0,9.0,14.0,13.0,5.0,14.0,12.0,13.0,13.0,14.0,14.0,12.0,14.0,11.0,15.0,8.0,11.0,13.0,11.0,14.0,13.0,14.0,13.0,7.0,12.0,6.0,14.0,20.0,16.0,12.0,11.0,12.0,10.0,12.0,14.0,9.0,9.0,12.0,12.0,9.0,7.0,11.0,6.0,24.0,0.0,0.0,0.0,0.0,186.0,77.0,3.0,2.0,2.0,3.0,3.0,4.0,3.0,3.0,2.0,2.0,1.0,7.0,7.0,9.0,8.0,10.0,7.0,13.0,10.0,13.0,14.0,11.0,12.0,14.0,11.0,13.0,11.0,14.0,9.0,14.0,9.0,10.0,15.0,10.0,12.0,11.0,13.0,13.0,11.0,11.0,7.0,13.0,13.0,7.0,14.0,12.0,20.0,10.0,14.0,15.0,13.0,10.0,6.0,13.0,12.0,14.0,12.0,15.0,13.0,14.0,10.0,6.0,30.0,29.0,2.0,10.0,2.0,180.0,77.0,3.0,3.0,3.0,2.0,2.0,3.0,1.0,1.0,2.0,2.0,2.0,9.0,11.0,13.0,14.0,13.0,7.0,10.0,14.0,7.0,10.0,15.0,13.0,8.0,14.0,14.0,18.0,17.0,14.0,10.0,9.0,15.0,16.0,12.0,11.0,14.0,10.0,8.0,12.0,13.0,8.0,13.0,8.0,20.0,9.0,13.0,13.0,10.0,10.0,11.0,15.0,15.0,8.0,9.0,8.0,18.0,14.0,8.0,10.0,10.0,8.0,9.0,24.0,0.0,0.0,0.0,0.0,187.0,81.0,2.0,1.0,3.0,2.0,4.0,2.0,1.0,2.0,3.0,1.0,1.0,5.0,8.0,12.0,7.0,14.0,1.0,6.0,12.0,2.0,9.0,12.0,3.0,11.0,11.0,15.0,11.0,12.0,10.0,9.0,14.0,10.0,7.0,9.0,9.0,10.0,11.0,12.0,13.0,12.0,10.0,12.0,14.0,6.0,15.0,11.0,20.0,12.0,11.0,10.0,6.0,10.0,10.0,10.0,20.0,11.0,13.0,9.0,13.0,8.0,12.0,4.0,28.0,0.0,0.0,4.0,1.0,183.0,83.0,1.0,1.0,1.0,1.0,1.0,2.0,2.0,1.0,3.0,3.0,2.0,8.0,9.0,12.0,11.0,10.0,7.0,12.0,13.0,10.0,11.0,11.0,13.0,9.0,9.0,16.0,11.0,14.0,10.0,11.0,7.0,10.0,12.0,13.0,11.0,13.0,9.0,9.0,15.0,16.0,11.0,15.0,12.0,9.0,16.0,15.0,20.0,13.0,16.0,11.0,13.0,13.0,7.0,9.0,7.0,7.0,10.0,9.0,9.0,10.0,5.0,15.0
3,2,17.0,2.0,0.0,3.0,0.0,196.0,90.0,15.0,15.0,13.0,5.0,15.0,13.0,14.0,17.0,15.0,14.0,11.0,9.0,2.0,4.0,1.0,10.0,12.0,7.0,2.0,8.0,3.0,8.0,3.0,7.0,8.0,8.0,12.0,15.0,13.0,15.0,9.0,12.0,15.0,7.0,14.0,2.0,13.0,11.0,13.0,9.0,13.0,14.0,18.0,7.0,15.0,12.0,20.0,13.0,14.0,13.0,7.0,10.0,4.0,12.0,12.0,15.0,16.0,16.0,14.0,16.0,14.0,3.0,16.0,0.0,0.0,0.0,0.0,173.0,0.0,2.0,1.0,2.0,4.0,3.0,1.0,3.0,2.0,2.0,2.0,1.0,4.0,7.0,3.0,2.0,4.0,6.0,5.0,2.0,3.0,2.0,4.0,4.0,3.0,6.0,11.0,4.0,16.0,5.0,4.0,5.0,5.0,7.0,15.0,3.0,5.0,3.0,4.0,6.0,15.0,11.0,2.0,7.0,5.0,14.0,13.0,20.0,9.0,2.0,3.0,12.0,6.0,9.0,6.0,5.0,16.0,10.0,6.0,10.0,13.0,9.0,9.0,22.0,21.0,6.0,2.0,0.0,178.0,69.0,3.0,3.0,3.0,3.0,1.0,2.0,3.0,2.0,1.0,2.0,3.0,18.0,16.0,12.0,13.0,17.0,18.0,7.0,17.0,5.0,7.0,14.0,15.0,10.0,17.0,10.0,12.0,8.0,14.0,9.0,15.0,11.0,9.0,17.0,6.0,12.0,8.0,10.0,14.0,12.0,15.0,9.0,6.0,14.0,13.0,12.0,20.0,15.0,8.0,10.0,6.0,13.0,5.0,14.0,11.0,18.0,5.0,14.0,10.0,7.0,11.0,16.0,25.0,1.0,0.0,18.0,6.0,179.0,75.0,3.0,1.0,3.0,1.0,1.0,1.0,2.0,1.0,2.0,1.0,3.0,12.0,12.0,12.0,13.0,13.0,11.0,9.0,13.0,10.0,5.0,12.0,16.0,9.0,13.0,11.0,12.0,11.0,14.0,11.0,11.0,9.0,15.0,12.0,7.0,14.0,11.0,12.0,17.0,14.0,14.0,10.0,9.0,12.0,14.0,13.0,20.0,16.0,10.0,10.0,4.0,16.0,5.0,13.0,14.0,17.0,12.0,16.0,15.0,6.0,11.0,4.0,21.0,4.0,0.0,15.0,1.0,188.0,78.0,1.0,3.0,3.0,3.0,3.0,2.0,1.0,3.0,1.0,1.0,1.0,3.0,7.0,10.0,6.0,13.0,5.0,15.0,6.0,11.0,16.0,13.0,5.0,16.0,12.0,12.0,16.0,13.0,14.0,14.0,12.0,12.0,15.0,5.0,11.0,8.0,15.0,15.0,13.0,12.0,14.0,15.0,14.0,20.0,14.0,14.0,10.0,16.0,14.0,13.0,13.0,13.0,10.0,10.0,17.0,15.0,13.0,14.0,14.0,13.0,14.0,4.0,29.0,62.0,4.0,0.0,0.0,190.0,86.0,2.0,2.0,1.0,4.0,1.0,1.0,1.0,1.0,2.0,1.0,2.0,9.0,9.0,12.0,9.0,13.0,12.0,14.0,12.0,8.0,16.0,17.0,13.0,15.0,13.0,11.0,20.0,16.0,14.0,16.0,19.0,12.0,17.0,13.0,19.0,7.0,20.0,16.0,14.0,14.0,13.0,15.0,14.0,9.0,15.0,14.0,20.0,16.0,15.0,16.0,11.0,14.0,5.0,11.0,14.0,15.0,16.0,14.0,18.0,14.0,9.0,3.0,29.0,22.0,1.0,18.0,2.0,180.0,73.0,1.0,3.0,1.0,2.0,3.0,3.0,4.0,1.0,3.0,2.0,3.0,3.0,12.0,13.0,4.0,11.0,2.0,10.0,6.0,14.0,13.0,12.0,4.0,13.0,11.0,15.0,14.0,14.0,11.0,13.0,9.0,12.0,14.0,6.0,13.0,13.0,13.0,15.0,14.0,17.0,16.0,13.0,10.0,7.0,12.0,17.0,20.0,15.0,12.0,13.0,13.0,12.0,14.0,8.0,11.0,13.0,18.0,13.0,16.0,15.0,12.0,7.0,25.0,3.0,0.0,3.0,0.0,182.0,80.0,2.0,1.0,2.0,1.0,2.0,2.0,2.0,2.0,2.0,1.0,4.0,6.0,7.0,11.0,8.0,13.0,6.0,15.0,8.0,9.0,16.0,15.0,10.0,17.0,14.0,17.0,16.0,16.0,17.0,13.0,10.0,14.0,16.0,8.0,14.0,6.0,17.0,16.0,15.0,13.0,12.0,10.0,12.0,9.0,13.0,13.0,20.0,12.0,13.0,13.0,10.0,13.0,10.0,10.0,13.0,15.0,12.0,14.0,15.0,11.0,12.0,8.0,18.0,0.0,0.0,0.0,0.0,183.0,73.0,2.0,1.0,3.0,2.0,1.0,3.0,1.0,1.0,1.0,2.0,2.0,1.0,1.0,10.0,11.0,10.0,4.0,11.0,7.0,3.0,2.0,7.0,10.0,2.0,12.0,11.0,13.0,12.0,10.0,10.0,10.0,11.0,16.0,10.0,7.0,13.0,3.0,7.0,8.0,13.0,13.0,10.0,11.0,8.0,15.0,14.0,20.0,12.0,9.0,11.0,8.0,6.0,7.0,5.0,14.0,14.0,18.0,12.0,14.0,11.0,13.0,5.0,18.0,0.0,0.0,0.0,0.0,186.0,75.0,3.0,4.0,2.0,1.0,1.0,3.0,2.0,3.0,3.0,3.0,2.0,8.0,6.0,10.0,7.0,15.0,9.0,11.0,12.0,11.0,8.0,15.0,10.0,6.0,16.0,12.0,13.0,9.0,11.0,13.0,14.0,12.0,15.0,13.0,8.0,10.0,13.0,14.0,13.0,13.0,14.0,13.0,14.0,11.0,15.0,14.0,20.0,13.0,10.0,14.0,10.0,8.0,10.0,13.0,9.0,16.0,17.0,12.0,16.0,19.0,15.0,4.0,19.0,6.0,0.0,10.0,0.0,180.0,77.0,3.0,1.0,1.0,1.0,1.0,2.0,2.0,3.0,2.0,2.0,4.0,6.0,10.0,9.0,10.0,10.0,7.0,11.0,12.0,9.0,13.0,13.0,13.0,16.0,10.0,13.0,13.0,17.0,13.0,14.0,8.0,13.0,17.0,10.0,13.0,14.0,12.0,11.0,14.0,13.0,14.0,18.0,11.0,10.0,13.0,15.0,20.0,17.0,17.0,12.0,13.0,11.0,4.0,15.0,16.0,16.0,8.0,12.0,9.0,11.0,13.0,12.0,23.0,0.0,0.0,3.0,0.0,191.0,83.0,13.0,11.0,9.0,6.0,11.0,11.0,12.0,11.0,11.0,10.0,11.0,8.0,3.0,1.0,2.0,4.0,10.0,2.0,3.0,3.0,3.0,4.0,4.0,3.0,7.0,7.0,11.0,11.0,11.0,11.0,10.0,12.0,12.0,3.0,10.0,1.0,10.0,10.0,9.0,10.0,9.0,11.0,13.0,5.0,14.0,11.0,20.0,4.0,13.0,10.0,8.0,4.0,10.0,10.0,13.0,11.0,11.0,15.0,10.0,16.0,19.0,2.0,27.0,4.0,0.0,0.0,0.0,180.0,70.0,3.0,4.0,4.0,2.0,2.0,2.0,1.0,3.0,1.0,2.0,1.0,8.0,12.0,14.0,9.0,10.0,9.0,8.0,13.0,9.0,9.0,13.0,12.0,8.0,13.0,15.0,10.0,15.0,9.0,12.0,10.0,9.0,13.0,12.0,8.0,12.0,10.0,12.0,14.0,15.0,12.0,11.0,9.0,8.0,13.0,14.0,20.0,13.0,10.0,10.0,13.0,10.0,8.0,15.0,12.0,10.0,5.0,12.0,8.0,7.0,13.0,10.0,23.0,13.0,0.0,2.0,0.0,180.0,70.0,1.0,2.0,3.0,3.0,2.0,4.0,4.0,1.0,1.0,1.0,1.0,10.0,12.0,9.0,6.0,11.0,10.0,9.0,10.0,9.0,11.0,13.0,3.0,14.0,12.0,8.0,9.0,12.0,8.0,12.0,10.0,11.0,16.0,5.0,5.0,11.0,13.0,14.0,16.0,13.0,10.0,12.0,10.0,20.0,15.0,14.0,5.0,16.0,11.0,7.0,9.0,8.0,5.0,14.0,13.0,11.0,10.0,13.0,14.0,13.0,9.0,5.0,24.0,0.0,0.0,0.0,0.0,180.0,78.0,1.0,1.0,4.0,1.0,1.0,2.0,2.0,1.0,2.0,1.0,1.0,4.0,9.0,11.0,11.0,10.0,8.0,10.0,10.0,3.0,6.0,11.0,12.0,7.0,12.0,11.0,12.0,12.0,11.0,11.0,11.0,11.0,11.0,12.0,9.0,12.0,8.0,11.0,12.0,12.0,14.0,11.0,9.0,10.0,13.0,12.0,20.0,13.0,9.0,11.0,11.0,11.0,11.0,7.0,16.0,10.0,11.0,12.0,10.0,8.0,10.0,7.0,24.0,0.0,0.0,3.0,0.0,188.0,85.0,2.0,2.0,1.0,3.0,1.0,3.0,3.0,1.0,2.0,3.0,2.0,8.0,9.0,8.0,6.0,11.0,8.0,14.0,10.0,12.0,11.0,10.0,7.0,12.0,11.0,12.0,12.0,14.0,12.0,11.0,10.0,10.0,15.0,7.0,13.0,7.0,13.0,14.0,14.0,12.0,11.0,14.0,13.0,7.0,12.0,12.0,20.0,16.0,15.0,11.0,6.0,12.0,5.0,12.0,14.0,13.0,14.0,11.0,14.0,13.0,15.0,1.0,22.0,0.0,0.0,0.0,0.0,189.0,86.0,3.0,2.0,2.0,2.0,1.0,1.0,2.0,3.0,4.0,3.0,2.0,4.0,6.0,10.0,8.0,10.0,14.0,14.0,7.0,12.0,13.0,13.0,14.0,12.0,12.0,12.0,12.0,14.0,13.0,10.0,12.0,10.0,14.0,12.0,14.0,10.0,12.0,12.0,10.0,10.0,12.0,13.0,14.0,12.0,16.0,12.0,20.0,10.0,15.0,11.0,11.0,8.0,6.0,12.0,11.0,13.0,12.0,12.0,14.0,12.0,13.0,6.0,22.0,0.0,0.0,0.0,0.0,187.0,72.0,3.0,1.0,1.0,2.0,3.0,3.0,2.0,4.0,2.0,2.0,3.0,11.0,8.0,13.0,13.0,12.0,12.0,13.0,13.0,9.0,4.0,10.0,5.0,4.0,14.0,12.0,12.0,12.0,13.0,10.0,11.0,10.0,10.0,14.0,7.0,13.0,5.0,8.0,9.0,11.0,10.0,14.0,15.0,14.0,14.0,11.0,20.0,11.0,10.0,12.0,10.0,14.0,11.0,11.0,18.0,11.0,13.0,11.0,10.0,3.0,17.0,3.0,22.0,0.0,0.0,4.0,0.0,178.0,76.0,3.0,3.0,2.0,3.0,1.0,2.0,1.0,3.0,2.0,2.0,1.0,6.0,10.0,14.0,10.0,15.0,8.0,5.0,13.0,2.0,7.0,15.0,9.0,9.0,16.0,10.0,12.0,11.0,13.0,8.0,15.0,11.0,12.0,14.0,5.0,12.0,10.0,13.0,11.0,13.0,13.0,9.0,9.0,12.0,10.0,12.0,20.0,12.0,11.0,12.0,6.0,11.0,11.0,13.0,7.0,13.0,12.0,11.0,12.0,11.0,14.0,6.0,22.0,0.0,0.0,5.0,0.0,184.0,79.0,1.0,2.0,2.0,1.0,3.0,2.0,2.0,1.0,1.0,3.0,3.0,14.0,12.0,11.0,8.0,13.0,11.0,11.0,11.0,4.0,10.0,13.0,7.0,12.0,13.0,15.0,12.0,14.0,12.0,12.0,14.0,14.0,15.0,12.0,14.0,11.0,11.0,15.0,12.0,11.0,13.0,14.0,11.0,8.0,15.0,12.0,20.0,12.0,12.0,14.0,12.0,13.0,7.0,13.0,5.0,12.0,11.0,12.0,12.0,10.0,12.0,5.0,24.0,1.0,0.0,3.0,0.0,185.0,77.0,2.0,1.0,2.0,3.0,1.0,1.0,1.0,3.0,2.0,2.0,3.0,12.0,11.0,11.0,8.0,14.0,11.0,7.0,8.0,8.0,9.0,14.0,12.0,14.0,14.0,13.0,10.0,16.0,10.0,11.0,14.0,9.0,16.0,13.0,13.0,11.0,12.0,15.0,16.0,12.0,13.0,12.0,12.0,10.0,14.0,11.0,20.0,17.0,12.0,13.0,12.0,10.0,7.0,13.0,12.0,12.0,13.0,14.0,14.0,10.0,13.0,7.0,24.0,7.0,0.0,14.0,1.0,177.0,70.0,1.0,1.0,2.0,2.0,3.0,2.0,3.0,1.0,1.0,3.0,2.0,8.0,12.0,11.0,9.0,12.0,7.0,9.0,9.0,12.0,10.0,11.0,10.0,10.0,13.0,15.0,11.0,12.0,10.0,9.0,10.0,10.0,17.0,12.0,11.0,13.0,10.0,12.0,18.0,15.0,14.0,12.0,9.0,6.0,16.0,14.0,20.0,15.0,13.0,12.0,15.0,16.0,8.0,14.0,11.0,14.0,13.0,13.0,14.0,6.0,8.0,8.0
2,1,17.0,0.0,0.0,0.0,0.0,163.0,59.0,2.0,3.0,3.0,1.0,2.0,3.0,3.0,1.0,2.0,3.0,3.0,8.0,12.0,13.0,7.0,13.0,7.0,5.0,7.0,7.0,7.0,12.0,5.0,8.0,12.0,9.0,12.0,16.0,10.0,8.0,7.0,10.0,11.0,14.0,7.0,12.0,8.0,7.0,7.0,14.0,11.0,4.0,4.0,20.0,10.0,14.0,6.0,6.0,4.0,8.0,4.0,9.0,9.0,9.0,16.0,7.0,11.0,9.0,8.0,2.0,10.0,10.0,25.0,0.0,0.0,0.0,0.0,184.0,79.0,3.0,1.0,2.0,3.0,1.0,3.0,3.0,2.0,3.0,2.0,3.0,13.0,13.0,14.0,9.0,12.0,13.0,8.0,11.0,11.0,9.0,12.0,8.0,11.0,13.0,14.0,12.0,11.0,13.0,12.0,12.0,12.0,13.0,13.0,8.0,13.0,11.0,13.0,11.0,14.0,13.0,12.0,12.0,20.0,13.0,13.0,5.0,13.0,13.0,12.0,13.0,10.0,6.0,12.0,12.0,13.0,11.0,12.0,12.0,14.0,10.0,7.0,20.0,0.0,0.0,0.0,0.0,183.0,0.0,2.0,3.0,2.0,1.0,2.0,2.0,3.0,1.0,2.0,3.0,3.0,7.0,12.0,13.0,12.0,12.0,5.0,7.0,8.0,5.0,6.0,6.0,3.0,4.0,13.0,9.0,9.0,8.0,8.0,5.0,8.0,9.0,7.0,13.0,1.0,8.0,6.0,7.0,8.0,13.0,11.0,7.0,9.0,8.0,13.0,11.0,20.0,8.0,6.0,9.0,6.0,6.0,9.0,8.0,15.0,12.0,14.0,11.0,11.0,10.0,13.0,3.0,27.0,0.0,0.0,0.0,0.0,185.0,0.0,4.0,1.0,3.0,3.0,1.0,1.0,3.0,3.0,1.0,1.0,1.0,7.0,5.0,6.0,8.0,13.0,7.0,2.0,10.0,3.0,11.0,7.0,7.0,10.0,9.0,9.0,9.0,9.0,9.0,9.0,7.0,13.0,10.0,10.0,9.0,7.0,8.0,8.0,12.0,13.0,13.0,8.0,9.0,10.0,12.0,12.0,20.0,13.0,9.0,10.0,10.0,1.0,10.0,10.0,20.0,11.0,10.0,10.0,10.0,2.0,17.0,6.0,15.0,0.0,0.0,0.0,0.0,175.0,0.0,2.0,1.0,1.0,1.0,2.0,2.0,3.0,3.0,3.0,1.0,2.0,6.0,9.0,7.0,4.0,9.0,8.0,2.0,6.0,2.0,5.0,4.0,5.0,5.0,13.0,5.0,6.0,6.0,5.0,6.0,5.0,6.0,5.0,11.0,6.0,7.0,3.0,9.0,13.0,8.0,8.0,10.0,9.0,20.0,6.0,9.0,9.0,8.0,4.0,4.0,15.0,9.0,9.0,7.0,6.0,4.0,7.0,5.0,14.0,9.0,9.0,7.0,22.0,0.0,0.0,2.0,0.0,178.0,70.0,2.0,2.0,1.0,2.0,1.0,3.0,3.0,2.0,1.0,1.0,2.0,11.0,11.0,13.0,7.0,13.0,11.0,5.0,8.0,4.0,7.0,13.0,10.0,10.0,15.0,14.0,13.0,13.0,7.0,8.0,13.0,12.0,15.0,14.0,11.0,14.0,10.0,13.0,12.0,12.0,14.0,9.0,7.0,13.0,12.0,13.0,20.0,12.0,6.0,7.0,8.0,13.0,7.0,8.0,12.0,12.0,18.0,11.0,15.0,13.0,11.0,4.0,26.0,0.0,0.0,1.0,0.0,188.0,84.0,13.0,12.0,10.0,4.0,15.0,15.0,10.0,15.0,16.0,12.0,10.0,8.0,1.0,3.0,1.0,10.0,11.0,7.0,2.0,3.0,1.0,12.0,10.0,2.0,10.0,6.0,10.0,8.0,11.0,14.0,10.0,13.0,13.0,2.0,8.0,3.0,15.0,10.0,14.0,7.0,14.0,13.0,13.0,10.0,12.0,10.0,20.0,12.0,12.0,15.0,11.0,11.0,11.0,11.0,13.0,16.0,14.0,8.0,19.0,15.0,11.0,2.0,26.0,0.0,0.0,0.0,0.0,191.0,84.0,3.0,1.0,4.0,1.0,2.0,1.0,1.0,3.0,2.0,2.0,3.0,2.0,9.0,11.0,8.0,13.0,4.0,16.0,9.0,10.0,14.0,12.0,8.0,15.0,13.0,19.0,14.0,16.0,13.0,13.0,11.0,10.0,15.0,8.0,8.0,6.0,13.0,13.0,13.0,12.0,12.0,14.0,14.0,20.0,13.0,12.0,10.0,12.0,14.0,12.0,20.0,6.0,4.0,10.0,13.0,15.0,11.0,7.0,10.0,6.0,2.0,12.0,24.0,16.0,0.0,5.0,0.0,184.0,78.0,3.0,1.0,2.0,2.0,1.0,2.0,2.0,1.0,3.0,3.0,1.0,12.0,12.0,12.0,8.0,14.0,8.0,13.0,13.0,7.0,12.0,15.0,10.0,14.0,15.0,15.0,13.0,13.0,14.0,15.0,14.0,14.0,13.0,6.0,15.0,13.0,14.0,14.0,13.0,11.0,12.0,15.0,13.0,20.0,14.0,12.0,8.0,14.0,13.0,14.0,7.0,11.0,5.0,9.0,9.0,12.0,11.0,13.0,15.0,15.0,12.0,8.0,23.0,0.0,0.0,18.0,3.0,173.0,65.0,1.0,2.0,4.0,1.0,2.0,1.0,1.0,2.0,3.0,2.0,3.0,12.0,13.0,11.0,11.0,12.0,10.0,7.0,11.0,11.0,9.0,12.0,13.0,12.0,13.0,13.0,11.0,13.0,10.0,11.0,11.0,11.0,16.0,10.0,7.0,15.0,11.0,14.0,15.0,13.0,13.0,12.0,9.0,9.0,13.0,13.0,20.0,14.0,9.0,14.0,7.0,12.0,6.0,18.0,13.0,16.0,13.0,12.0,17.0,12.0,12.0,10.0,28.0,0.0,0.0,0.0,0.0,176.0,69.0,1.0,3.0,1.0,4.0,2.0,3.0,2.0,1.0,2.0,3.0,2.0,8.0,14.0,12.0,6.0,13.0,12.0,7.0,13.0,11.0,11.0,13.0,12.0,13.0,14.0,11.0,13.0,12.0,12.0,14.0,10.0,13.0,14.0,11.0,8.0,15.0,11.0,12.0,14.0,15.0,14.0,10.0,7.0,12.0,14.0,14.0,20.0,15.0,8.0,15.0,8.0,13.0,6.0,14.0,14.0,10.0,13.0,14.0,15.0,12.0,15.0,5.0,27.0,20.0,0.0,19.0,0.0,192.0,83.0,14.0,14.0,15.0,5.0,14.0,16.0,12.0,15.0,8.0,13.0,14.0,8.0,2.0,3.0,3.0,8.0,12.0,11.0,1.0,1.0,1.0,9.0,4.0,2.0,7.0,9.0,14.0,13.0,13.0,14.0,5.0,12.0,10.0,6.0,12.0,4.0,14.0,12.0,11.0,9.0,12.0,12.0,16.0,10.0,10.0,10.0,20.0,11.0,14.0,16.0,11.0,14.0,5.0,12.0,8.0,10.0,16.0,12.0,12.0,12.0,15.0,9.0,30.0,20.0,0.0,13.0,0.0,177.0,71.0,1.0,1.0,1.0,2.0,3.0,1.0,1.0,1.0,1.0,1.0,2.0,5.0,8.0,12.0,6.0,15.0,5.0,12.0,5.0,6.0,13.0,13.0,6.0,14.0,14.0,11.0,15.0,13.0,12.0,9.0,12.0,11.0,13.0,10.0,7.0,13.0,14.0,15.0,16.0,16.0,15.0,14.0,11.0,20.0,17.0,15.0,12.0,18.0,12.0,14.0,10.0,13.0,10.0,10.0,17.0,14.0,17.0,11.0,16.0,15.0,16.0,3.0,35.0,93.0,9.0,12.0,4.0,170.0,72.0,2.0,1.0,1.0,2.0,1.0,2.0,3.0,2.0,3.0,1.0,2.0,14.0,14.0,11.0,11.0,16.0,14.0,8.0,13.0,7.0,9.0,17.0,16.0,11.0,17.0,17.0,17.0,15.0,18.0,13.0,16.0,17.0,19.0,16.0,16.0,11.0,12.0,14.0,9.0,10.0,12.0,14.0,5.0,20.0,10.0,7.0,5.0,6.0,11.0,16.0,13.0,17.0,14.0,10.0,15.0,18.0,17.0,16.0,17.0,4.0,15.0,20.0,29.0,69.0,8.0,0.0,0.0,187.0,87.0,3.0,4.0,2.0,2.0,1.0,2.0,3.0,2.0,3.0,3.0,2.0,5.0,7.0,8.0,7.0,12.0,8.0,14.0,10.0,10.0,14.0,12.0,9.0,12.0,9.0,10.0,15.0,16.0,15.0,15.0,9.0,12.0,13.0,8.0,15.0,9.0,15.0,12.0,10.0,8.0,9.0,14.0,14.0,20.0,13.0,11.0,10.0,11.0,15.0,16.0,12.0,10.0,8.0,12.0,14.0,13.0,15.0,16.0,16.0,14.0,15.0,17.0,26.0,26.0,2.0,16.0,3.0,172.0,63.0,1.0,2.0,3.0,2.0,2.0,3.0,1.0,3.0,1.0,2.0,3.0,12.0,12.0,14.0,13.0,12.0,12.0,8.0,14.0,7.0,6.0,10.0,10.0,7.0,13.0,7.0,11.0,7.0,10.0,13.0,10.0,10.0,15.0,16.0,4.0,16.0,7.0,12.0,14.0,17.0,16.0,8.0,7.0,16.0,12.0,14.0,20.0,13.0,7.0,14.0,5.0,13.0,5.0,16.0,13.0,14.0,16.0,12.0,13.0,15.0,16.0,4.0,20.0,0.0,0.0,0.0,0.0,192.0,0.0,1.0,4.0,1.0,1.0,1.0,2.0,3.0,2.0,1.0,1.0,3.0,7.0,12.0,14.0,8.0,14.0,7.0,7.0,9.0,7.0,5.0,10.0,1.0,9.0,14.0,5.0,10.0,3.0,6.0,8.0,12.0,11.0,4.0,13.0,9.0,9.0,7.0,8.0,11.0,10.0,9.0,7.0,12.0,8.0,13.0,11.0,20.0,8.0,13.0,9.0,7.0,9.0,4.0,9.0,19.0,11.0,14.0,10.0,13.0,1.0,10.0,4.0,29.0,28.0,2.0,7.0,1.0,176.0,75.0,1.0,3.0,2.0,1.0,3.0,4.0,1.0,3.0,1.0,3.0,1.0,10.0,14.0,17.0,12.0,16.0,9.0,5.0,12.0,7.0,5.0,11.0,10.0,5.0,16.0,10.0,11.0,6.0,10.0,7.0,13.0,11.0,7.0,18.0,4.0,12.0,5.0,6.0,12.0,16.0,17.0,12.0,7.0,9.0,12.0,15.0,20.0,9.0,10.0,10.0,9.0,9.0,7.0,12.0,12.0,17.0,8.0,11.0,7.0,10.0,8.0,18.0,29.0,33.0,8.0,5.0,2.0,181.0,85.0,2.0,2.0,3.0,3.0,2.0,2.0,3.0,2.0,1.0,1.0,1.0,6.0,8.0,12.0,14.0,11.0,8.0,15.0,10.0,6.0,5.0,9.0,13.0,5.0,11.0,10.0,13.0,15.0,10.0,12.0,10.0,9.0,15.0,12.0,8.0,15.0,8.0,12.0,13.0,15.0,13.0,15.0,11.0,12.0,15.0,15.0,20.0,14.0,15.0,10.0,10.0,14.0,8.0,8.0,7.0,16.0,12.0,9.0,12.0,14.0,14.0,7.0,30.0,9.0,0.0,0.0,0.0,191.0,82.0,1.0,3.0,3.0,4.0,2.0,3.0,2.0,3.0,3.0,1.0,2.0,5.0,6.0,10.0,8.0,12.0,8.0,16.0,15.0,14.0,13.0,12.0,13.0,14.0,13.0,16.0,10.0,16.0,9.0,8.0,13.0,10.0,13.0,8.0,11.0,12.0,13.0,13.0,14.0,12.0,13.0,16.0,16.0,5.0,13.0,13.0,20.0,15.0,16.0,10.0,15.0,10.0,8.0,8.0,14.0,16.0,8.0,12.0,12.0,6.0,7.0,9.0,27.0,0.0,0.0,0.0,0.0,172.0,62.0,4.0,2.0,1.0,2.0,2.0,3.0,2.0,2.0,2.0,2.0,3.0,9.0,14.0,12.0,7.0,13.0,9.0,7.0,10.0,15.0,11.0,12.0,9.0,12.0,13.0,16.0,10.0,14.0,12.0,10.0,12.0,10.0,16.0,14.0,6.0,13.0,8.0,10.0,17.0,16.0,15.0,10.0,8.0,12.0,19.0,14.0,20.0,17.0,7.0,17.0,12.0,17.0,5.0,14.0,16.0,14.0,13.0,11.0,15.0,8.0,8.0,5.0,32.0,89.0,7.0,3.0,0.0,183.0,80.0,2.0,1.0,3.0,1.0,2.0,3.0,2.0,1.0,4.0,2.0,3.0,7.0,10.0,12.0,11.0,14.0,9.0,12.0,16.0,6.0,13.0,15.0,12.0,14.0,14.0,15.0,13.0,15.0,14.0,12.0,14.0,12.0,15.0,9.0,14.0,8.0,14.0,16.0,13.0,9.0,10.0,15.0,11.0,15.0,13.0,10.0,20.0,12.0,14.0,12.0,13.0,15.0,5.0,8.0,10.0,15.0,16.0,15.0,18.0,20.0,17.0,4.0
1,1,30.0,1.0,0.0,12.0,0.0,193.0,93.0,14.0,11.0,11.0,7.0,13.0,10.0,11.0,14.0,12.0,8.0,10.0,2.0,3.0,2.0,3.0,6.0,3.0,3.0,4.0,3.0,4.0,9.0,4.0,6.0,9.0,8.0,14.0,14.0,12.0,16.0,8.0,13.0,12.0,15.0,14.0,5.0,13.0,8.0,4.0,7.0,9.0,13.0,16.0,6.0,11.0,12.0,20.0,8.0,12.0,13.0,12.0,12.0,6.0,1.0,4.0,8.0,19.0,11.0,12.0,9.0,9.0,4.0,23.0,3.0,0.0,0.0,0.0,183.0,65.0,1.0,1.0,1.0,4.0,2.0,2.0,2.0,1.0,2.0,2.0,2.0,1.0,9.0,9.0,5.0,15.0,1.0,12.0,6.0,9.0,4.0,9.0,8.0,4.0,11.0,10.0,10.0,9.0,9.0,5.0,6.0,7.0,7.0,13.0,4.0,14.0,12.0,6.0,15.0,15.0,15.0,5.0,15.0,8.0,11.0,14.0,20.0,9.0,6.0,6.0,11.0,4.0,10.0,6.0,11.0,12.0,12.0,12.0,9.0,12.0,19.0,2.0,30.0,28.0,3.0,0.0,0.0,180.0,77.0,1.0,4.0,1.0,3.0,1.0,2.0,3.0,3.0,1.0,3.0,1.0,9.0,11.0,10.0,12.0,11.0,7.0,9.0,10.0,10.0,13.0,13.0,10.0,13.0,11.0,17.0,12.0,14.0,12.0,14.0,9.0,10.0,18.0,11.0,12.0,17.0,13.0,15.0,17.0,13.0,11.0,14.0,10.0,20.0,17.0,12.0,10.0,17.0,13.0,15.0,10.0,16.0,10.0,17.0,10.0,12.0,14.0,12.0,17.0,14.0,13.0,3.0,23.0,0.0,0.0,0.0,0.0,180.0,73.0,1.0,2.0,1.0,1.0,1.0,2.0,1.0,1.0,3.0,1.0,3.0,7.0,4.0,9.0,12.0,14.0,7.0,10.0,8.0,1.0,7.0,8.0,5.0,4.0,13.0,9.0,10.0,8.0,11.0,8.0,7.0,11.0,4.0,12.0,8.0,12.0,5.0,7.0,9.0,14.0,14.0,8.0,7.0,3.0,11.0,14.0,20.0,9.0,9.0,9.0,9.0,9.0,9.0,9.0,17.0,10.0,10.0,14.0,10.0,8.0,13.0,1.0,33.0,0.0,0.0,0.0,0.0,184.0,81.0,3.0,1.0,3.0,3.0,2.0,2.0,2.0,3.0,4.0,2.0,2.0,4.0,5.0,5.0,8.0,5.0,5.0,15.0,15.0,8.0,14.0,6.0,7.0,12.0,6.0,14.0,9.0,18.0,11.0,18.0,7.0,10.0,10.0,6.0,12.0,8.0,6.0,16.0,18.0,9.0,6.0,16.0,11.0,8.0,17.0,8.0,20.0,18.0,15.0,16.0,14.0,9.0,6.0,14.0,7.0,8.0,14.0,8.0,10.0,10.0,10.0,4.0,20.0,0.0,0.0,10.0,0.0,175.0,64.0,3.0,3.0,1.0,1.0,1.0,2.0,1.0,1.0,3.0,2.0,1.0,12.0,12.0,12.0,10.0,12.0,11.0,11.0,11.0,6.0,7.0,13.0,11.0,10.0,11.0,6.0,12.0,8.0,13.0,14.0,12.0,12.0,10.0,13.0,7.0,10.0,13.0,13.0,14.0,11.0,13.0,12.0,6.0,20.0,14.0,12.0,9.0,15.0,11.0,11.0,7.0,8.0,13.0,11.0,10.0,10.0,12.0,8.0,10.0,12.0,10.0,6.0,26.0,0.0,0.0,0.0,0.0,186.0,78.0,3.0,3.0,3.0,4.0,1.0,2.0,4.0,3.0,2.0,4.0,2.0,4.0,9.0,10.0,8.0,10.0,8.0,11.0,9.0,9.0,12.0,11.0,10.0,12.0,8.0,9.0,11.0,10.0,10.0,12.0,9.0,12.0,9.0,9.0,16.0,10.0,13.0,10.0,10.0,9.0,11.0,10.0,12.0,10.0,11.0,9.0,20.0,12.0,12.0,14.0,10.0,10.0,7.0,10.0,9.0,8.0,11.0,9.0,10.0,10.0,9.0,9.0,22.0,0.0,0.0,0.0,0.0,179.0,77.0,1.0,4.0,2.0,2.0,1.0,3.0,3.0,1.0,2.0,2.0,1.0,9.0,13.0,13.0,7.0,11.0,7.0,6.0,8.0,7.0,7.0,8.0,3.0,7.0,11.0,10.0,10.0,9.0,5.0,6.0,8.0,13.0,4.0,11.0,6.0,9.0,7.0,9.0,11.0,13.0,13.0,9.0,3.0,9.0,11.0,13.0,20.0,13.0,6.0,10.0,10.0,10.0,7.0,10.0,15.0,12.0,10.0,9.0,12.0,3.0,17.0,4.0,20.0,0.0,0.0,0.0,0.0,193.0,88.0,1.0,2.0,3.0,1.0,1.0,1.0,2.0,2.0,1.0,1.0,3.0,3.0,1.0,1.0,1.0,3.0,1.0,7.0,1.0,1.0,12.0,5.0,1.0,8.0,3.0,8.0,10.0,6.0,4.0,10.0,2.0,12.0,1.0,4.0,1.0,2.0,5.0,4.0,5.0,8.0,9.0,5.0,14.0,7.0,8.0,10.0,20.0,10.0,11.0,8.0,8.0,8.0,7.0,8.0,14.0,10.0,9.0,12.0,11.0,4.0,14.0,2.0,20.0,0.0,0.0,0.0,0.0,170.0,65.0,1.0,1.0,2.0,1.0,2.0,3.0,1.0,2.0,1.0,1.0,3.0,9.0,14.0,12.0,10.0,12.0,8.0,8.0,9.0,8.0,8.0,10.0,7.0,10.0,12.0,5.0,10.0,7.0,6.0,10.0,11.0,14.0,4.0,11.0,1.0,10.0,5.0,10.0,12.0,14.0,12.0,4.0,3.0,11.0,11.0,11.0,20.0,9.0,6.0,10.0,10.0,10.0,10.0,10.0,10.0,10.0,11.0,10.0,13.0,9.0,14.0,3.0,25.0,0.0,0.0,0.0,0.0,177.0,70.0,3.0,3.0,4.0,3.0,2.0,1.0,1.0,4.0,1.0,2.0,4.0,4.0,7.0,5.0,7.0,11.0,2.0,6.0,3.0,6.0,9.0,9.0,7.0,13.0,9.0,9.0,11.0,5.0,4.0,7.0,6.0,7.0,2.0,7.0,10.0,7.0,11.0,9.0,9.0,14.0,14.0,5.0,8.0,10.0,14.0,14.0,20.0,14.0,9.0,9.0,6.0,9.0,7.0,8.0,18.0,11.0,11.0,13.0,12.0,2.0,12.0,2.0,34.0,30.0,0.0,21.0,0.0,189.0,85.0,12.0,12.0,13.0,5.0,13.0,14.0,14.0,15.0,10.0,11.0,13.0,6.0,2.0,3.0,3.0,10.0,10.0,8.0,1.0,3.0,2.0,11.0,5.0,6.0,10.0,8.0,12.0,13.0,13.0,10.0,6.0,14.0,13.0,3.0,12.0,2.0,14.0,14.0,8.0,6.0,13.0,15.0,14.0,5.0,16.0,7.0,20.0,8.0,14.0,13.0,8.0,14.0,7.0,6.0,12.0,8.0,15.0,14.0,16.0,16.0,12.0,10.0,28.0,22.0,0.0,20.0,1.0,176.0,74.0,2.0,3.0,2.0,1.0,1.0,1.0,3.0,3.0,2.0,2.0,1.0,15.0,15.0,12.0,8.0,13.0,12.0,5.0,11.0,15.0,10.0,13.0,9.0,10.0,12.0,10.0,11.0,10.0,13.0,12.0,11.0,12.0,11.0,11.0,7.0,13.0,10.0,14.0,15.0,15.0,14.0,10.0,8.0,20.0,13.0,14.0,8.0,15.0,8.0,14.0,5.0,12.0,5.0,14.0,15.0,15.0,10.0,14.0,13.0,12.0,12.0,2.0,31.0,64.0,2.0,5.0,0.0,184.0,80.0,1.0,3.0,2.0,1.0,2.0,2.0,1.0,3.0,2.0,3.0,3.0,10.0,10.0,7.0,5.0,12.0,7.0,10.0,5.0,17.0,13.0,13.0,5.0,15.0,9.0,16.0,16.0,15.0,16.0,17.0,6.0,16.0,15.0,4.0,15.0,10.0,15.0,17.0,16.0,8.0,11.0,11.0,12.0,9.0,17.0,10.0,20.0,17.0,14.0,15.0,3.0,16.0,2.0,20.0,16.0,14.0,18.0,16.0,19.0,18.0,18.0,2.0,26.0,0.0,0.0,1.0,0.0,184.0,72.0,1.0,1.0,2.0,3.0,2.0,2.0,3.0,1.0,2.0,3.0,3.0,13.0,12.0,15.0,6.0,11.0,13.0,13.0,9.0,9.0,5.0,13.0,10.0,4.0,15.0,5.0,12.0,12.0,12.0,12.0,16.0,13.0,13.0,12.0,9.0,13.0,11.0,14.0,14.0,13.0,13.0,13.0,14.0,20.0,15.0,13.0,11.0,13.0,12.0,11.0,5.0,9.0,8.0,15.0,16.0,14.0,11.0,10.0,12.0,12.0,13.0,8.0,22.0,2.0,0.0,1.0,0.0,189.0,89.0,4.0,3.0,1.0,1.0,3.0,3.0,1.0,3.0,2.0,1.0,1.0,8.0,10.0,12.0,14.0,13.0,8.0,11.0,12.0,6.0,3.0,13.0,12.0,4.0,13.0,10.0,12.0,10.0,13.0,13.0,12.0,12.0,13.0,13.0,9.0,12.0,5.0,11.0,14.0,13.0,12.0,11.0,13.0,20.0,10.0,12.0,11.0,12.0,13.0,13.0,8.0,13.0,8.0,14.0,10.0,12.0,10.0,10.0,12.0,13.0,12.0,9.0,25.0,8.0,0.0,19.0,2.0,189.0,79.0,2.0,1.0,2.0,3.0,3.0,1.0,2.0,3.0,4.0,1.0,2.0,8.0,9.0,12.0,6.0,13.0,9.0,4.0,15.0,4.0,6.0,15.0,4.0,10.0,13.0,7.0,14.0,11.0,6.0,6.0,14.0,14.0,12.0,10.0,8.0,8.0,9.0,9.0,9.0,14.0,13.0,11.0,13.0,11.0,14.0,15.0,20.0,15.0,9.0,9.0,13.0,7.0,4.0,9.0,13.0,12.0,12.0,8.0,10.0,10.0,10.0,10.0,20.0,0.0,0.0,3.0,2.0,190.0,76.0,2.0,3.0,3.0,1.0,2.0,1.0,1.0,2.0,2.0,1.0,2.0,4.0,1.0,4.0,5.0,9.0,1.0,14.0,5.0,5.0,12.0,8.0,3.0,15.0,4.0,10.0,11.0,10.0,7.0,6.0,7.0,14.0,10.0,1.0,3.0,8.0,15.0,8.0,9.0,13.0,12.0,9.0,16.0,11.0,12.0,12.0,20.0,6.0,9.0,10.0,8.0,7.0,10.0,10.0,13.0,12.0,11.0,12.0,10.0,12.0,12.0,4.0,25.0,12.0,0.0,0.0,0.0,182.0,75.0,1.0,1.0,2.0,3.0,1.0,3.0,3.0,3.0,3.0,2.0,3.0,12.0,12.0,13.0,7.0,14.0,11.0,6.0,13.0,13.0,10.0,13.0,11.0,12.0,14.0,17.0,14.0,13.0,8.0,9.0,13.0,10.0,14.0,13.0,6.0,13.0,10.0,10.0,15.0,14.0,13.0,8.0,10.0,13.0,16.0,15.0,20.0,16.0,8.0,12.0,15.0,15.0,5.0,15.0,4.0,17.0,6.0,12.0,8.0,8.0,10.0,13.0,23.0,0.0,0.0,13.0,0.0,189.0,77.0,2.0,3.0,1.0,4.0,2.0,3.0,2.0,2.0,1.0,3.0,4.0,13.0,12.0,14.0,11.0,14.0,14.0,6.0,13.0,7.0,5.0,13.0,11.0,5.0,14.0,7.0,14.0,10.0,12.0,11.0,13.0,13.0,8.0,15.0,8.0,13.0,8.0,12.0,10.0,12.0,13.0,12.0,14.0,15.0,13.0,13.0,20.0,13.0,13.0,12.0,5.0,13.0,7.0,14.0,10.0,16.0,7.0,12.0,13.0,12.0,8.0,4.0,17.0,0.0,0.0,0.0,0.0,175.0,68.0,1.0,2.0,2.0,3.0,2.0,1.0,2.0,1.0,2.0,3.0,2.0,11.0,9.0,12.0,9.0,12.0,11.0,8.0,10.0,4.0,4.0,11.0,13.0,5.0,13.0,10.0,8.0,7.0,9.0,8.0,11.0,9.0,9.0,12.0,5.0,11.0,6.0,12.0,6.0,13.0,12.0,7.0,6.0,20.0,10.0,13.0,8.0,8.0,5.0,9.0,6.0,11.0,5.0,10.0,18.0,10.0,10.0,11.0,10.0,17.0,20.0,6.0,22.0,0.0,0.0,12.0,0.0,190.0,87.0,1.0,3.0,1.0,1.0,2.0,1.0,3.0,2.0,2.0,3.0,2.0,7.0,7.0,7.0,6.0,10.0,9.0,13.0,8.0,13.0,13.0,9.0,10.0,12.0,10.0,10.0,12.0,14.0,9.0,13.0,9.0,11.0,16.0,13.0,12.0,9.0,11.0,14.0,13.0,15.0,9.0,14.0,14.0,8.0,14.0,12.0,20.0,14.0,16.0,14.0,13.0,10.0,6.0,9.0,11.0,14.0,12.0,10.0,12.0,12.0,10.0,8.0
3,1,27.0,38.0,0.0,0.0,0.0,194.0,92.0,15.0,12.0,13.0,15.0,13.0,12.0,15.0,16.0,16.0,15.0,12.0,9.0,1.0,1.0,2.0,10.0,12.0,12.0,1.0,3.0,2.0,10.0,12.0,2.0,10.0,14.0,12.0,15.0,12.0,14.0,11.0,11.0,14.0,3.0,11.0,2.0,14.0,10.0,11.0,12.0,14.0,13.0,17.0,20.0,13.0,10.0,7.0,15.0,13.0,12.0,4.0,14.0,6.0,12.0,15.0,17.0,12.0,9.0,17.0,17.0,15.0,11.0,21.0,0.0,0.0,2.0,0.0,186.0,80.0,1.0,2.0,1.0,1.0,4.0,1.0,3.0,1.0,3.0,2.0,1.0,12.0,11.0,10.0,8.0,14.0,12.0,11.0,13.0,9.0,9.0,15.0,13.0,12.0,15.0,8.0,9.0,10.0,15.0,11.0,14.0,15.0,12.0,11.0,7.0,8.0,12.0,15.0,11.0,10.0,11.0,15.0,14.0,11.0,15.0,10.0,20.0,12.0,12.0,12.0,9.0,12.0,7.0,8.0,7.0,12.0,11.0,12.0,16.0,18.0,17.0,3.0,30.0,0.0,0.0,0.0,0.0,185.0,79.0,2.0,3.0,3.0,2.0,3.0,2.0,3.0,2.0,1.0,3.0,3.0,3.0,8.0,7.0,4.0,11.0,4.0,13.0,7.0,7.0,15.0,10.0,4.0,14.0,11.0,13.0,15.0,13.0,14.0,15.0,7.0,13.0,16.0,5.0,12.0,7.0,15.0,13.0,13.0,13.0,14.0,13.0,12.0,9.0,14.0,13.0,20.0,13.0,14.0,14.0,8.0,14.0,7.0,10.0,11.0,15.0,4.0,15.0,15.0,13.0,16.0,7.0,26.0,0.0,0.0,0.0,0.0,190.0,78.0,2.0,1.0,1.0,4.0,3.0,3.0,2.0,2.0,3.0,2.0,1.0,5.0,10.0,11.0,5.0,11.0,6.0,14.0,4.0,12.0,11.0,12.0,8.0,14.0,10.0,15.0,11.0,13.0,11.0,11.0,9.0,10.0,13.0,10.0,9.0,11.0,11.0,12.0,14.0,14.0,11.0,11.0,17.0,20.0,15.0,14.0,10.0,13.0,16.0,13.0,11.0,12.0,5.0,7.0,11.0,12.0,10.0,9.0,13.0,11.0,10.0,6.0,22.0,0.0,0.0,0.0,0.0,175.0,75.0,2.0,1.0,1.0,2.0,2.0,3.0,2.0,3.0,3.0,1.0,2.0,9.0,11.0,3.0,5.0,11.0,6.0,9.0,6.0,6.0,12.0,10.0,8.0,11.0,11.0,9.0,13.0,10.0,10.0,8.0,8.0,16.0,8.0,7.0,10.0,8.0,8.0,10.0,10.0,11.0,9.0,6.0,8.0,20.0,9.0,12.0,8.0,11.0,9.0,9.0,6.0,7.0,9.0,9.0,11.0,11.0,11.0,10.0,13.0,9.0,15.0,2.0,24.0,0.0,0.0,8.0,1.0,181.0,77.0,2.0,2.0,3.0,2.0,3.0,3.0,2.0,2.0,2.0,2.0,2.0,9.0,13.0,15.0,11.0,14.0,9.0,12.0,13.0,7.0,8.0,14.0,7.0,11.0,14.0,14.0,13.0,9.0,14.0,11.0,14.0,14.0,11.0,13.0,11.0,14.0,9.0,15.0,14.0,14.0,15.0,13.0,10.0,10.0,12.0,14.0,20.0,15.0,11.0,13.0,10.0,9.0,6.0,12.0,14.0,12.0,11.0,10.0,13.0,12.0,13.0,7.0,22.0,0.0,0.0,3.0,0.0,187.0,80.0,3.0,3.0,2.0,3.0,1.0,2.0,1.0,3.0,1.0,3.0,2.0,5.0,5.0,6.0,7.0,10.0,3.0,12.0,6.0,5.0,15.0,10.0,8.0,13.0,10.0,12.0,14.0,13.0,10.0,13.0,7.0,15.0,13.0,7.0,12.0,7.0,15.0,11.0,12.0,13.0,12.0,14.0,14.0,10.0,12.0,13.0,20.0,14.0,13.0,13.0,6.0,11.0,6.0,10.0,13.0,13.0,11.0,8.0,17.0,16.0,12.0,3.0,21.0,0.0,0.0,0.0,0.0,188.0,85.0,2.0,1.0,2.0,2.0,3.0,3.0,2.0,2.0,1.0,3.0,4.0,3.0,4.0,13.0,14.0,13.0,4.0,15.0,11.0,8.0,5.0,14.0,12.0,5.0,14.0,13.0,12.0,11.0,9.0,9.0,11.0,9.0,15.0,9.0,7.0,15.0,9.0,17.0,13.0,14.0,14.0,16.0,15.0,20.0,13.0,15.0,7.0,12.0,17.0,12.0,11.0,7.0,6.0,5.0,18.0,15.0,14.0,10.0,13.0,16.0,14.0,5.0,22.0,0.0,0.0,0.0,0.0,187.0,81.0,2.0,3.0,2.0,1.0,3.0,1.0,3.0,3.0,1.0,4.0,1.0,8.0,11.0,9.0,4.0,12.0,7.0,12.0,5.0,11.0,12.0,13.0,7.0,13.0,12.0,16.0,13.0,13.0,13.0,13.0,9.0,12.0,16.0,10.0,10.0,13.0,12.0,14.0,14.0,12.0,13.0,14.0,11.0,6.0,13.0,13.0,20.0,13.0,15.0,12.0,7.0,11.0,11.0,11.0,19.0,14.0,13.0,12.0,13.0,11.0,12.0,6.0,23.0,0.0,0.0,0.0,0.0,186.0,79.0,1.0,2.0,1.0,1.0,3.0,3.0,2.0,3.0,3.0,1.0,4.0,6.0,12.0,13.0,7.0,10.0,7.0,9.0,8.0,8.0,10.0,11.0,8.0,9.0,12.0,9.0,10.0,9.0,8.0,10.0,12.0,10.0,12.0,14.0,7.0,12.0,11.0,12.0,11.0,16.0,13.0,12.0,11.0,11.0,15.0,17.0,20.0,13.0,10.0,9.0,7.0,12.0,5.0,18.0,15.0,15.0,10.0,10.0,12.0,9.0,7.0,5.0,28.0,43.0,2.0,5.0,0.0,190.0,79.0,3.0,1.0,4.0,2.0,3.0,3.0,2.0,1.0,3.0,3.0,1.0,15.0,13.0,14.0,14.0,15.0,15.0,9.0,16.0,5.0,6.0,15.0,16.0,9.0,16.0,13.0,15.0,7.0,14.0,11.0,14.0,15.0,14.0,15.0,11.0,16.0,11.0,11.0,11.0,12.0,13.0,13.0,14.0,20.0,12.0,13.0,12.0,14.0,13.0,12.0,10.0,14.0,7.0,15.0,14.0,14.0,14.0,13.0,16.0,15.0,12.0,7.0,33.0,1.0,0.0,24.0,0.0,193.0,83.0,12.0,14.0,11.0,4.0,13.0,14.0,12.0,14.0,12.0,10.0,14.0,6.0,1.0,2.0,2.0,7.0,9.0,6.0,3.0,3.0,3.0,7.0,5.0,1.0,5.0,8.0,13.0,13.0,12.0,12.0,6.0,13.0,12.0,3.0,10.0,3.0,13.0,15.0,7.0,7.0,8.0,13.0,10.0,5.0,9.0,6.0,20.0,5.0,13.0,16.0,6.0,12.0,7.0,10.0,14.0,15.0,15.0,15.0,16.0,10.0,17.0,8.0,30.0,0.0,0.0,0.0,0.0,170.0,68.0,2.0,2.0,3.0,3.0,1.0,3.0,3.0,2.0,1.0,3.0,2.0,5.0,5.0,10.0,7.0,11.0,5.0,7.0,6.0,6.0,13.0,9.0,6.0,14.0,8.0,17.0,12.0,14.0,13.0,12.0,9.0,13.0,16.0,6.0,11.0,5.0,14.0,14.0,14.0,12.0,10.0,14.0,6.0,5.0,11.0,11.0,20.0,14.0,14.0,14.0,13.0,7.0,14.0,7.0,18.0,12.0,15.0,14.0,16.0,12.0,13.0,7.0,25.0,0.0,0.0,5.0,0.0,173.0,73.0,1.0,4.0,2.0,3.0,3.0,3.0,2.0,3.0,3.0,2.0,1.0,6.0,11.0,15.0,10.0,14.0,8.0,10.0,12.0,8.0,16.0,14.0,10.0,17.0,14.0,16.0,13.0,16.0,14.0,15.0,13.0,14.0,16.0,13.0,11.0,13.0,14.0,16.0,15.0,14.0,14.0,13.0,9.0,8.0,14.0,14.0,20.0,16.0,15.0,14.0,12.0,13.0,12.0,15.0,13.0,13.0,12.0,14.0,14.0,12.0,13.0,9.0,24.0,0.0,0.0,0.0,0.0,184.0,73.0,2.0,2.0,3.0,3.0,3.0,3.0,3.0,1.0,3.0,3.0,4.0,11.0,12.0,15.0,14.0,12.0,11.0,9.0,14.0,6.0,8.0,13.0,12.0,8.0,14.0,12.0,11.0,12.0,11.0,10.0,14.0,12.0,13.0,14.0,8.0,13.0,9.0,12.0,13.0,14.0,14.0,11.0,10.0,12.0,12.0,13.0,20.0,13.0,11.0,12.0,12.0,10.0,9.0,13.0,3.0,14.0,10.0,12.0,7.0,8.0,9.0,7.0,27.0,0.0,0.0,0.0,0.0,183.0,78.0,3.0,1.0,2.0,2.0,4.0,3.0,2.0,3.0,2.0,3.0,1.0,12.0,13.0,12.0,11.0,12.0,11.0,9.0,13.0,8.0,8.0,12.0,12.0,10.0,14.0,12.0,13.0,12.0,12.0,12.0,13.0,14.0,13.0,12.0,10.0,12.0,11.0,13.0,13.0,12.0,12.0,13.0,12.0,20.0,15.0,12.0,6.0,12.0,13.0,12.0,10.0,12.0,7.0,16.0,12.0,11.0,11.0,11.0,11.0,12.0,12.0,8.0,30.0,70.0,3.0,13.0,4.0,178.0,74.0,2.0,1.0,4.0,2.0,2.0,2.0,2.0,3.0,3.0,2.0,1.0,8.0,8.0,13.0,12.0,12.0,13.0,12.0,13.0,10.0,6.0,12.0,12.0,7.0,14.0,6.0,12.0,12.0,13.0,13.0,12.0,12.0,14.0,11.0,13.0,14.0,3.0,14.0,11.0,13.0,14.0,12.0,8.0,11.0,12.0,13.0,20.0,12.0,8.0,12.0,12.0,12.0,6.0,6.0,14.0,16.0,7.0,8.0,14.0,10.0,6.0,13.0,28.0,0.0,0.0,0.0,0.0,190.0,83.0,1.0,2.0,2.0,2.0,1.0,3.0,2.0,1.0,1.0,2.0,2.0,6.0,9.0,6.0,8.0,9.0,5.0,14.0,12.0,8.0,15.0,10.0,9.0,13.0,10.0,16.0,14.0,16.0,12.0,14.0,10.0,13.0,8.0,6.0,10.0,9.0,13.0,16.0,18.0,9.0,9.0,8.0,15.0,7.0,15.0,14.0,20.0,17.0,16.0,16.0,6.0,13.0,7.0,12.0,7.0,10.0,11.0,9.0,10.0,9.0,7.0,8.0,20.0,0.0,0.0,0.0,0.0,192.0,84.0,3.0,2.0,3.0,3.0,3.0,1.0,2.0,1.0,2.0,1.0,3.0,9.0,9.0,9.0,9.0,9.0,8.0,13.0,9.0,10.0,12.0,10.0,8.0,12.0,11.0,15.0,11.0,15.0,11.0,10.0,8.0,9.0,11.0,10.0,6.0,10.0,10.0,14.0,14.0,11.0,11.0,12.0,14.0,5.0,14.0,11.0,20.0,12.0,14.0,10.0,6.0,11.0,14.0,12.0,12.0,12.0,13.0,10.0,12.0,12.0,12.0,5.0,24.0,0.0,0.0,4.0,0.0,175.0,67.0,3.0,1.0,3.0,1.0,1.0,2.0,3.0,1.0,2.0,3.0,3.0,12.0,14.0,13.0,12.0,12.0,9.0,7.0,12.0,5.0,5.0,14.0,10.0,5.0,12.0,15.0,10.0,9.0,12.0,11.0,10.0,11.0,14.0,14.0,6.0,12.0,9.0,12.0,15.0,16.0,13.0,10.0,6.0,5.0,12.0,15.0,20.0,12.0,6.0,10.0,6.0,12.0,7.0,9.0,15.0,13.0,11.0,13.0,14.0,13.0,10.0,5.0,22.0,0.0,0.0,0.0,0.0,186.0,80.0,1.0,3.0,2.0,1.0,2.0,1.0,3.0,1.0,1.0,2.0,3.0,8.0,6.0,7.0,5.0,9.0,5.0,10.0,8.0,9.0,15.0,11.0,5.0,12.0,10.0,10.0,7.0,10.0,11.0,8.0,5.0,14.0,10.0,4.0,1.0,9.0,12.0,9.0,11.0,15.0,15.0,11.0,14.0,20.0,7.0,15.0,11.0,7.0,9.0,10.0,10.0,10.0,5.0,10.0,7.0,13.0,10.0,13.0,11.0,8.0,20.0,1.0,24.0,0.0,0.0,0.0,0.0,181.0,78.0,1.0,2.0,3.0,3.0,3.0,3.0,2.0,4.0,1.0,1.0,3.0,3.0,5.0,7.0,13.0,8.0,7.0,12.0,7.0,4.0,5.0,8.0,9.0,6.0,8.0,14.0,11.0,16.0,10.0,13.0,7.0,12.0,17.0,9.0,10.0,15.0,6.0,12.0,14.0,14.0,11.0,14.0,12.0,10.0,15.0,13.0,20.0,16.0,13.0,13.0,11.0,8.0,12.0,5.0,14.0,12.0,13.0,9.0,12.0,6.0,8.0,7.0
0,0,17.0,2.0,0.0,3.0,0.0,196.0,90.0,15.0,15.0,13.0,5.0,15.0,13.0,14.0,17.0,15.0,14.0,11.0,9.0,2.0,4.0,1.0,10.0,12.0,7.0,2.0,8.0,3.0,8.0,3.0,7.0,8.0,8.0,12.0,15.0,13.0,15.0,9.0,12.0,15.0,7.0,14.0,2.0,13.0,11.0,13.0,9.0,13.0,14.0,18.0,7.0,15.0,12.0,20.0,13.0,14.0,13.0,7.0,10.0,4.0,12.0,12.0,15.0,16.0,16.0,14.0,16.0,14.0,3.0,19.0,0.0,0.0,1.0,0.0,177.0,70.0,3.0,1.0,2.0,1.0,3.0,3.0,3.0,1.0,1.0,1.0,2.0,4.0,12.0,13.0,3.0,13.0,2.0,7.0,8.0,7.0,13.0,12.0,6.0,11.0,13.0,13.0,13.0,12.0,11.0,12.0,10.0,11.0,16.0,5.0,8.0,12.0,12.0,13.0,12.0,15.0,15.0,9.0,9.0,11.0,16.0,14.0,20.0,12.0,8.0,13.0,8.0,7.0,11.0,14.0,11.0,14.0,17.0,11.0,14.0,17.0,14.0,4.0,26.0,8.0,0.0,12.0,3.0,180.0,75.0,2.0,1.0,3.0,2.0,1.0,2.0,3.0,1.0,3.0,2.0,2.0,14.0,14.0,15.0,11.0,15.0,15.0,13.0,15.0,6.0,10.0,14.0,11.0,11.0,14.0,12.0,14.0,13.0,14.0,13.0,14.0,14.0,14.0,14.0,12.0,15.0,12.0,15.0,14.0,15.0,14.0,12.0,11.0,12.0,15.0,14.0,20.0,13.0,11.0,14.0,8.0,15.0,4.0,17.0,17.0,15.0,15.0,13.0,15.0,13.0,14.0,5.0,31.0,0.0,0.0,0.0,0.0,176.0,74.0,3.0,2.0,2.0,2.0,3.0,1.0,2.0,1.0,1.0,1.0,3.0,7.0,13.0,13.0,12.0,11.0,11.0,5.0,9.0,5.0,4.0,11.0,11.0,6.0,12.0,14.0,10.0,15.0,10.0,11.0,11.0,10.0,14.0,13.0,14.0,14.0,7.0,12.0,15.0,15.0,13.0,13.0,8.0,10.0,11.0,15.0,20.0,13.0,11.0,11.0,14.0,15.0,8.0,7.0,13.0,12.0,16.0,10.0,13.0,7.0,7.0,10.0,16.0,0.0,0.0,0.0,0.0,173.0,0.0,2.0,1.0,2.0,4.0,3.0,1.0,3.0,2.0,2.0,2.0,1.0,4.0,7.0,3.0,2.0,4.0,6.0,5.0,2.0,3.0,2.0,4.0,4.0,3.0,6.0,11.0,4.0,16.0,5.0,4.0,5.0,5.0,7.0,15.0,3.0,5.0,3.0,4.0,6.0,15.0,11.0,2.0,7.0,5.0,14.0,13.0,20.0,9.0,2.0,3.0,12.0,6.0,9.0,6.0,5.0,16.0,10.0,6.0,10.0,13.0,9.0,9.0,22.0,21.0,6.0,2.0,0.0,178.0,69.0,3.0,3.0,3.0,3.0,1.0,2.0,3.0,2.0,1.0,2.0,3.0,18.0,16.0,12.0,13.0,17.0,18.0,7.0,17.0,5.0,7.0,14.0,15.0,10.0,17.0,10.0,12.0,8.0,14.0,9.0,15.0,11.0,9.0,17.0,6.0,12.0,8.0,10.0,14.0,12.0,15.0,9.0,6.0,14.0,13.0,12.0,20.0,15.0,8.0,10.0,6.0,13.0,5.0,14.0,11.0,18.0,5.0,14.0,10.0,7.0,11.0,16.0,29.0,62.0,4.0,0.0,0.0,190.0,86.0,2.0,2.0,1.0,4.0,1.0,1.0,1.0,1.0,2.0,1.0,2.0,9.0,9.0,12.0,9.0,13.0,12.0,14.0,12.0,8.0,16.0,17.0,13.0,15.0,13.0,11.0,20.0,16.0,14.0,16.0,19.0,12.0,17.0,13.0,19.0,7.0,20.0,16.0,14.0,14.0,13.0,15.0,14.0,9.0,15.0,14.0,20.0,16.0,15.0,16.0,11.0,14.0,5.0,11.0,14.0,15.0,16.0,14.0,18.0,14.0,9.0,3.0,25.0,3.0,0.0,3.0,0.0,182.0,80.0,2.0,1.0,2.0,1.0,2.0,2.0,2.0,2.0,2.0,1.0,4.0,6.0,7.0,11.0,8.0,13.0,6.0,15.0,8.0,9.0,16.0,15.0,10.0,17.0,14.0,17.0,16.0,16.0,17.0,13.0,10.0,14.0,16.0,8.0,14.0,6.0,17.0,16.0,15.0,13.0,12.0,10.0,12.0,9.0,13.0,13.0,20.0,12.0,13.0,13.0,10.0,13.0,10.0,10.0,13.0,15.0,12.0,14.0,15.0,11.0,12.0,8.0,18.0,0.0,0.0,0.0,0.0,183.0,73.0,2.0,1.0,3.0,2.0,1.0,3.0,1.0,1.0,1.0,2.0,2.0,1.0,1.0,10.0,11.0,10.0,4.0,11.0,7.0,3.0,2.0,7.0,10.0,2.0,12.0,11.0,13.0,12.0,10.0,10.0,10.0,11.0,16.0,10.0,7.0,13.0,3.0,7.0,8.0,13.0,13.0,10.0,11.0,8.0,15.0,14.0,20.0,12.0,9.0,11.0,8.0,6.0,7.0,5.0,14.0,14.0,18.0,12.0,14.0,11.0,13.0,5.0,15.0,0.0,0.0,0.0,0.0,165.0,0.0,2.0,3.0,1.0,2.0,1.0,2.0,3.0,3.0,3.0,3.0,1.0,3.0,5.0,3.0,3.0,5.0,2.0,6.0,4.0,4.0,6.0,7.0,4.0,11.0,5.0,14.0,4.0,9.0,5.0,6.0,4.0,10.0,14.0,13.0,9.0,5.0,5.0,7.0,8.0,11.0,6.0,6.0,5.0,20.0,12.0,6.0,6.0,12.0,6.0,4.0,14.0,11.0,4.0,6.0,14.0,13.0,14.0,11.0,8.0,5.0,8.0,10.0,18.0,0.0,0.0,0.0,0.0,186.0,75.0,3.0,4.0,2.0,1.0,1.0,3.0,2.0,3.0,3.0,3.0,2.0,8.0,6.0,10.0,7.0,15.0,9.0,11.0,12.0,11.0,8.0,15.0,10.0,6.0,16.0,12.0,13.0,9.0,11.0,13.0,14.0,12.0,15.0,13.0,8.0,10.0,13.0,14.0,13.0,13.0,14.0,13.0,14.0,11.0,15.0,14.0,20.0,13.0,10.0,14.0,10.0,8.0,10.0,13.0,9.0,16.0,17.0,12.0,16.0,19.0,15.0,4.0,25.0,0.0,0.0,0.0,0.0,198.0,93.0,14.0,11.0,12.0,6.0,12.0,12.0,12.0,13.0,13.0,12.0,13.0,4.0,1.0,1.0,1.0,8.0,9.0,3.0,1.0,3.0,1.0,11.0,2.0,1.0,8.0,12.0,12.0,14.0,12.0,12.0,11.0,11.0,15.0,2.0,9.0,2.0,12.0,12.0,11.0,9.0,12.0,12.0,16.0,10.0,13.0,10.0,20.0,11.0,12.0,12.0,4.0,12.0,11.0,11.0,14.0,16.0,11.0,12.0,14.0,12.0,13.0,3.0,25.0,1.0,0.0,0.0,0.0,175.0,65.0,2.0,2.0,1.0,3.0,2.0,1.0,3.0,3.0,4.0,1.0,2.0,7.0,12.0,10.0,6.0,8.0,4.0,7.0,8.0,12.0,11.0,10.0,11.0,12.0,10.0,14.0,12.0,13.0,9.0,11.0,10.0,11.0,13.0,8.0,9.0,11.0,11.0,12.0,15.0,15.0,15.0,9.0,8.0,10.0,14.0,15.0,20.0,13.0,7.0,12.0,2.0,13.0,4.0,14.0,8.0,15.0,10.0,13.0,14.0,12.0,14.0,9.0,27.0,0.0,0.0,0.0,0.0,179.0,66.0,3.0,1.0,3.0,2.0,3.0,3.0,2.0,2.0,3.0,1.0,1.0,13.0,13.0,12.0,9.0,12.0,9.0,8.0,13.0,12.0,10.0,12.0,5.0,13.0,13.0,12.0,11.0,13.0,13.0,11.0,10.0,12.0,14.0,13.0,12.0,16.0,10.0,12.0,14.0,15.0,14.0,13.0,9.0,20.0,12.0,15.0,8.0,13.0,10.0,14.0,8.0,10.0,8.0,12.0,10.0,12.0,12.0,12.0,14.0,14.0,14.0,5.0,26.0,26.0,0.0,11.0,2.0,185.0,74.0,4.0,2.0,3.0,4.0,1.0,3.0,1.0,1.0,3.0,2.0,1.0,5.0,6.0,11.0,9.0,10.0,4.0,16.0,7.0,9.0,13.0,11.0,12.0,15.0,10.0,14.0,13.0,17.0,12.0,12.0,8.0,13.0,12.0,9.0,5.0,11.0,13.0,12.0,12.0,11.0,11.0,14.0,14.0,9.0,13.0,12.0,20.0,12.0,11.0,12.0,7.0,10.0,7.0,10.0,14.0,15.0,13.0,14.0,13.0,13.0,11.0,5.0,29.0,28.0,1.0,13.0,7.0,183.0,78.0,3.0,2.0,1.0,1.0,2.0,2.0,1.0,3.0,4.0,2.0,1.0,12.0,14.0,14.0,11.0,13.0,12.0,12.0,12.0,6.0,7.0,14.0,10.0,9.0,14.0,9.0,13.0,11.0,12.0,11.0,13.0,11.0,11.0,14.0,10.0,14.0,8.0,10.0,11.0,13.0,13.0,13.0,12.0,8.0,12.0,14.0,20.0,13.0,12.0,9.0,12.0,12.0,12.0,12.0,16.0,15.0,14.0,13.0,15.0,12.0,10.0,12.0,26.0,0.0,0.0,0.0,0.0,177.0,74.0,2.0,3.0,2.0,2.0,2.0,1.0,2.0,1.0,2.0,1.0,3.0,10.0,10.0,11.0,10.0,12.0,8.0,13.0,10.0,10.0,14.0,13.0,8.0,13.0,13.0,15.0,14.0,15.0,14.0,14.0,11.0,14.0,16.0,8.0,12.0,13.0,14.0,14.0,16.0,12.0,13.0,13.0,7.0,8.0,15.0,13.0,20.0,15.0,12.0,15.0,12.0,13.0,4.0,15.0,13.0,15.0,13.0,13.0,13.0,15.0,15.0,11.0,22.0,0.0,0.0,5.0,3.0,182.0,81.0,3.0,1.0,2.0,4.0,1.0,2.0,2.0,2.0,3.0,3.0,3.0,9.0,10.0,13.0,13.0,13.0,12.0,14.0,12.0,5.0,5.0,11.0,10.0,5.0,14.0,16.0,12.0,16.0,12.0,8.0,12.0,11.0,10.0,14.0,8.0,13.0,8.0,7.0,13.0,13.0,14.0,14.0,11.0,14.0,10.0,13.0,20.0,13.0,13.0,12.0,15.0,11.0,12.0,10.0,10.0,11.0,10.0,11.0,7.0,10.0,5.0,16.0,29.0,0.0,0.0,0.0,0.0,174.0,70.0,3.0,2.0,2.0,3.0,1.0,3.0,3.0,1.0,1.0,1.0,3.0,13.0,14.0,13.0,8.0,12.0,14.0,7.0,13.0,12.0,10.0,13.0,14.0,10.0,13.0,13.0,14.0,13.0,13.0,12.0,12.0,12.0,11.0,11.0,10.0,12.0,10.0,13.0,14.0,14.0,13.0,9.0,8.0,8.0,13.0,15.0,20.0,13.0,9.0,12.0,10.0,10.0,7.0,14.0,14.0,12.0,14.0,12.0,16.0,12.0,12.0,6.0,17.0,0.0,0.0,0.0,0.0,173.0,67.0,1.0,2.0,1.0,3.0,3.0,3.0,2.0,1.0,2.0,3.0,3.0,2.0,9.0,11.0,12.0,12.0,4.0,6.0,3.0,2.0,2.0,12.0,7.0,2.0,11.0,8.0,12.0,8.0,12.0,12.0,9.0,12.0,3.0,9.0,8.0,11.0,4.0,9.0,10.0,12.0,12.0,6.0,7.0,6.0,11.0,12.0,20.0,6.0,4.0,5.0,8.0,8.0,8.0,8.0,19.0,13.0,11.0,10.0,13.0,13.0,12.0,1.0,24.0,7.0,1.0,6.0,0.0,176.0,73.0,1.0,1.0,3.0,3.0,4.0,1.0,2.0,1.0,1.0,2.0,3.0,14.0,13.0,13.0,12.0,13.0,14.0,10.0,12.0,6.0,8.0,15.0,14.0,8.0,15.0,13.0,13.0,12.0,13.0,13.0,15.0,13.0,13.0,13.0,13.0,12.0,8.0,13.0,13.0,12.0,14.0,9.0,7.0,10.0,13.0,12.0,20.0,12.0,8.0,13.0,12.0,14.0,4.0,12.0,11.0,14.0,13.0,14.0,16.0,11.0,12.0,3.0,21.0,1.0,0.0,8.0,0.0,193.0,85.0,4.0,1.0,1.0,2.0,3.0,2.0,1.0,2.0,1.0,3.0,1.0,3.0,8.0,8.0,6.0,12.0,6.0,13.0,5.0,6.0,12.0,12.0,6.0,10.0,11.0,12.0,13.0,13.0,13.0,13.0,8.0,12.0,12.0,4.0,9.0,5.0,12.0,12.0,12.0,9.0,9.0,13.0,16.0,15.0,13.0,9.0,20.0,12.0,13.0,13.0,8.0,12.0,6.0,12.0,16.0,13.0,13.0,14.0,14.0,14.0,14.0,6.0
2,2,31.0,0.0,0.0,4.0,0.0,188.0,81.0,13.0,13.0,12.0,11.0,13.0,12.0,17.0,17.0,13.0,11.0,13.0,3.0,3.0,4.0,1.0,5.0,3.0,4.0,3.0,7.0,3.0,7.0,4.0,5.0,4.0,9.0,13.0,13.0,7.0,7.0,7.0,12.0,12.0,9.0,11.0,1.0,12.0,11.0,11.0,11.0,14.0,15.0,14.0,8.0,10.0,10.0,20.0,13.0,14.0,12.0,4.0,10.0,10.0,1.0,13.0,16.0,11.0,9.0,13.0,14.0,15.0,12.0,16.0,0.0,0.0,0.0,0.0,184.0,0.0,2.0,2.0,3.0,1.0,1.0,1.0,3.0,4.0,2.0,2.0,2.0,9.0,7.0,8.0,8.0,12.0,13.0,7.0,12.0,4.0,9.0,14.0,8.0,7.0,9.0,11.0,8.0,7.0,8.0,10.0,12.0,13.0,20.0,4.0,12.0,8.0,12.0,14.0,11.0,10.0,10.0,7.0,13.0,2.0,11.0,10.0,20.0,13.0,9.0,11.0,9.0,14.0,5.0,8.0,7.0,10.0,17.0,7.0,13.0,13.0,16.0,10.0,20.0,1.0,0.0,1.0,0.0,179.0,72.0,1.0,4.0,2.0,1.0,2.0,1.0,1.0,3.0,3.0,1.0,2.0,8.0,14.0,13.0,12.0,15.0,6.0,8.0,13.0,7.0,13.0,15.0,9.0,14.0,15.0,14.0,15.0,8.0,11.0,12.0,15.0,11.0,14.0,12.0,11.0,14.0,15.0,12.0,9.0,12.0,15.0,12.0,9.0,10.0,12.0,12.0,20.0,13.0,12.0,14.0,7.0,12.0,7.0,10.0,13.0,16.0,13.0,17.0,15.0,15.0,15.0,4.0,29.0,38.0,13.0,0.0,0.0,181.0,77.0,3.0,2.0,1.0,1.0,1.0,2.0,1.0,3.0,1.0,1.0,3.0,6.0,10.0,14.0,17.0,14.0,6.0,13.0,12.0,8.0,5.0,13.0,17.0,6.0,15.0,13.0,14.0,17.0,16.0,14.0,12.0,14.0,15.0,15.0,14.0,17.0,6.0,12.0,13.0,15.0,15.0,16.0,11.0,10.0,14.0,16.0,20.0,14.0,15.0,13.0,12.0,13.0,6.0,7.0,14.0,15.0,13.0,13.0,14.0,15.0,11.0,10.0,28.0,0.0,0.0,0.0,0.0,171.0,66.0,2.0,3.0,2.0,2.0,2.0,1.0,2.0,3.0,4.0,2.0,3.0,12.0,14.0,11.0,7.0,12.0,8.0,7.0,10.0,13.0,12.0,12.0,6.0,15.0,12.0,15.0,14.0,15.0,11.0,13.0,11.0,12.0,15.0,11.0,6.0,14.0,13.0,16.0,16.0,17.0,14.0,15.0,6.0,20.0,14.0,16.0,6.0,16.0,9.0,16.0,13.0,13.0,5.0,9.0,16.0,12.0,13.0,13.0,14.0,11.0,12.0,6.0,24.0,0.0,0.0,0.0,0.0,178.0,70.0,2.0,1.0,3.0,3.0,4.0,1.0,3.0,1.0,2.0,1.0,1.0,15.0,13.0,14.0,10.0,16.0,14.0,8.0,13.0,6.0,8.0,16.0,13.0,9.0,16.0,13.0,14.0,11.0,16.0,13.0,16.0,15.0,13.0,13.0,10.0,13.0,10.0,15.0,14.0,11.0,17.0,11.0,9.0,11.0,14.0,11.0,20.0,15.0,8.0,11.0,9.0,12.0,5.0,10.0,20.0,12.0,14.0,15.0,14.0,13.0,13.0,6.0,19.0,2.0,0.0,13.0,3.0,185.0,75.0,3.0,3.0,4.0,4.0,2.0,2.0,3.0,3.0,3.0,2.0,1.0,4.0,7.0,12.0,15.0,14.0,15.0,12.0,13.0,3.0,1.0,10.0,14.0,2.0,15.0,7.0,10.0,10.0,13.0,10.0,10.0,10.0,15.0,14.0,11.0,14.0,3.0,11.0,12.0,12.0,15.0,12.0,10.0,16.0,12.0,12.0,20.0,11.0,12.0,13.0,4.0,3.0,11.0,10.0,8.0,15.0,12.0,12.0,15.0,12.0,10.0,5.0,25.0,8.0,0.0,14.0,2.0,182.0,76.0,3.0,1.0,1.0,1.0,2.0,1.0,2.0,3.0,1.0,1.0,2.0,11.0,11.0,14.0,12.0,14.0,10.0,9.0,13.0,5.0,9.0,15.0,9.0,10.0,16.0,10.0,14.0,13.0,13.0,13.0,15.0,14.0,13.0,14.0,10.0,14.0,13.0,14.0,14.0,14.0,14.0,13.0,10.0,12.0,12.0,13.0,20.0,14.0,13.0,13.0,12.0,12.0,7.0,12.0,16.0,14.0,12.0,13.0,10.0,12.0,10.0,8.0,31.0,0.0,0.0,0.0,0.0,181.0,78.0,1.0,4.0,2.0,2.0,3.0,3.0,4.0,2.0,1.0,4.0,3.0,10.0,8.0,10.0,7.0,11.0,10.0,6.0,9.0,3.0,4.0,12.0,10.0,4.0,13.0,11.0,8.0,10.0,10.0,7.0,12.0,7.0,9.0,13.0,9.0,11.0,7.0,10.0,11.0,14.0,12.0,10.0,11.0,8.0,12.0,12.0,20.0,14.0,11.0,9.0,7.0,10.0,7.0,9.0,9.0,9.0,12.0,10.0,12.0,7.0,19.0,5.0,35.0,16.0,0.0,34.0,0.0,183.0,74.0,3.0,1.0,2.0,2.0,2.0,1.0,1.0,3.0,1.0,2.0,2.0,2.0,9.0,8.0,4.0,10.0,2.0,14.0,8.0,13.0,16.0,11.0,5.0,14.0,11.0,13.0,14.0,13.0,15.0,14.0,9.0,13.0,14.0,5.0,15.0,10.0,16.0,15.0,14.0,11.0,11.0,10.0,11.0,9.0,9.0,11.0,20.0,13.0,13.0,13.0,15.0,8.0,15.0,12.0,13.0,13.0,17.0,13.0,16.0,15.0,16.0,8.0,19.0,0.0,0.0,9.0,0.0,183.0,71.0,2.0,3.0,4.0,3.0,1.0,3.0,1.0,2.0,1.0,1.0,3.0,6.0,6.0,5.0,7.0,13.0,6.0,4.0,7.0,1.0,9.0,13.0,5.0,8.0,13.0,9.0,10.0,8.0,8.0,7.0,11.0,12.0,9.0,9.0,1.0,7.0,12.0,7.0,11.0,12.0,12.0,7.0,5.0,8.0,10.0,13.0,20.0,7.0,8.0,9.0,7.0,4.0,9.0,9.0,20.0,10.0,11.0,10.0,12.0,9.0,4.0,2.0,33.0,3.0,0.0,17.0,0.0,190.0,80.0,12.0,12.0,11.0,15.0,13.0,13.0,14.0,15.0,12.0,16.0,14.0,2.0,1.0,1.0,1.0,4.0,3.0,3.0,2.0,4.0,6.0,10.0,2.0,8.0,4.0,13.0,3.0,12.0,10.0,10.0,7.0,10.0,16.0,1.0,11.0,6.0,15.0,13.0,14.0,10.0,11.0,15.0,14.0,8.0,12.0,7.0,20.0,17.0,15.0,9.0,1.0,12.0,5.0,2.0,15.0,12.0,11.0,12.0,16.0,17.0,9.0,5.0,21.0,0.0,0.0,1.0,0.0,186.0,73.0,1.0,2.0,2.0,1.0,2.0,3.0,3.0,1.0,3.0,1.0,2.0,13.0,14.0,12.0,10.0,10.0,16.0,4.0,6.0,7.0,10.0,11.0,8.0,12.0,13.0,7.0,7.0,10.0,12.0,13.0,13.0,10.0,15.0,14.0,11.0,13.0,11.0,14.0,15.0,15.0,14.0,7.0,11.0,20.0,8.0,15.0,5.0,14.0,11.0,11.0,11.0,8.0,11.0,13.0,14.0,12.0,16.0,15.0,15.0,16.0,15.0,2.0,24.0,0.0,0.0,7.0,0.0,187.0,86.0,1.0,1.0,2.0,1.0,3.0,3.0,3.0,1.0,2.0,1.0,1.0,9.0,12.0,12.0,6.0,10.0,7.0,6.0,6.0,8.0,10.0,9.0,8.0,14.0,11.0,14.0,10.0,15.0,14.0,15.0,8.0,10.0,13.0,14.0,12.0,9.0,11.0,13.0,14.0,12.0,14.0,14.0,11.0,8.0,12.0,12.0,20.0,14.0,14.0,14.0,12.0,12.0,8.0,8.0,11.0,12.0,10.0,10.0,13.0,10.0,10.0,10.0,22.0,0.0,0.0,1.0,0.0,170.0,60.0,1.0,1.0,2.0,1.0,3.0,3.0,3.0,1.0,1.0,1.0,1.0,14.0,14.0,13.0,10.0,14.0,14.0,6.0,8.0,9.0,7.0,14.0,11.0,9.0,14.0,7.0,10.0,6.0,8.0,12.0,11.0,11.0,12.0,14.0,6.0,11.0,9.0,11.0,13.0,8.0,15.0,7.0,6.0,15.0,7.0,15.0,20.0,15.0,7.0,10.0,7.0,7.0,12.0,13.0,8.0,13.0,11.0,13.0,12.0,12.0,11.0,10.0,32.0,38.0,4.0,17.0,0.0,178.0,70.0,1.0,2.0,3.0,1.0,1.0,3.0,2.0,3.0,1.0,3.0,1.0,15.0,13.0,14.0,11.0,15.0,13.0,7.0,9.0,7.0,4.0,16.0,10.0,8.0,16.0,10.0,14.0,12.0,11.0,11.0,15.0,14.0,15.0,13.0,13.0,15.0,9.0,11.0,12.0,12.0,13.0,11.0,8.0,18.0,14.0,13.0,20.0,12.0,8.0,11.0,6.0,11.0,10.0,12.0,16.0,16.0,13.0,11.0,18.0,14.0,11.0,8.0,22.0,0.0,0.0,12.0,1.0,189.0,78.0,4.0,3.0,1.0,2.0,3.0,2.0,1.0,3.0,2.0,2.0,3.0,15.0,15.0,7.0,6.0,13.0,15.0,6.0,14.0,10.0,10.0,15.0,12.0,10.0,10.0,5.0,12.0,5.0,7.0,8.0,6.0,8.0,15.0,11.0,9.0,15.0,14.0,14.0,14.0,15.0,14.0,9.0,12.0,20.0,14.0,16.0,10.0,11.0,11.0,8.0,5.0,10.0,6.0,15.0,10.0,11.0,14.0,13.0,15.0,15.0,10.0,8.0,24.0,4.0,0.0,0.0,0.0,192.0,87.0,1.0,3.0,4.0,1.0,3.0,1.0,1.0,2.0,1.0,1.0,3.0,1.0,3.0,11.0,4.0,11.0,4.0,15.0,5.0,5.0,14.0,8.0,2.0,13.0,14.0,12.0,10.0,14.0,10.0,5.0,9.0,10.0,13.0,18.0,7.0,9.0,10.0,8.0,9.0,15.0,14.0,19.0,19.0,20.0,14.0,14.0,11.0,14.0,19.0,10.0,8.0,12.0,8.0,13.0,12.0,12.0,8.0,12.0,11.0,8.0,9.0,10.0,21.0,0.0,0.0,7.0,1.0,190.0,84.0,2.0,2.0,1.0,2.0,1.0,1.0,2.0,1.0,2.0,2.0,3.0,2.0,4.0,5.0,9.0,5.0,2.0,16.0,10.0,2.0,12.0,8.0,4.0,14.0,5.0,15.0,13.0,16.0,12.0,11.0,5.0,10.0,16.0,5.0,12.0,10.0,13.0,13.0,13.0,11.0,11.0,16.0,17.0,8.0,12.0,12.0,20.0,14.0,17.0,10.0,10.0,13.0,10.0,10.0,10.0,13.0,13.0,14.0,15.0,17.0,10.0,9.0,25.0,0.0,0.0,4.0,0.0,182.0,79.0,3.0,2.0,2.0,2.0,1.0,1.0,1.0,2.0,1.0,2.0,3.0,2.0,10.0,10.0,8.0,10.0,10.0,15.0,8.0,10.0,14.0,12.0,5.0,14.0,10.0,11.0,12.0,14.0,12.0,14.0,8.0,12.0,14.0,12.0,12.0,10.0,14.0,12.0,14.0,13.0,10.0,12.0,15.0,8.0,15.0,12.0,20.0,7.0,14.0,15.0,5.0,13.0,10.0,8.0,11.0,12.0,18.0,12.0,13.0,12.0,10.0,8.0,20.0,0.0,0.0,3.0,1.0,179.0,72.0,3.0,2.0,2.0,2.0,3.0,1.0,2.0,3.0,4.0,1.0,1.0,6.0,8.0,11.0,13.0,15.0,11.0,9.0,10.0,7.0,9.0,15.0,7.0,10.0,12.0,10.0,11.0,9.0,10.0,9.0,13.0,11.0,13.0,11.0,10.0,9.0,10.0,10.0,12.0,14.0,10.0,9.0,8.0,11.0,14.0,13.0,20.0,11.0,9.0,10.0,9.0,10.0,6.0,9.0,10.0,12.0,12.0,14.0,12.0,11.0,12.0,10.0,26.0,42.0,12.0,20.0,14.0,193.0,84.0,2.0,3.0,2.0,1.0,1.0,2.0,3.0,2.0,1.0,1.0,1.0,5.0,6.0,10.0,14.0,13.0,5.0,18.0,10.0,5.0,7.0,7.0,14.0,8.0,10.0,15.0,13.0,14.0,13.0,12.0,12.0,13.0,14.0,8.0,9.0,15.0,7.0,15.0,8.0,10.0,7.0,16.0,17.0,10.0,13.0,11.0,20.0,11.0,17.0,12.0,6.0,14.0,5.0,3.0,14.0,17.0,13.0,10.0,18.0,15.0,17.0,4.0
1,0,21.0,0.0,0.0,12.0,0.0,192.0,80.0,14.0,11.0,12.0,11.0,13.0,13.0,14.0,15.0,10.0,10.0,10.0,6.0,3.0,3.0,2.0,10.0,11.0,10.0,1.0,1.0,2.0,11.0,2.0,1.0,8.0,8.0,10.0,10.0,10.0,12.0,8.0,13.0,18.0,11.0,7.0,3.0,13.0,10.0,16.0,12.0,14.0,13.0,18.0,8.0,15.0,13.0,20.0,14.0,14.0,14.0,14.0,12.0,7.0,11.0,14.0,15.0,14.0,15.0,15.0,15.0,15.0,5.0,24.0,30.0,3.0,12.0,0.0,189.0,75.0,3.0,2.0,1.0,3.0,4.0,1.0,2.0,1.0,4.0,2.0,3.0,5.0,6.0,11.0,6.0,12.0,5.0,15.0,5.0,5.0,16.0,13.0,8.0,16.0,12.0,14.0,16.0,15.0,13.0,13.0,13.0,14.0,15.0,12.0,12.0,9.0,15.0,15.0,15.0,12.0,12.0,13.0,15.0,15.0,15.0,13.0,20.0,14.0,15.0,16.0,9.0,15.0,14.0,13.0,16.0,15.0,14.0,17.0,17.0,17.0,16.0,2.0,21.0,0.0,0.0,0.0,0.0,181.0,74.0,3.0,1.0,3.0,2.0,2.0,1.0,2.0,3.0,2.0,3.0,4.0,3.0,10.0,10.0,10.0,11.0,3.0,9.0,10.0,6.0,8.0,10.0,10.0,8.0,11.0,14.0,9.0,12.0,6.0,6.0,9.0,6.0,13.0,13.0,3.0,11.0,8.0,11.0,11.0,13.0,11.0,11.0,9.0,20.0,13.0,12.0,3.0,12.0,11.0,12.0,14.0,11.0,5.0,14.0,11.0,11.0,10.0,11.0,11.0,10.0,6.0,10.0,21.0,5.0,0.0,9.0,0.0,177.0,83.0,2.0,3.0,3.0,3.0,1.0,2.0,4.0,1.0,1.0,2.0,2.0,11.0,14.0,13.0,6.0,13.0,9.0,7.0,9.0,5.0,12.0,10.0,10.0,13.0,13.0,14.0,12.0,14.0,11.0,11.0,8.0,10.0,15.0,12.0,8.0,12.0,12.0,12.0,13.0,15.0,12.0,13.0,10.0,20.0,16.0,16.0,15.0,12.0,14.0,10.0,14.0,12.0,12.0,14.0,13.0,13.0,12.0,12.0,10.0,14.0,13.0,4.0,29.0,24.0,0.0,9.0,4.0,179.0,74.0,2.0,3.0,1.0,1.0,2.0,1.0,3.0,2.0,3.0,4.0,3.0,7.0,8.0,11.0,5.0,15.0,8.0,12.0,4.0,5.0,15.0,16.0,9.0,15.0,14.0,15.0,18.0,14.0,16.0,16.0,9.0,15.0,16.0,10.0,11.0,14.0,17.0,16.0,16.0,11.0,14.0,14.0,12.0,10.0,14.0,10.0,20.0,15.0,13.0,15.0,11.0,14.0,8.0,11.0,18.0,14.0,18.0,16.0,17.0,12.0,15.0,6.0,26.0,0.0,0.0,0.0,0.0,173.0,63.0,3.0,2.0,1.0,2.0,2.0,1.0,1.0,2.0,3.0,2.0,3.0,6.0,4.0,3.0,6.0,14.0,4.0,6.0,6.0,1.0,7.0,9.0,1.0,7.0,12.0,8.0,8.0,4.0,9.0,7.0,10.0,14.0,8.0,8.0,8.0,9.0,5.0,8.0,12.0,14.0,14.0,7.0,6.0,5.0,8.0,14.0,20.0,11.0,8.0,8.0,8.0,8.0,5.0,8.0,12.0,8.0,10.0,10.0,14.0,13.0,18.0,2.0,32.0,0.0,0.0,0.0,0.0,183.0,80.0,3.0,2.0,3.0,1.0,2.0,3.0,2.0,3.0,3.0,2.0,3.0,9.0,9.0,10.0,9.0,12.0,8.0,12.0,14.0,10.0,12.0,12.0,12.0,14.0,12.0,15.0,13.0,14.0,12.0,13.0,12.0,12.0,12.0,10.0,13.0,12.0,14.0,14.0,13.0,10.0,10.0,12.0,11.0,7.0,12.0,10.0,20.0,11.0,11.0,14.0,11.0,12.0,13.0,16.0,14.0,14.0,14.0,12.0,11.0,10.0,10.0,10.0,27.0,55.0,15.0,0.0,0.0,187.0,81.0,3.0,2.0,1.0,1.0,2.0,1.0,3.0,3.0,1.0,1.0,2.0,7.0,12.0,12.0,15.0,12.0,9.0,14.0,15.0,7.0,7.0,12.0,14.0,8.0,14.0,14.0,14.0,14.0,15.0,13.0,13.0,13.0,15.0,14.0,9.0,11.0,8.0,11.0,10.0,14.0,14.0,12.0,14.0,20.0,12.0,14.0,10.0,16.0,14.0,12.0,8.0,11.0,11.0,8.0,15.0,17.0,10.0,10.0,15.0,15.0,12.0,5.0,25.0,0.0,0.0,0.0,0.0,178.0,73.0,2.0,2.0,1.0,1.0,3.0,1.0,3.0,2.0,1.0,2.0,1.0,10.0,12.0,12.0,9.0,11.0,11.0,6.0,11.0,12.0,8.0,11.0,12.0,8.0,12.0,13.0,11.0,12.0,10.0,11.0,10.0,11.0,14.0,13.0,6.0,12.0,9.0,11.0,12.0,14.0,14.0,7.0,7.0,16.0,16.0,14.0,20.0,11.0,8.0,13.0,11.0,12.0,6.0,16.0,12.0,14.0,8.0,14.0,11.0,9.0,13.0,13.0,23.0,9.0,0.0,0.0,0.0,185.0,81.0,2.0,2.0,2.0,2.0,3.0,1.0,3.0,3.0,2.0,3.0,1.0,11.0,11.0,10.0,10.0,11.0,10.0,10.0,12.0,11.0,10.0,11.0,12.0,10.0,11.0,10.0,10.0,13.0,12.0,12.0,10.0,12.0,14.0,12.0,11.0,10.0,11.0,12.0,13.0,15.0,10.0,15.0,13.0,5.0,12.0,16.0,20.0,12.0,14.0,14.0,10.0,11.0,8.0,13.0,14.0,12.0,11.0,12.0,12.0,2.0,17.0,12.0,19.0,0.0,0.0,0.0,0.0,185.0,78.0,1.0,3.0,3.0,3.0,1.0,3.0,1.0,2.0,2.0,2.0,2.0,12.0,9.0,11.0,11.0,13.0,14.0,11.0,13.0,6.0,6.0,13.0,12.0,11.0,12.0,15.0,12.0,13.0,11.0,12.0,13.0,10.0,17.0,13.0,10.0,13.0,13.0,15.0,17.0,11.0,12.0,12.0,11.0,12.0,16.0,13.0,20.0,10.0,13.0,15.0,11.0,14.0,6.0,9.0,11.0,15.0,17.0,16.0,17.0,16.0,15.0,4.0,23.0,0.0,0.0,3.0,0.0,192.0,94.0,13.0,12.0,13.0,7.0,13.0,8.0,17.0,16.0,10.0,15.0,15.0,5.0,1.0,1.0,1.0,11.0,9.0,6.0,1.0,2.0,1.0,12.0,2.0,3.0,12.0,2.0,13.0,15.0,10.0,11.0,7.0,9.0,9.0,6.0,6.0,2.0,12.0,10.0,10.0,13.0,15.0,12.0,13.0,9.0,9.0,12.0,20.0,8.0,9.0,12.0,4.0,13.0,4.0,11.0,10.0,11.0,14.0,9.0,10.0,1.0,14.0,7.0,24.0,0.0,0.0,2.0,0.0,179.0,72.0,2.0,2.0,3.0,3.0,3.0,3.0,1.0,1.0,1.0,2.0,1.0,12.0,14.0,12.0,7.0,13.0,12.0,6.0,10.0,5.0,10.0,13.0,10.0,12.0,13.0,12.0,13.0,11.0,12.0,12.0,12.0,12.0,17.0,8.0,9.0,13.0,11.0,14.0,15.0,14.0,13.0,12.0,7.0,8.0,14.0,13.0,20.0,15.0,10.0,14.0,12.0,14.0,8.0,15.0,11.0,14.0,13.0,9.0,14.0,15.0,15.0,7.0,23.0,0.0,0.0,0.0,0.0,185.0,67.0,3.0,1.0,3.0,1.0,2.0,2.0,3.0,1.0,2.0,2.0,1.0,13.0,11.0,14.0,13.0,13.0,12.0,3.0,14.0,5.0,5.0,15.0,11.0,5.0,14.0,6.0,12.0,11.0,13.0,13.0,12.0,12.0,15.0,11.0,2.0,12.0,12.0,14.0,13.0,11.0,13.0,12.0,7.0,10.0,7.0,13.0,20.0,14.0,8.0,13.0,10.0,13.0,10.0,9.0,9.0,11.0,12.0,10.0,12.0,10.0,17.0,3.0,32.0,121.0,29.0,1.0,0.0,170.0,67.0,2.0,1.0,2.0,1.0,1.0,3.0,2.0,1.0,3.0,1.0,1.0,15.0,16.0,11.0,14.0,18.0,17.0,7.0,18.0,6.0,2.0,17.0,13.0,5.0,18.0,12.0,16.0,9.0,12.0,13.0,19.0,16.0,17.0,17.0,15.0,15.0,9.0,15.0,8.0,13.0,13.0,11.0,6.0,17.0,13.0,9.0,20.0,11.0,8.0,13.0,10.0,17.0,6.0,17.0,16.0,16.0,17.0,19.0,16.0,14.0,10.0,12.0,23.0,0.0,0.0,1.0,0.0,181.0,78.0,1.0,2.0,2.0,3.0,1.0,3.0,1.0,1.0,1.0,2.0,2.0,5.0,12.0,14.0,13.0,14.0,8.0,14.0,12.0,7.0,5.0,12.0,12.0,6.0,14.0,10.0,13.0,10.0,13.0,13.0,11.0,12.0,13.0,11.0,6.0,13.0,10.0,9.0,12.0,16.0,14.0,13.0,10.0,8.0,14.0,15.0,20.0,13.0,14.0,13.0,8.0,7.0,9.0,8.0,16.0,14.0,13.0,12.0,13.0,15.0,15.0,7.0,21.0,0.0,0.0,3.0,0.0,174.0,70.0,3.0,1.0,3.0,3.0,2.0,2.0,1.0,3.0,3.0,2.0,1.0,10.0,11.0,12.0,10.0,13.0,8.0,7.0,11.0,6.0,10.0,14.0,11.0,8.0,13.0,7.0,11.0,11.0,12.0,12.0,14.0,11.0,8.0,11.0,10.0,12.0,8.0,13.0,14.0,13.0,14.0,13.0,9.0,20.0,11.0,12.0,8.0,13.0,11.0,13.0,7.0,10.0,5.0,12.0,13.0,11.0,12.0,9.0,11.0,12.0,10.0,5.0,26.0,0.0,0.0,0.0,0.0,185.0,77.0,3.0,3.0,1.0,2.0,2.0,2.0,3.0,4.0,1.0,1.0,3.0,7.0,12.0,10.0,6.0,11.0,7.0,14.0,5.0,11.0,14.0,14.0,6.0,15.0,12.0,17.0,13.0,15.0,11.0,13.0,11.0,13.0,15.0,7.0,8.0,10.0,11.0,13.0,14.0,12.0,12.0,14.0,13.0,20.0,12.0,13.0,5.0,15.0,13.0,13.0,12.0,14.0,10.0,12.0,20.0,13.0,16.0,12.0,14.0,14.0,14.0,5.0,24.0,0.0,0.0,5.0,0.0,168.0,68.0,4.0,2.0,2.0,1.0,1.0,2.0,2.0,3.0,4.0,4.0,2.0,8.0,12.0,12.0,8.0,14.0,7.0,7.0,7.0,6.0,14.0,13.0,11.0,14.0,11.0,14.0,13.0,14.0,12.0,12.0,13.0,14.0,14.0,8.0,7.0,8.0,10.0,15.0,18.0,16.0,14.0,14.0,5.0,8.0,15.0,13.0,20.0,17.0,12.0,12.0,11.0,14.0,7.0,12.0,8.0,14.0,14.0,13.0,14.0,14.0,14.0,6.0,32.0,11.0,1.0,0.0,0.0,176.0,68.0,2.0,1.0,3.0,2.0,2.0,2.0,2.0,3.0,3.0,2.0,2.0,8.0,10.0,10.0,7.0,11.0,8.0,10.0,11.0,12.0,11.0,13.0,12.0,14.0,12.0,9.0,14.0,15.0,13.0,12.0,11.0,12.0,17.0,8.0,14.0,14.0,11.0,18.0,18.0,14.0,14.0,12.0,10.0,10.0,14.0,13.0,20.0,17.0,13.0,15.0,9.0,13.0,8.0,13.0,17.0,13.0,15.0,16.0,16.0,16.0,18.0,5.0,20.0,0.0,0.0,1.0,0.0,168.0,58.0,2.0,3.0,2.0,1.0,2.0,1.0,2.0,3.0,1.0,3.0,3.0,10.0,13.0,13.0,10.0,14.0,10.0,8.0,8.0,5.0,12.0,14.0,10.0,12.0,13.0,14.0,13.0,12.0,13.0,14.0,13.0,13.0,13.0,12.0,8.0,12.0,12.0,14.0,14.0,14.0,15.0,14.0,6.0,12.0,14.0,13.0,20.0,14.0,7.0,14.0,6.0,12.0,5.0,10.0,9.0,13.0,14.0,13.0,14.0,13.0,15.0,7.0,32.0,13.0,2.0,0.0,0.0,187.0,82.0,4.0,3.0,3.0,1.0,3.0,3.0,3.0,3.0,3.0,3.0,2.0,6.0,10.0,12.0,8.0,14.0,7.0,15.0,7.0,12.0,17.0,15.0,10.0,18.0,13.0,12.0,16.0,18.0,17.0,12.0,14.0,12.0,18.0,16.0,15.0,6.0,16.0,10.0,9.0,8.0,11.0,17.0,14.0,20.0,15.0,10.0,12.0,13.0,15.0,16.0,14.0,15.0,7.0,10.0,16.0,14.0,9.0,17.0,14.0,7.0,8.0,13.0
0,0,21.0,0.0,0.0,0.0,0.0,199.0,92.0,17.0,9.0,12.0,1.0,12.0,7.0,11.0,14.0,9.0,10.0,9.0,4.0,3.0,3.0,2.0,6.0,6.0,6.0,1.0,2.0,3.0,5.0,3.0,1.0,5.0,9.0,11.0,12.0,11.0,11.0,10.0,10.0,12.0,1.0,12.0,2.0,12.0,12.0,10.0,6.0,12.0,15.0,18.0,4.0,13.0,7.0,20.0,11.0,12.0,12.0,10.0,6.0,6.0,10.0,17.0,12.0,11.0,11.0,12.0,12.0,12.0,5.0,30.0,27.0,2.0,2.0,0.0,178.0,78.0,2.0,2.0,1.0,1.0,1.0,1.0,3.0,2.0,1.0,1.0,1.0,8.0,13.0,13.0,8.0,12.0,7.0,14.0,9.0,12.0,14.0,11.0,8.0,16.0,11.0,14.0,14.0,17.0,12.0,14.0,12.0,13.0,17.0,11.0,12.0,13.0,15.0,14.0,15.0,13.0,13.0,13.0,12.0,9.0,12.0,13.0,20.0,13.0,11.0,14.0,14.0,14.0,13.0,18.0,14.0,13.0,13.0,15.0,16.0,13.0,12.0,8.0,24.0,34.0,2.0,7.0,0.0,174.0,65.0,2.0,3.0,2.0,3.0,2.0,1.0,1.0,4.0,3.0,3.0,3.0,12.0,12.0,15.0,11.0,16.0,11.0,6.0,12.0,3.0,8.0,15.0,12.0,12.0,16.0,15.0,15.0,17.0,14.0,14.0,16.0,15.0,13.0,16.0,13.0,16.0,11.0,17.0,15.0,14.0,14.0,16.0,6.0,20.0,13.0,13.0,8.0,14.0,11.0,14.0,13.0,15.0,15.0,15.0,11.0,15.0,17.0,14.0,12.0,10.0,10.0,14.0,29.0,55.0,20.0,0.0,0.0,192.0,88.0,1.0,3.0,1.0,2.0,3.0,2.0,1.0,3.0,2.0,2.0,2.0,4.0,8.0,12.0,16.0,14.0,12.0,18.0,14.0,3.0,8.0,11.0,14.0,7.0,15.0,14.0,16.0,17.0,14.0,14.0,14.0,14.0,16.0,13.0,9.0,16.0,9.0,19.0,18.0,11.0,10.0,19.0,17.0,20.0,15.0,13.0,10.0,15.0,19.0,15.0,10.0,16.0,8.0,3.0,15.0,14.0,14.0,15.0,16.0,14.0,14.0,8.0,27.0,43.0,8.0,21.0,6.0,176.0,71.0,3.0,1.0,3.0,3.0,1.0,1.0,1.0,3.0,1.0,1.0,1.0,13.0,11.0,14.0,14.0,12.0,10.0,5.0,7.0,3.0,6.0,12.0,10.0,7.0,13.0,9.0,12.0,10.0,13.0,12.0,11.0,12.0,13.0,13.0,3.0,14.0,8.0,13.0,14.0,19.0,16.0,12.0,7.0,9.0,13.0,18.0,20.0,14.0,9.0,12.0,4.0,13.0,13.0,14.0,12.0,17.0,15.0,11.0,15.0,18.0,17.0,7.0,20.0,0.0,0.0,2.0,0.0,188.0,83.0,1.0,3.0,1.0,4.0,3.0,1.0,1.0,2.0,3.0,2.0,2.0,5.0,8.0,10.0,5.0,12.0,9.0,14.0,5.0,11.0,13.0,12.0,5.0,14.0,12.0,12.0,12.0,14.0,15.0,14.0,13.0,12.0,9.0,10.0,11.0,5.0,14.0,15.0,15.0,12.0,12.0,13.0,14.0,8.0,14.0,13.0,20.0,14.0,13.0,13.0,5.0,12.0,4.0,10.0,17.0,9.0,10.0,8.0,12.0,13.0,19.0,1.0,18.0,0.0,0.0,0.0,0.0,177.0,0.0,1.0,1.0,2.0,2.0,1.0,1.0,1.0,3.0,2.0,2.0,3.0,12.0,9.0,12.0,7.0,13.0,8.0,6.0,12.0,6.0,8.0,13.0,5.0,11.0,12.0,10.0,13.0,7.0,12.0,9.0,12.0,10.0,14.0,15.0,7.0,12.0,10.0,12.0,14.0,15.0,13.0,13.0,8.0,9.0,13.0,13.0,20.0,13.0,11.0,10.0,9.0,11.0,7.0,13.0,15.0,15.0,9.0,8.0,6.0,11.0,12.0,12.0,25.0,0.0,0.0,7.0,0.0,179.0,74.0,1.0,2.0,1.0,2.0,2.0,2.0,3.0,2.0,2.0,2.0,2.0,4.0,10.0,10.0,7.0,15.0,4.0,13.0,7.0,8.0,15.0,14.0,8.0,16.0,14.0,15.0,15.0,18.0,14.0,14.0,12.0,15.0,17.0,8.0,10.0,11.0,15.0,18.0,17.0,14.0,12.0,15.0,12.0,12.0,16.0,13.0,20.0,17.0,15.0,17.0,12.0,15.0,8.0,17.0,15.0,14.0,14.0,15.0,16.0,12.0,15.0,5.0,23.0,37.0,2.0,5.0,1.0,180.0,77.0,2.0,2.0,3.0,3.0,4.0,2.0,1.0,3.0,4.0,2.0,3.0,8.0,7.0,11.0,6.0,14.0,8.0,12.0,14.0,8.0,13.0,14.0,14.0,15.0,15.0,12.0,14.0,14.0,16.0,15.0,13.0,14.0,14.0,8.0,11.0,10.0,13.0,17.0,18.0,12.0,12.0,15.0,13.0,8.0,18.0,13.0,20.0,18.0,15.0,13.0,8.0,12.0,6.0,8.0,14.0,14.0,14.0,15.0,15.0,14.0,18.0,4.0,16.0,0.0,0.0,0.0,0.0,176.0,66.0,3.0,1.0,2.0,1.0,3.0,3.0,3.0,2.0,1.0,2.0,1.0,12.0,10.0,13.0,12.0,12.0,10.0,6.0,9.0,5.0,6.0,10.0,12.0,5.0,13.0,8.0,10.0,10.0,11.0,9.0,11.0,9.0,14.0,15.0,11.0,12.0,6.0,12.0,13.0,14.0,12.0,8.0,6.0,10.0,14.0,14.0,20.0,11.0,8.0,12.0,6.0,9.0,6.0,11.0,8.0,12.0,10.0,10.0,13.0,14.0,13.0,5.0,16.0,0.0,0.0,0.0,0.0,165.0,0.0,1.0,1.0,3.0,3.0,3.0,1.0,2.0,1.0,3.0,3.0,3.0,7.0,8.0,9.0,7.0,13.0,7.0,6.0,5.0,4.0,3.0,7.0,2.0,6.0,9.0,8.0,5.0,8.0,8.0,8.0,8.0,6.0,5.0,8.0,7.0,6.0,5.0,6.0,7.0,13.0,10.0,6.0,6.0,12.0,14.0,14.0,20.0,7.0,5.0,7.0,8.0,8.0,6.0,8.0,17.0,10.0,12.0,12.0,12.0,13.0,16.0,3.0,28.0,23.0,0.0,0.0,0.0,195.0,80.0,13.0,15.0,14.0,7.0,13.0,10.0,13.0,15.0,11.0,8.0,13.0,4.0,3.0,2.0,3.0,7.0,7.0,7.0,3.0,3.0,1.0,4.0,2.0,2.0,3.0,11.0,12.0,16.0,12.0,11.0,5.0,10.0,15.0,3.0,13.0,4.0,13.0,11.0,10.0,10.0,13.0,14.0,16.0,1.0,15.0,9.0,20.0,10.0,14.0,13.0,15.0,13.0,8.0,11.0,12.0,13.0,10.0,11.0,12.0,13.0,5.0,9.0,26.0,0.0,0.0,4.0,0.0,184.0,74.0,3.0,3.0,4.0,2.0,3.0,3.0,3.0,3.0,2.0,3.0,2.0,5.0,8.0,12.0,11.0,13.0,9.0,15.0,11.0,5.0,12.0,12.0,11.0,13.0,13.0,14.0,12.0,13.0,11.0,12.0,12.0,11.0,13.0,12.0,10.0,13.0,12.0,13.0,13.0,11.0,12.0,15.0,13.0,9.0,12.0,11.0,20.0,14.0,12.0,13.0,14.0,14.0,9.0,16.0,15.0,14.0,8.0,9.0,9.0,11.0,11.0,11.0,25.0,3.0,0.0,6.0,0.0,182.0,75.0,1.0,4.0,1.0,2.0,1.0,1.0,3.0,3.0,1.0,1.0,1.0,12.0,12.0,12.0,10.0,13.0,12.0,8.0,11.0,5.0,12.0,14.0,8.0,14.0,12.0,14.0,14.0,12.0,12.0,12.0,13.0,13.0,11.0,12.0,11.0,11.0,13.0,14.0,14.0,12.0,12.0,10.0,10.0,20.0,14.0,12.0,10.0,13.0,13.0,10.0,13.0,13.0,7.0,8.0,13.0,13.0,15.0,12.0,13.0,13.0,15.0,8.0,25.0,28.0,1.0,0.0,0.0,167.0,63.0,4.0,1.0,4.0,2.0,2.0,3.0,1.0,3.0,1.0,3.0,1.0,13.0,11.0,12.0,10.0,12.0,13.0,6.0,13.0,3.0,9.0,15.0,12.0,10.0,14.0,16.0,10.0,12.0,10.0,10.0,15.0,10.0,14.0,14.0,12.0,14.0,9.0,11.0,11.0,15.0,16.0,12.0,5.0,9.0,15.0,14.0,20.0,13.0,5.0,10.0,15.0,13.0,5.0,12.0,11.0,14.0,11.0,8.0,7.0,8.0,6.0,12.0,23.0,10.0,3.0,6.0,2.0,187.0,80.0,3.0,2.0,1.0,2.0,3.0,3.0,2.0,4.0,2.0,3.0,1.0,4.0,9.0,11.0,11.0,12.0,5.0,13.0,13.0,4.0,8.0,11.0,13.0,5.0,12.0,9.0,11.0,12.0,11.0,12.0,10.0,11.0,12.0,15.0,11.0,15.0,5.0,14.0,14.0,14.0,12.0,9.0,13.0,6.0,11.0,14.0,20.0,13.0,14.0,9.0,8.0,12.0,5.0,10.0,4.0,12.0,13.0,13.0,14.0,11.0,10.0,2.0,27.0,0.0,0.0,0.0,0.0,184.0,85.0,1.0,2.0,3.0,2.0,2.0,3.0,3.0,1.0,3.0,1.0,2.0,12.0,11.0,12.0,10.0,14.0,11.0,12.0,14.0,13.0,11.0,13.0,14.0,12.0,13.0,13.0,13.0,12.0,12.0,12.0,12.0,12.0,12.0,11.0,8.0,13.0,13.0,11.0,12.0,12.0,13.0,14.0,12.0,8.0,12.0,12.0,20.0,13.0,14.0,13.0,10.0,12.0,14.0,13.0,11.0,16.0,9.0,10.0,9.0,9.0,11.0,13.0,23.0,1.0,0.0,0.0,0.0,180.0,79.0,2.0,3.0,3.0,2.0,3.0,1.0,3.0,2.0,2.0,3.0,1.0,13.0,13.0,11.0,6.0,11.0,8.0,8.0,9.0,14.0,12.0,12.0,10.0,12.0,12.0,11.0,12.0,9.0,12.0,12.0,10.0,13.0,9.0,11.0,11.0,14.0,12.0,12.0,12.0,13.0,12.0,11.0,8.0,8.0,11.0,13.0,20.0,14.0,11.0,15.0,8.0,14.0,8.0,9.0,11.0,11.0,6.0,13.0,9.0,10.0,11.0,15.0,20.0,0.0,0.0,0.0,0.0,178.0,81.0,2.0,1.0,3.0,3.0,2.0,2.0,3.0,3.0,2.0,3.0,3.0,11.0,12.0,15.0,12.0,14.0,8.0,7.0,14.0,5.0,3.0,10.0,10.0,3.0,14.0,16.0,12.0,10.0,12.0,8.0,11.0,8.0,11.0,15.0,8.0,13.0,5.0,7.0,6.0,14.0,14.0,12.0,8.0,8.0,8.0,14.0,20.0,9.0,10.0,11.0,14.0,10.0,6.0,9.0,6.0,14.0,4.0,11.0,4.0,7.0,4.0,18.0,24.0,0.0,0.0,8.0,2.0,173.0,64.0,2.0,2.0,3.0,2.0,3.0,2.0,2.0,2.0,3.0,3.0,1.0,10.0,12.0,13.0,12.0,13.0,10.0,8.0,12.0,8.0,9.0,12.0,9.0,9.0,13.0,12.0,13.0,11.0,12.0,11.0,12.0,11.0,13.0,12.0,12.0,13.0,10.0,11.0,14.0,14.0,13.0,10.0,5.0,8.0,11.0,14.0,20.0,14.0,10.0,10.0,10.0,10.0,6.0,9.0,13.0,13.0,12.0,10.0,11.0,11.0,10.0,9.0,23.0,0.0,0.0,0.0,0.0,185.0,80.0,1.0,2.0,1.0,3.0,4.0,1.0,2.0,3.0,1.0,1.0,4.0,10.0,11.0,10.0,9.0,11.0,7.0,10.0,7.0,5.0,9.0,12.0,7.0,11.0,11.0,15.0,12.0,12.0,9.0,9.0,13.0,10.0,13.0,10.0,16.0,9.0,11.0,12.0,12.0,11.0,12.0,10.0,10.0,8.0,10.0,12.0,20.0,11.0,10.0,11.0,14.0,8.0,9.0,16.0,13.0,12.0,10.0,13.0,9.0,8.0,7.0,9.0,26.0,0.0,0.0,11.0,4.0,194.0,82.0,2.0,1.0,3.0,3.0,3.0,4.0,2.0,3.0,2.0,3.0,3.0,3.0,6.0,7.0,5.0,11.0,6.0,14.0,7.0,7.0,12.0,10.0,9.0,12.0,9.0,11.0,13.0,14.0,11.0,7.0,10.0,6.0,10.0,7.0,8.0,7.0,12.0,10.0,13.0,9.0,7.0,11.0,14.0,9.0,12.0,10.0,20.0,12.0,14.0,10.0,10.0,9.0,12.0,8.0,7.0,12.0,9.0,10.0,6.0,9.0,12.0,14.0
3,1,17.0,0.0,0.0,0.0,0.0,163.0,59.0,2.0,3.0,3.0,1.0,2.0,3.0,3.0,1.0,2.0,3.0,3.0,8.0,12.0,13.0,7.0,13.0,7.0,5.0,7.0,7.0,7.0,12.0,5.0,8.0,12.0,9.0,12.0,16.0,10.0,8.0,7.0,10.0,11.0,14.0,7.0,12.0,8.0,7.0,7.0,14.0,11.0,4.0,4.0,20.0,10.0,14.0,6.0,6.0,4.0,8.0,4.0,9.0,9.0,9.0,16.0,7.0,11.0,9.0,8.0,2.0,10.0,10.0,28.0,0.0,0.0,0.0,0.0,189.0,74.0,3.0,1.0,3.0,4.0,3.0,1.0,2.0,1.0,1.0,1.0,3.0,7.0,8.0,12.0,12.0,9.0,10.0,13.0,7.0,4.0,5.0,12.0,13.0,4.0,12.0,9.0,12.0,10.0,11.0,9.0,12.0,12.0,11.0,9.0,11.0,13.0,11.0,12.0,13.0,10.0,11.0,12.0,15.0,9.0,15.0,11.0,20.0,13.0,13.0,12.0,7.0,9.0,8.0,6.0,5.0,14.0,9.0,12.0,13.0,12.0,12.0,8.0,27.0,0.0,0.0,0.0,0.0,185.0,0.0,4.0,1.0,3.0,3.0,1.0,1.0,3.0,3.0,1.0,1.0,1.0,7.0,5.0,6.0,8.0,13.0,7.0,2.0,10.0,3.0,11.0,7.0,7.0,10.0,9.0,9.0,9.0,9.0,9.0,9.0,7.0,13.0,10.0,10.0,9.0,7.0,8.0,8.0,12.0,13.0,13.0,8.0,9.0,10.0,12.0,12.0,20.0,13.0,9.0,10.0,10.0,1.0,10.0,10.0,20.0,11.0,10.0,10.0,10.0,2.0,17.0,6.0,15.0,0.0,0.0,0.0,0.0,175.0,0.0,2.0,1.0,1.0,1.0,2.0,2.0,3.0,3.0,3.0,1.0,2.0,6.0,9.0,7.0,4.0,9.0,8.0,2.0,6.0,2.0,5.0,4.0,5.0,5.0,13.0,5.0,6.0,6.0,5.0,6.0,5.0,6.0,5.0,11.0,6.0,7.0,3.0,9.0,13.0,8.0,8.0,10.0,9.0,20.0,6.0,9.0,9.0,8.0,4.0,4.0,15.0,9.0,9.0,7.0,6.0,4.0,7.0,5.0,14.0,9.0,9.0,7.0,22.0,0.0,0.0,2.0,0.0,178.0,70.0,2.0,2.0,1.0,2.0,1.0,3.0,3.0,2.0,1.0,1.0,2.0,11.0,11.0,13.0,7.0,13.0,11.0,5.0,8.0,4.0,7.0,13.0,10.0,10.0,15.0,14.0,13.0,13.0,7.0,8.0,13.0,12.0,15.0,14.0,11.0,14.0,10.0,13.0,12.0,12.0,14.0,9.0,7.0,13.0,12.0,13.0,20.0,12.0,6.0,7.0,8.0,13.0,7.0,8.0,12.0,12.0,18.0,11.0,15.0,13.0,11.0,4.0,26.0,0.0,0.0,1.0,0.0,188.0,84.0,13.0,12.0,10.0,4.0,15.0,15.0,10.0,15.0,16.0,12.0,10.0,8.0,1.0,3.0,1.0,10.0,11.0,7.0,2.0,3.0,1.0,12.0,10.0,2.0,10.0,6.0,10.0,8.0,11.0,14.0,10.0,13.0,13.0,2.0,8.0,3.0,15.0,10.0,14.0,7.0,14.0,13.0,13.0,10.0,12.0,10.0,20.0,12.0,12.0,15.0,11.0,11.0,11.0,11.0,13.0,16.0,14.0,8.0,19.0,15.0,11.0,2.0,25.0,0.0,0.0,0.0,0.0,187.0,84.0,3.0,1.0,1.0,1.0,3.0,1.0,3.0,2.0,2.0,3.0,2.0,6.0,7.0,10.0,10.0,12.0,10.0,15.0,13.0,6.0,12.0,14.0,13.0,13.0,12.0,12.0,15.0,13.0,13.0,13.0,13.0,12.0,14.0,13.0,7.0,13.0,14.0,13.0,14.0,12.0,12.0,15.0,15.0,12.0,12.0,13.0,20.0,15.0,14.0,13.0,13.0,10.0,8.0,16.0,12.0,13.0,10.0,12.0,14.0,9.0,7.0,6.0,26.0,0.0,0.0,0.0,0.0,191.0,84.0,3.0,1.0,4.0,1.0,2.0,1.0,1.0,3.0,2.0,2.0,3.0,2.0,9.0,11.0,8.0,13.0,4.0,16.0,9.0,10.0,14.0,12.0,8.0,15.0,13.0,19.0,14.0,16.0,13.0,13.0,11.0,10.0,15.0,8.0,8.0,6.0,13.0,13.0,13.0,12.0,12.0,14.0,14.0,20.0,13.0,12.0,10.0,12.0,14.0,12.0,20.0,6.0,4.0,10.0,13.0,15.0,11.0,7.0,10.0,6.0,2.0,12.0,24.0,16.0,0.0,5.0,0.0,184.0,78.0,3.0,1.0,2.0,2.0,1.0,2.0,2.0,1.0,3.0,3.0,1.0,12.0,12.0,12.0,8.0,14.0,8.0,13.0,13.0,7.0,12.0,15.0,10.0,14.0,15.0,15.0,13.0,13.0,14.0,15.0,14.0,14.0,13.0,6.0,15.0,13.0,14.0,14.0,13.0,11.0,12.0,15.0,13.0,20.0,14.0,12.0,8.0,14.0,13.0,14.0,7.0,11.0,5.0,9.0,9.0,12.0,11.0,13.0,15.0,15.0,12.0,8.0,23.0,0.0,0.0,18.0,3.0,173.0,65.0,1.0,2.0,4.0,1.0,2.0,1.0,1.0,2.0,3.0,2.0,3.0,12.0,13.0,11.0,11.0,12.0,10.0,7.0,11.0,11.0,9.0,12.0,13.0,12.0,13.0,13.0,11.0,13.0,10.0,11.0,11.0,11.0,16.0,10.0,7.0,15.0,11.0,14.0,15.0,13.0,13.0,12.0,9.0,9.0,13.0,13.0,20.0,14.0,9.0,14.0,7.0,12.0,6.0,18.0,13.0,16.0,13.0,12.0,17.0,12.0,12.0,10.0,28.0,0.0,0.0,0.0,0.0,176.0,69.0,1.0,3.0,1.0,4.0,2.0,3.0,2.0,1.0,2.0,3.0,2.0,8.0,14.0,12.0,6.0,13.0,12.0,7.0,13.0,11.0,11.0,13.0,12.0,13.0,14.0,11.0,13.0,12.0,12.0,14.0,10.0,13.0,14.0,11.0,8.0,15.0,11.0,12.0,14.0,15.0,14.0,10.0,7.0,12.0,14.0,14.0,20.0,15.0,8.0,15.0,8.0,13.0,6.0,14.0,14.0,10.0,13.0,14.0,15.0,12.0,15.0,5.0,26.0,0.0,0.0,10.0,0.0,187.0,80.0,10.0,10.0,14.0,8.0,16.0,11.0,16.0,16.0,16.0,8.0,15.0,6.0,3.0,2.0,3.0,9.0,9.0,6.0,3.0,3.0,1.0,8.0,5.0,3.0,9.0,8.0,16.0,11.0,13.0,16.0,7.0,13.0,13.0,4.0,11.0,1.0,14.0,17.0,10.0,12.0,14.0,12.0,13.0,15.0,16.0,10.0,20.0,13.0,14.0,17.0,5.0,14.0,2.0,12.0,8.0,14.0,14.0,12.0,18.0,16.0,10.0,6.0,26.0,28.0,2.0,24.0,1.0,188.0,85.0,3.0,2.0,1.0,1.0,2.0,2.0,3.0,1.0,3.0,3.0,1.0,10.0,11.0,9.0,8.0,11.0,12.0,11.0,12.0,18.0,14.0,11.0,8.0,14.0,10.0,17.0,14.0,16.0,10.0,14.0,10.0,12.0,15.0,7.0,13.0,11.0,12.0,18.0,17.0,11.0,10.0,12.0,14.0,12.0,17.0,12.0,20.0,17.0,14.0,14.0,10.0,14.0,9.0,15.0,17.0,14.0,13.0,13.0,17.0,14.0,16.0,8.0,22.0,0.0,0.0,2.0,0.0,185.0,80.0,3.0,2.0,2.0,2.0,3.0,3.0,3.0,3.0,3.0,2.0,2.0,17.0,16.0,12.0,13.0,14.0,16.0,8.0,15.0,7.0,9.0,15.0,13.0,12.0,15.0,14.0,11.0,14.0,14.0,10.0,15.0,12.0,11.0,15.0,9.0,13.0,10.0,10.0,16.0,12.0,14.0,10.0,11.0,20.0,15.0,12.0,10.0,15.0,11.0,13.0,9.0,13.0,9.0,13.0,11.0,17.0,6.0,12.0,12.0,10.0,8.0,14.0,20.0,0.0,0.0,6.0,3.0,187.0,74.0,1.0,1.0,1.0,2.0,1.0,3.0,1.0,3.0,2.0,1.0,1.0,14.0,13.0,10.0,14.0,15.0,12.0,12.0,13.0,7.0,8.0,15.0,11.0,10.0,14.0,9.0,14.0,8.0,15.0,8.0,14.0,11.0,8.0,11.0,7.0,15.0,9.0,12.0,9.0,11.0,13.0,10.0,14.0,12.0,13.0,15.0,20.0,12.0,9.0,12.0,4.0,13.0,6.0,17.0,12.0,14.0,8.0,12.0,13.0,15.0,18.0,6.0,23.0,0.0,0.0,14.0,2.0,180.0,78.0,2.0,2.0,1.0,2.0,3.0,2.0,2.0,2.0,3.0,2.0,1.0,10.0,11.0,12.0,8.0,11.0,10.0,7.0,9.0,14.0,10.0,9.0,8.0,13.0,11.0,14.0,9.0,14.0,8.0,12.0,8.0,9.0,16.0,11.0,7.0,10.0,10.0,12.0,16.0,16.0,11.0,14.0,9.0,20.0,15.0,18.0,6.0,15.0,12.0,13.0,4.0,12.0,5.0,16.0,8.0,12.0,14.0,9.0,13.0,15.0,15.0,5.0,24.0,0.0,0.0,18.0,5.0,182.0,81.0,3.0,1.0,2.0,2.0,2.0,2.0,1.0,3.0,2.0,3.0,3.0,13.0,11.0,14.0,12.0,12.0,11.0,8.0,14.0,12.0,7.0,11.0,10.0,9.0,13.0,15.0,10.0,13.0,9.0,12.0,10.0,9.0,11.0,14.0,7.0,11.0,8.0,12.0,15.0,14.0,13.0,15.0,10.0,12.0,13.0,17.0,20.0,14.0,12.0,13.0,5.0,11.0,5.0,14.0,12.0,14.0,8.0,10.0,14.0,12.0,10.0,5.0,19.0,0.0,0.0,1.0,0.0,180.0,72.0,1.0,1.0,2.0,3.0,2.0,2.0,1.0,2.0,3.0,1.0,4.0,16.0,15.0,15.0,12.0,12.0,15.0,5.0,13.0,7.0,7.0,13.0,12.0,10.0,14.0,17.0,10.0,14.0,10.0,8.0,13.0,9.0,15.0,15.0,9.0,14.0,10.0,15.0,17.0,12.0,14.0,11.0,9.0,12.0,15.0,14.0,20.0,15.0,10.0,11.0,10.0,11.0,4.0,16.0,10.0,16.0,10.0,13.0,11.0,8.0,8.0,14.0,24.0,0.0,0.0,8.0,0.0,194.0,85.0,1.0,2.0,1.0,3.0,1.0,3.0,4.0,1.0,1.0,2.0,2.0,6.0,9.0,8.0,7.0,10.0,7.0,12.0,8.0,15.0,14.0,12.0,5.0,15.0,10.0,15.0,12.0,16.0,10.0,14.0,9.0,11.0,15.0,7.0,12.0,8.0,13.0,16.0,12.0,12.0,8.0,17.0,15.0,12.0,16.0,17.0,20.0,15.0,16.0,15.0,12.0,13.0,10.0,14.0,9.0,15.0,12.0,11.0,13.0,10.0,8.0,12.0,25.0,14.0,4.0,9.0,5.0,177.0,73.0,2.0,4.0,1.0,1.0,3.0,1.0,3.0,3.0,3.0,3.0,1.0,8.0,11.0,14.0,15.0,16.0,10.0,13.0,12.0,6.0,5.0,13.0,16.0,6.0,15.0,13.0,15.0,10.0,12.0,12.0,14.0,9.0,10.0,16.0,5.0,13.0,7.0,12.0,17.0,16.0,15.0,13.0,10.0,15.0,16.0,14.0,20.0,14.0,10.0,11.0,4.0,11.0,5.0,10.0,11.0,17.0,12.0,10.0,14.0,12.0,16.0,13.0,32.0,0.0,0.0,0.0,0.0,185.0,82.0,2.0,2.0,2.0,3.0,2.0,2.0,3.0,1.0,3.0,1.0,2.0,8.0,3.0,2.0,4.0,9.0,4.0,11.0,7.0,3.0,12.0,9.0,4.0,12.0,8.0,9.0,8.0,6.0,7.0,11.0,7.0,14.0,11.0,8.0,10.0,8.0,15.0,8.0,10.0,11.0,8.0,9.0,12.0,7.0,13.0,9.0,20.0,6.0,11.0,17.0,8.0,16.0,6.0,9.0,8.0,11.0,11.0,11.0,12.0,12.0,11.0,10.0,19.0,0.0,0.0,0.0,0.0,188.0,76.0,3.0,3.0,2.0,1.0,3.0,3.0,1.0,3.0,3.0,4.0,2.0,6.0,6.0,8.0,8.0,10.0,3.0,8.0,8.0,1.0,10.0,8.0,1.0,12.0,5.0,9.0,9.0,10.0,6.0,6.0,8.0,15.0,9.0,9.0,6.0,8.0,7.0,9.0,10.0,10.0,12.0,9.0,14.0,8.0,10.0,13.0,20.0,7.0,11.0,9.0,9.0,2.0,9.0,9.0,17.0,13.0,12.0,10.0,10.0,9.0,14.0,8.0
1,3,33.0,33.0,0.0,20.0,0.0,188.0,92.0,11.0,11.0,17.0,15.0,13.0,18.0,13.0,14.0,18.0,13.0,17.0,9.0,1.0,2.0,2.0,12.0,11.0,10.0,1.0,3.0,1.0,13.0,6.0,2.0,12.0,10.0,17.0,14.0,18.0,12.0,12.0,11.0,15.0,3.0,15.0,1.0,15.0,13.0,10.0,11.0,15.0,12.0,13.0,10.0,12.0,10.0,20.0,12.0,17.0,14.0,9.0,13.0,6.0,12.0,17.0,12.0,14.0,13.0,17.0,16.0,10.0,9.0,29.0,2.0,0.0,4.0,1.0,178.0,73.0,3.0,3.0,2.0,1.0,1.0,2.0,1.0,1.0,1.0,3.0,3.0,9.0,13.0,12.0,14.0,15.0,11.0,10.0,13.0,8.0,9.0,14.0,12.0,10.0,15.0,12.0,14.0,14.0,14.0,14.0,14.0,14.0,16.0,15.0,10.0,17.0,9.0,17.0,15.0,15.0,15.0,13.0,10.0,11.0,14.0,14.0,20.0,16.0,12.0,15.0,8.0,15.0,7.0,13.0,16.0,15.0,15.0,14.0,14.0,10.0,8.0,11.0,34.0,34.0,0.0,2.0,0.0,184.0,79.0,1.0,2.0,1.0,2.0,2.0,1.0,3.0,1.0,3.0,2.0,1.0,8.0,12.0,12.0,10.0,12.0,4.0,13.0,8.0,13.0,12.0,12.0,2.0,15.0,13.0,13.0,14.0,15.0,11.0,13.0,12.0,12.0,11.0,7.0,10.0,14.0,15.0,13.0,15.0,12.0,13.0,15.0,13.0,9.0,15.0,14.0,20.0,13.0,14.0,12.0,9.0,15.0,12.0,14.0,10.0,12.0,15.0,14.0,15.0,18.0,10.0,7.0,28.0,91.0,19.0,2.0,0.0,183.0,79.0,3.0,1.0,2.0,2.0,2.0,1.0,2.0,3.0,2.0,3.0,1.0,14.0,13.0,13.0,14.0,15.0,12.0,15.0,14.0,8.0,8.0,16.0,14.0,9.0,17.0,11.0,14.0,12.0,15.0,10.0,16.0,14.0,15.0,15.0,17.0,18.0,14.0,15.0,10.0,15.0,15.0,13.0,11.0,15.0,15.0,14.0,20.0,14.0,13.0,13.0,6.0,12.0,5.0,14.0,17.0,16.0,19.0,13.0,18.0,14.0,12.0,8.0,22.0,16.0,3.0,7.0,1.0,180.0,75.0,3.0,1.0,4.0,1.0,1.0,2.0,2.0,3.0,1.0,2.0,1.0,15.0,13.0,16.0,11.0,15.0,12.0,7.0,11.0,8.0,8.0,16.0,10.0,11.0,16.0,13.0,15.0,14.0,12.0,12.0,16.0,14.0,14.0,15.0,9.0,16.0,8.0,13.0,13.0,13.0,16.0,11.0,9.0,13.0,14.0,14.0,20.0,14.0,10.0,13.0,9.0,12.0,6.0,12.0,13.0,14.0,11.0,13.0,14.0,14.0,12.0,13.0,22.0,22.0,0.0,4.0,0.0,180.0,75.0,2.0,2.0,3.0,2.0,2.0,2.0,3.0,3.0,2.0,1.0,3.0,8.0,13.0,10.0,5.0,14.0,5.0,11.0,9.0,11.0,14.0,13.0,7.0,14.0,13.0,15.0,12.0,15.0,13.0,13.0,12.0,13.0,12.0,8.0,10.0,12.0,14.0,15.0,14.0,15.0,14.0,14.0,11.0,10.0,16.0,15.0,20.0,17.0,14.0,15.0,6.0,13.0,6.0,13.0,15.0,14.0,13.0,14.0,14.0,13.0,13.0,7.0,25.0,6.0,0.0,0.0,0.0,195.0,89.0,2.0,3.0,1.0,3.0,3.0,3.0,2.0,2.0,3.0,1.0,3.0,6.0,7.0,10.0,6.0,12.0,6.0,16.0,8.0,8.0,16.0,12.0,6.0,16.0,11.0,14.0,16.0,14.0,13.0,10.0,11.0,11.0,16.0,8.0,12.0,9.0,15.0,14.0,16.0,12.0,14.0,18.0,17.0,10.0,14.0,16.0,20.0,16.0,19.0,14.0,13.0,14.0,8.0,10.0,12.0,15.0,11.0,14.0,12.0,14.0,14.0,7.0,20.0,4.0,0.0,4.0,1.0,180.0,73.0,1.0,2.0,2.0,3.0,3.0,1.0,2.0,2.0,1.0,4.0,2.0,12.0,11.0,14.0,8.0,11.0,14.0,7.0,13.0,4.0,11.0,12.0,13.0,10.0,13.0,15.0,12.0,12.0,8.0,12.0,12.0,10.0,17.0,14.0,6.0,15.0,10.0,10.0,17.0,17.0,16.0,6.0,10.0,12.0,15.0,15.0,20.0,16.0,7.0,12.0,11.0,13.0,11.0,17.0,14.0,15.0,12.0,14.0,12.0,9.0,14.0,6.0,19.0,0.0,0.0,0.0,0.0,172.0,64.0,1.0,3.0,2.0,2.0,4.0,2.0,1.0,2.0,3.0,3.0,1.0,13.0,13.0,15.0,12.0,15.0,12.0,6.0,12.0,3.0,2.0,13.0,11.0,3.0,16.0,8.0,10.0,9.0,12.0,9.0,13.0,10.0,12.0,15.0,8.0,13.0,4.0,5.0,7.0,17.0,16.0,14.0,5.0,20.0,11.0,15.0,12.0,10.0,8.0,8.0,10.0,14.0,8.0,10.0,17.0,14.0,9.0,10.0,9.0,4.0,10.0,10.0,18.0,0.0,0.0,0.0,0.0,183.0,75.0,2.0,1.0,1.0,1.0,4.0,1.0,2.0,2.0,3.0,3.0,2.0,8.0,8.0,10.0,6.0,14.0,11.0,10.0,10.0,8.0,14.0,15.0,4.0,15.0,11.0,13.0,12.0,15.0,10.0,12.0,13.0,13.0,13.0,7.0,8.0,10.0,12.0,16.0,14.0,14.0,14.0,16.0,13.0,12.0,14.0,15.0,20.0,17.0,16.0,13.0,13.0,12.0,3.0,11.0,16.0,20.0,13.0,11.0,12.0,11.0,19.0,3.0,26.0,0.0,0.0,1.0,0.0,183.0,78.0,2.0,2.0,4.0,1.0,3.0,2.0,2.0,2.0,3.0,1.0,4.0,5.0,7.0,6.0,7.0,8.0,6.0,16.0,7.0,7.0,15.0,9.0,5.0,16.0,9.0,15.0,15.0,15.0,14.0,14.0,10.0,13.0,15.0,7.0,13.0,6.0,15.0,14.0,15.0,13.0,12.0,14.0,13.0,8.0,15.0,14.0,20.0,15.0,15.0,15.0,15.0,12.0,11.0,12.0,9.0,12.0,14.0,9.0,15.0,13.0,11.0,6.0,26.0,3.0,0.0,26.0,0.0,192.0,83.0,12.0,9.0,10.0,6.0,13.0,14.0,15.0,16.0,14.0,12.0,10.0,5.0,2.0,2.0,1.0,10.0,10.0,3.0,3.0,1.0,1.0,9.0,4.0,3.0,10.0,8.0,14.0,12.0,14.0,12.0,8.0,11.0,10.0,1.0,9.0,2.0,12.0,15.0,10.0,12.0,14.0,15.0,14.0,10.0,13.0,10.0,20.0,12.0,15.0,15.0,10.0,15.0,10.0,11.0,14.0,16.0,12.0,11.0,17.0,14.0,18.0,5.0,23.0,0.0,0.0,2.0,0.0,186.0,83.0,4.0,2.0,1.0,3.0,3.0,1.0,4.0,2.0,3.0,1.0,1.0,5.0,7.0,7.0,8.0,11.0,5.0,16.0,8.0,10.0,15.0,10.0,8.0,17.0,11.0,11.0,13.0,17.0,11.0,15.0,9.0,12.0,15.0,6.0,13.0,6.0,14.0,17.0,12.0,11.0,11.0,15.0,14.0,14.0,16.0,13.0,20.0,12.0,14.0,15.0,10.0,15.0,8.0,14.0,9.0,14.0,13.0,12.0,16.0,13.0,15.0,5.0,17.0,0.0,0.0,0.0,0.0,185.0,83.0,3.0,1.0,3.0,2.0,2.0,3.0,2.0,3.0,3.0,2.0,3.0,4.0,8.0,12.0,6.0,10.0,6.0,11.0,8.0,10.0,14.0,13.0,7.0,13.0,12.0,14.0,12.0,15.0,13.0,9.0,12.0,10.0,13.0,11.0,8.0,7.0,11.0,12.0,13.0,14.0,13.0,16.0,14.0,12.0,16.0,18.0,20.0,12.0,15.0,11.0,8.0,13.0,4.0,10.0,13.0,16.0,9.0,14.0,12.0,14.0,12.0,7.0,22.0,21.0,3.0,7.0,1.0,177.0,74.0,3.0,2.0,3.0,3.0,3.0,1.0,1.0,3.0,3.0,1.0,2.0,9.0,11.0,13.0,15.0,12.0,9.0,8.0,11.0,6.0,6.0,12.0,10.0,8.0,13.0,17.0,11.0,14.0,12.0,10.0,13.0,9.0,15.0,13.0,7.0,14.0,8.0,10.0,17.0,16.0,13.0,14.0,9.0,14.0,17.0,14.0,20.0,16.0,11.0,15.0,6.0,15.0,4.0,15.0,10.0,18.0,7.0,16.0,13.0,8.0,8.0,15.0,21.0,21.0,2.0,0.0,0.0,172.0,68.0,3.0,1.0,3.0,3.0,3.0,3.0,2.0,2.0,1.0,2.0,1.0,10.0,11.0,14.0,12.0,13.0,10.0,7.0,11.0,6.0,9.0,13.0,10.0,14.0,16.0,18.0,14.0,14.0,13.0,12.0,14.0,12.0,15.0,13.0,8.0,17.0,11.0,16.0,18.0,15.0,17.0,12.0,7.0,12.0,16.0,12.0,20.0,17.0,8.0,17.0,8.0,14.0,6.0,13.0,14.0,17.0,10.0,13.0,13.0,10.0,9.0,8.0,22.0,13.0,2.0,15.0,4.0,193.0,83.0,3.0,1.0,1.0,1.0,3.0,1.0,2.0,2.0,3.0,1.0,1.0,6.0,10.0,12.0,10.0,12.0,7.0,13.0,8.0,11.0,6.0,9.0,10.0,8.0,11.0,18.0,12.0,18.0,9.0,12.0,10.0,13.0,16.0,10.0,11.0,15.0,10.0,16.0,18.0,14.0,11.0,15.0,18.0,12.0,17.0,17.0,20.0,16.0,14.0,14.0,8.0,15.0,5.0,13.0,15.0,17.0,8.0,12.0,13.0,15.0,9.0,9.0,20.0,0.0,0.0,4.0,3.0,180.0,75.0,1.0,2.0,3.0,1.0,3.0,3.0,2.0,2.0,2.0,1.0,3.0,7.0,9.0,12.0,14.0,11.0,8.0,13.0,11.0,6.0,5.0,10.0,12.0,6.0,12.0,15.0,13.0,10.0,12.0,10.0,8.0,9.0,11.0,11.0,6.0,15.0,8.0,10.0,14.0,17.0,14.0,12.0,11.0,15.0,14.0,17.0,20.0,15.0,11.0,13.0,5.0,12.0,3.0,12.0,8.0,16.0,13.0,10.0,13.0,8.0,14.0,10.0,20.0,0.0,0.0,5.0,0.0,189.0,83.0,3.0,1.0,2.0,3.0,2.0,1.0,2.0,3.0,3.0,1.0,1.0,7.0,11.0,8.0,8.0,9.0,6.0,12.0,6.0,15.0,13.0,10.0,5.0,14.0,10.0,12.0,14.0,16.0,9.0,12.0,8.0,10.0,14.0,7.0,11.0,10.0,11.0,13.0,14.0,14.0,9.0,15.0,15.0,12.0,16.0,18.0,20.0,14.0,14.0,13.0,8.0,13.0,6.0,16.0,12.0,16.0,7.0,13.0,13.0,15.0,17.0,6.0,21.0,0.0,0.0,7.0,2.0,173.0,70.0,4.0,1.0,3.0,3.0,1.0,1.0,2.0,2.0,2.0,1.0,2.0,12.0,10.0,17.0,10.0,14.0,9.0,5.0,11.0,6.0,2.0,11.0,12.0,6.0,16.0,8.0,10.0,6.0,12.0,10.0,11.0,10.0,12.0,18.0,4.0,13.0,7.0,7.0,11.0,19.0,15.0,10.0,6.0,10.0,9.0,18.0,20.0,12.0,7.0,12.0,6.0,13.0,8.0,14.0,16.0,17.0,7.0,12.0,14.0,14.0,14.0,5.0,19.0,0.0,0.0,0.0,0.0,179.0,68.0,2.0,3.0,3.0,3.0,3.0,1.0,2.0,3.0,4.0,3.0,3.0,10.0,11.0,11.0,11.0,11.0,10.0,6.0,12.0,5.0,5.0,11.0,8.0,9.0,11.0,11.0,10.0,11.0,12.0,13.0,15.0,12.0,8.0,11.0,13.0,13.0,11.0,11.0,12.0,10.0,11.0,7.0,7.0,16.0,8.0,10.0,20.0,18.0,6.0,10.0,5.0,6.0,4.0,9.0,9.0,10.0,9.0,10.0,16.0,16.0,13.0,3.0,25.0,23.0,2.0,17.0,2.0,178.0,65.0,1.0,3.0,2.0,3.0,2.0,2.0,1.0,3.0,2.0,3.0,3.0,11.0,11.0,14.0,10.0,15.0,10.0,6.0,13.0,6.0,8.0,13.0,10.0,12.0,15.0,18.0,12.0,8.0,13.0,12.0,15.0,14.0,14.0,15.0,7.0,15.0,11.0,16.0,18.0,15.0,17.0,10.0,8.0,12.0,16.0,12.0,20.0,17.0,7.0,15.0,5.0,14.0,6.0,17.0,9.0,16.0,7.0,13.0,12.0,10.0,10.0,11.0
0,2,17.0,2.0,0.0,3.0,0.0,196.0,90.0,15.0,15.0,13.0,5.0,15.0,13.0,14.0,17.0,15.0,14.0,11.0,9.0,2.0,4.0,1.0,10.0,12.0,7.0,2.0,8.0,3.0,8.0,3.0,7.0,8.0,8.0,12.0,15.0,13.0,15.0,9.0,12.0,15.0,7.0,14.0,2.0,13.0,11.0,13.0,9.0,13.0,14.0,18.0,7.0,15.0,12.0,20.0,13.0,14.0,13.0,7.0,10.0,4.0,12.0,12.0,15.0,16.0,16.0,14.0,16.0,14.0,3.0,19.0,0.0,0.0,1.0,0.0,177.0,70.0,3.0,1.0,2.0,1.0,3.0,3.0,3.0,1.0,1.0,1.0,2.0,4.0,12.0,13.0,3.0,13.0,2.0,7.0,8.0,7.0,13.0,12.0,6.0,11.0,13.0,13.0,13.0,12.0,11.0,12.0,10.0,11.0,16.0,5.0,8.0,12.0,12.0,13.0,12.0,15.0,15.0,9.0,9.0,11.0,16.0,14.0,20.0,12.0,8.0,13.0,8.0,7.0,11.0,14.0,11.0,14.0,17.0,11.0,14.0,17.0,14.0,4.0,26.0,8.0,0.0,12.0,3.0,180.0,75.0,2.0,1.0,3.0,2.0,1.0,2.0,3.0,1.0,3.0,2.0,2.0,14.0,14.0,15.0,11.0,15.0,15.0,13.0,15.0,6.0,10.0,14.0,11.0,11.0,14.0,12.0,14.0,13.0,14.0,13.0,14.0,14.0,14.0,14.0,12.0,15.0,12.0,15.0,14.0,15.0,14.0,12.0,11.0,12.0,15.0,14.0,20.0,13.0,11.0,14.0,8.0,15.0,4.0,17.0,17.0,15.0,15.0,13.0,15.0,13.0,14.0,5.0,31.0,0.0,0.0,0.0,0.0,176.0,74.0,3.0,2.0,2.0,2.0,3.0,1.0,2.0,1.0,1.0,1.0,3.0,7.0,13.0,13.0,12.0,11.0,11.0,5.0,9.0,5.0,4.0,11.0,11.0,6.0,12.0,14.0,10.0,15.0,10.0,11.0,11.0,10.0,14.0,13.0,14.0,14.0,7.0,12.0,15.0,15.0,13.0,13.0,8.0,10.0,11.0,15.0,20.0,13.0,11.0,11.0,14.0,15.0,8.0,7.0,13.0,12.0,16.0,10.0,13.0,7.0,7.0,10.0,22.0,21.0,6.0,2.0,0.0,178.0,69.0,3.0,3.0,3.0,3.0,1.0,2.0,3.0,2.0,1.0,2.0,3.0,18.0,16.0,12.0,13.0,17.0,18.0,7.0,17.0,5.0,7.0,14.0,15.0,10.0,17.0,10.0,12.0,8.0,14.0,9.0,15.0,11.0,9.0,17.0,6.0,12.0,8.0,10.0,14.0,12.0,15.0,9.0,6.0,14.0,13.0,12.0,20.0,15.0,8.0,10.0,6.0,13.0,5.0,14.0,11.0,18.0,5.0,14.0,10.0,7.0,11.0,16.0,21.0,4.0,0.0,15.0,1.0,188.0,78.0,1.0,3.0,3.0,3.0,3.0,2.0,1.0,3.0,1.0,1.0,1.0,3.0,7.0,10.0,6.0,13.0,5.0,15.0,6.0,11.0,16.0,13.0,5.0,16.0,12.0,12.0,16.0,13.0,14.0,14.0,12.0,12.0,15.0,5.0,11.0,8.0,15.0,15.0,13.0,12.0,14.0,15.0,14.0,20.0,14.0,14.0,10.0,16.0,14.0,13.0,13.0,13.0,10.0,10.0,17.0,15.0,13.0,14.0,14.0,13.0,14.0,4.0,29.0,62.0,4.0,0.0,0.0,190.0,86.0,2.0,2.0,1.0,4.0,1.0,1.0,1.0,1.0,2.0,1.0,2.0,9.0,9.0,12.0,9.0,13.0,12.0,14.0,12.0,8.0,16.0,17.0,13.0,15.0,13.0,11.0,20.0,16.0,14.0,16.0,19.0,12.0,17.0,13.0,19.0,7.0,20.0,16.0,14.0,14.0,13.0,15.0,14.0,9.0,15.0,14.0,20.0,16.0,15.0,16.0,11.0,14.0,5.0,11.0,14.0,15.0,16.0,14.0,18.0,14.0,9.0,3.0,30.0,45.0,1.0,6.0,0.0,178.0,74.0,3.0,2.0,2.0,1.0,3.0,3.0,1.0,3.0,3.0,2.0,2.0,15.0,12.0,11.0,11.0,16.0,16.0,8.0,14.0,3.0,14.0,17.0,15.0,17.0,16.0,14.0,15.0,12.0,12.0,14.0,15.0,14.0,17.0,14.0,16.0,10.0,15.0,16.0,14.0,11.0,13.0,15.0,8.0,15.0,17.0,11.0,20.0,15.0,10.0,14.0,13.0,13.0,14.0,12.0,15.0,19.0,14.0,12.0,18.0,17.0,16.0,6.0,18.0,0.0,0.0,0.0,0.0,183.0,73.0,2.0,1.0,3.0,2.0,1.0,3.0,1.0,1.0,1.0,2.0,2.0,1.0,1.0,10.0,11.0,10.0,4.0,11.0,7.0,3.0,2.0,7.0,10.0,2.0,12.0,11.0,13.0,12.0,10.0,10.0,10.0,11.0,16.0,10.0,7.0,13.0,3.0,7.0,8.0,13.0,13.0,10.0,11.0,8.0,15.0,14.0,20.0,12.0,9.0,11.0,8.0,6.0,7.0,5.0,14.0,14.0,18.0,12.0,14.0,11.0,13.0,5.0,15.0,0.0,0.0,0.0,0.0,165.0,0.0,2.0,3.0,1.0,2.0,1.0,2.0,3.0,3.0,3.0,3.0,1.0,3.0,5.0,3.0,3.0,5.0,2.0,6.0,4.0,4.0,6.0,7.0,4.0,11.0,5.0,14.0,4.0,9.0,5.0,6.0,4.0,10.0,14.0,13.0,9.0,5.0,5.0,7.0,8.0,11.0,6.0,6.0,5.0,20.0,12.0,6.0,6.0,12.0,6.0,4.0,14.0,11.0,4.0,6.0,14.0,13.0,14.0,11.0,8.0,5.0,8.0,10.0,19.0,6.0,0.0,10.0,0.0,180.0,77.0,3.0,1.0,1.0,1.0,1.0,2.0,2.0,3.0,2.0,2.0,4.0,6.0,10.0,9.0,10.0,10.0,7.0,11.0,12.0,9.0,13.0,13.0,13.0,16.0,10.0,13.0,13.0,17.0,13.0,14.0,8.0,13.0,17.0,10.0,13.0,14.0,12.0,11.0,14.0,13.0,14.0,18.0,11.0,10.0,13.0,15.0,20.0,17.0,17.0,12.0,13.0,11.0,4.0,15.0,16.0,16.0,8.0,12.0,9.0,11.0,13.0,12.0,16.0,0.0,0.0,0.0,0.0,172.0,0.0,2.0,1.0,2.0,3.0,2.0,1.0,2.0,1.0,2.0,3.0,3.0,5.0,3.0,5.0,5.0,8.0,4.0,4.0,8.0,3.0,6.0,10.0,3.0,7.0,6.0,5.0,10.0,9.0,9.0,6.0,7.0,10.0,8.0,4.0,5.0,6.0,8.0,12.0,7.0,7.0,7.0,11.0,7.0,9.0,14.0,9.0,20.0,8.0,6.0,7.0,7.0,15.0,6.0,15.0,6.0,3.0,11.0,12.0,8.0,14.0,13.0,1.0,30.0,36.0,1.0,0.0,0.0,186.0,75.0,3.0,1.0,2.0,1.0,1.0,3.0,3.0,3.0,2.0,4.0,1.0,2.0,5.0,8.0,8.0,13.0,3.0,17.0,4.0,4.0,17.0,12.0,5.0,19.0,12.0,16.0,17.0,18.0,16.0,15.0,10.0,14.0,16.0,5.0,14.0,10.0,16.0,15.0,16.0,15.0,12.0,14.0,14.0,8.0,15.0,14.0,20.0,15.0,15.0,18.0,11.0,16.0,7.0,8.0,14.0,15.0,16.0,15.0,17.0,15.0,15.0,5.0,25.0,44.0,11.0,12.0,2.0,178.0,67.0,3.0,2.0,2.0,4.0,1.0,1.0,3.0,2.0,2.0,1.0,2.0,9.0,13.0,15.0,12.0,15.0,8.0,5.0,12.0,3.0,9.0,15.0,12.0,12.0,17.0,10.0,14.0,13.0,16.0,14.0,17.0,14.0,15.0,14.0,12.0,17.0,11.0,16.0,16.0,13.0,16.0,14.0,8.0,12.0,16.0,12.0,20.0,16.0,12.0,14.0,6.0,15.0,12.0,16.0,14.0,14.0,16.0,14.0,17.0,16.0,14.0,6.0,24.0,34.0,2.0,7.0,0.0,174.0,65.0,2.0,3.0,2.0,3.0,2.0,1.0,1.0,4.0,3.0,3.0,3.0,12.0,12.0,15.0,11.0,16.0,11.0,6.0,12.0,3.0,8.0,15.0,12.0,12.0,16.0,15.0,15.0,17.0,14.0,14.0,16.0,15.0,13.0,16.0,13.0,16.0,11.0,17.0,15.0,14.0,14.0,16.0,6.0,20.0,13.0,13.0,8.0,14.0,11.0,14.0,13.0,15.0,15.0,15.0,11.0,15.0,17.0,14.0,12.0,10.0,10.0,14.0,27.0,79.0,20.0,16.0,5.0,183.0,72.0,3.0,3.0,4.0,2.0,3.0,3.0,1.0,2.0,3.0,3.0,3.0,15.0,16.0,17.0,12.0,19.0,13.0,7.0,11.0,4.0,6.0,19.0,13.0,9.0,19.0,7.0,18.0,9.0,19.0,15.0,20.0,18.0,14.0,19.0,8.0,20.0,6.0,19.0,12.0,14.0,16.0,14.0,9.0,20.0,15.0,13.0,10.0,15.0,9.0,13.0,5.0,16.0,6.0,10.0,16.0,16.0,12.0,17.0,15.0,14.0,16.0,10.0,24.0,12.0,1.0,7.0,0.0,184.0,82.0,4.0,3.0,1.0,1.0,3.0,3.0,3.0,2.0,1.0,3.0,1.0,4.0,11.0,11.0,9.0,12.0,3.0,16.0,4.0,11.0,16.0,13.0,5.0,16.0,12.0,14.0,14.0,15.0,14.0,13.0,12.0,15.0,15.0,6.0,13.0,10.0,15.0,15.0,16.0,15.0,12.0,15.0,14.0,11.0,15.0,14.0,20.0,14.0,15.0,14.0,12.0,15.0,6.0,11.0,16.0,16.0,15.0,13.0,16.0,16.0,12.0,6.0,21.0,3.0,0.0,14.0,0.0,183.0,73.0,1.0,1.0,2.0,1.0,3.0,2.0,3.0,3.0,3.0,1.0,4.0,8.0,11.0,11.0,8.0,13.0,8.0,15.0,8.0,14.0,14.0,13.0,8.0,15.0,13.0,11.0,13.0,13.0,12.0,12.0,12.0,10.0,15.0,10.0,9.0,9.0,13.0,15.0,15.0,14.0,13.0,15.0,15.0,10.0,14.0,14.0,20.0,15.0,14.0,12.0,7.0,11.0,7.0,16.0,15.0,11.0,14.0,12.0,13.0,13.0,13.0,8.0,25.0,34.0,14.0,14.0,5.0,185.0,73.0,3.0,1.0,2.0,4.0,2.0,3.0,2.0,3.0,3.0,3.0,2.0,5.0,9.0,14.0,15.0,13.0,4.0,13.0,8.0,3.0,6.0,12.0,10.0,6.0,14.0,11.0,13.0,14.0,12.0,12.0,10.0,14.0,14.0,17.0,4.0,14.0,8.0,16.0,17.0,17.0,15.0,16.0,14.0,12.0,15.0,17.0,20.0,15.0,14.0,14.0,5.0,12.0,12.0,12.0,9.0,15.0,16.0,14.0,15.0,11.0,15.0,4.0,23.0,47.0,6.0,5.0,0.0,185.0,82.0,3.0,2.0,1.0,1.0,1.0,3.0,2.0,2.0,1.0,3.0,1.0,9.0,11.0,11.0,9.0,14.0,12.0,10.0,15.0,6.0,12.0,17.0,10.0,13.0,16.0,16.0,13.0,15.0,14.0,12.0,16.0,13.0,13.0,12.0,12.0,10.0,12.0,16.0,14.0,12.0,11.0,16.0,13.0,20.0,14.0,13.0,12.0,16.0,15.0,13.0,15.0,15.0,5.0,10.0,14.0,17.0,8.0,14.0,13.0,10.0,6.0,15.0,23.0,13.0,0.0,0.0,0.0,183.0,82.0,2.0,1.0,1.0,3.0,3.0,2.0,1.0,3.0,1.0,3.0,3.0,6.0,10.0,12.0,7.0,12.0,6.0,13.0,8.0,15.0,16.0,11.0,9.0,17.0,11.0,17.0,10.0,18.0,8.0,13.0,9.0,10.0,17.0,9.0,10.0,12.0,11.0,12.0,17.0,14.0,13.0,18.0,12.0,20.0,18.0,17.0,9.0,17.0,15.0,15.0,14.0,15.0,5.0,14.0,12.0,16.0,10.0,15.0,12.0,10.0,8.0,13.0,27.0,59.0,19.0,13.0,9.0,178.0,72.0,2.0,1.0,1.0,1.0,3.0,2.0,2.0,3.0,1.0,2.0,1.0,15.0,12.0,14.0,13.0,15.0,10.0,10.0,13.0,6.0,7.0,13.0,11.0,11.0,14.0,17.0,16.0,10.0,11.0,10.0,14.0,12.0,12.0,14.0,9.0,17.0,10.0,16.0,17.0,16.0,16.0,12.0,8.0,16.0,18.0,15.0,20.0,17.0,8.0,13.0,6.0,12.0,3.0,17.0,15.0,17.0,6.0,8.0,18.0,12.0,14.0,10.0
3,1,16.0,0.0,0.0,0.0,0.0,172.0,0.0,2.0,1.0,2.0,3.0,2.0,1.0,2.0,1.0,2.0,3.0,3.0,5.0,3.0,5.0,5.0,8.0,4.0,4.0,8.0,3.0,6.0,10.0,3.0,7.0,6.0,5.0,10.0,9.0,9.0,6.0,7.0,10.0,8.0,4.0,5.0,6.0,8.0,12.0,7.0,7.0,7.0,11.0,7.0,9.0,14.0,9.0,20.0,8.0,6.0,7.0,7.0,15.0,6.0,15.0,6.0,3.0,11.0,12.0,8.0,14.0,13.0,1.0,30.0,36.0,1.0,0.0,0.0,186.0,75.0,3.0,1.0,2.0,1.0,1.0,3.0,3.0,3.0,2.0,4.0,1.0,2.0,5.0,8.0,8.0,13.0,3.0,17.0,4.0,4.0,17.0,12.0,5.0,19.0,12.0,16.0,17.0,18.0,16.0,15.0,10.0,14.0,16.0,5.0,14.0,10.0,16.0,15.0,16.0,15.0,12.0,14.0,14.0,8.0,15.0,14.0,20.0,15.0,15.0,18.0,11.0,16.0,7.0,8.0,14.0,15.0,16.0,15.0,17.0,15.0,15.0,5.0,25.0,44.0,11.0,12.0,2.0,178.0,67.0,3.0,2.0,2.0,4.0,1.0,1.0,3.0,2.0,2.0,1.0,2.0,9.0,13.0,15.0,12.0,15.0,8.0,5.0,12.0,3.0,9.0,15.0,12.0,12.0,17.0,10.0,14.0,13.0,16.0,14.0,17.0,14.0,15.0,14.0,12.0,17.0,11.0,16.0,16.0,13.0,16.0,14.0,8.0,12.0,16.0,12.0,20.0,16.0,12.0,14.0,6.0,15.0,12.0,16.0,14.0,14.0,16.0,14.0,17.0,16.0,14.0,6.0,24.0,34.0,2.0,7.0,0.0,174.0,65.0,2.0,3.0,2.0,3.0,2.0,1.0,1.0,4.0,3.0,3.0,3.0,12.0,12.0,15.0,11.0,16.0,11.0,6.0,12.0,3.0,8.0,15.0,12.0,12.0,16.0,15.0,15.0,17.0,14.0,14.0,16.0,15.0,13.0,16.0,13.0,16.0,11.0,17.0,15.0,14.0,14.0,16.0,6.0,20.0,13.0,13.0,8.0,14.0,11.0,14.0,13.0,15.0,15.0,15.0,11.0,15.0,17.0,14.0,12.0,10.0,10.0,14.0,27.0,79.0,20.0,16.0,5.0,183.0,72.0,3.0,3.0,4.0,2.0,3.0,3.0,1.0,2.0,3.0,3.0,3.0,15.0,16.0,17.0,12.0,19.0,13.0,7.0,11.0,4.0,6.0,19.0,13.0,9.0,19.0,7.0,18.0,9.0,19.0,15.0,20.0,18.0,14.0,19.0,8.0,20.0,6.0,19.0,12.0,14.0,16.0,14.0,9.0,20.0,15.0,13.0,10.0,15.0,9.0,13.0,5.0,16.0,6.0,10.0,16.0,16.0,12.0,17.0,15.0,14.0,16.0,10.0,30.0,16.0,0.0,9.0,0.0,178.0,72.0,1.0,3.0,3.0,2.0,3.0,3.0,3.0,1.0,3.0,1.0,1.0,7.0,12.0,12.0,7.0,12.0,7.0,15.0,7.0,14.0,16.0,13.0,7.0,16.0,13.0,14.0,15.0,15.0,15.0,16.0,10.0,15.0,15.0,6.0,8.0,12.0,15.0,16.0,15.0,14.0,13.0,14.0,12.0,20.0,14.0,14.0,8.0,16.0,12.0,16.0,10.0,18.0,9.0,8.0,15.0,12.0,14.0,14.0,16.0,14.0,16.0,6.0,24.0,12.0,1.0,7.0,0.0,184.0,82.0,4.0,3.0,1.0,1.0,3.0,3.0,3.0,2.0,1.0,3.0,1.0,4.0,11.0,11.0,9.0,12.0,3.0,16.0,4.0,11.0,16.0,13.0,5.0,16.0,12.0,14.0,14.0,15.0,14.0,13.0,12.0,15.0,15.0,6.0,13.0,10.0,15.0,15.0,16.0,15.0,12.0,15.0,14.0,11.0,15.0,14.0,20.0,14.0,15.0,14.0,12.0,15.0,6.0,11.0,16.0,16.0,15.0,13.0,16.0,16.0,12.0,6.0,25.0,34.0,14.0,14.0,5.0,185.0,73.0,3.0,1.0,2.0,4.0,2.0,3.0,2.0,3.0,3.0,3.0,2.0,5.0,9.0,14.0,15.0,13.0,4.0,13.0,8.0,3.0,6.0,12.0,10.0,6.0,14.0,11.0,13.0,14.0,12.0,12.0,10.0,14.0,14.0,17.0,4.0,14.0,8.0,16.0,17.0,17.0,15.0,16.0,14.0,12.0,15.0,17.0,20.0,15.0,14.0,14.0,5.0,12.0,12.0,12.0,9.0,15.0,16.0,14.0,15.0,11.0,15.0,4.0,21.0,3.0,0.0,0.0,0.0,177.0,72.0,3.0,2.0,3.0,1.0,3.0,3.0,1.0,1.0,3.0,1.0,2.0,8.0,13.0,13.0,9.0,12.0,5.0,10.0,11.0,12.0,13.0,11.0,8.0,15.0,14.0,12.0,12.0,15.0,13.0,13.0,10.0,12.0,15.0,12.0,4.0,14.0,13.0,14.0,16.0,20.0,15.0,13.0,9.0,8.0,16.0,20.0,20.0,16.0,9.0,17.0,8.0,15.0,5.0,14.0,15.0,15.0,14.0,15.0,15.0,15.0,15.0,5.0,23.0,47.0,6.0,5.0,0.0,185.0,82.0,3.0,2.0,1.0,1.0,1.0,3.0,2.0,2.0,1.0,3.0,1.0,9.0,11.0,11.0,9.0,14.0,12.0,10.0,15.0,6.0,12.0,17.0,10.0,13.0,16.0,16.0,13.0,15.0,14.0,12.0,16.0,13.0,13.0,12.0,12.0,10.0,12.0,16.0,14.0,12.0,11.0,16.0,13.0,20.0,14.0,13.0,12.0,16.0,15.0,13.0,15.0,15.0,5.0,10.0,14.0,17.0,8.0,14.0,13.0,10.0,6.0,15.0,27.0,59.0,19.0,13.0,9.0,178.0,72.0,2.0,1.0,1.0,1.0,3.0,2.0,2.0,3.0,1.0,2.0,1.0,15.0,12.0,14.0,13.0,15.0,10.0,10.0,13.0,6.0,7.0,13.0,11.0,11.0,14.0,17.0,16.0,10.0,11.0,10.0,14.0,12.0,12.0,14.0,9.0,17.0,10.0,16.0,17.0,16.0,16.0,12.0,8.0,16.0,18.0,15.0,20.0,17.0,8.0,13.0,6.0,12.0,3.0,17.0,15.0,17.0,6.0,8.0,18.0,12.0,14.0,10.0,17.0,2.0,0.0,3.0,0.0,196.0,90.0,15.0,15.0,13.0,5.0,15.0,13.0,14.0,17.0,15.0,14.0,11.0,9.0,2.0,4.0,1.0,10.0,12.0,7.0,2.0,8.0,3.0,8.0,3.0,7.0,8.0,8.0,12.0,15.0,13.0,15.0,9.0,12.0,15.0,7.0,14.0,2.0,13.0,11.0,13.0,9.0,13.0,14.0,18.0,7.0,15.0,12.0,20.0,13.0,14.0,13.0,7.0,10.0,4.0,12.0,12.0,15.0,16.0,16.0,14.0,16.0,14.0,3.0,31.0,0.0,0.0,0.0,0.0,176.0,74.0,3.0,2.0,2.0,2.0,3.0,1.0,2.0,1.0,1.0,1.0,3.0,7.0,13.0,13.0,12.0,11.0,11.0,5.0,9.0,5.0,4.0,11.0,11.0,6.0,12.0,14.0,10.0,15.0,10.0,11.0,11.0,10.0,14.0,13.0,14.0,14.0,7.0,12.0,15.0,15.0,13.0,13.0,8.0,10.0,11.0,15.0,20.0,13.0,11.0,11.0,14.0,15.0,8.0,7.0,13.0,12.0,16.0,10.0,13.0,7.0,7.0,10.0,16.0,0.0,0.0,0.0,0.0,173.0,0.0,2.0,1.0,2.0,4.0,3.0,1.0,3.0,2.0,2.0,2.0,1.0,4.0,7.0,3.0,2.0,4.0,6.0,5.0,2.0,3.0,2.0,4.0,4.0,3.0,6.0,11.0,4.0,16.0,5.0,4.0,5.0,5.0,7.0,15.0,3.0,5.0,3.0,4.0,6.0,15.0,11.0,2.0,7.0,5.0,14.0,13.0,20.0,9.0,2.0,3.0,12.0,6.0,9.0,6.0,5.0,16.0,10.0,6.0,10.0,13.0,9.0,9.0,22.0,21.0,6.0,2.0,0.0,178.0,69.0,3.0,3.0,3.0,3.0,1.0,2.0,3.0,2.0,1.0,2.0,3.0,18.0,16.0,12.0,13.0,17.0,18.0,7.0,17.0,5.0,7.0,14.0,15.0,10.0,17.0,10.0,12.0,8.0,14.0,9.0,15.0,11.0,9.0,17.0,6.0,12.0,8.0,10.0,14.0,12.0,15.0,9.0,6.0,14.0,13.0,12.0,20.0,15.0,8.0,10.0,6.0,13.0,5.0,14.0,11.0,18.0,5.0,14.0,10.0,7.0,11.0,16.0,25.0,1.0,0.0,18.0,6.0,179.0,75.0,3.0,1.0,3.0,1.0,1.0,1.0,2.0,1.0,2.0,1.0,3.0,12.0,12.0,12.0,13.0,13.0,11.0,9.0,13.0,10.0,5.0,12.0,16.0,9.0,13.0,11.0,12.0,11.0,14.0,11.0,11.0,9.0,15.0,12.0,7.0,14.0,11.0,12.0,17.0,14.0,14.0,10.0,9.0,12.0,14.0,13.0,20.0,16.0,10.0,10.0,4.0,16.0,5.0,13.0,14.0,17.0,12.0,16.0,15.0,6.0,11.0,4.0,21.0,4.0,0.0,15.0,1.0,188.0,78.0,1.0,3.0,3.0,3.0,3.0,2.0,1.0,3.0,1.0,1.0,1.0,3.0,7.0,10.0,6.0,13.0,5.0,15.0,6.0,11.0,16.0,13.0,5.0,16.0,12.0,12.0,16.0,13.0,14.0,14.0,12.0,12.0,15.0,5.0,11.0,8.0,15.0,15.0,13.0,12.0,14.0,15.0,14.0,20.0,14.0,14.0,10.0,16.0,14.0,13.0,13.0,13.0,10.0,10.0,17.0,15.0,13.0,14.0,14.0,13.0,14.0,4.0,31.0,64.0,2.0,25.0,4.0,182.0,79.0,2.0,2.0,2.0,3.0,1.0,3.0,3.0,3.0,2.0,3.0,1.0,15.0,13.0,12.0,7.0,16.0,14.0,8.0,15.0,8.0,13.0,15.0,14.0,14.0,16.0,13.0,13.0,9.0,14.0,14.0,15.0,13.0,12.0,13.0,13.0,11.0,13.0,15.0,13.0,11.0,12.0,13.0,10.0,14.0,12.0,11.0,20.0,13.0,12.0,14.0,13.0,12.0,15.0,12.0,7.0,14.0,14.0,12.0,15.0,16.0,17.0,9.0,29.0,62.0,4.0,0.0,0.0,190.0,86.0,2.0,2.0,1.0,4.0,1.0,1.0,1.0,1.0,2.0,1.0,2.0,9.0,9.0,12.0,9.0,13.0,12.0,14.0,12.0,8.0,16.0,17.0,13.0,15.0,13.0,11.0,20.0,16.0,14.0,16.0,19.0,12.0,17.0,13.0,19.0,7.0,20.0,16.0,14.0,14.0,13.0,15.0,14.0,9.0,15.0,14.0,20.0,16.0,15.0,16.0,11.0,14.0,5.0,11.0,14.0,15.0,16.0,14.0,18.0,14.0,9.0,3.0,18.0,0.0,0.0,0.0,0.0,183.0,73.0,2.0,1.0,3.0,2.0,1.0,3.0,1.0,1.0,1.0,2.0,2.0,1.0,1.0,10.0,11.0,10.0,4.0,11.0,7.0,3.0,2.0,7.0,10.0,2.0,12.0,11.0,13.0,12.0,10.0,10.0,10.0,11.0,16.0,10.0,7.0,13.0,3.0,7.0,8.0,13.0,13.0,10.0,11.0,8.0,15.0,14.0,20.0,12.0,9.0,11.0,8.0,6.0,7.0,5.0,14.0,14.0,18.0,12.0,14.0,11.0,13.0,5.0,15.0,0.0,0.0,0.0,0.0,165.0,0.0,2.0,3.0,1.0,2.0,1.0,2.0,3.0,3.0,3.0,3.0,1.0,3.0,5.0,3.0,3.0,5.0,2.0,6.0,4.0,4.0,6.0,7.0,4.0,11.0,5.0,14.0,4.0,9.0,5.0,6.0,4.0,10.0,14.0,13.0,9.0,5.0,5.0,7.0,8.0,11.0,6.0,6.0,5.0,20.0,12.0,6.0,6.0,12.0,6.0,4.0,14.0,11.0,4.0,6.0,14.0,13.0,14.0,11.0,8.0,5.0,8.0,10.0,19.0,6.0,0.0,10.0,0.0,180.0,77.0,3.0,1.0,1.0,1.0,1.0,2.0,2.0,3.0,2.0,2.0,4.0,6.0,10.0,9.0,10.0,10.0,7.0,11.0,12.0,9.0,13.0,13.0,13.0,16.0,10.0,13.0,13.0,17.0,13.0,14.0,8.0,13.0,17.0,10.0,13.0,14.0,12.0,11.0,14.0,13.0,14.0,18.0,11.0,10.0,13.0,15.0,20.0,17.0,17.0,12.0,13.0,11.0,4.0,15.0,16.0,16.0,8.0,12.0,9.0,11.0,13.0,12.0
2,1,30.0,0.0,0.0,0.0,0.0,193.0,86.0,11.0,14.0,14.0,9.0,14.0,11.0,15.0,13.0,9.0,12.0,10.0,2.0,2.0,2.0,3.0,8.0,4.0,1.0,3.0,3.0,4.0,10.0,6.0,8.0,7.0,7.0,14.0,13.0,15.0,11.0,9.0,13.0,15.0,9.0,9.0,4.0,12.0,10.0,2.0,12.0,12.0,8.0,15.0,7.0,9.0,11.0,20.0,12.0,13.0,17.0,11.0,14.0,9.0,4.0,11.0,10.0,19.0,14.0,12.0,12.0,11.0,6.0,28.0,5.0,3.0,17.0,1.0,180.0,68.0,3.0,2.0,2.0,3.0,3.0,3.0,3.0,2.0,3.0,2.0,4.0,4.0,9.0,16.0,12.0,17.0,11.0,6.0,13.0,7.0,9.0,16.0,13.0,13.0,16.0,9.0,15.0,12.0,12.0,9.0,14.0,14.0,11.0,16.0,5.0,11.0,11.0,11.0,10.0,12.0,12.0,9.0,8.0,15.0,11.0,10.0,20.0,9.0,9.0,14.0,13.0,14.0,7.0,7.0,11.0,9.0,15.0,11.0,17.0,17.0,11.0,4.0,26.0,0.0,0.0,5.0,1.0,175.0,68.0,1.0,1.0,2.0,1.0,1.0,3.0,1.0,1.0,1.0,1.0,1.0,14.0,16.0,15.0,11.0,16.0,16.0,5.0,5.0,5.0,5.0,13.0,13.0,9.0,14.0,9.0,9.0,8.0,8.0,12.0,10.0,9.0,11.0,18.0,4.0,12.0,4.0,12.0,10.0,12.0,16.0,7.0,6.0,20.0,8.0,16.0,7.0,12.0,4.0,7.0,12.0,14.0,12.0,8.0,10.0,11.0,8.0,8.0,12.0,8.0,12.0,13.0,26.0,2.0,1.0,11.0,0.0,177.0,73.0,1.0,3.0,3.0,1.0,3.0,2.0,1.0,1.0,2.0,3.0,2.0,12.0,11.0,14.0,13.0,13.0,10.0,8.0,14.0,9.0,8.0,13.0,13.0,10.0,13.0,15.0,11.0,14.0,11.0,10.0,11.0,11.0,10.0,16.0,7.0,12.0,8.0,8.0,11.0,14.0,14.0,12.0,8.0,10.0,8.0,16.0,20.0,12.0,8.0,11.0,13.0,11.0,9.0,7.0,10.0,13.0,19.0,9.0,11.0,8.0,6.0,12.0,27.0,1.0,0.0,11.0,0.0,181.0,74.0,2.0,1.0,1.0,2.0,1.0,2.0,1.0,3.0,2.0,3.0,4.0,13.0,14.0,12.0,8.0,12.0,9.0,12.0,12.0,14.0,13.0,13.0,14.0,12.0,11.0,13.0,12.0,12.0,15.0,15.0,9.0,13.0,16.0,14.0,11.0,12.0,11.0,10.0,14.0,14.0,11.0,16.0,13.0,7.0,15.0,13.0,20.0,14.0,12.0,16.0,14.0,16.0,7.0,10.0,10.0,12.0,16.0,17.0,14.0,12.0,10.0,6.0,24.0,14.0,0.0,21.0,1.0,177.0,67.0,2.0,3.0,3.0,2.0,2.0,3.0,2.0,3.0,2.0,1.0,4.0,11.0,11.0,13.0,13.0,13.0,12.0,5.0,13.0,6.0,9.0,14.0,13.0,5.0,14.0,12.0,13.0,13.0,14.0,14.0,12.0,14.0,11.0,15.0,8.0,11.0,13.0,11.0,14.0,13.0,14.0,13.0,7.0,12.0,6.0,14.0,20.0,16.0,12.0,11.0,12.0,10.0,12.0,14.0,9.0,9.0,12.0,12.0,9.0,7.0,11.0,6.0,28.0,0.0,0.0,13.0,2.0,185.0,75.0,2.0,1.0,3.0,2.0,1.0,1.0,2.0,2.0,2.0,2.0,3.0,15.0,19.0,12.0,12.0,14.0,15.0,8.0,9.0,9.0,10.0,15.0,13.0,12.0,14.0,9.0,11.0,10.0,11.0,10.0,9.0,11.0,12.0,13.0,9.0,11.0,14.0,11.0,12.0,13.0,11.0,11.0,10.0,20.0,11.0,12.0,8.0,13.0,11.0,15.0,12.0,14.0,9.0,13.0,7.0,10.0,12.0,13.0,12.0,10.0,10.0,8.0,24.0,0.0,0.0,0.0,0.0,186.0,77.0,3.0,2.0,2.0,3.0,3.0,4.0,3.0,3.0,2.0,2.0,1.0,7.0,7.0,9.0,8.0,10.0,7.0,13.0,10.0,13.0,14.0,11.0,12.0,14.0,11.0,13.0,11.0,14.0,9.0,14.0,9.0,10.0,15.0,10.0,12.0,11.0,13.0,13.0,11.0,11.0,7.0,13.0,13.0,7.0,14.0,12.0,20.0,10.0,14.0,15.0,13.0,10.0,6.0,13.0,12.0,14.0,12.0,15.0,13.0,14.0,10.0,6.0,33.0,13.0,0.0,9.0,3.0,184.0,76.0,1.0,3.0,1.0,1.0,3.0,2.0,2.0,1.0,3.0,3.0,1.0,7.0,8.0,14.0,15.0,11.0,9.0,15.0,7.0,7.0,5.0,10.0,14.0,8.0,12.0,9.0,15.0,12.0,11.0,13.0,14.0,16.0,16.0,12.0,13.0,16.0,12.0,7.0,8.0,12.0,11.0,15.0,14.0,8.0,15.0,12.0,20.0,12.0,10.0,13.0,11.0,16.0,14.0,12.0,11.0,15.0,18.0,12.0,12.0,10.0,9.0,8.0,21.0,0.0,0.0,7.0,1.0,175.0,69.0,2.0,2.0,3.0,4.0,3.0,3.0,3.0,1.0,2.0,2.0,3.0,6.0,7.0,9.0,5.0,14.0,8.0,5.0,9.0,6.0,6.0,10.0,5.0,10.0,14.0,10.0,7.0,6.0,13.0,7.0,14.0,14.0,3.0,10.0,12.0,6.0,8.0,9.0,11.0,14.0,14.0,9.0,4.0,9.0,10.0,14.0,20.0,10.0,7.0,10.0,10.0,10.0,10.0,10.0,16.0,11.0,14.0,11.0,14.0,6.0,17.0,3.0,30.0,29.0,2.0,10.0,2.0,180.0,77.0,3.0,3.0,3.0,2.0,2.0,3.0,1.0,1.0,2.0,2.0,2.0,9.0,11.0,13.0,14.0,13.0,7.0,10.0,14.0,7.0,10.0,15.0,13.0,8.0,14.0,14.0,18.0,17.0,14.0,10.0,9.0,15.0,16.0,12.0,11.0,14.0,10.0,8.0,12.0,13.0,8.0,13.0,8.0,20.0,9.0,13.0,13.0,10.0,10.0,11.0,15.0,15.0,8.0,9.0,8.0,18.0,14.0,8.0,10.0,10.0,8.0,9.0,28.0,42.0,0.0,12.0,0.0,190.0,84.0,16.0,14.0,16.0,5.0,16.0,14.0,17.0,18.0,15.0,12.0,14.0,6.0,3.0,5.0,2.0,7.0,8.0,8.0,3.0,12.0,3.0,8.0,1.0,1.0,11.0,12.0,12.0,13.0,14.0,14.0,10.0,13.0,15.0,11.0,16.0,11.0,16.0,13.0,14.0,11.0,14.0,16.0,16.0,20.0,13.0,10.0,5.0,12.0,15.0,14.0,7.0,15.0,8.0,13.0,19.0,8.0,20.0,15.0,17.0,18.0,17.0,4.0,28.0,52.0,5.0,8.0,6.0,179.0,70.0,3.0,3.0,2.0,3.0,2.0,3.0,1.0,1.0,2.0,3.0,1.0,13.0,15.0,15.0,11.0,14.0,12.0,12.0,12.0,14.0,13.0,14.0,12.0,16.0,14.0,14.0,15.0,15.0,12.0,14.0,13.0,14.0,12.0,13.0,11.0,16.0,13.0,13.0,15.0,14.0,13.0,14.0,10.0,20.0,9.0,14.0,8.0,13.0,11.0,13.0,14.0,17.0,15.0,15.0,12.0,14.0,14.0,13.0,8.0,11.0,12.0,14.0,17.0,0.0,0.0,0.0,0.0,174.0,69.0,3.0,1.0,3.0,4.0,4.0,2.0,2.0,3.0,2.0,1.0,3.0,2.0,4.0,6.0,5.0,10.0,1.0,1.0,8.0,1.0,2.0,9.0,1.0,3.0,13.0,7.0,4.0,2.0,3.0,2.0,5.0,13.0,7.0,13.0,11.0,3.0,1.0,6.0,11.0,13.0,10.0,5.0,5.0,5.0,8.0,12.0,20.0,6.0,3.0,4.0,7.0,7.0,7.0,5.0,17.0,9.0,12.0,11.0,11.0,9.0,12.0,5.0,16.0,0.0,0.0,0.0,0.0,162.0,0.0,4.0,1.0,1.0,3.0,1.0,1.0,2.0,3.0,1.0,1.0,1.0,6.0,8.0,4.0,4.0,4.0,2.0,2.0,2.0,3.0,3.0,5.0,3.0,4.0,8.0,13.0,4.0,5.0,5.0,4.0,3.0,7.0,7.0,11.0,4.0,3.0,4.0,5.0,6.0,13.0,9.0,4.0,4.0,1.0,12.0,12.0,20.0,8.0,4.0,6.0,14.0,10.0,11.0,11.0,6.0,10.0,11.0,9.0,10.0,11.0,10.0,11.0,24.0,1.0,0.0,0.0,0.0,172.0,73.0,1.0,4.0,2.0,1.0,2.0,2.0,1.0,1.0,4.0,3.0,2.0,14.0,14.0,15.0,10.0,14.0,15.0,7.0,14.0,5.0,10.0,14.0,9.0,10.0,15.0,8.0,12.0,13.0,11.0,11.0,11.0,13.0,14.0,16.0,9.0,13.0,8.0,14.0,15.0,14.0,14.0,15.0,7.0,20.0,13.0,15.0,10.0,12.0,11.0,15.0,12.0,15.0,8.0,10.0,14.0,13.0,12.0,13.0,15.0,10.0,10.0,9.0,24.0,0.0,0.0,29.0,1.0,187.0,75.0,1.0,2.0,4.0,2.0,2.0,3.0,1.0,3.0,3.0,2.0,3.0,6.0,11.0,12.0,12.0,14.0,7.0,11.0,13.0,6.0,13.0,12.0,10.0,12.0,13.0,12.0,12.0,12.0,13.0,14.0,12.0,13.0,13.0,13.0,8.0,11.0,13.0,14.0,14.0,14.0,14.0,13.0,12.0,8.0,13.0,14.0,20.0,15.0,14.0,14.0,13.0,12.0,8.0,10.0,10.0,14.0,8.0,10.0,8.0,14.0,12.0,12.0,30.0,91.0,21.0,0.0,0.0,188.0,81.0,3.0,2.0,2.0,1.0,4.0,3.0,3.0,3.0,2.0,1.0,2.0,15.0,16.0,16.0,12.0,17.0,15.0,11.0,13.0,3.0,6.0,16.0,16.0,8.0,17.0,7.0,11.0,9.0,17.0,11.0,17.0,16.0,11.0,16.0,10.0,16.0,9.0,12.0,11.0,11.0,16.0,13.0,11.0,20.0,14.0,11.0,13.0,11.0,9.0,13.0,5.0,10.0,11.0,12.0,13.0,13.0,13.0,13.0,14.0,15.0,10.0,1.0,32.0,4.0,0.0,13.0,2.0,189.0,84.0,2.0,2.0,1.0,1.0,2.0,1.0,3.0,1.0,3.0,1.0,2.0,12.0,11.0,10.0,8.0,10.0,11.0,15.0,14.0,14.0,16.0,12.0,11.0,15.0,14.0,12.0,14.0,14.0,13.0,14.0,10.0,15.0,13.0,8.0,11.0,11.0,16.0,15.0,16.0,11.0,10.0,10.0,16.0,20.0,13.0,13.0,7.0,15.0,15.0,14.0,11.0,14.0,13.0,17.0,11.0,15.0,13.0,14.0,14.0,14.0,16.0,5.0,27.0,43.0,2.0,3.0,0.0,193.0,86.0,2.0,3.0,3.0,2.0,1.0,3.0,2.0,1.0,2.0,1.0,2.0,10.0,8.0,10.0,10.0,13.0,13.0,14.0,13.0,10.0,12.0,14.0,12.0,14.0,12.0,13.0,11.0,12.0,13.0,14.0,12.0,13.0,14.0,10.0,11.0,10.0,14.0,14.0,12.0,11.0,13.0,13.0,16.0,12.0,14.0,11.0,20.0,14.0,15.0,12.0,15.0,11.0,7.0,9.0,4.0,13.0,18.0,10.0,10.0,13.0,12.0,7.0,27.0,6.0,1.0,10.0,5.0,192.0,78.0,3.0,3.0,3.0,3.0,3.0,3.0,2.0,1.0,1.0,2.0,2.0,6.0,9.0,10.0,18.0,15.0,8.0,16.0,9.0,5.0,5.0,10.0,15.0,5.0,13.0,8.0,18.0,14.0,18.0,16.0,10.0,13.0,10.0,10.0,6.0,17.0,6.0,8.0,9.0,11.0,9.0,12.0,15.0,15.0,12.0,13.0,20.0,13.0,14.0,15.0,4.0,12.0,10.0,5.0,12.0,17.0,8.0,13.0,12.0,10.0,8.0,14.0,21.0,0.0,0.0,3.0,1.0,173.0,65.0,3.0,1.0,2.0,3.0,3.0,2.0,1.0,1.0,1.0,3.0,3.0,6.0,10.0,18.0,13.0,16.0,5.0,5.0,9.0,2.0,5.0,11.0,12.0,6.0,17.0,11.0,14.0,12.0,14.0,12.0,13.0,12.0,15.0,19.0,6.0,14.0,7.0,11.0,12.0,17.0,17.0,14.0,7.0,12.0,14.0,16.0,20.0,11.0,8.0,13.0,6.0,14.0,6.0,10.0,16.0,14.0,15.0,14.0,15.0,13.0,12.0,7.0
5,2,33.0,0.0,0.0,2.0,0.0,196.0,89.0,15.0,13.0,12.0,7.0,14.0,10.0,14.0,14.0,11.0,9.0,12.0,4.0,3.0,1.0,1.0,9.0,7.0,2.0,2.0,1.0,1.0,10.0,2.0,2.0,9.0,10.0,14.0,14.0,13.0,12.0,11.0,12.0,14.0,6.0,12.0,1.0,13.0,11.0,6.0,9.0,13.0,16.0,18.0,5.0,12.0,10.0,20.0,12.0,16.0,14.0,10.0,15.0,13.0,1.0,8.0,14.0,14.0,14.0,10.0,15.0,15.0,9.0,26.0,27.0,0.0,0.0,0.0,183.0,70.0,1.0,3.0,1.0,3.0,4.0,1.0,3.0,3.0,2.0,1.0,3.0,9.0,14.0,12.0,8.0,10.0,8.0,12.0,13.0,14.0,9.0,12.0,7.0,13.0,11.0,14.0,9.0,15.0,10.0,12.0,9.0,10.0,16.0,10.0,9.0,12.0,8.0,12.0,17.0,14.0,11.0,13.0,12.0,10.0,16.0,16.0,20.0,16.0,13.0,13.0,10.0,14.0,6.0,15.0,10.0,15.0,14.0,10.0,16.0,13.0,13.0,4.0,16.0,0.0,0.0,0.0,0.0,192.0,0.0,2.0,3.0,1.0,2.0,3.0,1.0,1.0,1.0,2.0,3.0,3.0,6.0,8.0,8.0,6.0,10.0,6.0,12.0,6.0,7.0,12.0,10.0,7.0,12.0,10.0,13.0,12.0,14.0,11.0,10.0,8.0,10.0,10.0,8.0,6.0,8.0,9.0,10.0,13.0,13.0,11.0,12.0,13.0,6.0,14.0,12.0,20.0,10.0,10.0,10.0,7.0,8.0,8.0,10.0,9.0,13.0,10.0,11.0,11.0,10.0,15.0,9.0,21.0,0.0,0.0,11.0,2.0,180.0,72.0,2.0,3.0,3.0,3.0,3.0,2.0,2.0,1.0,3.0,2.0,3.0,12.0,13.0,14.0,9.0,14.0,13.0,8.0,12.0,5.0,8.0,14.0,10.0,9.0,14.0,12.0,12.0,9.0,13.0,12.0,15.0,13.0,14.0,15.0,8.0,13.0,10.0,16.0,14.0,15.0,14.0,12.0,9.0,8.0,15.0,14.0,20.0,13.0,12.0,12.0,8.0,11.0,10.0,11.0,10.0,14.0,16.0,14.0,15.0,15.0,15.0,6.0,29.0,26.0,6.0,12.0,4.0,175.0,77.0,1.0,2.0,1.0,3.0,3.0,2.0,1.0,2.0,1.0,2.0,2.0,16.0,14.0,16.0,15.0,15.0,18.0,6.0,15.0,6.0,6.0,18.0,11.0,5.0,17.0,9.0,12.0,10.0,16.0,12.0,16.0,14.0,14.0,16.0,6.0,16.0,6.0,10.0,10.0,13.0,15.0,14.0,8.0,15.0,15.0,14.0,20.0,13.0,12.0,11.0,9.0,16.0,7.0,8.0,8.0,11.0,8.0,13.0,12.0,13.0,11.0,10.0,28.0,47.0,9.0,17.0,4.0,188.0,94.0,3.0,3.0,3.0,2.0,3.0,2.0,3.0,3.0,1.0,1.0,3.0,6.0,11.0,12.0,17.0,16.0,11.0,18.0,13.0,5.0,6.0,13.0,13.0,6.0,16.0,8.0,14.0,13.0,16.0,16.0,13.0,15.0,11.0,16.0,10.0,13.0,8.0,8.0,8.0,10.0,11.0,17.0,15.0,20.0,13.0,12.0,14.0,13.0,16.0,14.0,14.0,15.0,9.0,5.0,14.0,16.0,14.0,11.0,13.0,14.0,14.0,10.0,24.0,0.0,0.0,0.0,0.0,177.0,65.0,1.0,2.0,1.0,2.0,1.0,2.0,1.0,1.0,1.0,2.0,3.0,8.0,11.0,13.0,10.0,13.0,8.0,10.0,11.0,7.0,5.0,12.0,13.0,6.0,13.0,8.0,11.0,9.0,10.0,9.0,9.0,11.0,13.0,12.0,5.0,12.0,8.0,7.0,9.0,16.0,15.0,12.0,8.0,10.0,15.0,15.0,20.0,14.0,12.0,11.0,8.0,13.0,7.0,12.0,20.0,14.0,13.0,12.0,9.0,12.0,11.0,10.0,22.0,0.0,0.0,3.0,0.0,176.0,70.0,1.0,1.0,1.0,3.0,2.0,1.0,2.0,3.0,1.0,3.0,3.0,10.0,15.0,14.0,6.0,13.0,10.0,13.0,10.0,9.0,9.0,13.0,8.0,11.0,14.0,10.0,11.0,12.0,10.0,13.0,11.0,13.0,14.0,13.0,7.0,13.0,9.0,11.0,13.0,17.0,13.0,12.0,10.0,20.0,14.0,16.0,5.0,15.0,11.0,13.0,10.0,14.0,8.0,10.0,11.0,13.0,16.0,11.0,15.0,14.0,13.0,7.0,28.0,41.0,2.0,0.0,0.0,187.0,80.0,3.0,2.0,3.0,2.0,1.0,1.0,2.0,3.0,1.0,4.0,2.0,7.0,10.0,11.0,7.0,12.0,7.0,10.0,12.0,13.0,15.0,13.0,8.0,18.0,12.0,18.0,13.0,17.0,12.0,14.0,10.0,12.0,17.0,7.0,13.0,9.0,14.0,17.0,18.0,14.0,13.0,16.0,14.0,20.0,18.0,13.0,12.0,18.0,14.0,15.0,16.0,15.0,6.0,15.0,14.0,13.0,10.0,14.0,12.0,8.0,7.0,8.0,23.0,0.0,0.0,10.0,7.0,179.0,70.0,1.0,1.0,2.0,2.0,1.0,3.0,3.0,2.0,1.0,4.0,3.0,10.0,13.0,14.0,12.0,15.0,11.0,10.0,13.0,6.0,3.0,13.0,12.0,4.0,16.0,11.0,12.0,11.0,13.0,11.0,13.0,12.0,12.0,16.0,6.0,14.0,6.0,10.0,12.0,16.0,14.0,12.0,9.0,20.0,13.0,14.0,10.0,13.0,10.0,12.0,7.0,12.0,6.0,8.0,12.0,13.0,5.0,10.0,8.0,14.0,12.0,8.0,18.0,0.0,0.0,0.0,0.0,167.0,60.0,2.0,1.0,2.0,2.0,2.0,1.0,2.0,1.0,1.0,1.0,1.0,10.0,11.0,12.0,8.0,13.0,10.0,3.0,10.0,5.0,6.0,13.0,12.0,8.0,15.0,8.0,11.0,8.0,12.0,11.0,13.0,12.0,13.0,12.0,6.0,11.0,11.0,12.0,13.0,15.0,14.0,8.0,5.0,8.0,15.0,12.0,20.0,12.0,7.0,8.0,8.0,14.0,7.0,8.0,18.0,11.0,12.0,11.0,12.0,15.0,15.0,7.0,26.0,3.0,0.0,26.0,0.0,192.0,83.0,12.0,9.0,10.0,6.0,13.0,14.0,15.0,16.0,14.0,12.0,10.0,5.0,2.0,2.0,1.0,10.0,10.0,3.0,3.0,1.0,1.0,9.0,4.0,3.0,10.0,8.0,14.0,12.0,14.0,12.0,8.0,11.0,10.0,1.0,9.0,2.0,12.0,15.0,10.0,12.0,14.0,15.0,14.0,10.0,13.0,10.0,20.0,12.0,15.0,15.0,10.0,15.0,10.0,11.0,14.0,16.0,12.0,11.0,17.0,14.0,18.0,5.0,17.0,0.0,0.0,0.0,0.0,185.0,83.0,3.0,1.0,3.0,2.0,2.0,3.0,2.0,3.0,3.0,2.0,3.0,4.0,8.0,12.0,6.0,10.0,6.0,11.0,8.0,10.0,14.0,13.0,7.0,13.0,12.0,14.0,12.0,15.0,13.0,9.0,12.0,10.0,13.0,11.0,8.0,7.0,11.0,12.0,13.0,14.0,13.0,16.0,14.0,12.0,16.0,18.0,20.0,12.0,15.0,11.0,8.0,13.0,4.0,10.0,13.0,16.0,9.0,14.0,12.0,14.0,12.0,7.0,17.0,0.0,0.0,0.0,0.0,192.0,84.0,3.0,1.0,2.0,1.0,2.0,1.0,2.0,2.0,1.0,3.0,2.0,5.0,4.0,6.0,6.0,8.0,4.0,10.0,5.0,7.0,10.0,8.0,6.0,10.0,8.0,13.0,9.0,14.0,12.0,9.0,8.0,10.0,10.0,5.0,7.0,6.0,12.0,14.0,13.0,12.0,10.0,12.0,14.0,5.0,13.0,10.0,20.0,12.0,13.0,12.0,9.0,13.0,7.0,12.0,16.0,13.0,10.0,13.0,12.0,11.0,10.0,9.0,22.0,21.0,3.0,7.0,1.0,177.0,74.0,3.0,2.0,3.0,3.0,3.0,1.0,1.0,3.0,3.0,1.0,2.0,9.0,11.0,13.0,15.0,12.0,9.0,8.0,11.0,6.0,6.0,12.0,10.0,8.0,13.0,17.0,11.0,14.0,12.0,10.0,13.0,9.0,15.0,13.0,7.0,14.0,8.0,10.0,17.0,16.0,13.0,14.0,9.0,14.0,17.0,14.0,20.0,16.0,11.0,15.0,6.0,15.0,4.0,15.0,10.0,18.0,7.0,16.0,13.0,8.0,8.0,15.0,21.0,21.0,2.0,0.0,0.0,172.0,68.0,3.0,1.0,3.0,3.0,3.0,3.0,2.0,2.0,1.0,2.0,1.0,10.0,11.0,14.0,12.0,13.0,10.0,7.0,11.0,6.0,9.0,13.0,10.0,14.0,16.0,18.0,14.0,14.0,13.0,12.0,14.0,12.0,15.0,13.0,8.0,17.0,11.0,16.0,18.0,15.0,17.0,12.0,7.0,12.0,16.0,12.0,20.0,17.0,8.0,17.0,8.0,14.0,6.0,13.0,14.0,17.0,10.0,13.0,13.0,10.0,9.0,8.0,27.0,18.0,0.0,9.0,0.0,189.0,74.0,3.0,1.0,2.0,1.0,2.0,2.0,1.0,2.0,2.0,3.0,2.0,9.0,10.0,9.0,6.0,10.0,9.0,14.0,11.0,8.0,15.0,12.0,9.0,16.0,10.0,17.0,12.0,17.0,10.0,16.0,9.0,10.0,17.0,7.0,16.0,11.0,14.0,18.0,17.0,11.0,10.0,16.0,14.0,8.0,17.0,12.0,20.0,17.0,14.0,17.0,12.0,17.0,6.0,11.0,9.0,12.0,15.0,15.0,17.0,12.0,14.0,3.0,20.0,0.0,0.0,5.0,0.0,189.0,83.0,3.0,1.0,2.0,3.0,2.0,1.0,2.0,3.0,3.0,1.0,1.0,7.0,11.0,8.0,8.0,9.0,6.0,12.0,6.0,15.0,13.0,10.0,5.0,14.0,10.0,12.0,14.0,16.0,9.0,12.0,8.0,10.0,14.0,7.0,11.0,10.0,11.0,13.0,14.0,14.0,9.0,15.0,15.0,12.0,16.0,18.0,20.0,14.0,14.0,13.0,8.0,13.0,6.0,16.0,12.0,16.0,7.0,13.0,13.0,15.0,17.0,6.0,21.0,0.0,0.0,7.0,2.0,173.0,70.0,4.0,1.0,3.0,3.0,1.0,1.0,2.0,2.0,2.0,1.0,2.0,12.0,10.0,17.0,10.0,14.0,9.0,5.0,11.0,6.0,2.0,11.0,12.0,6.0,16.0,8.0,10.0,6.0,12.0,10.0,11.0,10.0,12.0,18.0,4.0,13.0,7.0,7.0,11.0,19.0,15.0,10.0,6.0,10.0,9.0,18.0,20.0,12.0,7.0,12.0,6.0,13.0,8.0,14.0,16.0,17.0,7.0,12.0,14.0,14.0,14.0,5.0,19.0,0.0,0.0,0.0,0.0,177.0,69.0,1.0,2.0,4.0,4.0,2.0,2.0,1.0,2.0,2.0,3.0,2.0,4.0,9.0,11.0,12.0,13.0,7.0,10.0,13.0,5.0,3.0,10.0,10.0,5.0,13.0,14.0,10.0,14.0,10.0,10.0,10.0,11.0,11.0,14.0,5.0,13.0,5.0,11.0,12.0,16.0,13.0,14.0,9.0,8.0,13.0,14.0,20.0,12.0,10.0,10.0,9.0,10.0,10.0,10.0,16.0,12.0,14.0,12.0,12.0,8.0,18.0,5.0,24.0,0.0,0.0,0.0,0.0,173.0,66.0,3.0,2.0,2.0,1.0,3.0,1.0,2.0,1.0,2.0,2.0,1.0,11.0,11.0,10.0,6.0,12.0,8.0,8.0,6.0,10.0,14.0,12.0,7.0,17.0,13.0,18.0,14.0,17.0,12.0,14.0,13.0,12.0,17.0,9.0,10.0,9.0,13.0,16.0,18.0,12.0,14.0,15.0,7.0,12.0,19.0,12.0,20.0,18.0,10.0,11.0,10.0,11.0,10.0,16.0,8.0,15.0,10.0,13.0,16.0,12.0,8.0,5.0,25.0,23.0,2.0,17.0,2.0,178.0,65.0,1.0,3.0,2.0,3.0,2.0,2.0,1.0,3.0,2.0,3.0,3.0,11.0,11.0,14.0,10.0,15.0,10.0,6.0,13.0,6.0,8.0,13.0,10.0,12.0,15.0,18.0,12.0,8.0,13.0,12.0,15.0,14.0,14.0,15.0,7.0,15.0,11.0,16.0,18.0,15.0,17.0,10.0,8.0,12.0,16.0,12.0,20.0,17.0,7.0,15.0,5.0,14.0,6.0,17.0,9.0,16.0,7.0,13.0,12.0,10.0,10.0,11.0
2,1,33.0,0.0,0.0,2.0,0.0,188.0,83.0,14.0,13.0,12.0,13.0,12.0,14.0,12.0,16.0,11.0,11.0,15.0,3.0,1.0,1.0,2.0,7.0,8.0,2.0,2.0,2.0,4.0,11.0,5.0,10.0,9.0,15.0,12.0,11.0,13.0,13.0,11.0,11.0,14.0,13.0,12.0,3.0,14.0,13.0,11.0,12.0,11.0,12.0,14.0,9.0,13.0,11.0,20.0,12.0,12.0,12.0,5.0,12.0,5.0,11.0,7.0,5.0,8.0,13.0,15.0,12.0,11.0,10.0,18.0,0.0,0.0,0.0,0.0,176.0,70.0,4.0,3.0,1.0,1.0,3.0,4.0,3.0,2.0,2.0,3.0,2.0,9.0,9.0,9.0,10.0,15.0,9.0,9.0,11.0,7.0,8.0,15.0,6.0,14.0,12.0,10.0,13.0,10.0,9.0,9.0,15.0,15.0,10.0,5.0,3.0,9.0,10.0,10.0,8.0,11.0,8.0,10.0,6.0,1.0,11.0,9.0,20.0,7.0,7.0,10.0,10.0,7.0,10.0,10.0,9.0,11.0,9.0,10.0,10.0,12.0,14.0,2.0,19.0,0.0,0.0,7.0,2.0,188.0,85.0,1.0,3.0,2.0,1.0,2.0,3.0,3.0,2.0,2.0,3.0,1.0,10.0,6.0,9.0,8.0,10.0,12.0,15.0,8.0,7.0,14.0,11.0,10.0,13.0,10.0,14.0,11.0,13.0,9.0,11.0,10.0,10.0,9.0,1.0,8.0,12.0,13.0,13.0,14.0,13.0,10.0,13.0,15.0,9.0,12.0,13.0,20.0,14.0,14.0,9.0,11.0,4.0,9.0,11.0,14.0,13.0,12.0,12.0,12.0,1.0,13.0,2.0,20.0,1.0,0.0,9.0,2.0,175.0,70.0,3.0,2.0,2.0,2.0,3.0,1.0,1.0,1.0,2.0,2.0,1.0,8.0,8.0,5.0,10.0,13.0,8.0,8.0,11.0,3.0,10.0,14.0,8.0,14.0,14.0,9.0,11.0,9.0,10.0,8.0,11.0,14.0,9.0,5.0,11.0,8.0,11.0,10.0,13.0,14.0,13.0,5.0,7.0,5.0,9.0,14.0,20.0,8.0,9.0,10.0,10.0,10.0,7.0,10.0,15.0,11.0,11.0,11.0,13.0,12.0,17.0,3.0,24.0,6.0,1.0,22.0,13.0,181.0,74.0,3.0,2.0,3.0,1.0,3.0,2.0,2.0,1.0,1.0,3.0,1.0,5.0,12.0,13.0,15.0,15.0,8.0,12.0,10.0,5.0,6.0,13.0,14.0,6.0,14.0,11.0,13.0,9.0,14.0,13.0,13.0,13.0,13.0,12.0,8.0,16.0,6.0,13.0,12.0,13.0,14.0,9.0,10.0,20.0,13.0,12.0,16.0,14.0,10.0,14.0,5.0,13.0,8.0,11.0,9.0,14.0,12.0,7.0,14.0,11.0,9.0,8.0,23.0,0.0,0.0,0.0,0.0,176.0,72.0,4.0,2.0,1.0,3.0,3.0,2.0,1.0,3.0,2.0,2.0,3.0,9.0,10.0,14.0,12.0,14.0,13.0,8.0,13.0,9.0,11.0,13.0,11.0,12.0,14.0,10.0,9.0,8.0,10.0,11.0,12.0,11.0,6.0,16.0,8.0,12.0,12.0,13.0,15.0,12.0,14.0,7.0,5.0,13.0,13.0,14.0,20.0,13.0,11.0,11.0,10.0,9.0,11.0,11.0,14.0,16.0,12.0,12.0,15.0,7.0,10.0,5.0,24.0,0.0,0.0,0.0,0.0,182.0,75.0,3.0,3.0,2.0,2.0,2.0,3.0,3.0,3.0,3.0,3.0,1.0,6.0,9.0,11.0,7.0,12.0,10.0,14.0,9.0,10.0,15.0,12.0,8.0,17.0,13.0,14.0,16.0,16.0,14.0,10.0,10.0,11.0,12.0,9.0,9.0,8.0,14.0,13.0,12.0,9.0,11.0,14.0,13.0,10.0,16.0,11.0,20.0,15.0,13.0,12.0,12.0,13.0,4.0,12.0,13.0,16.0,9.0,16.0,14.0,13.0,8.0,8.0,30.0,3.0,0.0,1.0,0.0,175.0,69.0,2.0,3.0,3.0,2.0,3.0,3.0,1.0,3.0,2.0,1.0,3.0,8.0,14.0,12.0,9.0,9.0,8.0,9.0,11.0,14.0,13.0,12.0,7.0,13.0,11.0,13.0,13.0,15.0,12.0,11.0,9.0,10.0,6.0,12.0,11.0,12.0,13.0,14.0,16.0,12.0,13.0,15.0,12.0,20.0,15.0,13.0,13.0,14.0,13.0,12.0,5.0,10.0,7.0,12.0,17.0,8.0,12.0,11.0,9.0,11.0,18.0,1.0,23.0,3.0,0.0,7.0,0.0,175.0,75.0,3.0,1.0,2.0,2.0,2.0,3.0,2.0,3.0,2.0,1.0,3.0,11.0,8.0,12.0,13.0,7.0,11.0,6.0,13.0,6.0,4.0,8.0,8.0,8.0,12.0,17.0,7.0,16.0,8.0,8.0,9.0,10.0,16.0,15.0,5.0,12.0,7.0,16.0,18.0,16.0,16.0,14.0,8.0,8.0,15.0,15.0,20.0,17.0,14.0,12.0,13.0,9.0,14.0,11.0,20.0,14.0,16.0,13.0,8.0,8.0,12.0,10.0,23.0,0.0,0.0,0.0,0.0,176.0,73.0,3.0,2.0,3.0,3.0,2.0,3.0,1.0,1.0,1.0,2.0,3.0,10.0,12.0,12.0,8.0,12.0,8.0,13.0,9.0,9.0,14.0,14.0,7.0,14.0,13.0,5.0,11.0,12.0,10.0,11.0,12.0,11.0,18.0,11.0,10.0,14.0,12.0,12.0,12.0,14.0,13.0,13.0,13.0,9.0,12.0,14.0,20.0,12.0,12.0,10.0,3.0,11.0,4.0,11.0,10.0,11.0,13.0,10.0,11.0,10.0,14.0,7.0,18.0,0.0,0.0,0.0,0.0,182.0,74.0,2.0,2.0,4.0,3.0,2.0,2.0,3.0,1.0,2.0,2.0,2.0,8.0,12.0,10.0,9.0,13.0,8.0,7.0,8.0,6.0,9.0,14.0,6.0,9.0,14.0,8.0,7.0,9.0,8.0,7.0,12.0,14.0,10.0,2.0,4.0,6.0,8.0,9.0,13.0,11.0,14.0,9.0,11.0,8.0,12.0,14.0,20.0,13.0,8.0,10.0,2.0,10.0,9.0,10.0,10.0,11.0,11.0,11.0,14.0,11.0,17.0,1.0,33.0,0.0,0.0,2.0,0.0,196.0,89.0,15.0,13.0,12.0,7.0,14.0,10.0,14.0,14.0,11.0,9.0,12.0,4.0,3.0,1.0,1.0,9.0,7.0,2.0,2.0,1.0,1.0,10.0,2.0,2.0,9.0,10.0,14.0,14.0,13.0,12.0,11.0,12.0,14.0,6.0,12.0,1.0,13.0,11.0,6.0,9.0,13.0,16.0,18.0,5.0,12.0,10.0,20.0,12.0,16.0,14.0,10.0,15.0,13.0,1.0,8.0,14.0,14.0,14.0,10.0,15.0,15.0,9.0,21.0,0.0,0.0,0.0,0.0,187.0,84.0,4.0,2.0,1.0,2.0,3.0,1.0,2.0,3.0,1.0,1.0,2.0,11.0,13.0,15.0,12.0,14.0,11.0,13.0,14.0,4.0,5.0,12.0,14.0,5.0,16.0,12.0,12.0,14.0,12.0,10.0,10.0,9.0,14.0,17.0,10.0,12.0,7.0,10.0,14.0,14.0,16.0,14.0,15.0,9.0,13.0,14.0,20.0,14.0,14.0,14.0,8.0,15.0,5.0,14.0,11.0,16.0,13.0,14.0,13.0,15.0,15.0,6.0,21.0,0.0,0.0,11.0,2.0,180.0,72.0,2.0,3.0,3.0,3.0,3.0,2.0,2.0,1.0,3.0,2.0,3.0,12.0,13.0,14.0,9.0,14.0,13.0,8.0,12.0,5.0,8.0,14.0,10.0,9.0,14.0,12.0,12.0,9.0,13.0,12.0,15.0,13.0,14.0,15.0,8.0,13.0,10.0,16.0,14.0,15.0,14.0,12.0,9.0,8.0,15.0,14.0,20.0,13.0,12.0,12.0,8.0,11.0,10.0,11.0,10.0,14.0,16.0,14.0,15.0,15.0,15.0,6.0,29.0,26.0,6.0,12.0,4.0,175.0,77.0,1.0,2.0,1.0,3.0,3.0,2.0,1.0,2.0,1.0,2.0,2.0,16.0,14.0,16.0,15.0,15.0,18.0,6.0,15.0,6.0,6.0,18.0,11.0,5.0,17.0,9.0,12.0,10.0,16.0,12.0,16.0,14.0,14.0,16.0,6.0,16.0,6.0,10.0,10.0,13.0,15.0,14.0,8.0,15.0,15.0,14.0,20.0,13.0,12.0,11.0,9.0,16.0,7.0,8.0,8.0,11.0,8.0,13.0,12.0,13.0,11.0,10.0,24.0,0.0,0.0,0.0,0.0,177.0,65.0,1.0,2.0,1.0,2.0,1.0,2.0,1.0,1.0,1.0,2.0,3.0,8.0,11.0,13.0,10.0,13.0,8.0,10.0,11.0,7.0,5.0,12.0,13.0,6.0,13.0,8.0,11.0,9.0,10.0,9.0,9.0,11.0,13.0,12.0,5.0,12.0,8.0,7.0,9.0,16.0,15.0,12.0,8.0,10.0,15.0,15.0,20.0,14.0,12.0,11.0,8.0,13.0,7.0,12.0,20.0,14.0,13.0,12.0,9.0,12.0,11.0,10.0,22.0,0.0,0.0,3.0,0.0,176.0,70.0,1.0,1.0,1.0,3.0,2.0,1.0,2.0,3.0,1.0,3.0,3.0,10.0,15.0,14.0,6.0,13.0,10.0,13.0,10.0,9.0,9.0,13.0,8.0,11.0,14.0,10.0,11.0,12.0,10.0,13.0,11.0,13.0,14.0,13.0,7.0,13.0,9.0,11.0,13.0,17.0,13.0,12.0,10.0,20.0,14.0,16.0,5.0,15.0,11.0,13.0,10.0,14.0,8.0,10.0,11.0,13.0,16.0,11.0,15.0,14.0,13.0,7.0,28.0,41.0,2.0,0.0,0.0,187.0,80.0,3.0,2.0,3.0,2.0,1.0,1.0,2.0,3.0,1.0,4.0,2.0,7.0,10.0,11.0,7.0,12.0,7.0,10.0,12.0,13.0,15.0,13.0,8.0,18.0,12.0,18.0,13.0,17.0,12.0,14.0,10.0,12.0,17.0,7.0,13.0,9.0,14.0,17.0,18.0,14.0,13.0,16.0,14.0,20.0,18.0,13.0,12.0,18.0,14.0,15.0,16.0,15.0,6.0,15.0,14.0,13.0,10.0,14.0,12.0,8.0,7.0,8.0,30.0,32.0,1.0,0.0,0.0,190.0,88.0,1.0,2.0,2.0,2.0,3.0,1.0,1.0,3.0,3.0,2.0,2.0,5.0,7.0,9.0,8.0,10.0,7.0,16.0,11.0,9.0,15.0,13.0,5.0,16.0,12.0,17.0,16.0,17.0,13.0,13.0,11.0,12.0,16.0,7.0,14.0,10.0,14.0,15.0,15.0,14.0,12.0,17.0,16.0,9.0,15.0,14.0,20.0,16.0,18.0,15.0,15.0,14.0,10.0,12.0,14.0,15.0,12.0,14.0,12.0,13.0,11.0,15.0,23.0,0.0,0.0,10.0,7.0,179.0,70.0,1.0,1.0,2.0,2.0,1.0,3.0,3.0,2.0,1.0,4.0,3.0,10.0,13.0,14.0,12.0,15.0,11.0,10.0,13.0,6.0,3.0,13.0,12.0,4.0,16.0,11.0,12.0,11.0,13.0,11.0,13.0,12.0,12.0,16.0,6.0,14.0,6.0,10.0,12.0,16.0,14.0,12.0,9.0,20.0,13.0,14.0,10.0,13.0,10.0,12.0,7.0,12.0,6.0,8.0,12.0,13.0,5.0,10.0,8.0,14.0,12.0,8.0,18.0,0.0,0.0,0.0,0.0,167.0,60.0,2.0,1.0,2.0,2.0,2.0,1.0,2.0,1.0,1.0,1.0,1.0,10.0,11.0,12.0,8.0,13.0,10.0,3.0,10.0,5.0,6.0,13.0,12.0,8.0,15.0,8.0,11.0,8.0,12.0,11.0,13.0,12.0,13.0,12.0,6.0,11.0,11.0,12.0,13.0,15.0,14.0,8.0,5.0,8.0,15.0,12.0,20.0,12.0,7.0,8.0,8.0,14.0,7.0,8.0,18.0,11.0,12.0,11.0,12.0,15.0,15.0,7.0,26.0,0.0,0.0,4.0,0.0,180.0,73.0,2.0,3.0,1.0,4.0,2.0,3.0,3.0,1.0,1.0,4.0,1.0,11.0,13.0,13.0,14.0,14.0,11.0,15.0,12.0,3.0,7.0,14.0,14.0,8.0,13.0,12.0,14.0,17.0,13.0,15.0,14.0,14.0,16.0,12.0,15.0,16.0,12.0,18.0,16.0,13.0,14.0,13.0,12.0,8.0,14.0,13.0,20.0,15.0,12.0,15.0,8.0,14.0,7.0,15.0,19.0,14.0,17.0,14.0,18.0,16.0,16.0,5.0
0,1,22.0,0.0,0.0,0.0,0.0,191.0,84.0,13.0,10.0,9.0,1.0,13.0,7.0,13.0,14.0,10.0,10.0,8.0,5.0,2.0,2.0,1.0,3.0,8.0,1.0,3.0,2.0,1.0,2.0,3.0,1.0,1.0,10.0,7.0,14.0,8.0,6.0,8.0,10.0,7.0,2.0,10.0,3.0,12.0,9.0,8.0,12.0,13.0,8.0,15.0,6.0,12.0,13.0,20.0,5.0,11.0,10.0,7.0,8.0,6.0,10.0,19.0,11.0,9.0,10.0,14.0,10.0,10.0,7.0,19.0,0.0,0.0,0.0,0.0,171.0,0.0,3.0,3.0,4.0,3.0,2.0,3.0,2.0,1.0,3.0,3.0,2.0,9.0,12.0,12.0,3.0,8.0,6.0,2.0,11.0,6.0,5.0,8.0,6.0,7.0,10.0,8.0,8.0,4.0,8.0,4.0,8.0,4.0,13.0,9.0,10.0,7.0,6.0,7.0,8.0,12.0,12.0,2.0,3.0,8.0,7.0,13.0,20.0,9.0,4.0,7.0,8.0,6.0,7.0,8.0,16.0,11.0,10.0,12.0,13.0,2.0,10.0,7.0,23.0,0.0,0.0,0.0,0.0,186.0,80.0,3.0,2.0,1.0,4.0,1.0,1.0,2.0,1.0,1.0,2.0,3.0,14.0,17.0,9.0,8.0,8.0,13.0,8.0,11.0,13.0,8.0,10.0,4.0,11.0,9.0,14.0,10.0,12.0,10.0,10.0,10.0,10.0,7.0,6.0,5.0,12.0,9.0,12.0,15.0,14.0,11.0,11.0,12.0,20.0,12.0,13.0,8.0,14.0,12.0,12.0,8.0,2.0,10.0,10.0,8.0,15.0,4.0,12.0,13.0,9.0,10.0,14.0,21.0,0.0,0.0,0.0,0.0,168.0,62.0,1.0,3.0,1.0,3.0,4.0,3.0,2.0,1.0,2.0,2.0,2.0,11.0,12.0,13.0,10.0,10.0,8.0,15.0,11.0,7.0,8.0,13.0,12.0,10.0,12.0,14.0,8.0,7.0,6.0,8.0,13.0,14.0,14.0,10.0,13.0,14.0,7.0,14.0,15.0,12.0,13.0,8.0,6.0,6.0,16.0,13.0,20.0,14.0,6.0,10.0,5.0,6.0,10.0,10.0,12.0,17.0,11.0,8.0,17.0,1.0,11.0,4.0,27.0,0.0,0.0,0.0,0.0,174.0,72.0,1.0,2.0,2.0,3.0,1.0,1.0,1.0,1.0,2.0,3.0,1.0,9.0,12.0,13.0,8.0,12.0,7.0,9.0,9.0,9.0,7.0,11.0,10.0,8.0,13.0,14.0,11.0,9.0,9.0,9.0,13.0,11.0,12.0,13.0,13.0,11.0,7.0,11.0,15.0,16.0,13.0,8.0,8.0,5.0,11.0,13.0,20.0,14.0,8.0,14.0,7.0,8.0,16.0,15.0,12.0,12.0,13.0,10.0,14.0,14.0,14.0,5.0,19.0,0.0,0.0,0.0,0.0,172.0,58.0,2.0,3.0,3.0,3.0,2.0,2.0,2.0,3.0,1.0,1.0,1.0,9.0,7.0,10.0,5.0,12.0,9.0,9.0,10.0,9.0,10.0,9.0,7.0,12.0,11.0,9.0,9.0,9.0,11.0,9.0,10.0,11.0,2.0,9.0,3.0,9.0,10.0,11.0,11.0,7.0,12.0,11.0,9.0,20.0,12.0,11.0,9.0,8.0,8.0,8.0,6.0,9.0,6.0,9.0,20.0,10.0,11.0,13.0,13.0,7.0,11.0,8.0,25.0,0.0,0.0,0.0,0.0,187.0,81.0,3.0,1.0,1.0,4.0,2.0,1.0,1.0,3.0,3.0,3.0,4.0,10.0,10.0,11.0,9.0,14.0,7.0,10.0,13.0,10.0,9.0,12.0,13.0,11.0,13.0,11.0,10.0,15.0,7.0,8.0,13.0,10.0,15.0,12.0,11.0,10.0,10.0,13.0,10.0,11.0,10.0,11.0,13.0,10.0,10.0,11.0,20.0,13.0,12.0,9.0,6.0,5.0,10.0,15.0,7.0,12.0,11.0,9.0,16.0,9.0,10.0,4.0,24.0,0.0,0.0,0.0,0.0,190.0,83.0,4.0,1.0,3.0,1.0,1.0,1.0,3.0,2.0,1.0,2.0,3.0,10.0,10.0,9.0,8.0,9.0,9.0,13.0,9.0,6.0,13.0,10.0,7.0,13.0,9.0,12.0,13.0,13.0,10.0,12.0,12.0,11.0,4.0,13.0,6.0,10.0,11.0,15.0,14.0,14.0,10.0,14.0,15.0,6.0,13.0,12.0,20.0,15.0,15.0,11.0,7.0,10.0,10.0,10.0,12.0,11.0,16.0,13.0,18.0,6.0,14.0,8.0,21.0,0.0,0.0,0.0,0.0,187.0,75.0,2.0,2.0,3.0,1.0,2.0,1.0,1.0,1.0,3.0,3.0,1.0,8.0,11.0,12.0,11.0,10.0,7.0,9.0,8.0,7.0,7.0,7.0,7.0,4.0,11.0,10.0,11.0,7.0,8.0,9.0,10.0,14.0,15.0,13.0,13.0,10.0,7.0,6.0,10.0,13.0,12.0,9.0,10.0,10.0,15.0,14.0,20.0,15.0,9.0,10.0,10.0,10.0,7.0,10.0,16.0,10.0,9.0,8.0,15.0,9.0,14.0,3.0,21.0,0.0,0.0,2.0,0.0,188.0,80.0,3.0,3.0,1.0,3.0,3.0,3.0,2.0,1.0,3.0,3.0,2.0,3.0,7.0,10.0,12.0,12.0,3.0,12.0,10.0,3.0,5.0,14.0,11.0,6.0,12.0,9.0,11.0,13.0,11.0,10.0,10.0,10.0,12.0,9.0,5.0,12.0,5.0,12.0,13.0,12.0,11.0,10.0,15.0,15.0,13.0,12.0,20.0,13.0,14.0,10.0,7.0,10.0,8.0,11.0,20.0,11.0,12.0,11.0,11.0,5.0,14.0,3.0,23.0,0.0,0.0,0.0,0.0,184.0,88.0,2.0,2.0,3.0,3.0,3.0,1.0,2.0,1.0,3.0,1.0,1.0,7.0,6.0,9.0,12.0,7.0,3.0,9.0,8.0,4.0,4.0,11.0,10.0,7.0,9.0,10.0,9.0,10.0,9.0,11.0,12.0,9.0,10.0,8.0,4.0,9.0,6.0,7.0,7.0,17.0,15.0,15.0,12.0,9.0,15.0,16.0,20.0,15.0,15.0,8.0,10.0,13.0,12.0,10.0,14.0,9.0,10.0,11.0,12.0,9.0,11.0,8.0,34.0,35.0,0.0,6.0,0.0,183.0,74.0,10.0,10.0,13.0,10.0,15.0,9.0,12.0,16.0,9.0,13.0,13.0,5.0,3.0,1.0,1.0,8.0,9.0,9.0,3.0,2.0,3.0,10.0,3.0,3.0,8.0,15.0,13.0,15.0,11.0,13.0,12.0,13.0,15.0,4.0,15.0,3.0,13.0,10.0,12.0,8.0,13.0,15.0,11.0,7.0,13.0,8.0,20.0,13.0,15.0,10.0,14.0,19.0,10.0,11.0,4.0,16.0,20.0,11.0,13.0,6.0,9.0,16.0,24.0,0.0,0.0,0.0,0.0,182.0,75.0,3.0,2.0,3.0,1.0,2.0,3.0,3.0,1.0,1.0,1.0,3.0,13.0,13.0,13.0,13.0,13.0,17.0,9.0,15.0,7.0,9.0,11.0,13.0,10.0,11.0,11.0,10.0,11.0,11.0,9.0,12.0,10.0,13.0,8.0,10.0,15.0,7.0,11.0,10.0,15.0,13.0,11.0,9.0,7.0,15.0,14.0,20.0,13.0,12.0,13.0,9.0,13.0,9.0,14.0,16.0,11.0,13.0,10.0,13.0,12.0,13.0,3.0,23.0,0.0,0.0,0.0,0.0,191.0,90.0,2.0,4.0,2.0,2.0,2.0,1.0,2.0,3.0,3.0,3.0,1.0,6.0,7.0,9.0,6.0,11.0,3.0,14.0,3.0,7.0,13.0,12.0,6.0,13.0,13.0,9.0,12.0,13.0,11.0,13.0,7.0,12.0,15.0,4.0,17.0,8.0,12.0,13.0,14.0,12.0,12.0,12.0,15.0,8.0,14.0,13.0,20.0,14.0,14.0,12.0,6.0,13.0,5.0,7.0,10.0,11.0,9.0,7.0,14.0,10.0,11.0,1.0,18.0,0.0,0.0,0.0,0.0,176.0,0.0,1.0,1.0,3.0,1.0,2.0,2.0,3.0,1.0,1.0,3.0,1.0,6.0,5.0,8.0,9.0,12.0,6.0,14.0,7.0,2.0,5.0,7.0,7.0,1.0,7.0,8.0,10.0,6.0,9.0,7.0,7.0,5.0,7.0,8.0,1.0,7.0,4.0,6.0,7.0,12.0,9.0,7.0,6.0,8.0,10.0,11.0,20.0,10.0,7.0,8.0,7.0,5.0,7.0,8.0,20.0,13.0,10.0,11.0,13.0,9.0,20.0,5.0,24.0,0.0,0.0,19.0,1.0,183.0,67.0,1.0,2.0,3.0,3.0,2.0,1.0,1.0,1.0,1.0,1.0,1.0,5.0,6.0,12.0,5.0,13.0,4.0,8.0,9.0,7.0,10.0,16.0,7.0,12.0,11.0,7.0,11.0,12.0,10.0,12.0,14.0,10.0,19.0,6.0,14.0,13.0,12.0,13.0,14.0,13.0,11.0,13.0,11.0,10.0,10.0,12.0,20.0,18.0,13.0,14.0,8.0,12.0,8.0,11.0,15.0,10.0,11.0,11.0,12.0,12.0,13.0,7.0,18.0,0.0,0.0,0.0,0.0,183.0,0.0,1.0,1.0,3.0,2.0,2.0,2.0,3.0,2.0,2.0,2.0,1.0,5.0,10.0,16.0,9.0,16.0,7.0,8.0,8.0,7.0,8.0,14.0,7.0,8.0,16.0,8.0,11.0,8.0,14.0,9.0,13.0,11.0,8.0,13.0,5.0,12.0,9.0,11.0,11.0,10.0,12.0,14.0,8.0,9.0,11.0,12.0,20.0,11.0,9.0,12.0,7.0,12.0,7.0,10.0,9.0,10.0,10.0,11.0,13.0,12.0,12.0,7.0,23.0,1.0,0.0,3.0,0.0,178.0,79.0,1.0,3.0,3.0,2.0,2.0,3.0,1.0,2.0,3.0,2.0,3.0,7.0,11.0,9.0,7.0,13.0,4.0,13.0,6.0,9.0,15.0,13.0,7.0,17.0,13.0,16.0,14.0,17.0,13.0,15.0,11.0,13.0,19.0,7.0,10.0,12.0,15.0,15.0,15.0,11.0,12.0,13.0,11.0,8.0,14.0,12.0,20.0,15.0,13.0,14.0,12.0,14.0,14.0,14.0,12.0,12.0,12.0,13.0,15.0,8.0,11.0,8.0,19.0,0.0,0.0,0.0,0.0,194.0,80.0,2.0,2.0,3.0,3.0,2.0,2.0,3.0,3.0,1.0,1.0,3.0,7.0,7.0,11.0,8.0,10.0,10.0,13.0,8.0,1.0,10.0,10.0,4.0,14.0,11.0,11.0,13.0,12.0,10.0,10.0,8.0,9.0,13.0,8.0,8.0,7.0,13.0,11.0,13.0,12.0,12.0,10.0,16.0,7.0,11.0,12.0,20.0,13.0,11.0,15.0,10.0,10.0,10.0,13.0,12.0,12.0,12.0,12.0,14.0,12.0,14.0,7.0,20.0,0.0,0.0,4.0,0.0,177.0,84.0,2.0,3.0,3.0,1.0,3.0,1.0,3.0,3.0,2.0,2.0,3.0,9.0,9.0,12.0,16.0,13.0,8.0,10.0,8.0,5.0,5.0,8.0,10.0,6.0,11.0,10.0,16.0,14.0,13.0,10.0,12.0,10.0,15.0,14.0,11.0,15.0,12.0,12.0,12.0,13.0,12.0,12.0,10.0,20.0,8.0,12.0,11.0,8.0,12.0,13.0,11.0,17.0,8.0,11.0,11.0,11.0,7.0,12.0,14.0,10.0,10.0,11.0,20.0,0.0,0.0,0.0,0.0,175.0,77.0,2.0,1.0,2.0,3.0,3.0,3.0,3.0,1.0,4.0,3.0,1.0,8.0,8.0,12.0,12.0,11.0,8.0,13.0,10.0,9.0,10.0,11.0,10.0,9.0,12.0,12.0,6.0,9.0,9.0,11.0,15.0,11.0,4.0,10.0,8.0,12.0,11.0,10.0,13.0,14.0,15.0,15.0,8.0,8.0,9.0,15.0,20.0,11.0,12.0,12.0,8.0,4.0,10.0,10.0,15.0,11.0,12.0,11.0,9.0,10.0,10.0,7.0,19.0,0.0,0.0,0.0,0.0,176.0,65.0,2.0,1.0,1.0,3.0,2.0,1.0,1.0,1.0,3.0,2.0,4.0,11.0,11.0,13.0,9.0,12.0,8.0,5.0,11.0,2.0,4.0,10.0,9.0,7.0,14.0,7.0,9.0,7.0,12.0,10.0,13.0,9.0,6.0,15.0,5.0,13.0,6.0,12.0,12.0,14.0,12.0,10.0,6.0,13.0,13.0,14.0,20.0,11.0,8.0,11.0,7.0,9.0,7.0,11.0,13.0,11.0,11.0,12.0,11.0,10.0,11.0,6.0
0,0,20.0,0.0,0.0,1.0,0.0,190.0,80.0,14.0,12.0,12.0,9.0,13.0,14.0,12.0,14.0,15.0,13.0,12.0,2.0,3.0,3.0,3.0,10.0,5.0,6.0,2.0,3.0,3.0,10.0,6.0,3.0,8.0,6.0,14.0,12.0,14.0,14.0,6.0,12.0,14.0,6.0,6.0,4.0,15.0,10.0,10.0,10.0,14.0,11.0,14.0,8.0,14.0,10.0,20.0,10.0,8.0,15.0,5.0,14.0,5.0,10.0,15.0,13.0,12.0,18.0,14.0,13.0,15.0,6.0,21.0,0.0,0.0,0.0,0.0,174.0,0.0,1.0,3.0,1.0,4.0,1.0,1.0,1.0,1.0,3.0,1.0,2.0,2.0,6.0,4.0,6.0,13.0,2.0,6.0,10.0,4.0,9.0,8.0,4.0,11.0,11.0,9.0,7.0,6.0,6.0,8.0,9.0,12.0,6.0,1.0,10.0,7.0,7.0,8.0,12.0,13.0,10.0,8.0,6.0,16.0,12.0,12.0,20.0,10.0,6.0,9.0,9.0,8.0,9.0,9.0,18.0,14.0,12.0,10.0,12.0,9.0,12.0,5.0,19.0,0.0,0.0,0.0,0.0,194.0,90.0,1.0,1.0,1.0,1.0,2.0,1.0,2.0,3.0,3.0,2.0,2.0,4.0,2.0,4.0,1.0,8.0,4.0,13.0,2.0,1.0,6.0,10.0,1.0,9.0,5.0,7.0,6.0,8.0,5.0,13.0,4.0,14.0,6.0,1.0,11.0,4.0,6.0,6.0,7.0,14.0,12.0,7.0,11.0,20.0,10.0,11.0,8.0,7.0,13.0,8.0,8.0,2.0,8.0,8.0,7.0,12.0,10.0,11.0,11.0,1.0,14.0,8.0,21.0,13.0,0.0,7.0,0.0,181.0,75.0,2.0,3.0,1.0,1.0,3.0,1.0,1.0,4.0,3.0,4.0,2.0,8.0,8.0,12.0,12.0,12.0,9.0,5.0,13.0,12.0,8.0,12.0,6.0,11.0,12.0,8.0,11.0,13.0,10.0,10.0,12.0,7.0,11.0,10.0,6.0,8.0,6.0,5.0,13.0,13.0,12.0,9.0,8.0,14.0,15.0,12.0,20.0,14.0,11.0,8.0,6.0,6.0,5.0,12.0,15.0,13.0,5.0,10.0,9.0,11.0,12.0,6.0,25.0,13.0,1.0,0.0,0.0,181.0,71.0,2.0,2.0,2.0,2.0,3.0,2.0,1.0,1.0,1.0,1.0,3.0,10.0,10.0,11.0,13.0,11.0,8.0,7.0,12.0,7.0,7.0,9.0,10.0,8.0,11.0,10.0,10.0,10.0,10.0,11.0,9.0,11.0,11.0,11.0,8.0,12.0,10.0,11.0,10.0,14.0,11.0,12.0,8.0,12.0,10.0,16.0,20.0,10.0,8.0,11.0,7.0,12.0,7.0,10.0,13.0,12.0,9.0,12.0,8.0,3.0,9.0,8.0,26.0,23.0,1.0,7.0,0.0,182.0,78.0,1.0,2.0,2.0,3.0,3.0,1.0,1.0,3.0,4.0,3.0,3.0,6.0,8.0,12.0,14.0,13.0,9.0,11.0,10.0,2.0,3.0,10.0,13.0,6.0,12.0,16.0,12.0,9.0,14.0,9.0,8.0,8.0,13.0,13.0,8.0,12.0,7.0,6.0,6.0,13.0,13.0,9.0,9.0,12.0,13.0,12.0,20.0,10.0,11.0,10.0,13.0,10.0,10.0,12.0,8.0,11.0,12.0,7.0,13.0,8.0,13.0,2.0,24.0,0.0,0.0,5.0,0.0,178.0,68.0,3.0,1.0,2.0,2.0,3.0,3.0,3.0,2.0,1.0,3.0,2.0,13.0,13.0,12.0,12.0,12.0,14.0,9.0,13.0,4.0,4.0,13.0,14.0,10.0,15.0,10.0,12.0,7.0,10.0,10.0,11.0,8.0,11.0,16.0,7.0,15.0,9.0,10.0,12.0,15.0,15.0,11.0,9.0,10.0,15.0,14.0,20.0,12.0,7.0,13.0,10.0,12.0,13.0,12.0,20.0,10.0,15.0,8.0,13.0,14.0,10.0,8.0,20.0,0.0,0.0,0.0,0.0,170.0,64.0,1.0,2.0,1.0,2.0,1.0,3.0,3.0,3.0,3.0,3.0,3.0,12.0,10.0,11.0,9.0,12.0,13.0,7.0,12.0,4.0,6.0,11.0,13.0,13.0,12.0,14.0,10.0,14.0,9.0,10.0,10.0,10.0,14.0,13.0,9.0,10.0,10.0,11.0,16.0,12.0,13.0,11.0,6.0,10.0,13.0,11.0,20.0,16.0,8.0,12.0,8.0,13.0,10.0,15.0,16.0,12.0,12.0,11.0,12.0,12.0,14.0,6.0,19.0,0.0,0.0,0.0,0.0,176.0,70.0,2.0,1.0,2.0,3.0,3.0,3.0,4.0,1.0,1.0,2.0,3.0,8.0,7.0,6.0,6.0,11.0,8.0,8.0,14.0,2.0,12.0,8.0,3.0,15.0,9.0,9.0,8.0,8.0,8.0,7.0,14.0,15.0,5.0,7.0,13.0,9.0,10.0,10.0,14.0,13.0,11.0,10.0,6.0,2.0,13.0,12.0,20.0,10.0,8.0,9.0,6.0,2.0,6.0,9.0,16.0,12.0,10.0,11.0,8.0,6.0,17.0,4.0,24.0,0.0,0.0,0.0,0.0,194.0,92.0,3.0,1.0,3.0,1.0,1.0,3.0,1.0,1.0,2.0,2.0,3.0,5.0,8.0,7.0,8.0,11.0,7.0,16.0,6.0,8.0,13.0,12.0,6.0,13.0,11.0,10.0,13.0,13.0,14.0,11.0,10.0,11.0,11.0,6.0,10.0,7.0,12.0,14.0,10.0,8.0,10.0,13.0,17.0,14.0,14.0,11.0,20.0,12.0,16.0,14.0,8.0,13.0,4.0,7.0,13.0,16.0,7.0,13.0,14.0,14.0,12.0,7.0,25.0,0.0,0.0,0.0,0.0,180.0,74.0,3.0,2.0,3.0,1.0,3.0,3.0,3.0,3.0,3.0,1.0,1.0,10.0,12.0,10.0,8.0,11.0,10.0,7.0,8.0,10.0,9.0,11.0,14.0,11.0,13.0,18.0,8.0,11.0,9.0,8.0,12.0,11.0,12.0,13.0,8.0,12.0,8.0,13.0,11.0,14.0,14.0,10.0,10.0,20.0,10.0,13.0,10.0,12.0,8.0,13.0,8.0,13.0,9.0,14.0,17.0,12.0,10.0,12.0,14.0,15.0,11.0,3.0,28.0,1.0,0.0,0.0,0.0,187.0,83.0,12.0,12.0,12.0,10.0,12.0,9.0,12.0,13.0,12.0,12.0,11.0,7.0,7.0,7.0,7.0,6.0,7.0,6.0,7.0,7.0,7.0,6.0,7.0,7.0,5.0,10.0,13.0,14.0,12.0,12.0,10.0,11.0,14.0,8.0,6.0,8.0,13.0,10.0,9.0,9.0,13.0,10.0,12.0,1.0,12.0,9.0,20.0,10.0,10.0,13.0,8.0,15.0,6.0,12.0,12.0,13.0,14.0,12.0,14.0,11.0,12.0,5.0,21.0,0.0,0.0,9.0,2.0,185.0,77.0,2.0,2.0,2.0,2.0,2.0,2.0,2.0,2.0,2.0,2.0,2.0,7.0,9.0,8.0,7.0,9.0,8.0,15.0,8.0,10.0,14.0,10.0,9.0,14.0,10.0,13.0,10.0,14.0,10.0,11.0,9.0,11.0,11.0,8.0,10.0,9.0,12.0,15.0,15.0,10.0,10.0,11.0,13.0,6.0,14.0,11.0,20.0,13.0,14.0,10.0,8.0,10.0,4.0,10.0,10.0,9.0,12.0,11.0,11.0,12.0,12.0,13.0,31.0,34.0,1.0,0.0,0.0,180.0,78.0,1.0,3.0,4.0,1.0,1.0,2.0,2.0,3.0,2.0,2.0,2.0,11.0,9.0,10.0,8.0,11.0,11.0,13.0,12.0,9.0,14.0,12.0,9.0,14.0,10.0,11.0,13.0,14.0,14.0,14.0,12.0,14.0,15.0,10.0,17.0,12.0,15.0,14.0,13.0,11.0,12.0,15.0,12.0,5.0,12.0,12.0,20.0,12.0,12.0,14.0,9.0,13.0,8.0,11.0,11.0,15.0,11.0,14.0,14.0,13.0,14.0,5.0,25.0,0.0,0.0,4.0,1.0,184.0,81.0,1.0,3.0,3.0,2.0,3.0,3.0,4.0,2.0,1.0,2.0,1.0,10.0,11.0,10.0,9.0,10.0,9.0,13.0,12.0,11.0,14.0,13.0,10.0,14.0,11.0,10.0,10.0,10.0,10.0,11.0,11.0,10.0,14.0,6.0,10.0,13.0,12.0,12.0,12.0,12.0,12.0,14.0,13.0,20.0,15.0,13.0,5.0,12.0,15.0,11.0,11.0,14.0,14.0,14.0,14.0,13.0,13.0,9.0,14.0,11.0,12.0,5.0,28.0,0.0,0.0,0.0,0.0,185.0,87.0,3.0,1.0,1.0,3.0,1.0,2.0,3.0,4.0,2.0,3.0,3.0,8.0,5.0,9.0,13.0,13.0,8.0,16.0,10.0,6.0,5.0,10.0,16.0,6.0,12.0,16.0,10.0,14.0,12.0,10.0,13.0,12.0,12.0,8.0,6.0,13.0,7.0,13.0,13.0,12.0,12.0,16.0,16.0,20.0,15.0,13.0,8.0,13.0,18.0,12.0,12.0,12.0,7.0,5.0,16.0,14.0,6.0,13.0,13.0,14.0,15.0,9.0,21.0,1.0,0.0,8.0,3.0,185.0,71.0,1.0,2.0,2.0,3.0,2.0,3.0,1.0,1.0,4.0,2.0,1.0,11.0,12.0,14.0,14.0,13.0,11.0,12.0,12.0,5.0,6.0,12.0,14.0,5.0,13.0,10.0,11.0,12.0,13.0,12.0,12.0,11.0,16.0,15.0,9.0,13.0,8.0,11.0,12.0,12.0,13.0,12.0,11.0,7.0,13.0,14.0,20.0,13.0,11.0,14.0,8.0,12.0,5.0,10.0,16.0,16.0,10.0,11.0,13.0,12.0,14.0,7.0,29.0,0.0,0.0,0.0,0.0,186.0,80.0,2.0,1.0,3.0,3.0,3.0,2.0,3.0,2.0,2.0,2.0,2.0,10.0,11.0,10.0,11.0,11.0,10.0,10.0,12.0,9.0,13.0,11.0,10.0,12.0,11.0,10.0,12.0,12.0,12.0,11.0,9.0,12.0,13.0,9.0,10.0,12.0,14.0,13.0,12.0,13.0,12.0,13.0,12.0,20.0,13.0,13.0,7.0,14.0,14.0,13.0,10.0,10.0,7.0,10.0,13.0,13.0,9.0,9.0,14.0,14.0,12.0,7.0,24.0,0.0,0.0,1.0,0.0,191.0,84.0,2.0,1.0,3.0,2.0,3.0,4.0,3.0,3.0,3.0,3.0,3.0,10.0,11.0,5.0,5.0,11.0,8.0,14.0,8.0,8.0,14.0,10.0,8.0,13.0,7.0,13.0,10.0,10.0,10.0,12.0,6.0,12.0,13.0,9.0,16.0,10.0,12.0,10.0,11.0,10.0,12.0,11.0,15.0,15.0,9.0,10.0,20.0,12.0,13.0,13.0,10.0,12.0,13.0,9.0,11.0,13.0,12.0,12.0,12.0,12.0,12.0,9.0,24.0,1.0,0.0,10.0,1.0,177.0,79.0,2.0,3.0,1.0,2.0,3.0,1.0,1.0,2.0,3.0,2.0,4.0,8.0,16.0,13.0,8.0,11.0,12.0,12.0,15.0,11.0,12.0,14.0,12.0,13.0,12.0,9.0,11.0,13.0,11.0,10.0,13.0,12.0,14.0,11.0,14.0,14.0,12.0,15.0,15.0,13.0,12.0,10.0,11.0,5.0,12.0,13.0,20.0,13.0,12.0,12.0,4.0,12.0,5.0,11.0,10.0,11.0,14.0,12.0,14.0,12.0,12.0,11.0,35.0,0.0,0.0,9.0,2.0,175.0,73.0,1.0,1.0,2.0,4.0,2.0,1.0,2.0,1.0,1.0,1.0,3.0,10.0,12.0,14.0,11.0,14.0,13.0,6.0,12.0,7.0,7.0,14.0,10.0,7.0,15.0,8.0,14.0,10.0,14.0,12.0,13.0,13.0,15.0,14.0,7.0,13.0,9.0,12.0,13.0,12.0,12.0,14.0,5.0,8.0,8.0,10.0,20.0,13.0,11.0,9.0,7.0,10.0,9.0,14.0,17.0,15.0,11.0,13.0,15.0,17.0,17.0,7.0,17.0,0.0,0.0,0.0,0.0,175.0,68.0,1.0,1.0,1.0,1.0,1.0,2.0,2.0,2.0,3.0,1.0,2.0,7.0,9.0,11.0,12.0,12.0,7.0,10.0,10.0,7.0,5.0,12.0,10.0,7.0,11.0,7.0,11.0,10.0,11.0,11.0,12.0,11.0,11.0,13.0,5.0,14.0,11.0,12.0,12.0,12.0,11.0,7.0,9.0,20.0,13.0,11.0,13.0,11.0,10.0,10.0,4.0,11.0,2.0,11.0,12.0,13.0,11.0,8.0,11.0,13.0,8.0,6.0
2,1,28.0,1.0,0.0,0.0,0.0,187.0,83.0,12.0,12.0,12.0,10.0,12.0,9.0,12.0,13.0,12.0,12.0,11.0,7.0,7.0,7.0,7.0,6.0,7.0,6.0,7.0,7.0,7.0,6.0,7.0,7.0,5.0,10.0,13.0,14.0,12.0,12.0,10.0,11.0,14.0,8.0,6.0,8.0,13.0,10.0,9.0,9.0,13.0,10.0,12.0,1.0,12.0,9.0,20.0,10.0,10.0,13.0,8.0,15.0,6.0,12.0,12.0,13.0,14.0,12.0,14.0,11.0,12.0,5.0,21.0,0.0,0.0,9.0,2.0,185.0,77.0,2.0,2.0,2.0,2.0,2.0,2.0,2.0,2.0,2.0,2.0,2.0,7.0,9.0,8.0,7.0,9.0,8.0,15.0,8.0,10.0,14.0,10.0,9.0,14.0,10.0,13.0,10.0,14.0,10.0,11.0,9.0,11.0,11.0,8.0,10.0,9.0,12.0,15.0,15.0,10.0,10.0,11.0,13.0,6.0,14.0,11.0,20.0,13.0,14.0,10.0,8.0,10.0,4.0,10.0,10.0,9.0,12.0,11.0,11.0,12.0,12.0,13.0,31.0,34.0,1.0,0.0,0.0,180.0,78.0,1.0,3.0,4.0,1.0,1.0,2.0,2.0,3.0,2.0,2.0,2.0,11.0,9.0,10.0,8.0,11.0,11.0,13.0,12.0,9.0,14.0,12.0,9.0,14.0,10.0,11.0,13.0,14.0,14.0,14.0,12.0,14.0,15.0,10.0,17.0,12.0,15.0,14.0,13.0,11.0,12.0,15.0,12.0,5.0,12.0,12.0,20.0,12.0,12.0,14.0,9.0,13.0,8.0,11.0,11.0,15.0,11.0,14.0,14.0,13.0,14.0,5.0,25.0,0.0,0.0,4.0,1.0,184.0,81.0,1.0,3.0,3.0,2.0,3.0,3.0,4.0,2.0,1.0,2.0,1.0,10.0,11.0,10.0,9.0,10.0,9.0,13.0,12.0,11.0,14.0,13.0,10.0,14.0,11.0,10.0,10.0,10.0,10.0,11.0,11.0,10.0,14.0,6.0,10.0,13.0,12.0,12.0,12.0,12.0,12.0,14.0,13.0,20.0,15.0,13.0,5.0,12.0,15.0,11.0,11.0,14.0,14.0,14.0,14.0,13.0,13.0,9.0,14.0,11.0,12.0,5.0,28.0,0.0,0.0,0.0,0.0,185.0,87.0,3.0,1.0,1.0,3.0,1.0,2.0,3.0,4.0,2.0,3.0,3.0,8.0,5.0,9.0,13.0,13.0,8.0,16.0,10.0,6.0,5.0,10.0,16.0,6.0,12.0,16.0,10.0,14.0,12.0,10.0,13.0,12.0,12.0,8.0,6.0,13.0,7.0,13.0,13.0,12.0,12.0,16.0,16.0,20.0,15.0,13.0,8.0,13.0,18.0,12.0,12.0,12.0,7.0,5.0,16.0,14.0,6.0,13.0,13.0,14.0,15.0,9.0,21.0,1.0,0.0,8.0,3.0,185.0,71.0,1.0,2.0,2.0,3.0,2.0,3.0,1.0,1.0,4.0,2.0,1.0,11.0,12.0,14.0,14.0,13.0,11.0,12.0,12.0,5.0,6.0,12.0,14.0,5.0,13.0,10.0,11.0,12.0,13.0,12.0,12.0,11.0,16.0,15.0,9.0,13.0,8.0,11.0,12.0,12.0,13.0,12.0,11.0,7.0,13.0,14.0,20.0,13.0,11.0,14.0,8.0,12.0,5.0,10.0,16.0,16.0,10.0,11.0,13.0,12.0,14.0,7.0,29.0,0.0,0.0,0.0,0.0,176.0,73.0,3.0,2.0,1.0,3.0,1.0,3.0,2.0,2.0,3.0,2.0,1.0,13.0,14.0,11.0,10.0,12.0,12.0,6.0,14.0,12.0,12.0,13.0,12.0,12.0,15.0,10.0,10.0,10.0,12.0,10.0,12.0,12.0,12.0,15.0,7.0,15.0,12.0,14.0,14.0,13.0,13.0,14.0,8.0,20.0,13.0,12.0,5.0,13.0,13.0,14.0,8.0,15.0,7.0,12.0,14.0,11.0,13.0,13.0,13.0,10.0,11.0,8.0,24.0,0.0,0.0,1.0,0.0,191.0,84.0,2.0,1.0,3.0,2.0,3.0,4.0,3.0,3.0,3.0,3.0,3.0,10.0,11.0,5.0,5.0,11.0,8.0,14.0,8.0,8.0,14.0,10.0,8.0,13.0,7.0,13.0,10.0,10.0,10.0,12.0,6.0,12.0,13.0,9.0,16.0,10.0,12.0,10.0,11.0,10.0,12.0,11.0,15.0,15.0,9.0,10.0,20.0,12.0,13.0,13.0,10.0,12.0,13.0,9.0,11.0,13.0,12.0,12.0,12.0,12.0,12.0,9.0,24.0,1.0,0.0,10.0,1.0,177.0,79.0,2.0,3.0,1.0,2.0,3.0,1.0,1.0,2.0,3.0,2.0,4.0,8.0,16.0,13.0,8.0,11.0,12.0,12.0,15.0,11.0,12.0,14.0,12.0,13.0,12.0,9.0,11.0,13.0,11.0,10.0,13.0,12.0,14.0,11.0,14.0,14.0,12.0,15.0,15.0,13.0,12.0,10.0,11.0,5.0,12.0,13.0,20.0,13.0,12.0,12.0,4.0,12.0,5.0,11.0,10.0,11.0,14.0,12.0,14.0,12.0,12.0,11.0,35.0,0.0,0.0,9.0,2.0,175.0,73.0,1.0,1.0,2.0,4.0,2.0,1.0,2.0,1.0,1.0,1.0,3.0,10.0,12.0,14.0,11.0,14.0,13.0,6.0,12.0,7.0,7.0,14.0,10.0,7.0,15.0,8.0,14.0,10.0,14.0,12.0,13.0,13.0,15.0,14.0,7.0,13.0,9.0,12.0,13.0,12.0,12.0,14.0,5.0,8.0,8.0,10.0,20.0,13.0,11.0,9.0,7.0,10.0,9.0,14.0,17.0,15.0,11.0,13.0,15.0,17.0,17.0,7.0,17.0,0.0,0.0,0.0,0.0,175.0,68.0,1.0,1.0,1.0,1.0,1.0,2.0,2.0,2.0,3.0,1.0,2.0,7.0,9.0,11.0,12.0,12.0,7.0,10.0,10.0,7.0,5.0,12.0,10.0,7.0,11.0,7.0,11.0,10.0,11.0,11.0,12.0,11.0,11.0,13.0,5.0,14.0,11.0,12.0,12.0,12.0,11.0,7.0,9.0,20.0,13.0,11.0,13.0,11.0,10.0,10.0,4.0,11.0,2.0,11.0,12.0,13.0,11.0,8.0,11.0,13.0,8.0,6.0,20.0,0.0,0.0,1.0,0.0,190.0,80.0,14.0,12.0,12.0,9.0,13.0,14.0,12.0,14.0,15.0,13.0,12.0,2.0,3.0,3.0,3.0,10.0,5.0,6.0,2.0,3.0,3.0,10.0,6.0,3.0,8.0,6.0,14.0,12.0,14.0,14.0,6.0,12.0,14.0,6.0,6.0,4.0,15.0,10.0,10.0,10.0,14.0,11.0,14.0,8.0,14.0,10.0,20.0,10.0,8.0,15.0,5.0,14.0,5.0,10.0,15.0,13.0,12.0,18.0,14.0,13.0,15.0,6.0,21.0,0.0,0.0,0.0,0.0,174.0,0.0,1.0,3.0,1.0,4.0,1.0,1.0,1.0,1.0,3.0,1.0,2.0,2.0,6.0,4.0,6.0,13.0,2.0,6.0,10.0,4.0,9.0,8.0,4.0,11.0,11.0,9.0,7.0,6.0,6.0,8.0,9.0,12.0,6.0,1.0,10.0,7.0,7.0,8.0,12.0,13.0,10.0,8.0,6.0,16.0,12.0,12.0,20.0,10.0,6.0,9.0,9.0,8.0,9.0,9.0,18.0,14.0,12.0,10.0,12.0,9.0,12.0,5.0,19.0,0.0,0.0,0.0,0.0,194.0,90.0,1.0,1.0,1.0,1.0,2.0,1.0,2.0,3.0,3.0,2.0,2.0,4.0,2.0,4.0,1.0,8.0,4.0,13.0,2.0,1.0,6.0,10.0,1.0,9.0,5.0,7.0,6.0,8.0,5.0,13.0,4.0,14.0,6.0,1.0,11.0,4.0,6.0,6.0,7.0,14.0,12.0,7.0,11.0,20.0,10.0,11.0,8.0,7.0,13.0,8.0,8.0,2.0,8.0,8.0,7.0,12.0,10.0,11.0,11.0,1.0,14.0,8.0,21.0,13.0,0.0,7.0,0.0,181.0,75.0,2.0,3.0,1.0,1.0,3.0,1.0,1.0,4.0,3.0,4.0,2.0,8.0,8.0,12.0,12.0,12.0,9.0,5.0,13.0,12.0,8.0,12.0,6.0,11.0,12.0,8.0,11.0,13.0,10.0,10.0,12.0,7.0,11.0,10.0,6.0,8.0,6.0,5.0,13.0,13.0,12.0,9.0,8.0,14.0,15.0,12.0,20.0,14.0,11.0,8.0,6.0,6.0,5.0,12.0,15.0,13.0,5.0,10.0,9.0,11.0,12.0,6.0,26.0,23.0,1.0,7.0,0.0,182.0,78.0,1.0,2.0,2.0,3.0,3.0,1.0,1.0,3.0,4.0,3.0,3.0,6.0,8.0,12.0,14.0,13.0,9.0,11.0,10.0,2.0,3.0,10.0,13.0,6.0,12.0,16.0,12.0,9.0,14.0,9.0,8.0,8.0,13.0,13.0,8.0,12.0,7.0,6.0,6.0,13.0,13.0,9.0,9.0,12.0,13.0,12.0,20.0,10.0,11.0,10.0,13.0,10.0,10.0,12.0,8.0,11.0,12.0,7.0,13.0,8.0,13.0,2.0,24.0,0.0,0.0,5.0,0.0,178.0,68.0,3.0,1.0,2.0,2.0,3.0,3.0,3.0,2.0,1.0,3.0,2.0,13.0,13.0,12.0,12.0,12.0,14.0,9.0,13.0,4.0,4.0,13.0,14.0,10.0,15.0,10.0,12.0,7.0,10.0,10.0,11.0,8.0,11.0,16.0,7.0,15.0,9.0,10.0,12.0,15.0,15.0,11.0,9.0,10.0,15.0,14.0,20.0,12.0,7.0,13.0,10.0,12.0,13.0,12.0,20.0,10.0,15.0,8.0,13.0,14.0,10.0,8.0,20.0,0.0,0.0,0.0,0.0,170.0,64.0,1.0,2.0,1.0,2.0,1.0,3.0,3.0,3.0,3.0,3.0,3.0,12.0,10.0,11.0,9.0,12.0,13.0,7.0,12.0,4.0,6.0,11.0,13.0,13.0,12.0,14.0,10.0,14.0,9.0,10.0,10.0,10.0,14.0,13.0,9.0,10.0,10.0,11.0,16.0,12.0,13.0,11.0,6.0,10.0,13.0,11.0,20.0,16.0,8.0,12.0,8.0,13.0,10.0,15.0,16.0,12.0,12.0,11.0,12.0,12.0,14.0,6.0,23.0,0.0,0.0,0.0,0.0,180.0,74.0,3.0,2.0,3.0,3.0,2.0,1.0,3.0,1.0,3.0,2.0,1.0,5.0,10.0,11.0,13.0,12.0,3.0,10.0,8.0,9.0,7.0,13.0,15.0,6.0,12.0,12.0,13.0,12.0,10.0,9.0,12.0,9.0,13.0,10.0,6.0,12.0,10.0,14.0,12.0,12.0,12.0,14.0,11.0,20.0,13.0,12.0,6.0,12.0,15.0,12.0,13.0,11.0,8.0,11.0,14.0,12.0,14.0,13.0,14.0,12.0,10.0,5.0,19.0,0.0,0.0,0.0,0.0,176.0,70.0,2.0,1.0,2.0,3.0,3.0,3.0,4.0,1.0,1.0,2.0,3.0,8.0,7.0,6.0,6.0,11.0,8.0,8.0,14.0,2.0,12.0,8.0,3.0,15.0,9.0,9.0,8.0,8.0,8.0,7.0,14.0,15.0,5.0,7.0,13.0,9.0,10.0,10.0,14.0,13.0,11.0,10.0,6.0,2.0,13.0,12.0,20.0,10.0,8.0,9.0,6.0,2.0,6.0,9.0,16.0,12.0,10.0,11.0,8.0,6.0,17.0,4.0,24.0,0.0,0.0,0.0,0.0,194.0,92.0,3.0,1.0,3.0,1.0,1.0,3.0,1.0,1.0,2.0,2.0,3.0,5.0,8.0,7.0,8.0,11.0,7.0,16.0,6.0,8.0,13.0,12.0,6.0,13.0,11.0,10.0,13.0,13.0,14.0,11.0,10.0,11.0,11.0,6.0,10.0,7.0,12.0,14.0,10.0,8.0,10.0,13.0,17.0,14.0,14.0,11.0,20.0,12.0,16.0,14.0,8.0,13.0,4.0,7.0,13.0,16.0,7.0,13.0,14.0,14.0,12.0,7.0,25.0,0.0,0.0,0.0,0.0,180.0,74.0,3.0,2.0,3.0,1.0,3.0,3.0,3.0,3.0,3.0,1.0,1.0,10.0,12.0,10.0,8.0,11.0,10.0,7.0,8.0,10.0,9.0,11.0,14.0,11.0,13.0,18.0,8.0,11.0,9.0,8.0,12.0,11.0,12.0,13.0,8.0,12.0,8.0,13.0,11.0,14.0,14.0,10.0,10.0,20.0,10.0,13.0,10.0,12.0,8.0,13.0,8.0,13.0,9.0,14.0,17.0,12.0,10.0,12.0,14.0,15.0,11.0,3.0
2,3,27.0,0.0,0.0,6.0,0.0,190.0,89.0,14.0,13.0,11.0,6.0,13.0,13.0,14.0,13.0,12.0,11.0,11.0,1.0,2.0,3.0,2.0,7.0,3.0,7.0,1.0,3.0,1.0,6.0,3.0,3.0,7.0,9.0,12.0,14.0,13.0,12.0,11.0,10.0,13.0,2.0,10.0,3.0,13.0,14.0,14.0,13.0,14.0,12.0,16.0,11.0,17.0,13.0,20.0,14.0,15.0,10.0,12.0,12.0,9.0,11.0,7.0,10.0,14.0,15.0,16.0,11.0,13.0,9.0,23.0,0.0,0.0,6.0,0.0,181.0,73.0,1.0,3.0,1.0,1.0,2.0,2.0,2.0,2.0,2.0,3.0,1.0,6.0,11.0,10.0,5.0,10.0,7.0,11.0,7.0,12.0,11.0,11.0,9.0,12.0,10.0,15.0,11.0,18.0,11.0,11.0,9.0,10.0,15.0,9.0,13.0,9.0,13.0,12.0,15.0,14.0,13.0,11.0,12.0,8.0,13.0,14.0,20.0,13.0,11.0,13.0,11.0,13.0,8.0,18.0,20.0,13.0,13.0,13.0,15.0,9.0,9.0,6.0,27.0,0.0,0.0,0.0,0.0,168.0,65.0,2.0,3.0,3.0,4.0,3.0,1.0,1.0,3.0,1.0,3.0,1.0,10.0,12.0,13.0,9.0,12.0,11.0,7.0,10.0,12.0,10.0,12.0,10.0,10.0,14.0,13.0,10.0,10.0,11.0,10.0,12.0,10.0,14.0,13.0,5.0,15.0,10.0,13.0,14.0,16.0,16.0,9.0,7.0,10.0,12.0,13.0,20.0,13.0,7.0,10.0,9.0,10.0,8.0,14.0,7.0,11.0,12.0,10.0,10.0,10.0,11.0,6.0,25.0,0.0,0.0,0.0,0.0,166.0,65.0,2.0,1.0,3.0,1.0,4.0,2.0,1.0,2.0,2.0,3.0,3.0,11.0,15.0,14.0,10.0,11.0,14.0,9.0,13.0,12.0,12.0,13.0,11.0,13.0,14.0,14.0,12.0,15.0,13.0,11.0,14.0,10.0,15.0,14.0,10.0,15.0,13.0,13.0,15.0,15.0,16.0,11.0,6.0,20.0,14.0,14.0,8.0,15.0,10.0,13.0,10.0,13.0,9.0,13.0,14.0,12.0,15.0,14.0,14.0,5.0,5.0,7.0,24.0,0.0,0.0,0.0,0.0,175.0,75.0,1.0,4.0,3.0,2.0,1.0,1.0,2.0,2.0,2.0,1.0,3.0,14.0,12.0,15.0,11.0,14.0,14.0,8.0,13.0,7.0,10.0,15.0,14.0,11.0,14.0,11.0,13.0,11.0,11.0,12.0,15.0,12.0,14.0,13.0,8.0,10.0,10.0,12.0,12.0,10.0,13.0,12.0,10.0,9.0,15.0,10.0,20.0,12.0,10.0,13.0,3.0,14.0,8.0,13.0,13.0,12.0,11.0,12.0,14.0,12.0,12.0,9.0,32.0,31.0,0.0,2.0,0.0,176.0,70.0,3.0,2.0,3.0,2.0,2.0,1.0,2.0,1.0,3.0,1.0,1.0,10.0,10.0,12.0,9.0,12.0,9.0,10.0,8.0,6.0,13.0,12.0,12.0,14.0,12.0,19.0,12.0,19.0,14.0,11.0,12.0,10.0,16.0,9.0,17.0,13.0,14.0,16.0,16.0,12.0,16.0,13.0,10.0,8.0,18.0,11.0,20.0,16.0,11.0,13.0,14.0,12.0,6.0,17.0,12.0,14.0,16.0,13.0,15.0,2.0,5.0,5.0,29.0,5.0,4.0,26.0,5.0,178.0,76.0,1.0,1.0,3.0,2.0,2.0,3.0,2.0,1.0,1.0,3.0,3.0,12.0,11.0,12.0,15.0,13.0,15.0,12.0,15.0,3.0,4.0,10.0,16.0,5.0,13.0,12.0,13.0,15.0,14.0,10.0,11.0,10.0,15.0,15.0,11.0,16.0,7.0,9.0,12.0,12.0,11.0,14.0,11.0,20.0,14.0,11.0,12.0,12.0,14.0,13.0,8.0,13.0,10.0,8.0,14.0,14.0,13.0,14.0,17.0,11.0,13.0,7.0,31.0,6.0,0.0,21.0,1.0,183.0,78.0,1.0,3.0,2.0,2.0,1.0,1.0,1.0,3.0,1.0,3.0,3.0,2.0,8.0,10.0,7.0,12.0,11.0,14.0,9.0,2.0,13.0,12.0,13.0,16.0,11.0,17.0,13.0,18.0,13.0,13.0,11.0,12.0,17.0,10.0,16.0,9.0,15.0,14.0,13.0,10.0,8.0,13.0,13.0,9.0,16.0,10.0,20.0,13.0,14.0,13.0,14.0,14.0,5.0,20.0,15.0,12.0,16.0,13.0,15.0,2.0,5.0,10.0,31.0,4.0,1.0,0.0,0.0,177.0,70.0,3.0,1.0,3.0,1.0,2.0,1.0,3.0,3.0,3.0,2.0,2.0,13.0,12.0,15.0,13.0,14.0,13.0,11.0,11.0,5.0,4.0,15.0,12.0,5.0,15.0,10.0,12.0,11.0,15.0,10.0,17.0,10.0,12.0,17.0,12.0,14.0,7.0,10.0,10.0,13.0,17.0,12.0,11.0,14.0,12.0,11.0,20.0,11.0,8.0,13.0,14.0,12.0,7.0,18.0,14.0,14.0,16.0,12.0,16.0,6.0,6.0,7.0,21.0,0.0,0.0,0.0,0.0,175.0,66.0,1.0,3.0,3.0,4.0,3.0,2.0,1.0,1.0,1.0,4.0,2.0,11.0,9.0,15.0,9.0,13.0,12.0,3.0,11.0,11.0,5.0,9.0,7.0,11.0,15.0,9.0,11.0,9.0,11.0,11.0,9.0,11.0,7.0,14.0,1.0,13.0,5.0,11.0,9.0,17.0,15.0,9.0,8.0,20.0,14.0,15.0,12.0,13.0,7.0,11.0,8.0,11.0,8.0,11.0,11.0,15.0,12.0,12.0,8.0,5.0,4.0,1.0,23.0,0.0,0.0,0.0,0.0,173.0,61.0,1.0,1.0,4.0,2.0,1.0,2.0,1.0,3.0,1.0,4.0,3.0,7.0,12.0,13.0,8.0,12.0,11.0,7.0,10.0,1.0,4.0,10.0,8.0,5.0,12.0,9.0,8.0,8.0,9.0,7.0,9.0,6.0,12.0,10.0,4.0,14.0,4.0,9.0,10.0,18.0,17.0,8.0,8.0,5.0,11.0,17.0,20.0,11.0,8.0,10.0,5.0,10.0,4.0,9.0,8.0,14.0,9.0,8.0,8.0,11.0,8.0,16.0,26.0,29.0,0.0,10.0,0.0,190.0,80.0,12.0,15.0,12.0,13.0,11.0,16.0,14.0,15.0,17.0,13.0,18.0,6.0,3.0,2.0,3.0,11.0,10.0,8.0,2.0,2.0,2.0,10.0,8.0,3.0,11.0,8.0,16.0,10.0,15.0,12.0,9.0,12.0,14.0,1.0,8.0,3.0,14.0,10.0,12.0,13.0,14.0,13.0,15.0,12.0,12.0,10.0,20.0,12.0,11.0,11.0,6.0,11.0,5.0,2.0,17.0,16.0,13.0,10.0,14.0,14.0,12.0,6.0,20.0,1.0,0.0,3.0,0.0,192.0,90.0,1.0,1.0,2.0,2.0,3.0,2.0,3.0,2.0,3.0,2.0,1.0,6.0,10.0,9.0,5.0,12.0,5.0,12.0,5.0,13.0,15.0,12.0,7.0,14.0,13.0,10.0,14.0,13.0,16.0,10.0,11.0,12.0,10.0,8.0,10.0,5.0,13.0,15.0,9.0,13.0,11.0,16.0,17.0,12.0,14.0,17.0,20.0,13.0,17.0,14.0,6.0,14.0,4.0,10.0,8.0,13.0,7.0,14.0,12.0,16.0,16.0,11.0,25.0,49.0,1.0,0.0,0.0,184.0,76.0,3.0,3.0,1.0,2.0,3.0,1.0,1.0,1.0,1.0,3.0,2.0,5.0,8.0,9.0,8.0,12.0,5.0,11.0,7.0,8.0,14.0,12.0,10.0,16.0,11.0,10.0,17.0,15.0,15.0,12.0,10.0,14.0,15.0,7.0,12.0,7.0,18.0,14.0,8.0,12.0,10.0,14.0,12.0,15.0,15.0,15.0,20.0,13.0,13.0,14.0,6.0,15.0,4.0,7.0,14.0,18.0,10.0,16.0,12.0,10.0,8.0,17.0,15.0,0.0,0.0,0.0,0.0,175.0,0.0,2.0,1.0,1.0,1.0,2.0,2.0,3.0,3.0,3.0,1.0,2.0,6.0,9.0,7.0,4.0,9.0,8.0,2.0,6.0,2.0,5.0,4.0,5.0,5.0,13.0,5.0,6.0,6.0,5.0,6.0,5.0,6.0,5.0,11.0,6.0,7.0,3.0,9.0,13.0,8.0,8.0,10.0,9.0,20.0,6.0,9.0,9.0,8.0,4.0,4.0,15.0,9.0,9.0,7.0,6.0,4.0,7.0,5.0,14.0,9.0,9.0,7.0,27.0,19.0,4.0,1.0,0.0,184.0,77.0,2.0,1.0,1.0,1.0,3.0,3.0,1.0,1.0,2.0,3.0,3.0,7.0,10.0,8.0,9.0,12.0,7.0,12.0,11.0,13.0,15.0,13.0,8.0,17.0,11.0,15.0,16.0,18.0,12.0,17.0,10.0,14.0,17.0,5.0,13.0,13.0,14.0,19.0,18.0,11.0,11.0,14.0,12.0,10.0,20.0,13.0,20.0,17.0,13.0,18.0,6.0,18.0,10.0,15.0,9.0,14.0,14.0,16.0,19.0,15.0,18.0,2.0,20.0,1.0,0.0,8.0,1.0,185.0,82.0,2.0,2.0,1.0,3.0,3.0,4.0,1.0,4.0,3.0,1.0,1.0,12.0,12.0,16.0,14.0,17.0,13.0,6.0,11.0,7.0,5.0,13.0,11.0,6.0,16.0,10.0,14.0,7.0,12.0,9.0,15.0,13.0,10.0,15.0,5.0,15.0,8.0,13.0,10.0,16.0,14.0,10.0,12.0,12.0,13.0,13.0,20.0,12.0,11.0,11.0,4.0,11.0,4.0,14.0,10.0,17.0,8.0,11.0,14.0,14.0,16.0,7.0,24.0,8.0,0.0,11.0,7.0,189.0,83.0,1.0,4.0,1.0,2.0,4.0,3.0,3.0,2.0,3.0,2.0,2.0,5.0,9.0,11.0,13.0,13.0,6.0,14.0,9.0,5.0,5.0,12.0,8.0,6.0,13.0,11.0,12.0,12.0,11.0,13.0,11.0,11.0,10.0,13.0,5.0,14.0,10.0,14.0,14.0,13.0,12.0,13.0,13.0,8.0,13.0,13.0,20.0,14.0,15.0,8.0,8.0,13.0,13.0,4.0,8.0,12.0,14.0,10.0,13.0,8.0,8.0,12.0,27.0,0.0,0.0,0.0,0.0,170.0,66.0,2.0,1.0,3.0,2.0,2.0,2.0,3.0,2.0,1.0,2.0,2.0,7.0,8.0,11.0,11.0,10.0,9.0,10.0,9.0,4.0,6.0,10.0,8.0,6.0,10.0,9.0,11.0,9.0,11.0,10.0,10.0,12.0,2.0,13.0,1.0,11.0,10.0,9.0,9.0,13.0,14.0,14.0,6.0,11.0,3.0,13.0,20.0,14.0,6.0,10.0,9.0,9.0,9.0,8.0,13.0,12.0,12.0,11.0,11.0,8.0,2.0,7.0,22.0,0.0,0.0,0.0,0.0,183.0,75.0,2.0,2.0,3.0,1.0,1.0,3.0,1.0,1.0,3.0,2.0,3.0,7.0,9.0,8.0,9.0,11.0,8.0,12.0,10.0,10.0,14.0,12.0,8.0,16.0,11.0,17.0,12.0,16.0,10.0,14.0,9.0,11.0,13.0,8.0,10.0,10.0,13.0,16.0,17.0,11.0,11.0,14.0,11.0,10.0,16.0,14.0,20.0,16.0,13.0,14.0,12.0,14.0,4.0,17.0,10.0,12.0,13.0,10.0,14.0,15.0,17.0,5.0,22.0,0.0,0.0,2.0,0.0,176.0,67.0,2.0,1.0,2.0,2.0,2.0,1.0,1.0,1.0,1.0,3.0,3.0,10.0,14.0,15.0,11.0,14.0,12.0,6.0,11.0,12.0,11.0,12.0,9.0,12.0,13.0,14.0,10.0,10.0,13.0,10.0,13.0,12.0,12.0,14.0,8.0,12.0,11.0,11.0,14.0,16.0,15.0,10.0,8.0,14.0,13.0,16.0,20.0,14.0,8.0,12.0,8.0,13.0,9.0,18.0,7.0,11.0,12.0,13.0,10.0,11.0,8.0,15.0,17.0,0.0,0.0,0.0,0.0,186.0,77.0,2.0,1.0,2.0,3.0,3.0,1.0,2.0,1.0,2.0,3.0,1.0,10.0,11.0,12.0,12.0,15.0,9.0,10.0,10.0,9.0,8.0,13.0,12.0,10.0,15.0,16.0,13.0,13.0,15.0,8.0,14.0,11.0,12.0,13.0,8.0,15.0,8.0,15.0,17.0,12.0,11.0,14.0,14.0,20.0,16.0,16.0,10.0,12.0,11.0,12.0,7.0,14.0,4.0,16.0,10.0,14.0,13.0,12.0,13.0,15.0,17.0,5.0
2,2,33.0,1.0,0.0,24.0,0.0,193.0,83.0,12.0,14.0,11.0,4.0,13.0,14.0,12.0,14.0,12.0,10.0,14.0,6.0,1.0,2.0,2.0,7.0,9.0,6.0,3.0,3.0,3.0,7.0,5.0,1.0,5.0,8.0,13.0,13.0,12.0,12.0,6.0,13.0,12.0,3.0,10.0,3.0,13.0,15.0,7.0,7.0,8.0,13.0,10.0,5.0,9.0,6.0,20.0,5.0,13.0,16.0,6.0,12.0,7.0,10.0,14.0,15.0,15.0,15.0,16.0,10.0,17.0,8.0,30.0,0.0,0.0,0.0,0.0,170.0,68.0,2.0,2.0,3.0,3.0,1.0,3.0,3.0,2.0,1.0,3.0,2.0,5.0,5.0,10.0,7.0,11.0,5.0,7.0,6.0,6.0,13.0,9.0,6.0,14.0,8.0,17.0,12.0,14.0,13.0,12.0,9.0,13.0,16.0,6.0,11.0,5.0,14.0,14.0,14.0,12.0,10.0,14.0,6.0,5.0,11.0,11.0,20.0,14.0,14.0,14.0,13.0,7.0,14.0,7.0,18.0,12.0,15.0,14.0,16.0,12.0,13.0,7.0,27.0,7.0,0.0,0.0,0.0,185.0,71.0,3.0,3.0,2.0,3.0,3.0,3.0,2.0,3.0,3.0,3.0,2.0,13.0,12.0,10.0,7.0,15.0,13.0,8.0,12.0,3.0,7.0,14.0,11.0,9.0,15.0,11.0,12.0,8.0,12.0,10.0,15.0,10.0,7.0,13.0,3.0,12.0,8.0,12.0,13.0,13.0,14.0,13.0,12.0,10.0,10.0,11.0,20.0,11.0,11.0,7.0,13.0,9.0,13.0,13.0,9.0,14.0,10.0,10.0,10.0,10.0,11.0,12.0,28.0,0.0,0.0,3.0,0.0,184.0,75.0,3.0,1.0,1.0,2.0,3.0,1.0,3.0,3.0,3.0,2.0,3.0,7.0,13.0,13.0,11.0,11.0,11.0,14.0,10.0,4.0,6.0,11.0,13.0,7.0,11.0,12.0,11.0,13.0,10.0,11.0,12.0,10.0,13.0,10.0,8.0,14.0,8.0,11.0,13.0,12.0,12.0,14.0,13.0,9.0,12.0,13.0,20.0,12.0,13.0,8.0,7.0,11.0,10.0,5.0,8.0,14.0,14.0,9.0,11.0,13.0,11.0,11.0,28.0,0.0,0.0,0.0,0.0,170.0,75.0,2.0,3.0,3.0,2.0,1.0,3.0,1.0,1.0,1.0,3.0,2.0,13.0,13.0,14.0,14.0,12.0,15.0,9.0,13.0,4.0,6.0,13.0,12.0,4.0,14.0,10.0,14.0,11.0,13.0,13.0,14.0,13.0,12.0,14.0,10.0,16.0,10.0,12.0,14.0,12.0,13.0,10.0,8.0,20.0,12.0,12.0,10.0,11.0,10.0,13.0,9.0,13.0,9.0,11.0,16.0,15.0,10.0,14.0,13.0,9.0,8.0,10.0,24.0,0.0,0.0,0.0,0.0,184.0,73.0,2.0,2.0,3.0,3.0,3.0,3.0,3.0,1.0,3.0,3.0,4.0,11.0,12.0,15.0,14.0,12.0,11.0,9.0,14.0,6.0,8.0,13.0,12.0,8.0,14.0,12.0,11.0,12.0,11.0,10.0,14.0,12.0,13.0,14.0,8.0,13.0,9.0,12.0,13.0,14.0,14.0,11.0,10.0,12.0,12.0,13.0,20.0,13.0,11.0,12.0,12.0,10.0,9.0,13.0,3.0,14.0,10.0,12.0,7.0,8.0,9.0,7.0,27.0,0.0,0.0,0.0,0.0,178.0,75.0,3.0,1.0,3.0,4.0,1.0,1.0,3.0,3.0,2.0,3.0,2.0,9.0,12.0,13.0,10.0,10.0,7.0,5.0,13.0,6.0,3.0,9.0,8.0,4.0,12.0,4.0,10.0,6.0,12.0,8.0,10.0,9.0,8.0,16.0,7.0,13.0,6.0,10.0,10.0,18.0,16.0,10.0,9.0,8.0,14.0,14.0,20.0,12.0,10.0,9.0,3.0,7.0,10.0,13.0,11.0,6.0,7.0,6.0,15.0,11.0,7.0,4.0,29.0,3.0,0.0,0.0,0.0,177.0,69.0,1.0,2.0,3.0,2.0,3.0,3.0,3.0,2.0,2.0,2.0,3.0,8.0,10.0,13.0,8.0,12.0,11.0,7.0,10.0,7.0,4.0,11.0,12.0,4.0,13.0,15.0,12.0,12.0,11.0,9.0,9.0,10.0,14.0,12.0,5.0,12.0,6.0,8.0,9.0,15.0,14.0,10.0,8.0,20.0,13.0,14.0,8.0,12.0,8.0,11.0,15.0,13.0,8.0,8.0,10.0,14.0,12.0,7.0,10.0,13.0,14.0,9.0,29.0,0.0,0.0,0.0,0.0,185.0,74.0,2.0,1.0,1.0,2.0,2.0,2.0,4.0,2.0,1.0,1.0,2.0,9.0,11.0,9.0,8.0,11.0,8.0,13.0,10.0,8.0,13.0,12.0,10.0,12.0,10.0,11.0,12.0,11.0,13.0,13.0,10.0,12.0,12.0,7.0,11.0,8.0,14.0,14.0,12.0,10.0,10.0,14.0,13.0,20.0,14.0,11.0,9.0,14.0,12.0,14.0,11.0,12.0,5.0,9.0,12.0,14.0,12.0,12.0,14.0,14.0,13.0,7.0,28.0,0.0,0.0,0.0,0.0,190.0,83.0,1.0,2.0,2.0,2.0,1.0,3.0,2.0,1.0,1.0,2.0,2.0,6.0,9.0,6.0,8.0,9.0,5.0,14.0,12.0,8.0,15.0,10.0,9.0,13.0,10.0,16.0,14.0,16.0,12.0,14.0,10.0,13.0,8.0,6.0,10.0,9.0,13.0,16.0,18.0,9.0,9.0,8.0,15.0,7.0,15.0,14.0,20.0,17.0,16.0,16.0,6.0,13.0,7.0,12.0,7.0,10.0,11.0,9.0,10.0,9.0,7.0,8.0,25.0,0.0,0.0,0.0,0.0,180.0,78.0,3.0,3.0,2.0,2.0,3.0,1.0,2.0,1.0,4.0,3.0,2.0,10.0,10.0,13.0,8.0,12.0,9.0,9.0,10.0,10.0,5.0,8.0,11.0,6.0,11.0,9.0,12.0,12.0,11.0,9.0,11.0,8.0,15.0,11.0,6.0,13.0,6.0,13.0,12.0,14.0,14.0,11.0,11.0,10.0,13.0,13.0,20.0,14.0,11.0,8.0,4.0,12.0,6.0,11.0,14.0,13.0,12.0,9.0,11.0,10.0,8.0,4.0,33.0,0.0,0.0,2.0,0.0,196.0,89.0,15.0,13.0,12.0,7.0,14.0,10.0,14.0,14.0,11.0,9.0,12.0,4.0,3.0,1.0,1.0,9.0,7.0,2.0,2.0,1.0,1.0,10.0,2.0,2.0,9.0,10.0,14.0,14.0,13.0,12.0,11.0,12.0,14.0,6.0,12.0,1.0,13.0,11.0,6.0,9.0,13.0,16.0,18.0,5.0,12.0,10.0,20.0,12.0,16.0,14.0,10.0,15.0,13.0,1.0,8.0,14.0,14.0,14.0,10.0,15.0,15.0,9.0,26.0,27.0,0.0,0.0,0.0,183.0,70.0,1.0,3.0,1.0,3.0,4.0,1.0,3.0,3.0,2.0,1.0,3.0,9.0,14.0,12.0,8.0,10.0,8.0,12.0,13.0,14.0,9.0,12.0,7.0,13.0,11.0,14.0,9.0,15.0,10.0,12.0,9.0,10.0,16.0,10.0,9.0,12.0,8.0,12.0,17.0,14.0,11.0,13.0,12.0,10.0,16.0,16.0,20.0,16.0,13.0,13.0,10.0,14.0,6.0,15.0,10.0,15.0,14.0,10.0,16.0,13.0,13.0,4.0,16.0,0.0,0.0,0.0,0.0,192.0,0.0,2.0,3.0,1.0,2.0,3.0,1.0,1.0,1.0,2.0,3.0,3.0,6.0,8.0,8.0,6.0,10.0,6.0,12.0,6.0,7.0,12.0,10.0,7.0,12.0,10.0,13.0,12.0,14.0,11.0,10.0,8.0,10.0,10.0,8.0,6.0,8.0,9.0,10.0,13.0,13.0,11.0,12.0,13.0,6.0,14.0,12.0,20.0,10.0,10.0,10.0,7.0,8.0,8.0,10.0,9.0,13.0,10.0,11.0,11.0,10.0,15.0,9.0,20.0,0.0,0.0,0.0,0.0,178.0,81.0,2.0,1.0,3.0,3.0,2.0,2.0,3.0,3.0,2.0,3.0,3.0,11.0,12.0,15.0,12.0,14.0,8.0,7.0,14.0,5.0,3.0,10.0,10.0,3.0,14.0,16.0,12.0,10.0,12.0,8.0,11.0,8.0,11.0,15.0,8.0,13.0,5.0,7.0,6.0,14.0,14.0,12.0,8.0,8.0,8.0,14.0,20.0,9.0,10.0,11.0,14.0,10.0,6.0,9.0,6.0,14.0,4.0,11.0,4.0,7.0,4.0,18.0,29.0,26.0,6.0,12.0,4.0,175.0,77.0,1.0,2.0,1.0,3.0,3.0,2.0,1.0,2.0,1.0,2.0,2.0,16.0,14.0,16.0,15.0,15.0,18.0,6.0,15.0,6.0,6.0,18.0,11.0,5.0,17.0,9.0,12.0,10.0,16.0,12.0,16.0,14.0,14.0,16.0,6.0,16.0,6.0,10.0,10.0,13.0,15.0,14.0,8.0,15.0,15.0,14.0,20.0,13.0,12.0,11.0,9.0,16.0,7.0,8.0,8.0,11.0,8.0,13.0,12.0,13.0,11.0,10.0,28.0,47.0,9.0,17.0,4.0,188.0,94.0,3.0,3.0,3.0,2.0,3.0,2.0,3.0,3.0,1.0,1.0,3.0,6.0,11.0,12.0,17.0,16.0,11.0,18.0,13.0,5.0,6.0,13.0,13.0,6.0,16.0,8.0,14.0,13.0,16.0,16.0,13.0,15.0,11.0,16.0,10.0,13.0,8.0,8.0,8.0,10.0,11.0,17.0,15.0,20.0,13.0,12.0,14.0,13.0,16.0,14.0,14.0,15.0,9.0,5.0,14.0,16.0,14.0,11.0,13.0,14.0,14.0,10.0,26.0,28.0,3.0,12.0,1.0,186.0,78.0,1.0,3.0,1.0,3.0,2.0,1.0,3.0,2.0,1.0,1.0,3.0,10.0,12.0,10.0,11.0,13.0,10.0,10.0,13.0,5.0,10.0,17.0,13.0,15.0,13.0,17.0,16.0,15.0,18.0,16.0,15.0,16.0,19.0,8.0,16.0,14.0,15.0,17.0,16.0,12.0,13.0,15.0,11.0,20.0,7.0,14.0,9.0,14.0,16.0,15.0,12.0,15.0,16.0,10.0,16.0,16.0,14.0,17.0,17.0,13.0,15.0,8.0,19.0,0.0,0.0,7.0,2.0,188.0,85.0,1.0,3.0,2.0,1.0,2.0,3.0,3.0,2.0,2.0,3.0,1.0,10.0,6.0,9.0,8.0,10.0,12.0,15.0,8.0,7.0,14.0,11.0,10.0,13.0,10.0,14.0,11.0,13.0,9.0,11.0,10.0,10.0,9.0,1.0,8.0,12.0,13.0,13.0,14.0,13.0,10.0,13.0,15.0,9.0,12.0,13.0,20.0,14.0,14.0,9.0,11.0,4.0,9.0,11.0,14.0,13.0,12.0,12.0,12.0,1.0,13.0,2.0,22.0,0.0,0.0,3.0,0.0,176.0,70.0,1.0,1.0,1.0,3.0,2.0,1.0,2.0,3.0,1.0,3.0,3.0,10.0,15.0,14.0,6.0,13.0,10.0,13.0,10.0,9.0,9.0,13.0,8.0,11.0,14.0,10.0,11.0,12.0,10.0,13.0,11.0,13.0,14.0,13.0,7.0,13.0,9.0,11.0,13.0,17.0,13.0,12.0,10.0,20.0,14.0,16.0,5.0,15.0,11.0,13.0,10.0,14.0,8.0,10.0,11.0,13.0,16.0,11.0,15.0,14.0,13.0,7.0,28.0,41.0,2.0,0.0,0.0,187.0,80.0,3.0,2.0,3.0,2.0,1.0,1.0,2.0,3.0,1.0,4.0,2.0,7.0,10.0,11.0,7.0,12.0,7.0,10.0,12.0,13.0,15.0,13.0,8.0,18.0,12.0,18.0,13.0,17.0,12.0,14.0,10.0,12.0,17.0,7.0,13.0,9.0,14.0,17.0,18.0,14.0,13.0,16.0,14.0,20.0,18.0,13.0,12.0,18.0,14.0,15.0,16.0,15.0,6.0,15.0,14.0,13.0,10.0,14.0,12.0,8.0,7.0,8.0,18.0,0.0,0.0,0.0,0.0,167.0,60.0,2.0,1.0,2.0,2.0,2.0,1.0,2.0,1.0,1.0,1.0,1.0,10.0,11.0,12.0,8.0,13.0,10.0,3.0,10.0,5.0,6.0,13.0,12.0,8.0,15.0,8.0,11.0,8.0,12.0,11.0,13.0,12.0,13.0,12.0,6.0,11.0,11.0,12.0,13.0,15.0,14.0,8.0,5.0,8.0,15.0,12.0,20.0,12.0,7.0,8.0,8.0,14.0,7.0,8.0,18.0,11.0,12.0,11.0,12.0,15.0,15.0,7.0
4,0,25.0,0.0,0.0,11.0,0.0,189.0,83.0,12.0,12.0,11.0,7.0,13.0,12.0,17.0,17.0,16.0,12.0,13.0,6.0,2.0,1.0,1.0,10.0,10.0,7.0,1.0,1.0,1.0,9.0,5.0,1.0,10.0,8.0,15.0,14.0,14.0,12.0,7.0,13.0,12.0,6.0,9.0,3.0,16.0,17.0,10.0,13.0,16.0,14.0,12.0,8.0,15.0,10.0,20.0,13.0,14.0,14.0,5.0,14.0,4.0,12.0,15.0,15.0,13.0,13.0,17.0,15.0,17.0,4.0,24.0,0.0,0.0,0.0,0.0,184.0,89.0,2.0,3.0,3.0,2.0,2.0,3.0,3.0,1.0,2.0,3.0,2.0,4.0,10.0,8.0,6.0,11.0,9.0,14.0,9.0,7.0,14.0,11.0,6.0,11.0,11.0,13.0,12.0,16.0,11.0,13.0,10.0,11.0,14.0,6.0,8.0,7.0,12.0,13.0,14.0,14.0,12.0,16.0,12.0,20.0,14.0,13.0,6.0,14.0,16.0,14.0,13.0,13.0,7.0,8.0,7.0,14.0,13.0,12.0,14.0,14.0,14.0,6.0,29.0,59.0,2.0,9.0,0.0,179.0,70.0,2.0,3.0,2.0,1.0,1.0,1.0,1.0,1.0,4.0,3.0,3.0,6.0,8.0,8.0,7.0,12.0,6.0,10.0,8.0,12.0,14.0,12.0,7.0,14.0,11.0,18.0,14.0,16.0,10.0,16.0,8.0,12.0,17.0,6.0,14.0,8.0,14.0,18.0,19.0,13.0,12.0,14.0,11.0,10.0,18.0,15.0,20.0,18.0,13.0,15.0,13.0,15.0,7.0,15.0,18.0,14.0,8.0,13.0,18.0,12.0,14.0,5.0,18.0,0.0,0.0,4.0,0.0,181.0,75.0,3.0,1.0,3.0,3.0,3.0,3.0,4.0,2.0,3.0,3.0,3.0,7.0,10.0,13.0,12.0,14.0,10.0,12.0,11.0,9.0,8.0,12.0,12.0,8.0,15.0,11.0,13.0,11.0,14.0,12.0,9.0,12.0,12.0,14.0,8.0,14.0,8.0,10.0,11.0,13.0,13.0,12.0,13.0,11.0,12.0,12.0,20.0,12.0,11.0,12.0,9.0,10.0,9.0,9.0,13.0,10.0,12.0,11.0,11.0,13.0,13.0,13.0,22.0,0.0,0.0,10.0,6.0,189.0,89.0,3.0,1.0,1.0,2.0,2.0,4.0,2.0,1.0,1.0,2.0,3.0,2.0,6.0,9.0,14.0,12.0,7.0,15.0,13.0,5.0,5.0,11.0,18.0,4.0,13.0,10.0,14.0,15.0,15.0,11.0,11.0,13.0,9.0,15.0,7.0,15.0,5.0,8.0,12.0,13.0,12.0,16.0,14.0,12.0,14.0,12.0,20.0,14.0,14.0,12.0,11.0,13.0,8.0,5.0,20.0,12.0,10.0,11.0,10.0,14.0,14.0,4.0,21.0,0.0,0.0,3.0,1.0,175.0,66.0,1.0,3.0,3.0,1.0,2.0,3.0,2.0,2.0,2.0,2.0,2.0,10.0,12.0,14.0,12.0,14.0,10.0,9.0,11.0,6.0,6.0,11.0,10.0,8.0,13.0,13.0,12.0,8.0,10.0,11.0,11.0,10.0,13.0,15.0,13.0,14.0,6.0,12.0,10.0,16.0,16.0,8.0,8.0,11.0,12.0,14.0,20.0,10.0,7.0,13.0,8.0,13.0,9.0,12.0,13.0,14.0,13.0,12.0,12.0,11.0,13.0,8.0,22.0,20.0,0.0,0.0,0.0,169.0,71.0,3.0,3.0,3.0,1.0,2.0,3.0,1.0,3.0,1.0,1.0,1.0,13.0,17.0,13.0,8.0,14.0,10.0,6.0,11.0,15.0,11.0,15.0,5.0,12.0,15.0,7.0,11.0,15.0,14.0,11.0,12.0,12.0,14.0,14.0,5.0,15.0,11.0,14.0,11.0,15.0,15.0,12.0,6.0,20.0,13.0,15.0,9.0,13.0,11.0,8.0,11.0,12.0,12.0,12.0,18.0,13.0,15.0,16.0,15.0,12.0,8.0,3.0,32.0,99.0,2.0,0.0,0.0,179.0,72.0,1.0,1.0,3.0,2.0,2.0,1.0,2.0,2.0,2.0,3.0,3.0,11.0,15.0,10.0,7.0,13.0,9.0,12.0,10.0,10.0,12.0,14.0,8.0,14.0,13.0,15.0,13.0,16.0,14.0,16.0,10.0,14.0,14.0,8.0,14.0,7.0,12.0,18.0,12.0,11.0,14.0,10.0,8.0,12.0,17.0,12.0,20.0,16.0,9.0,16.0,5.0,12.0,5.0,17.0,14.0,10.0,17.0,12.0,18.0,13.0,15.0,1.0,30.0,0.0,0.0,0.0,0.0,190.0,75.0,3.0,2.0,2.0,3.0,1.0,3.0,3.0,2.0,2.0,2.0,1.0,5.0,6.0,9.0,7.0,8.0,8.0,14.0,10.0,12.0,15.0,10.0,7.0,16.0,8.0,14.0,12.0,17.0,8.0,14.0,8.0,11.0,17.0,5.0,14.0,10.0,13.0,16.0,14.0,10.0,8.0,15.0,16.0,10.0,14.0,12.0,20.0,14.0,17.0,13.0,15.0,13.0,4.0,12.0,8.0,10.0,15.0,16.0,14.0,8.0,7.0,13.0,22.0,0.0,0.0,5.0,1.0,186.0,84.0,3.0,1.0,2.0,1.0,1.0,2.0,3.0,3.0,3.0,2.0,3.0,6.0,11.0,12.0,7.0,11.0,7.0,10.0,6.0,15.0,13.0,10.0,9.0,14.0,11.0,15.0,10.0,15.0,10.0,11.0,9.0,9.0,15.0,8.0,7.0,11.0,10.0,13.0,15.0,14.0,13.0,15.0,13.0,10.0,16.0,18.0,20.0,14.0,13.0,13.0,8.0,11.0,10.0,14.0,10.0,13.0,11.0,12.0,15.0,14.0,14.0,4.0,24.0,5.0,0.0,18.0,2.0,176.0,81.0,2.0,3.0,2.0,1.0,3.0,1.0,2.0,1.0,1.0,2.0,2.0,11.0,14.0,12.0,10.0,11.0,11.0,10.0,8.0,13.0,9.0,12.0,8.0,13.0,11.0,17.0,8.0,13.0,9.0,10.0,10.0,8.0,13.0,14.0,5.0,14.0,9.0,12.0,17.0,16.0,14.0,13.0,8.0,20.0,12.0,15.0,10.0,13.0,10.0,11.0,12.0,11.0,8.0,16.0,9.0,14.0,11.0,6.0,11.0,9.0,6.0,15.0,33.0,0.0,0.0,2.0,0.0,196.0,89.0,15.0,13.0,12.0,7.0,14.0,10.0,14.0,14.0,11.0,9.0,12.0,4.0,3.0,1.0,1.0,9.0,7.0,2.0,2.0,1.0,1.0,10.0,2.0,2.0,9.0,10.0,14.0,14.0,13.0,12.0,11.0,12.0,14.0,6.0,12.0,1.0,13.0,11.0,6.0,9.0,13.0,16.0,18.0,5.0,12.0,10.0,20.0,12.0,16.0,14.0,10.0,15.0,13.0,1.0,8.0,14.0,14.0,14.0,10.0,15.0,15.0,9.0,16.0,0.0,0.0,0.0,0.0,192.0,0.0,2.0,3.0,1.0,2.0,3.0,1.0,1.0,1.0,2.0,3.0,3.0,6.0,8.0,8.0,6.0,10.0,6.0,12.0,6.0,7.0,12.0,10.0,7.0,12.0,10.0,13.0,12.0,14.0,11.0,10.0,8.0,10.0,10.0,8.0,6.0,8.0,9.0,10.0,13.0,13.0,11.0,12.0,13.0,6.0,14.0,12.0,20.0,10.0,10.0,10.0,7.0,8.0,8.0,10.0,9.0,13.0,10.0,11.0,11.0,10.0,15.0,9.0,20.0,0.0,0.0,0.0,0.0,178.0,81.0,2.0,1.0,3.0,3.0,2.0,2.0,3.0,3.0,2.0,3.0,3.0,11.0,12.0,15.0,12.0,14.0,8.0,7.0,14.0,5.0,3.0,10.0,10.0,3.0,14.0,16.0,12.0,10.0,12.0,8.0,11.0,8.0,11.0,15.0,8.0,13.0,5.0,7.0,6.0,14.0,14.0,12.0,8.0,8.0,8.0,14.0,20.0,9.0,10.0,11.0,14.0,10.0,6.0,9.0,6.0,14.0,4.0,11.0,4.0,7.0,4.0,18.0,28.0,47.0,9.0,17.0,4.0,188.0,94.0,3.0,3.0,3.0,2.0,3.0,2.0,3.0,3.0,1.0,1.0,3.0,6.0,11.0,12.0,17.0,16.0,11.0,18.0,13.0,5.0,6.0,13.0,13.0,6.0,16.0,8.0,14.0,13.0,16.0,16.0,13.0,15.0,11.0,16.0,10.0,13.0,8.0,8.0,8.0,10.0,11.0,17.0,15.0,20.0,13.0,12.0,14.0,13.0,16.0,14.0,14.0,15.0,9.0,5.0,14.0,16.0,14.0,11.0,13.0,14.0,14.0,10.0,19.0,0.0,0.0,7.0,2.0,188.0,85.0,1.0,3.0,2.0,1.0,2.0,3.0,3.0,2.0,2.0,3.0,1.0,10.0,6.0,9.0,8.0,10.0,12.0,15.0,8.0,7.0,14.0,11.0,10.0,13.0,10.0,14.0,11.0,13.0,9.0,11.0,10.0,10.0,9.0,1.0,8.0,12.0,13.0,13.0,14.0,13.0,10.0,13.0,15.0,9.0,12.0,13.0,20.0,14.0,14.0,9.0,11.0,4.0,9.0,11.0,14.0,13.0,12.0,12.0,12.0,1.0,13.0,2.0,24.0,0.0,0.0,0.0,0.0,177.0,65.0,1.0,2.0,1.0,2.0,1.0,2.0,1.0,1.0,1.0,2.0,3.0,8.0,11.0,13.0,10.0,13.0,8.0,10.0,11.0,7.0,5.0,12.0,13.0,6.0,13.0,8.0,11.0,9.0,10.0,9.0,9.0,11.0,13.0,12.0,5.0,12.0,8.0,7.0,9.0,16.0,15.0,12.0,8.0,10.0,15.0,15.0,20.0,14.0,12.0,11.0,8.0,13.0,7.0,12.0,20.0,14.0,13.0,12.0,9.0,12.0,11.0,10.0,22.0,0.0,0.0,3.0,0.0,176.0,70.0,1.0,1.0,1.0,3.0,2.0,1.0,2.0,3.0,1.0,3.0,3.0,10.0,15.0,14.0,6.0,13.0,10.0,13.0,10.0,9.0,9.0,13.0,8.0,11.0,14.0,10.0,11.0,12.0,10.0,13.0,11.0,13.0,14.0,13.0,7.0,13.0,9.0,11.0,13.0,17.0,13.0,12.0,10.0,20.0,14.0,16.0,5.0,15.0,11.0,13.0,10.0,14.0,8.0,10.0,11.0,13.0,16.0,11.0,15.0,14.0,13.0,7.0,28.0,41.0,2.0,0.0,0.0,187.0,80.0,3.0,2.0,3.0,2.0,1.0,1.0,2.0,3.0,1.0,4.0,2.0,7.0,10.0,11.0,7.0,12.0,7.0,10.0,12.0,13.0,15.0,13.0,8.0,18.0,12.0,18.0,13.0,17.0,12.0,14.0,10.0,12.0,17.0,7.0,13.0,9.0,14.0,17.0,18.0,14.0,13.0,16.0,14.0,20.0,18.0,13.0,12.0,18.0,14.0,15.0,16.0,15.0,6.0,15.0,14.0,13.0,10.0,14.0,12.0,8.0,7.0,8.0,30.0,46.0,0.0,0.0,0.0,184.0,74.0,2.0,3.0,1.0,1.0,2.0,2.0,1.0,2.0,3.0,2.0,2.0,5.0,7.0,9.0,6.0,11.0,6.0,14.0,8.0,12.0,14.0,11.0,7.0,14.0,10.0,12.0,14.0,16.0,14.0,14.0,11.0,13.0,13.0,7.0,7.0,11.0,14.0,15.0,16.0,11.0,12.0,14.0,12.0,10.0,17.0,13.0,20.0,14.0,11.0,16.0,9.0,14.0,12.0,11.0,15.0,12.0,14.0,11.0,16.0,14.0,16.0,7.0,18.0,0.0,0.0,0.0,0.0,167.0,60.0,2.0,1.0,2.0,2.0,2.0,1.0,2.0,1.0,1.0,1.0,1.0,10.0,11.0,12.0,8.0,13.0,10.0,3.0,10.0,5.0,6.0,13.0,12.0,8.0,15.0,8.0,11.0,8.0,12.0,11.0,13.0,12.0,13.0,12.0,6.0,11.0,11.0,12.0,13.0,15.0,14.0,8.0,5.0,8.0,15.0,12.0,20.0,12.0,7.0,8.0,8.0,14.0,7.0,8.0,18.0,11.0,12.0,11.0,12.0,15.0,15.0,7.0,26.0,0.0,0.0,4.0,0.0,180.0,73.0,2.0,3.0,1.0,4.0,2.0,3.0,3.0,1.0,1.0,4.0,1.0,11.0,13.0,13.0,14.0,14.0,11.0,15.0,12.0,3.0,7.0,14.0,14.0,8.0,13.0,12.0,14.0,17.0,13.0,15.0,14.0,14.0,16.0,12.0,15.0,16.0,12.0,18.0,16.0,13.0,14.0,13.0,12.0,8.0,14.0,13.0,20.0,15.0,12.0,15.0,8.0,14.0,7.0,15.0,19.0,14.0,17.0,14.0,18.0,16.0,16.0,5.0
0,1,31.0,22.0,0.0,17.0,0.0,185.0,82.0,12.0,12.0,13.0,6.0,14.0,11.0,15.0,18.0,14.0,10.0,13.0,7.0,3.0,8.0,5.0,9.0,10.0,8.0,12.0,2.0,2.0,9.0,6.0,3.0,10.0,6.0,12.0,15.0,16.0,12.0,8.0,12.0,14.0,8.0,15.0,3.0,13.0,13.0,8.0,13.0,17.0,14.0,13.0,7.0,12.0,11.0,20.0,15.0,14.0,13.0,6.0,16.0,3.0,1.0,8.0,16.0,12.0,13.0,16.0,16.0,16.0,7.0,21.0,1.0,0.0,10.0,1.0,186.0,79.0,3.0,2.0,1.0,3.0,4.0,1.0,1.0,2.0,3.0,1.0,2.0,5.0,8.0,11.0,7.0,13.0,5.0,15.0,6.0,7.0,14.0,13.0,8.0,14.0,12.0,15.0,13.0,14.0,11.0,13.0,8.0,12.0,11.0,9.0,7.0,13.0,10.0,11.0,11.0,12.0,13.0,13.0,14.0,20.0,15.0,13.0,8.0,14.0,16.0,13.0,4.0,1.0,4.0,7.0,16.0,12.0,12.0,12.0,9.0,13.0,13.0,1.0,21.0,0.0,0.0,0.0,0.0,186.0,82.0,1.0,3.0,3.0,1.0,1.0,4.0,1.0,2.0,2.0,1.0,2.0,5.0,6.0,9.0,6.0,11.0,6.0,12.0,6.0,5.0,14.0,11.0,7.0,14.0,12.0,15.0,13.0,13.0,11.0,13.0,8.0,12.0,14.0,8.0,13.0,7.0,11.0,13.0,13.0,14.0,13.0,13.0,12.0,6.0,13.0,14.0,20.0,13.0,15.0,13.0,11.0,12.0,8.0,9.0,13.0,14.0,10.0,13.0,12.0,8.0,7.0,1.0,25.0,7.0,0.0,1.0,0.0,175.0,71.0,3.0,3.0,1.0,4.0,2.0,3.0,2.0,4.0,1.0,2.0,1.0,7.0,11.0,11.0,7.0,11.0,7.0,10.0,9.0,5.0,12.0,9.0,11.0,13.0,12.0,14.0,12.0,16.0,12.0,13.0,9.0,11.0,15.0,9.0,7.0,11.0,12.0,14.0,16.0,15.0,13.0,14.0,10.0,8.0,17.0,15.0,20.0,16.0,13.0,13.0,14.0,14.0,11.0,10.0,17.0,12.0,14.0,13.0,14.0,13.0,13.0,6.0,21.0,0.0,0.0,9.0,0.0,185.0,75.0,1.0,1.0,2.0,2.0,2.0,1.0,1.0,4.0,2.0,3.0,2.0,11.0,15.0,14.0,7.0,13.0,9.0,11.0,11.0,14.0,13.0,13.0,10.0,14.0,13.0,15.0,12.0,13.0,10.0,11.0,11.0,12.0,14.0,11.0,10.0,14.0,12.0,13.0,15.0,15.0,13.0,14.0,13.0,20.0,14.0,16.0,8.0,15.0,15.0,13.0,13.0,12.0,9.0,10.0,14.0,14.0,13.0,12.0,12.0,13.0,9.0,9.0,22.0,5.0,1.0,0.0,0.0,183.0,83.0,2.0,3.0,1.0,2.0,2.0,3.0,3.0,1.0,2.0,3.0,2.0,7.0,11.0,15.0,12.0,14.0,8.0,12.0,12.0,6.0,13.0,14.0,9.0,15.0,14.0,10.0,14.0,13.0,12.0,10.0,13.0,12.0,14.0,13.0,10.0,13.0,12.0,13.0,16.0,15.0,15.0,15.0,12.0,10.0,14.0,15.0,20.0,15.0,14.0,13.0,10.0,14.0,6.0,14.0,14.0,15.0,12.0,14.0,13.0,15.0,12.0,7.0,32.0,55.0,0.0,0.0,0.0,180.0,74.0,1.0,3.0,3.0,2.0,1.0,2.0,2.0,1.0,3.0,3.0,1.0,6.0,8.0,8.0,6.0,11.0,10.0,12.0,10.0,6.0,13.0,11.0,7.0,15.0,11.0,14.0,14.0,17.0,12.0,14.0,10.0,13.0,16.0,8.0,12.0,8.0,14.0,16.0,18.0,12.0,13.0,13.0,10.0,8.0,16.0,14.0,20.0,18.0,13.0,16.0,15.0,14.0,5.0,10.0,9.0,15.0,13.0,15.0,14.0,11.0,10.0,7.0,23.0,0.0,0.0,10.0,7.0,179.0,70.0,1.0,1.0,2.0,2.0,1.0,3.0,3.0,2.0,1.0,4.0,3.0,10.0,13.0,14.0,12.0,15.0,11.0,10.0,13.0,6.0,3.0,13.0,12.0,4.0,16.0,11.0,12.0,11.0,13.0,11.0,13.0,12.0,12.0,16.0,6.0,14.0,6.0,10.0,12.0,16.0,14.0,12.0,9.0,20.0,13.0,14.0,10.0,13.0,10.0,12.0,7.0,12.0,6.0,8.0,12.0,13.0,5.0,10.0,8.0,14.0,12.0,8.0,27.0,0.0,0.0,0.0,0.0,173.0,70.0,2.0,1.0,2.0,2.0,3.0,2.0,2.0,1.0,1.0,2.0,4.0,9.0,12.0,14.0,11.0,14.0,12.0,8.0,13.0,7.0,3.0,13.0,11.0,4.0,14.0,13.0,13.0,12.0,12.0,10.0,13.0,11.0,13.0,14.0,6.0,12.0,7.0,8.0,11.0,15.0,16.0,12.0,8.0,20.0,14.0,14.0,10.0,13.0,11.0,11.0,11.0,12.0,12.0,10.0,10.0,15.0,10.0,12.0,13.0,12.0,9.0,12.0,27.0,25.0,4.0,11.0,3.0,179.0,73.0,1.0,3.0,2.0,2.0,3.0,3.0,1.0,2.0,1.0,1.0,2.0,14.0,13.0,14.0,12.0,13.0,16.0,8.0,13.0,7.0,5.0,14.0,9.0,6.0,14.0,8.0,13.0,11.0,15.0,12.0,16.0,11.0,14.0,15.0,11.0,14.0,7.0,13.0,12.0,12.0,14.0,13.0,8.0,10.0,12.0,14.0,20.0,13.0,11.0,14.0,8.0,13.0,13.0,14.0,15.0,15.0,13.0,8.0,14.0,14.0,14.0,7.0,22.0,7.0,3.0,13.0,7.0,185.0,85.0,1.0,3.0,3.0,1.0,2.0,3.0,3.0,3.0,2.0,3.0,1.0,11.0,11.0,14.0,14.0,15.0,12.0,11.0,13.0,5.0,4.0,12.0,12.0,3.0,14.0,12.0,12.0,14.0,14.0,12.0,11.0,12.0,12.0,14.0,4.0,15.0,8.0,12.0,11.0,15.0,15.0,14.0,13.0,9.0,12.0,16.0,20.0,13.0,15.0,14.0,11.0,15.0,8.0,10.0,11.0,15.0,14.0,12.0,5.0,8.0,9.0,11.0,36.0,0.0,0.0,0.0,0.0,185.0,78.0,11.0,14.0,12.0,7.0,13.0,12.0,14.0,15.0,13.0,14.0,10.0,4.0,1.0,3.0,1.0,8.0,8.0,11.0,8.0,3.0,3.0,7.0,2.0,1.0,8.0,11.0,13.0,15.0,11.0,12.0,7.0,13.0,9.0,5.0,14.0,3.0,13.0,15.0,8.0,11.0,14.0,13.0,12.0,5.0,15.0,11.0,20.0,12.0,14.0,13.0,11.0,13.0,8.0,1.0,19.0,14.0,16.0,10.0,17.0,9.0,9.0,11.0,34.0,23.0,1.0,0.0,0.0,186.0,81.0,3.0,3.0,1.0,2.0,1.0,3.0,2.0,3.0,1.0,3.0,3.0,4.0,8.0,6.0,10.0,7.0,8.0,17.0,12.0,10.0,14.0,7.0,9.0,15.0,7.0,15.0,13.0,17.0,8.0,12.0,7.0,12.0,15.0,6.0,17.0,7.0,14.0,15.0,14.0,8.0,10.0,16.0,13.0,12.0,13.0,9.0,20.0,13.0,15.0,11.0,15.0,14.0,9.0,10.0,10.0,14.0,11.0,13.0,15.0,11.0,11.0,12.0,28.0,0.0,0.0,0.0,0.0,183.0,81.0,1.0,2.0,4.0,1.0,1.0,3.0,2.0,3.0,3.0,3.0,1.0,5.0,5.0,6.0,10.0,12.0,6.0,14.0,8.0,6.0,15.0,11.0,6.0,13.0,12.0,13.0,14.0,16.0,14.0,14.0,10.0,12.0,14.0,5.0,14.0,8.0,14.0,15.0,15.0,9.0,12.0,15.0,13.0,7.0,11.0,12.0,20.0,15.0,15.0,14.0,14.0,14.0,9.0,8.0,14.0,14.0,11.0,13.0,15.0,13.0,15.0,6.0,27.0,10.0,0.0,0.0,0.0,181.0,69.0,1.0,1.0,3.0,3.0,3.0,3.0,2.0,3.0,3.0,3.0,1.0,5.0,13.0,10.0,7.0,13.0,9.0,10.0,10.0,12.0,12.0,11.0,7.0,12.0,11.0,11.0,13.0,12.0,11.0,13.0,9.0,9.0,12.0,8.0,7.0,12.0,11.0,11.0,13.0,15.0,13.0,13.0,10.0,20.0,12.0,15.0,8.0,15.0,12.0,13.0,11.0,14.0,13.0,12.0,10.0,14.0,12.0,10.0,11.0,15.0,15.0,7.0,24.0,0.0,0.0,0.0,0.0,179.0,68.0,3.0,2.0,3.0,2.0,1.0,3.0,3.0,1.0,3.0,3.0,1.0,4.0,13.0,9.0,6.0,12.0,9.0,12.0,7.0,8.0,12.0,14.0,8.0,14.0,12.0,15.0,14.0,13.0,14.0,13.0,10.0,12.0,14.0,10.0,9.0,9.0,10.0,13.0,14.0,14.0,12.0,13.0,9.0,9.0,8.0,14.0,20.0,15.0,14.0,11.0,11.0,13.0,10.0,14.0,13.0,14.0,14.0,11.0,16.0,15.0,15.0,6.0,27.0,14.0,1.0,0.0,0.0,183.0,77.0,1.0,2.0,1.0,2.0,3.0,2.0,3.0,2.0,2.0,1.0,1.0,5.0,12.0,9.0,8.0,13.0,10.0,13.0,10.0,6.0,14.0,13.0,6.0,13.0,12.0,14.0,13.0,15.0,11.0,11.0,11.0,11.0,13.0,9.0,8.0,9.0,12.0,14.0,16.0,14.0,12.0,14.0,12.0,7.0,14.0,12.0,20.0,15.0,14.0,14.0,14.0,15.0,7.0,10.0,12.0,13.0,14.0,12.0,13.0,11.0,11.0,7.0,30.0,0.0,0.0,0.0,0.0,167.0,60.0,3.0,1.0,1.0,2.0,3.0,1.0,1.0,3.0,1.0,1.0,3.0,10.0,11.0,12.0,8.0,13.0,10.0,6.0,9.0,10.0,12.0,14.0,9.0,10.0,14.0,11.0,14.0,14.0,14.0,14.0,13.0,14.0,12.0,14.0,11.0,13.0,12.0,15.0,15.0,15.0,14.0,11.0,5.0,11.0,11.0,15.0,20.0,11.0,8.0,14.0,10.0,12.0,13.0,11.0,11.0,12.0,11.0,10.0,12.0,11.0,11.0,2.0,33.0,0.0,0.0,0.0,0.0,187.0,76.0,2.0,2.0,3.0,1.0,1.0,3.0,2.0,1.0,2.0,3.0,2.0,15.0,14.0,14.0,10.0,15.0,13.0,10.0,12.0,7.0,4.0,15.0,13.0,7.0,15.0,6.0,12.0,9.0,14.0,11.0,15.0,12.0,12.0,14.0,12.0,13.0,7.0,13.0,12.0,11.0,12.0,14.0,12.0,14.0,15.0,12.0,20.0,11.0,12.0,12.0,6.0,14.0,6.0,11.0,14.0,13.0,12.0,12.0,15.0,15.0,13.0,9.0,22.0,0.0,0.0,3.0,0.0,172.0,73.0,2.0,3.0,1.0,1.0,3.0,3.0,2.0,1.0,2.0,3.0,2.0,6.0,13.0,13.0,11.0,13.0,7.0,10.0,11.0,5.0,5.0,10.0,11.0,3.0,13.0,8.0,12.0,9.0,10.0,8.0,12.0,12.0,13.0,13.0,5.0,11.0,7.0,8.0,8.0,15.0,16.0,15.0,7.0,8.0,14.0,16.0,20.0,12.0,11.0,11.0,8.0,13.0,8.0,7.0,13.0,14.0,13.0,12.0,10.0,15.0,15.0,9.0,30.0,0.0,0.0,0.0,0.0,178.0,73.0,3.0,4.0,1.0,1.0,2.0,4.0,3.0,2.0,2.0,2.0,3.0,13.0,14.0,12.0,7.0,13.0,12.0,7.0,13.0,5.0,10.0,13.0,9.0,10.0,13.0,11.0,11.0,12.0,12.0,13.0,11.0,14.0,14.0,11.0,7.0,11.0,10.0,13.0,15.0,13.0,15.0,15.0,8.0,20.0,14.0,14.0,8.0,14.0,11.0,13.0,11.0,14.0,8.0,10.0,19.0,12.0,12.0,9.0,12.0,12.0,10.0,10.0,24.0,0.0,0.0,0.0,0.0,182.0,82.0,3.0,3.0,2.0,1.0,1.0,3.0,2.0,2.0,3.0,2.0,2.0,4.0,7.0,13.0,14.0,13.0,12.0,14.0,12.0,5.0,7.0,10.0,14.0,6.0,15.0,13.0,13.0,16.0,8.0,12.0,11.0,11.0,12.0,14.0,7.0,13.0,8.0,12.0,13.0,14.0,14.0,15.0,12.0,10.0,10.0,12.0,20.0,16.0,15.0,12.0,13.0,14.0,10.0,8.0,8.0,13.0,5.0,10.0,11.0,9.0,9.0,13.0
0,0,25.0,4.0,0.0,11.0,0.0,184.0,81.0,14.0,14.0,13.0,9.0,15.0,12.0,16.0,16.0,13.0,7.0,11.0,8.0,1.0,2.0,1.0,11.0,12.0,6.0,1.0,3.0,3.0,11.0,5.0,3.0,11.0,8.0,15.0,15.0,13.0,14.0,10.0,11.0,14.0,8.0,13.0,5.0,13.0,10.0,10.0,14.0,16.0,14.0,13.0,20.0,14.0,12.0,5.0,14.0,14.0,15.0,9.0,16.0,6.0,1.0,17.0,11.0,15.0,13.0,14.0,12.0,12.0,4.0,32.0,19.0,0.0,9.0,0.0,185.0,85.0,2.0,3.0,2.0,1.0,2.0,1.0,1.0,2.0,2.0,3.0,3.0,5.0,10.0,9.0,8.0,11.0,11.0,15.0,13.0,9.0,15.0,12.0,10.0,14.0,11.0,14.0,15.0,16.0,12.0,11.0,9.0,11.0,17.0,7.0,12.0,9.0,15.0,13.0,10.0,9.0,9.0,15.0,13.0,10.0,13.0,11.0,20.0,13.0,15.0,12.0,15.0,12.0,13.0,10.0,11.0,13.0,11.0,13.0,18.0,15.0,13.0,5.0,22.0,3.0,0.0,7.0,1.0,182.0,75.0,3.0,3.0,1.0,3.0,2.0,3.0,1.0,1.0,2.0,2.0,1.0,4.0,11.0,10.0,6.0,14.0,7.0,13.0,10.0,9.0,16.0,14.0,8.0,15.0,14.0,13.0,17.0,15.0,16.0,14.0,11.0,14.0,15.0,8.0,11.0,10.0,15.0,16.0,14.0,14.0,14.0,14.0,11.0,20.0,15.0,14.0,10.0,15.0,15.0,15.0,12.0,15.0,8.0,11.0,12.0,14.0,16.0,15.0,14.0,14.0,14.0,5.0,37.0,0.0,0.0,0.0,0.0,185.0,83.0,1.0,1.0,2.0,1.0,3.0,2.0,3.0,1.0,1.0,3.0,1.0,6.0,8.0,9.0,12.0,10.0,8.0,13.0,9.0,4.0,5.0,10.0,14.0,4.0,11.0,11.0,10.0,11.0,13.0,12.0,12.0,13.0,15.0,14.0,12.0,11.0,7.0,12.0,8.0,7.0,7.0,12.0,12.0,11.0,11.0,7.0,20.0,8.0,14.0,12.0,8.0,13.0,9.0,12.0,12.0,12.0,19.0,14.0,15.0,14.0,8.0,8.0,32.0,52.0,1.0,0.0,0.0,180.0,80.0,2.0,3.0,2.0,2.0,1.0,4.0,1.0,2.0,3.0,4.0,3.0,7.0,12.0,12.0,6.0,12.0,7.0,12.0,11.0,13.0,13.0,11.0,9.0,13.0,12.0,13.0,13.0,15.0,12.0,10.0,11.0,12.0,16.0,12.0,10.0,13.0,11.0,13.0,14.0,15.0,13.0,14.0,10.0,20.0,12.0,14.0,5.0,15.0,14.0,10.0,13.0,12.0,7.0,8.0,12.0,15.0,13.0,12.0,13.0,14.0,14.0,9.0,24.0,0.0,0.0,6.0,1.0,172.0,70.0,3.0,1.0,1.0,3.0,1.0,2.0,3.0,1.0,1.0,3.0,3.0,11.0,12.0,11.0,8.0,12.0,10.0,6.0,14.0,7.0,11.0,15.0,8.0,12.0,13.0,14.0,14.0,18.0,13.0,12.0,13.0,13.0,15.0,12.0,12.0,12.0,11.0,18.0,18.0,13.0,14.0,13.0,7.0,10.0,16.0,12.0,20.0,14.0,12.0,14.0,14.0,15.0,4.0,8.0,7.0,14.0,14.0,13.0,14.0,12.0,10.0,6.0,21.0,0.0,0.0,15.0,3.0,181.0,78.0,3.0,3.0,4.0,2.0,1.0,2.0,2.0,4.0,2.0,1.0,1.0,5.0,7.0,11.0,10.0,14.0,5.0,14.0,10.0,6.0,13.0,14.0,8.0,14.0,14.0,12.0,14.0,12.0,11.0,10.0,12.0,11.0,16.0,11.0,12.0,14.0,14.0,14.0,14.0,14.0,13.0,14.0,13.0,10.0,16.0,14.0,20.0,16.0,14.0,12.0,10.0,11.0,5.0,19.0,8.0,11.0,14.0,11.0,16.0,13.0,13.0,10.0,36.0,0.0,0.0,7.0,2.0,171.0,74.0,1.0,1.0,2.0,3.0,2.0,3.0,2.0,4.0,1.0,1.0,2.0,12.0,12.0,10.0,5.0,15.0,12.0,4.0,10.0,4.0,8.0,16.0,11.0,12.0,14.0,10.0,15.0,13.0,13.0,14.0,16.0,12.0,11.0,11.0,12.0,10.0,13.0,17.0,13.0,9.0,9.0,9.0,6.0,14.0,13.0,9.0,20.0,9.0,9.0,13.0,10.0,13.0,14.0,12.0,14.0,13.0,14.0,12.0,15.0,16.0,16.0,6.0,28.0,2.0,1.0,0.0,0.0,174.0,66.0,2.0,2.0,2.0,1.0,1.0,3.0,2.0,3.0,3.0,1.0,4.0,6.0,11.0,13.0,15.0,13.0,11.0,14.0,11.0,6.0,5.0,10.0,12.0,5.0,13.0,8.0,14.0,10.0,13.0,14.0,8.0,12.0,12.0,12.0,5.0,14.0,8.0,12.0,11.0,17.0,15.0,11.0,12.0,7.0,14.0,15.0,20.0,13.0,10.0,12.0,8.0,14.0,8.0,8.0,19.0,15.0,12.0,10.0,11.0,13.0,13.0,12.0,25.0,10.0,1.0,11.0,4.0,175.0,73.0,1.0,3.0,3.0,3.0,3.0,3.0,3.0,1.0,2.0,3.0,1.0,5.0,10.0,15.0,17.0,15.0,10.0,11.0,12.0,5.0,5.0,14.0,15.0,5.0,16.0,8.0,15.0,12.0,15.0,14.0,13.0,15.0,15.0,15.0,14.0,14.0,10.0,10.0,12.0,16.0,16.0,15.0,9.0,10.0,15.0,16.0,20.0,13.0,15.0,14.0,8.0,14.0,7.0,10.0,8.0,16.0,17.0,13.0,15.0,15.0,14.0,5.0,22.0,5.0,1.0,1.0,0.0,173.0,72.0,1.0,3.0,1.0,3.0,3.0,3.0,3.0,3.0,3.0,2.0,2.0,14.0,13.0,16.0,14.0,16.0,14.0,5.0,11.0,5.0,5.0,15.0,11.0,5.0,16.0,8.0,13.0,9.0,14.0,13.0,15.0,13.0,15.0,16.0,5.0,13.0,5.0,9.0,10.0,15.0,16.0,14.0,5.0,20.0,14.0,15.0,5.0,12.0,14.0,13.0,11.0,13.0,8.0,14.0,10.0,15.0,14.0,10.0,13.0,10.0,10.0,13.0,25.0,0.0,0.0,0.0,0.0,187.0,83.0,11.0,14.0,12.0,8.0,13.0,11.0,14.0,15.0,13.0,13.0,9.0,8.0,1.0,1.0,1.0,11.0,11.0,1.0,2.0,2.0,1.0,10.0,3.0,2.0,11.0,8.0,12.0,14.0,12.0,12.0,10.0,12.0,14.0,6.0,14.0,2.0,12.0,12.0,8.0,13.0,15.0,14.0,13.0,20.0,15.0,11.0,5.0,14.0,13.0,13.0,8.0,8.0,10.0,1.0,9.0,13.0,14.0,12.0,15.0,15.0,15.0,5.0,28.0,0.0,0.0,0.0,0.0,184.0,85.0,2.0,3.0,2.0,1.0,1.0,3.0,2.0,2.0,3.0,1.0,3.0,4.0,8.0,8.0,6.0,12.0,6.0,14.0,8.0,5.0,13.0,12.0,6.0,14.0,12.0,11.0,13.0,14.0,13.0,12.0,11.0,11.0,13.0,7.0,14.0,10.0,15.0,16.0,12.0,12.0,11.0,15.0,12.0,20.0,13.0,11.0,7.0,14.0,16.0,13.0,11.0,13.0,13.0,12.0,15.0,13.0,13.0,14.0,15.0,14.0,14.0,6.0,22.0,12.0,2.0,13.0,0.0,170.0,71.0,2.0,2.0,1.0,3.0,2.0,2.0,1.0,1.0,1.0,3.0,2.0,15.0,15.0,12.0,10.0,14.0,15.0,8.0,13.0,12.0,9.0,13.0,10.0,10.0,14.0,14.0,16.0,10.0,17.0,14.0,12.0,16.0,14.0,12.0,8.0,14.0,10.0,17.0,16.0,16.0,17.0,10.0,6.0,20.0,17.0,13.0,8.0,15.0,7.0,15.0,6.0,15.0,8.0,17.0,13.0,13.0,12.0,12.0,14.0,16.0,16.0,8.0,26.0,14.0,0.0,0.0,0.0,181.0,74.0,2.0,1.0,1.0,1.0,3.0,2.0,3.0,1.0,3.0,3.0,2.0,6.0,13.0,8.0,5.0,12.0,7.0,12.0,8.0,11.0,13.0,12.0,6.0,14.0,10.0,14.0,12.0,14.0,10.0,12.0,8.0,8.0,14.0,6.0,6.0,12.0,11.0,14.0,15.0,16.0,14.0,14.0,11.0,5.0,14.0,14.0,20.0,16.0,14.0,12.0,13.0,14.0,8.0,10.0,8.0,14.0,12.0,13.0,15.0,15.0,15.0,6.0,26.0,0.0,0.0,0.0,0.0,177.0,68.0,4.0,2.0,1.0,2.0,3.0,1.0,1.0,2.0,3.0,3.0,3.0,12.0,13.0,11.0,8.0,13.0,11.0,8.0,10.0,8.0,10.0,13.0,10.0,12.0,13.0,7.0,12.0,10.0,13.0,11.0,15.0,13.0,14.0,11.0,7.0,14.0,10.0,14.0,14.0,13.0,15.0,12.0,9.0,20.0,15.0,14.0,5.0,15.0,8.0,13.0,7.0,14.0,6.0,12.0,11.0,12.0,14.0,13.0,16.0,16.0,16.0,5.0,29.0,0.0,0.0,0.0,0.0,188.0,74.0,1.0,2.0,3.0,3.0,2.0,3.0,1.0,3.0,2.0,1.0,1.0,4.0,8.0,10.0,6.0,13.0,7.0,14.0,9.0,6.0,13.0,12.0,8.0,13.0,13.0,12.0,14.0,13.0,14.0,11.0,13.0,12.0,14.0,6.0,13.0,8.0,14.0,15.0,15.0,9.0,12.0,14.0,14.0,10.0,13.0,10.0,20.0,16.0,12.0,13.0,12.0,15.0,9.0,11.0,11.0,14.0,14.0,12.0,15.0,13.0,13.0,6.0,30.0,7.0,0.0,0.0,0.0,181.0,72.0,1.0,3.0,3.0,1.0,2.0,3.0,2.0,1.0,3.0,2.0,2.0,12.0,11.0,14.0,8.0,14.0,12.0,8.0,12.0,6.0,5.0,13.0,13.0,5.0,14.0,8.0,12.0,10.0,11.0,12.0,15.0,11.0,13.0,14.0,9.0,13.0,10.0,12.0,13.0,12.0,14.0,12.0,10.0,12.0,15.0,13.0,20.0,15.0,9.0,10.0,8.0,13.0,5.0,8.0,12.0,14.0,14.0,12.0,11.0,14.0,14.0,8.0,32.0,25.0,0.0,0.0,0.0,181.0,82.0,2.0,3.0,3.0,1.0,1.0,1.0,1.0,3.0,1.0,2.0,3.0,5.0,10.0,6.0,7.0,10.0,7.0,14.0,9.0,8.0,11.0,12.0,7.0,13.0,10.0,15.0,14.0,16.0,11.0,13.0,10.0,12.0,16.0,9.0,15.0,8.0,11.0,16.0,18.0,11.0,12.0,14.0,11.0,8.0,13.0,11.0,20.0,17.0,15.0,13.0,15.0,11.0,6.0,14.0,18.0,12.0,13.0,13.0,14.0,11.0,11.0,8.0,24.0,0.0,0.0,5.0,0.0,183.0,79.0,4.0,4.0,3.0,3.0,1.0,3.0,2.0,1.0,3.0,2.0,3.0,4.0,7.0,12.0,13.0,12.0,8.0,13.0,12.0,5.0,6.0,11.0,12.0,4.0,13.0,11.0,12.0,14.0,9.0,12.0,10.0,10.0,13.0,12.0,6.0,14.0,12.0,13.0,14.0,15.0,14.0,14.0,11.0,10.0,13.0,14.0,20.0,14.0,14.0,12.0,12.0,14.0,9.0,5.0,7.0,13.0,15.0,11.0,14.0,14.0,14.0,6.0,27.0,33.0,4.0,3.0,0.0,180.0,75.0,2.0,1.0,2.0,1.0,4.0,2.0,1.0,3.0,1.0,1.0,2.0,12.0,11.0,13.0,13.0,11.0,11.0,11.0,10.0,7.0,5.0,10.0,14.0,5.0,14.0,9.0,11.0,12.0,10.0,11.0,12.0,12.0,14.0,13.0,8.0,14.0,8.0,11.0,14.0,16.0,14.0,13.0,10.0,7.0,12.0,15.0,20.0,14.0,12.0,12.0,9.0,13.0,10.0,10.0,9.0,15.0,8.0,9.0,13.0,14.0,14.0,7.0,21.0,0.0,0.0,0.0,0.0,180.0,71.0,1.0,2.0,1.0,3.0,3.0,3.0,2.0,2.0,2.0,2.0,3.0,10.0,10.0,11.0,10.0,12.0,10.0,8.0,10.0,8.0,8.0,12.0,5.0,6.0,12.0,4.0,11.0,8.0,10.0,9.0,11.0,10.0,10.0,13.0,8.0,12.0,7.0,11.0,12.0,13.0,12.0,10.0,10.0,5.0,12.0,12.0,20.0,11.0,10.0,10.0,10.0,5.0,10.0,12.0,7.0,10.0,14.0,12.0,9.0,10.0,16.0,7.0
0,0,31.0,25.0,0.0,6.0,0.0,191.0,84.0,11.0,14.0,13.0,12.0,15.0,14.0,15.0,16.0,13.0,14.0,14.0,8.0,2.0,10.0,5.0,11.0,11.0,7.0,10.0,2.0,5.0,10.0,11.0,11.0,9.0,12.0,13.0,15.0,13.0,13.0,8.0,13.0,16.0,12.0,14.0,1.0,16.0,13.0,11.0,12.0,13.0,16.0,16.0,8.0,16.0,13.0,20.0,15.0,15.0,17.0,8.0,15.0,7.0,2.0,15.0,15.0,17.0,15.0,17.0,16.0,15.0,6.0,38.0,89.0,6.0,14.0,1.0,183.0,79.0,3.0,3.0,2.0,3.0,2.0,3.0,2.0,4.0,3.0,2.0,3.0,4.0,8.0,8.0,7.0,12.0,6.0,14.0,8.0,11.0,17.0,12.0,11.0,16.0,12.0,15.0,16.0,17.0,15.0,17.0,10.0,16.0,18.0,6.0,15.0,8.0,16.0,17.0,13.0,8.0,8.0,12.0,11.0,10.0,13.0,8.0,20.0,10.0,11.0,16.0,12.0,16.0,11.0,7.0,15.0,16.0,16.0,15.0,18.0,16.0,14.0,4.0,32.0,0.0,0.0,3.0,0.0,187.0,82.0,1.0,2.0,2.0,3.0,2.0,1.0,1.0,2.0,2.0,3.0,1.0,5.0,11.0,8.0,7.0,10.0,6.0,15.0,9.0,13.0,15.0,10.0,8.0,16.0,9.0,16.0,14.0,17.0,12.0,15.0,8.0,12.0,17.0,9.0,14.0,11.0,13.0,15.0,13.0,12.0,11.0,16.0,14.0,6.0,13.0,14.0,20.0,13.0,16.0,15.0,14.0,14.0,8.0,14.0,14.0,14.0,15.0,16.0,15.0,12.0,10.0,7.0,23.0,2.0,0.0,5.0,3.0,182.0,73.0,3.0,1.0,1.0,1.0,2.0,1.0,2.0,1.0,3.0,4.0,2.0,12.0,14.0,14.0,10.0,13.0,12.0,16.0,11.0,13.0,12.0,13.0,13.0,14.0,14.0,12.0,11.0,14.0,13.0,11.0,13.0,11.0,15.0,15.0,9.0,15.0,10.0,14.0,15.0,16.0,15.0,13.0,13.0,20.0,14.0,15.0,6.0,15.0,12.0,13.0,9.0,13.0,14.0,15.0,17.0,15.0,13.0,12.0,12.0,15.0,13.0,9.0,31.0,0.0,0.0,6.0,0.0,174.0,80.0,1.0,1.0,1.0,1.0,1.0,5.0,1.0,1.0,1.0,1.0,1.0,14.0,12.0,11.0,7.0,12.0,13.0,9.0,7.0,10.0,11.0,11.0,10.0,10.0,12.0,11.0,11.0,11.0,10.0,6.0,10.0,9.0,12.0,12.0,12.0,10.0,12.0,12.0,14.0,12.0,15.0,10.0,9.0,20.0,12.0,12.0,7.0,12.0,9.0,9.0,10.0,12.0,7.0,9.0,11.0,14.0,9.0,7.0,14.0,8.0,9.0,9.0,32.0,36.0,0.0,12.0,2.0,183.0,77.0,1.0,3.0,2.0,1.0,3.0,1.0,1.0,2.0,1.0,1.0,3.0,6.0,11.0,8.0,6.0,13.0,11.0,13.0,10.0,6.0,15.0,14.0,10.0,17.0,12.0,15.0,16.0,18.0,14.0,17.0,12.0,15.0,17.0,11.0,17.0,7.0,17.0,20.0,16.0,9.0,11.0,15.0,11.0,8.0,15.0,10.0,20.0,14.0,14.0,17.0,10.0,16.0,10.0,13.0,15.0,15.0,15.0,14.0,18.0,15.0,13.0,6.0,29.0,90.0,4.0,16.0,2.0,170.0,61.0,2.0,3.0,3.0,1.0,3.0,1.0,2.0,2.0,2.0,2.0,1.0,15.0,14.0,15.0,9.0,17.0,16.0,7.0,12.0,4.0,11.0,18.0,15.0,12.0,17.0,15.0,15.0,16.0,13.0,16.0,17.0,14.0,16.0,15.0,14.0,12.0,14.0,18.0,16.0,13.0,14.0,12.0,8.0,10.0,14.0,11.0,20.0,14.0,10.0,14.0,9.0,17.0,10.0,14.0,13.0,17.0,15.0,16.0,17.0,15.0,16.0,7.0,21.0,7.0,0.0,14.0,6.0,173.0,64.0,3.0,2.0,3.0,2.0,3.0,3.0,3.0,2.0,3.0,3.0,3.0,14.0,14.0,18.0,14.0,17.0,14.0,7.0,11.0,2.0,6.0,15.0,14.0,6.0,18.0,12.0,14.0,14.0,15.0,13.0,16.0,14.0,17.0,17.0,12.0,13.0,9.0,13.0,17.0,15.0,17.0,13.0,7.0,20.0,14.0,14.0,9.0,14.0,9.0,15.0,7.0,16.0,7.0,14.0,15.0,17.0,15.0,16.0,17.0,16.0,15.0,4.0,30.0,18.0,2.0,0.0,0.0,184.0,79.0,2.0,2.0,2.0,1.0,2.0,2.0,3.0,1.0,3.0,1.0,1.0,13.0,16.0,15.0,10.0,13.0,12.0,9.0,11.0,11.0,10.0,14.0,12.0,8.0,14.0,14.0,10.0,15.0,10.0,12.0,12.0,11.0,15.0,12.0,14.0,14.0,11.0,13.0,14.0,15.0,14.0,15.0,11.0,7.0,15.0,15.0,20.0,15.0,14.0,13.0,13.0,13.0,11.0,14.0,12.0,14.0,14.0,10.0,13.0,14.0,11.0,9.0,25.0,0.0,0.0,0.0,0.0,191.0,87.0,2.0,1.0,2.0,2.0,3.0,1.0,1.0,3.0,2.0,3.0,1.0,5.0,8.0,10.0,14.0,13.0,8.0,17.0,12.0,4.0,6.0,13.0,14.0,6.0,13.0,12.0,13.0,16.0,13.0,14.0,11.0,13.0,15.0,9.0,12.0,15.0,9.0,15.0,14.0,11.0,12.0,15.0,17.0,10.0,14.0,13.0,20.0,14.0,15.0,12.0,6.0,13.0,7.0,6.0,11.0,13.0,14.0,12.0,16.0,15.0,14.0,7.0,22.0,2.0,0.0,14.0,7.0,175.0,73.0,2.0,3.0,1.0,1.0,1.0,3.0,1.0,3.0,2.0,3.0,3.0,12.0,14.0,15.0,12.0,14.0,11.0,10.0,13.0,3.0,3.0,12.0,14.0,4.0,15.0,13.0,11.0,14.0,11.0,10.0,12.0,9.0,16.0,16.0,8.0,15.0,7.0,11.0,11.0,15.0,14.0,11.0,8.0,9.0,10.0,16.0,20.0,13.0,12.0,11.0,10.0,13.0,11.0,8.0,11.0,14.0,12.0,11.0,14.0,14.0,13.0,8.0,33.0,101.0,0.0,0.0,0.0,182.0,87.0,12.0,11.0,15.0,12.0,14.0,13.0,14.0,15.0,15.0,13.0,12.0,9.0,2.0,3.0,8.0,9.0,11.0,10.0,11.0,1.0,3.0,12.0,15.0,8.0,10.0,8.0,14.0,14.0,14.0,12.0,9.0,12.0,16.0,9.0,15.0,2.0,13.0,12.0,6.0,12.0,13.0,14.0,13.0,8.0,13.0,10.0,20.0,12.0,15.0,13.0,8.0,15.0,5.0,1.0,13.0,15.0,13.0,15.0,18.0,18.0,15.0,5.0,20.0,0.0,0.0,7.0,0.0,186.0,76.0,3.0,1.0,2.0,4.0,3.0,1.0,1.0,2.0,3.0,3.0,1.0,5.0,9.0,12.0,6.0,12.0,5.0,11.0,9.0,10.0,13.0,14.0,10.0,12.0,14.0,14.0,16.0,14.0,16.0,11.0,12.0,13.0,13.0,9.0,10.0,8.0,13.0,15.0,10.0,10.0,11.0,13.0,13.0,10.0,14.0,12.0,20.0,12.0,11.0,13.0,8.0,11.0,6.0,15.0,7.0,14.0,13.0,10.0,14.0,15.0,17.0,6.0,32.0,0.0,0.0,0.0,0.0,195.0,89.0,3.0,2.0,3.0,1.0,4.0,2.0,4.0,2.0,3.0,1.0,2.0,3.0,5.0,5.0,11.0,8.0,8.0,14.0,9.0,11.0,15.0,12.0,9.0,13.0,8.0,16.0,13.0,19.0,10.0,14.0,8.0,13.0,16.0,5.0,15.0,10.0,15.0,15.0,14.0,8.0,8.0,16.0,17.0,5.0,11.0,10.0,20.0,13.0,17.0,13.0,12.0,15.0,7.0,5.0,12.0,14.0,14.0,12.0,15.0,8.0,8.0,7.0,25.0,0.0,0.0,26.0,3.0,176.0,64.0,3.0,2.0,2.0,1.0,3.0,3.0,3.0,2.0,1.0,1.0,1.0,12.0,13.0,12.0,7.0,13.0,13.0,11.0,11.0,11.0,14.0,13.0,11.0,14.0,13.0,13.0,13.0,14.0,13.0,13.0,11.0,13.0,17.0,12.0,11.0,10.0,12.0,14.0,14.0,14.0,14.0,12.0,8.0,8.0,17.0,14.0,20.0,15.0,12.0,14.0,12.0,13.0,5.0,12.0,17.0,15.0,15.0,14.0,16.0,15.0,15.0,7.0,23.0,0.0,0.0,1.0,0.0,182.0,71.0,3.0,1.0,2.0,3.0,4.0,2.0,3.0,1.0,2.0,1.0,3.0,9.0,13.0,14.0,8.0,14.0,13.0,12.0,10.0,13.0,14.0,14.0,13.0,15.0,13.0,14.0,14.0,13.0,11.0,12.0,12.0,13.0,16.0,12.0,12.0,15.0,13.0,14.0,15.0,15.0,13.0,14.0,12.0,9.0,16.0,15.0,20.0,15.0,15.0,15.0,10.0,14.0,6.0,12.0,8.0,15.0,14.0,16.0,15.0,15.0,16.0,6.0,32.0,13.0,0.0,19.0,1.0,172.0,72.0,3.0,1.0,3.0,2.0,1.0,2.0,2.0,2.0,3.0,1.0,1.0,7.0,12.0,12.0,5.0,13.0,7.0,6.0,9.0,9.0,12.0,14.0,9.0,14.0,12.0,13.0,14.0,14.0,15.0,15.0,10.0,13.0,17.0,7.0,18.0,8.0,15.0,18.0,15.0,12.0,14.0,12.0,6.0,10.0,16.0,13.0,20.0,15.0,12.0,15.0,9.0,15.0,5.0,10.0,12.0,16.0,14.0,13.0,15.0,18.0,18.0,5.0,33.0,14.0,0.0,0.0,0.0,172.0,68.0,3.0,3.0,1.0,1.0,1.0,1.0,1.0,3.0,1.0,2.0,1.0,14.0,11.0,13.0,8.0,14.0,13.0,7.0,13.0,4.0,10.0,13.0,10.0,12.0,14.0,11.0,13.0,14.0,13.0,13.0,12.0,14.0,15.0,10.0,13.0,12.0,13.0,16.0,17.0,13.0,13.0,12.0,7.0,10.0,14.0,12.0,20.0,14.0,9.0,14.0,11.0,15.0,10.0,12.0,20.0,13.0,13.0,15.0,14.0,13.0,12.0,8.0,36.0,0.0,0.0,3.0,0.0,168.0,72.0,3.0,2.0,1.0,3.0,1.0,3.0,3.0,1.0,3.0,3.0,1.0,11.0,8.0,12.0,5.0,13.0,11.0,8.0,13.0,6.0,12.0,13.0,8.0,14.0,13.0,17.0,14.0,17.0,14.0,15.0,13.0,14.0,17.0,12.0,16.0,10.0,15.0,16.0,14.0,10.0,13.0,14.0,4.0,8.0,16.0,8.0,20.0,12.0,13.0,17.0,14.0,14.0,7.0,10.0,19.0,15.0,14.0,16.0,15.0,9.0,9.0,7.0,28.0,0.0,0.0,0.0,0.0,168.0,65.0,3.0,4.0,1.0,1.0,2.0,3.0,1.0,2.0,2.0,1.0,2.0,14.0,14.0,15.0,8.0,14.0,14.0,9.0,8.0,7.0,8.0,13.0,10.0,7.0,14.0,12.0,12.0,12.0,13.0,13.0,13.0,12.0,15.0,13.0,6.0,11.0,7.0,14.0,14.0,16.0,14.0,10.0,6.0,20.0,13.0,15.0,5.0,13.0,9.0,12.0,12.0,14.0,9.0,6.0,18.0,14.0,14.0,14.0,14.0,13.0,13.0,6.0,22.0,2.0,0.0,0.0,0.0,169.0,59.0,3.0,1.0,3.0,1.0,1.0,1.0,1.0,1.0,3.0,3.0,2.0,13.0,13.0,15.0,13.0,15.0,13.0,7.0,13.0,8.0,6.0,13.0,13.0,5.0,16.0,10.0,10.0,8.0,13.0,11.0,14.0,12.0,12.0,14.0,10.0,12.0,6.0,10.0,8.0,16.0,15.0,17.0,6.0,12.0,12.0,15.0,20.0,13.0,9.0,12.0,8.0,12.0,8.0,12.0,13.0,13.0,13.0,14.0,12.0,10.0,13.0,9.0,21.0,0.0,0.0,0.0,0.0,189.0,77.0,2.0,1.0,1.0,1.0,3.0,3.0,3.0,3.0,3.0,3.0,1.0,5.0,11.0,12.0,10.0,13.0,6.0,13.0,11.0,6.0,5.0,12.0,11.0,5.0,12.0,8.0,12.0,13.0,11.0,10.0,10.0,10.0,13.0,10.0,6.0,13.0,8.0,13.0,14.0,12.0,12.0,15.0,14.0,7.0,14.0,13.0,20.0,13.0,14.0,12.0,8.0,10.0,8.0,8.0,8.0,14.0,13.0,11.0,14.0,15.0,16.0,6.0
1,0,36.0,0.0,0.0,0.0,0.0,185.0,78.0,11.0,14.0,12.0,7.0,13.0,12.0,14.0,15.0,13.0,14.0,10.0,4.0,1.0,3.0,1.0,8.0,8.0,11.0,8.0,3.0,3.0,7.0,2.0,1.0,8.0,11.0,13.0,15.0,11.0,12.0,7.0,13.0,9.0,5.0,14.0,3.0,13.0,15.0,8.0,11.0,14.0,13.0,12.0,5.0,15.0,11.0,20.0,12.0,14.0,13.0,11.0,13.0,8.0,1.0,19.0,14.0,16.0,10.0,17.0,9.0,9.0,11.0,34.0,23.0,1.0,0.0,0.0,186.0,81.0,3.0,3.0,1.0,2.0,1.0,3.0,2.0,3.0,1.0,3.0,3.0,4.0,8.0,6.0,10.0,7.0,8.0,17.0,12.0,10.0,14.0,7.0,9.0,15.0,7.0,15.0,13.0,17.0,8.0,12.0,7.0,12.0,15.0,6.0,17.0,7.0,14.0,15.0,14.0,8.0,10.0,16.0,13.0,12.0,13.0,9.0,20.0,13.0,15.0,11.0,15.0,14.0,9.0,10.0,10.0,14.0,11.0,13.0,15.0,11.0,11.0,12.0,28.0,0.0,0.0,0.0,0.0,183.0,81.0,1.0,2.0,4.0,1.0,1.0,3.0,2.0,3.0,3.0,3.0,1.0,5.0,5.0,6.0,10.0,12.0,6.0,14.0,8.0,6.0,15.0,11.0,6.0,13.0,12.0,13.0,14.0,16.0,14.0,14.0,10.0,12.0,14.0,5.0,14.0,8.0,14.0,15.0,15.0,9.0,12.0,15.0,13.0,7.0,11.0,12.0,20.0,15.0,15.0,14.0,14.0,14.0,9.0,8.0,14.0,14.0,11.0,13.0,15.0,13.0,15.0,6.0,27.0,10.0,0.0,0.0,0.0,181.0,69.0,1.0,1.0,3.0,3.0,3.0,3.0,2.0,3.0,3.0,3.0,1.0,5.0,13.0,10.0,7.0,13.0,9.0,10.0,10.0,12.0,12.0,11.0,7.0,12.0,11.0,11.0,13.0,12.0,11.0,13.0,9.0,9.0,12.0,8.0,7.0,12.0,11.0,11.0,13.0,15.0,13.0,13.0,10.0,20.0,12.0,15.0,8.0,15.0,12.0,13.0,11.0,14.0,13.0,12.0,10.0,14.0,12.0,10.0,11.0,15.0,15.0,7.0,24.0,0.0,0.0,0.0,0.0,179.0,68.0,3.0,2.0,3.0,2.0,1.0,3.0,3.0,1.0,3.0,3.0,1.0,4.0,13.0,9.0,6.0,12.0,9.0,12.0,7.0,8.0,12.0,14.0,8.0,14.0,12.0,15.0,14.0,13.0,14.0,13.0,10.0,12.0,14.0,10.0,9.0,9.0,10.0,13.0,14.0,14.0,12.0,13.0,9.0,9.0,8.0,14.0,20.0,15.0,14.0,11.0,11.0,13.0,10.0,14.0,13.0,14.0,14.0,11.0,16.0,15.0,15.0,6.0,27.0,14.0,1.0,0.0,0.0,183.0,77.0,1.0,2.0,1.0,2.0,3.0,2.0,3.0,2.0,2.0,1.0,1.0,5.0,12.0,9.0,8.0,13.0,10.0,13.0,10.0,6.0,14.0,13.0,6.0,13.0,12.0,14.0,13.0,15.0,11.0,11.0,11.0,11.0,13.0,9.0,8.0,9.0,12.0,14.0,16.0,14.0,12.0,14.0,12.0,7.0,14.0,12.0,20.0,15.0,14.0,14.0,14.0,15.0,7.0,10.0,12.0,13.0,14.0,12.0,13.0,11.0,11.0,7.0,30.0,0.0,0.0,0.0,0.0,167.0,60.0,3.0,1.0,1.0,2.0,3.0,1.0,1.0,3.0,1.0,1.0,3.0,10.0,11.0,12.0,8.0,13.0,10.0,6.0,9.0,10.0,12.0,14.0,9.0,10.0,14.0,11.0,14.0,14.0,14.0,14.0,13.0,14.0,12.0,14.0,11.0,13.0,12.0,15.0,15.0,15.0,14.0,11.0,5.0,11.0,11.0,15.0,20.0,11.0,8.0,14.0,10.0,12.0,13.0,11.0,11.0,12.0,11.0,10.0,12.0,11.0,11.0,2.0,33.0,0.0,0.0,0.0,0.0,187.0,76.0,2.0,2.0,3.0,1.0,1.0,3.0,2.0,1.0,2.0,3.0,2.0,15.0,14.0,14.0,10.0,15.0,13.0,10.0,12.0,7.0,4.0,15.0,13.0,7.0,15.0,6.0,12.0,9.0,14.0,11.0,15.0,12.0,12.0,14.0,12.0,13.0,7.0,13.0,12.0,11.0,12.0,14.0,12.0,14.0,15.0,12.0,20.0,11.0,12.0,12.0,6.0,14.0,6.0,11.0,14.0,13.0,12.0,12.0,15.0,15.0,13.0,9.0,22.0,0.0,0.0,3.0,0.0,172.0,73.0,2.0,3.0,1.0,1.0,3.0,3.0,2.0,1.0,2.0,3.0,2.0,6.0,13.0,13.0,11.0,13.0,7.0,10.0,11.0,5.0,5.0,10.0,11.0,3.0,13.0,8.0,12.0,9.0,10.0,8.0,12.0,12.0,13.0,13.0,5.0,11.0,7.0,8.0,8.0,15.0,16.0,15.0,7.0,8.0,14.0,16.0,20.0,12.0,11.0,11.0,8.0,13.0,8.0,7.0,13.0,14.0,13.0,12.0,10.0,15.0,15.0,9.0,30.0,0.0,0.0,0.0,0.0,178.0,73.0,3.0,4.0,1.0,1.0,2.0,4.0,3.0,2.0,2.0,2.0,3.0,13.0,14.0,12.0,7.0,13.0,12.0,7.0,13.0,5.0,10.0,13.0,9.0,10.0,13.0,11.0,11.0,12.0,12.0,13.0,11.0,14.0,14.0,11.0,7.0,11.0,10.0,13.0,15.0,13.0,15.0,15.0,8.0,20.0,14.0,14.0,8.0,14.0,11.0,13.0,11.0,14.0,8.0,10.0,19.0,12.0,12.0,9.0,12.0,12.0,10.0,10.0,24.0,0.0,0.0,0.0,0.0,182.0,82.0,3.0,3.0,2.0,1.0,1.0,3.0,2.0,2.0,3.0,2.0,2.0,4.0,7.0,13.0,14.0,13.0,12.0,14.0,12.0,5.0,7.0,10.0,14.0,6.0,15.0,13.0,13.0,16.0,8.0,12.0,11.0,11.0,12.0,14.0,7.0,13.0,8.0,12.0,13.0,14.0,14.0,15.0,12.0,10.0,10.0,12.0,20.0,16.0,15.0,12.0,13.0,14.0,10.0,8.0,8.0,13.0,5.0,10.0,11.0,9.0,9.0,13.0,28.0,0.0,0.0,6.0,0.0,186.0,82.0,12.0,12.0,12.0,13.0,11.0,13.0,13.0,13.0,14.0,16.0,15.0,8.0,1.0,3.0,1.0,11.0,11.0,1.0,2.0,1.0,1.0,10.0,3.0,2.0,10.0,7.0,13.0,12.0,9.0,8.0,8.0,10.0,12.0,3.0,10.0,2.0,11.0,11.0,13.0,13.0,15.0,15.0,11.0,9.0,17.0,14.0,20.0,14.0,11.0,10.0,7.0,13.0,11.0,11.0,8.0,5.0,7.0,12.0,13.0,14.0,14.0,5.0,23.0,5.0,0.0,13.0,0.0,186.0,82.0,3.0,3.0,1.0,4.0,3.0,1.0,2.0,1.0,2.0,1.0,2.0,4.0,8.0,8.0,5.0,11.0,6.0,13.0,8.0,6.0,14.0,10.0,7.0,13.0,11.0,14.0,13.0,14.0,11.0,11.0,9.0,11.0,14.0,8.0,11.0,9.0,15.0,12.0,12.0,14.0,12.0,14.0,13.0,8.0,15.0,14.0,20.0,14.0,14.0,15.0,14.0,13.0,6.0,10.0,15.0,13.0,12.0,12.0,14.0,11.0,13.0,9.0,26.0,5.0,0.0,0.0,0.0,184.0,86.0,3.0,3.0,2.0,1.0,2.0,2.0,4.0,1.0,3.0,1.0,3.0,4.0,10.0,9.0,6.0,10.0,7.0,14.0,8.0,8.0,14.0,9.0,6.0,14.0,9.0,14.0,14.0,16.0,9.0,15.0,7.0,11.0,13.0,8.0,10.0,9.0,13.0,12.0,12.0,12.0,12.0,17.0,12.0,5.0,15.0,15.0,20.0,14.0,17.0,11.0,14.0,13.0,7.0,10.0,13.0,16.0,14.0,11.0,11.0,12.0,9.0,14.0,31.0,9.0,0.0,0.0,0.0,181.0,80.0,1.0,1.0,1.0,3.0,1.0,3.0,1.0,3.0,1.0,3.0,3.0,10.0,15.0,9.0,7.0,12.0,8.0,13.0,6.0,13.0,12.0,11.0,12.0,13.0,11.0,13.0,11.0,14.0,11.0,11.0,10.0,11.0,13.0,10.0,12.0,12.0,11.0,13.0,15.0,13.0,12.0,14.0,11.0,9.0,13.0,12.0,20.0,16.0,14.0,12.0,13.0,12.0,12.0,8.0,13.0,15.0,12.0,9.0,13.0,11.0,11.0,9.0,26.0,4.0,0.0,2.0,0.0,180.0,74.0,3.0,3.0,1.0,2.0,2.0,1.0,3.0,4.0,1.0,2.0,1.0,8.0,13.0,13.0,6.0,13.0,9.0,12.0,7.0,11.0,13.0,13.0,11.0,12.0,12.0,16.0,14.0,14.0,9.0,12.0,11.0,13.0,4.0,4.0,6.0,11.0,12.0,8.0,12.0,14.0,14.0,13.0,9.0,20.0,16.0,13.0,5.0,15.0,13.0,12.0,6.0,9.0,10.0,12.0,8.0,14.0,8.0,11.0,12.0,11.0,13.0,2.0,26.0,17.0,0.0,19.0,1.0,191.0,79.0,3.0,2.0,1.0,1.0,1.0,1.0,2.0,2.0,3.0,3.0,4.0,4.0,8.0,11.0,9.0,12.0,7.0,14.0,10.0,6.0,12.0,13.0,7.0,11.0,12.0,14.0,13.0,14.0,12.0,10.0,11.0,12.0,15.0,9.0,7.0,11.0,12.0,12.0,15.0,14.0,13.0,16.0,15.0,8.0,15.0,13.0,20.0,19.0,15.0,11.0,14.0,14.0,7.0,12.0,12.0,14.0,12.0,10.0,9.0,14.0,14.0,14.0,23.0,11.0,0.0,0.0,0.0,180.0,71.0,2.0,1.0,2.0,3.0,3.0,1.0,1.0,2.0,2.0,1.0,1.0,6.0,11.0,10.0,8.0,10.0,7.0,11.0,9.0,12.0,13.0,11.0,6.0,13.0,11.0,12.0,11.0,13.0,12.0,9.0,11.0,11.0,14.0,12.0,11.0,12.0,11.0,13.0,15.0,15.0,13.0,13.0,11.0,7.0,14.0,15.0,20.0,12.0,11.0,12.0,12.0,13.0,10.0,15.0,10.0,13.0,16.0,12.0,15.0,14.0,14.0,7.0,32.0,0.0,0.0,13.0,0.0,175.0,65.0,2.0,1.0,1.0,2.0,3.0,3.0,1.0,2.0,3.0,2.0,3.0,15.0,13.0,11.0,6.0,14.0,13.0,10.0,12.0,8.0,8.0,16.0,8.0,12.0,13.0,11.0,14.0,15.0,14.0,15.0,14.0,14.0,14.0,6.0,13.0,9.0,15.0,18.0,13.0,12.0,13.0,13.0,8.0,8.0,13.0,10.0,20.0,13.0,13.0,12.0,11.0,15.0,12.0,10.0,17.0,14.0,15.0,14.0,16.0,14.0,14.0,6.0,28.0,0.0,0.0,0.0,0.0,180.0,79.0,3.0,2.0,3.0,3.0,2.0,2.0,2.0,1.0,3.0,2.0,3.0,8.0,11.0,15.0,12.0,15.0,12.0,7.0,10.0,7.0,8.0,13.0,13.0,6.0,16.0,11.0,11.0,10.0,13.0,10.0,15.0,12.0,3.0,15.0,6.0,13.0,13.0,12.0,12.0,15.0,16.0,14.0,8.0,12.0,12.0,14.0,20.0,12.0,12.0,13.0,6.0,13.0,6.0,6.0,8.0,9.0,13.0,10.0,12.0,12.0,2.0,2.0,25.0,0.0,0.0,3.0,0.0,170.0,68.0,2.0,1.0,3.0,1.0,3.0,1.0,3.0,2.0,2.0,4.0,1.0,12.0,11.0,15.0,16.0,16.0,13.0,11.0,12.0,4.0,5.0,12.0,14.0,4.0,17.0,7.0,14.0,7.0,15.0,13.0,13.0,14.0,14.0,15.0,7.0,16.0,8.0,10.0,13.0,15.0,15.0,12.0,6.0,11.0,14.0,14.0,20.0,13.0,11.0,12.0,7.0,15.0,7.0,8.0,12.0,14.0,13.0,14.0,13.0,16.0,16.0,8.0,25.0,14.0,1.0,2.0,0.0,177.0,77.0,3.0,3.0,1.0,2.0,3.0,3.0,1.0,3.0,3.0,4.0,1.0,8.0,11.0,13.0,12.0,12.0,10.0,11.0,10.0,2.0,3.0,11.0,10.0,5.0,13.0,12.0,12.0,13.0,11.0,10.0,11.0,10.0,14.0,16.0,14.0,15.0,5.0,13.0,14.0,15.0,14.0,12.0,12.0,12.0,14.0,16.0,20.0,13.0,14.0,13.0,7.0,14.0,11.0,13.0,14.0,11.0,12.0,8.0,12.0,13.0,15.0,6.0
1,1,28.0,0.0,0.0,6.0,0.0,186.0,82.0,12.0,12.0,12.0,13.0,11.0,13.0,13.0,13.0,14.0,16.0,15.0,8.0,1.0,3.0,1.0,11.0,11.0,1.0,2.0,1.0,1.0,10.0,3.0,2.0,10.0,7.0,13.0,12.0,9.0,8.0,8.0,10.0,12.0,3.0,10.0,2.0,11.0,11.0,13.0,13.0,15.0,15.0,11.0,9.0,17.0,14.0,20.0,14.0,11.0,10.0,7.0,13.0,11.0,11.0,8.0,5.0,7.0,12.0,13.0,14.0,14.0,5.0,26.0,5.0,0.0,0.0,0.0,184.0,86.0,3.0,3.0,2.0,1.0,2.0,2.0,4.0,1.0,3.0,1.0,3.0,4.0,10.0,9.0,6.0,10.0,7.0,14.0,8.0,8.0,14.0,9.0,6.0,14.0,9.0,14.0,14.0,16.0,9.0,15.0,7.0,11.0,13.0,8.0,10.0,9.0,13.0,12.0,12.0,12.0,12.0,17.0,12.0,5.0,15.0,15.0,20.0,14.0,17.0,11.0,14.0,13.0,7.0,10.0,13.0,16.0,14.0,11.0,11.0,12.0,9.0,14.0,23.0,0.0,0.0,0.0,0.0,180.0,77.0,2.0,1.0,3.0,2.0,3.0,2.0,2.0,2.0,3.0,1.0,2.0,6.0,11.0,11.0,6.0,13.0,7.0,11.0,5.0,8.0,14.0,12.0,9.0,12.0,9.0,15.0,14.0,17.0,10.0,14.0,8.0,13.0,14.0,7.0,8.0,7.0,10.0,13.0,15.0,15.0,13.0,13.0,10.0,5.0,14.0,14.0,20.0,15.0,14.0,14.0,15.0,6.0,7.0,11.0,18.0,13.0,14.0,15.0,13.0,12.0,14.0,2.0,26.0,0.0,0.0,0.0,0.0,187.0,78.0,2.0,1.0,2.0,3.0,2.0,1.0,1.0,1.0,3.0,3.0,1.0,10.0,12.0,14.0,9.0,11.0,11.0,13.0,8.0,14.0,13.0,11.0,9.0,12.0,14.0,13.0,13.0,13.0,13.0,12.0,12.0,11.0,15.0,12.0,8.0,13.0,13.0,13.0,14.0,15.0,12.0,8.0,14.0,20.0,12.0,14.0,6.0,14.0,12.0,12.0,13.0,11.0,12.0,15.0,8.0,15.0,9.0,15.0,14.0,12.0,15.0,10.0,31.0,9.0,0.0,0.0,0.0,181.0,80.0,1.0,1.0,1.0,3.0,1.0,3.0,1.0,3.0,1.0,3.0,3.0,10.0,15.0,9.0,7.0,12.0,8.0,13.0,6.0,13.0,12.0,11.0,12.0,13.0,11.0,13.0,11.0,14.0,11.0,11.0,10.0,11.0,13.0,10.0,12.0,12.0,11.0,13.0,15.0,13.0,12.0,14.0,11.0,9.0,13.0,12.0,20.0,16.0,14.0,12.0,13.0,12.0,12.0,8.0,13.0,15.0,12.0,9.0,13.0,11.0,11.0,9.0,26.0,17.0,0.0,19.0,1.0,191.0,79.0,3.0,2.0,1.0,1.0,1.0,1.0,2.0,2.0,3.0,3.0,4.0,4.0,8.0,11.0,9.0,12.0,7.0,14.0,10.0,6.0,12.0,13.0,7.0,11.0,12.0,14.0,13.0,14.0,12.0,10.0,11.0,12.0,15.0,9.0,7.0,11.0,12.0,12.0,15.0,14.0,13.0,16.0,15.0,8.0,15.0,13.0,20.0,19.0,15.0,11.0,14.0,14.0,7.0,12.0,12.0,14.0,12.0,10.0,9.0,14.0,14.0,14.0,32.0,0.0,0.0,13.0,0.0,175.0,65.0,2.0,1.0,1.0,2.0,3.0,3.0,1.0,2.0,3.0,2.0,3.0,15.0,13.0,11.0,6.0,14.0,13.0,10.0,12.0,8.0,8.0,16.0,8.0,12.0,13.0,11.0,14.0,15.0,14.0,15.0,14.0,14.0,14.0,6.0,13.0,9.0,15.0,18.0,13.0,12.0,13.0,13.0,8.0,8.0,13.0,10.0,20.0,13.0,13.0,12.0,11.0,15.0,12.0,10.0,17.0,14.0,15.0,14.0,16.0,14.0,14.0,6.0,23.0,11.0,0.0,0.0,0.0,180.0,71.0,2.0,1.0,2.0,3.0,3.0,1.0,1.0,2.0,2.0,1.0,1.0,6.0,11.0,10.0,8.0,10.0,7.0,11.0,9.0,12.0,13.0,11.0,6.0,13.0,11.0,12.0,11.0,13.0,12.0,9.0,11.0,11.0,14.0,12.0,11.0,12.0,11.0,13.0,15.0,15.0,13.0,13.0,11.0,7.0,14.0,15.0,20.0,12.0,11.0,12.0,12.0,13.0,10.0,15.0,10.0,13.0,16.0,12.0,15.0,14.0,14.0,7.0,28.0,0.0,0.0,0.0,0.0,180.0,79.0,3.0,2.0,3.0,3.0,2.0,2.0,2.0,1.0,3.0,2.0,3.0,8.0,11.0,15.0,12.0,15.0,12.0,7.0,10.0,7.0,8.0,13.0,13.0,6.0,16.0,11.0,11.0,10.0,13.0,10.0,15.0,12.0,3.0,15.0,6.0,13.0,13.0,12.0,12.0,15.0,16.0,14.0,8.0,12.0,12.0,14.0,20.0,12.0,12.0,13.0,6.0,13.0,6.0,6.0,8.0,9.0,13.0,10.0,12.0,12.0,2.0,2.0,25.0,0.0,0.0,3.0,0.0,170.0,68.0,2.0,1.0,3.0,1.0,3.0,1.0,3.0,2.0,2.0,4.0,1.0,12.0,11.0,15.0,16.0,16.0,13.0,11.0,12.0,4.0,5.0,12.0,14.0,4.0,17.0,7.0,14.0,7.0,15.0,13.0,13.0,14.0,14.0,15.0,7.0,16.0,8.0,10.0,13.0,15.0,15.0,12.0,6.0,11.0,14.0,14.0,20.0,13.0,11.0,12.0,7.0,15.0,7.0,8.0,12.0,14.0,13.0,14.0,13.0,16.0,16.0,8.0,25.0,14.0,1.0,2.0,0.0,177.0,77.0,3.0,3.0,1.0,2.0,3.0,3.0,1.0,3.0,3.0,4.0,1.0,8.0,11.0,13.0,12.0,12.0,10.0,11.0,10.0,2.0,3.0,11.0,10.0,5.0,13.0,12.0,12.0,13.0,11.0,10.0,11.0,10.0,14.0,16.0,14.0,15.0,5.0,13.0,14.0,15.0,14.0,12.0,12.0,12.0,14.0,16.0,20.0,13.0,14.0,13.0,7.0,14.0,11.0,13.0,14.0,11.0,12.0,8.0,12.0,13.0,15.0,6.0,31.0,25.0,0.0,6.0,0.0,191.0,84.0,11.0,14.0,13.0,12.0,15.0,14.0,15.0,16.0,13.0,14.0,14.0,8.0,2.0,10.0,5.0,11.0,11.0,7.0,10.0,2.0,5.0,10.0,11.0,11.0,9.0,12.0,13.0,15.0,13.0,13.0,8.0,13.0,16.0,12.0,14.0,1.0,16.0,13.0,11.0,12.0,13.0,16.0,16.0,8.0,16.0,13.0,20.0,15.0,15.0,17.0,8.0,15.0,7.0,2.0,15.0,15.0,17.0,15.0,17.0,16.0,15.0,6.0,26.0,0.0,0.0,0.0,0.0,167.0,0.0,3.0,2.0,1.0,2.0,2.0,3.0,3.0,3.0,2.0,3.0,2.0,11.0,12.0,12.0,11.0,12.0,13.0,8.0,10.0,7.0,5.0,12.0,11.0,6.0,12.0,11.0,10.0,11.0,10.0,10.0,13.0,11.0,9.0,10.0,9.0,11.0,6.0,10.0,11.0,11.0,11.0,10.0,6.0,5.0,13.0,11.0,20.0,12.0,9.0,12.0,5.0,10.0,9.0,8.0,12.0,11.0,9.0,9.0,11.0,4.0,1.0,5.0,23.0,2.0,0.0,5.0,3.0,182.0,73.0,3.0,1.0,1.0,1.0,2.0,1.0,2.0,1.0,3.0,4.0,2.0,12.0,14.0,14.0,10.0,13.0,12.0,16.0,11.0,13.0,12.0,13.0,13.0,14.0,14.0,12.0,11.0,14.0,13.0,11.0,13.0,11.0,15.0,15.0,9.0,15.0,10.0,14.0,15.0,16.0,15.0,13.0,13.0,20.0,14.0,15.0,6.0,15.0,12.0,13.0,9.0,13.0,14.0,15.0,17.0,15.0,13.0,12.0,12.0,15.0,13.0,9.0,20.0,0.0,0.0,0.0,0.0,184.0,80.0,1.0,4.0,4.0,1.0,3.0,1.0,4.0,3.0,3.0,3.0,2.0,7.0,14.0,13.0,8.0,12.0,7.0,16.0,7.0,12.0,13.0,13.0,11.0,12.0,13.0,12.0,13.0,14.0,13.0,12.0,12.0,12.0,15.0,12.0,10.0,14.0,13.0,14.0,13.0,14.0,12.0,14.0,12.0,6.0,13.0,14.0,20.0,13.0,14.0,14.0,8.0,15.0,10.0,13.0,9.0,16.0,15.0,14.0,16.0,16.0,17.0,5.0,21.0,0.0,0.0,9.0,0.0,184.0,72.0,1.0,3.0,1.0,2.0,3.0,2.0,1.0,1.0,2.0,1.0,2.0,6.0,10.0,12.0,7.0,12.0,7.0,14.0,11.0,7.0,14.0,13.0,10.0,13.0,12.0,14.0,13.0,14.0,12.0,12.0,12.0,12.0,16.0,11.0,10.0,12.0,13.0,14.0,15.0,14.0,13.0,16.0,12.0,12.0,14.0,15.0,20.0,15.0,17.0,14.0,12.0,15.0,9.0,9.0,10.0,16.0,14.0,15.0,14.0,14.0,14.0,8.0,32.0,36.0,0.0,12.0,2.0,183.0,77.0,1.0,3.0,2.0,1.0,3.0,1.0,1.0,2.0,1.0,1.0,3.0,6.0,11.0,8.0,6.0,13.0,11.0,13.0,10.0,6.0,15.0,14.0,10.0,17.0,12.0,15.0,16.0,18.0,14.0,17.0,12.0,15.0,17.0,11.0,17.0,7.0,17.0,20.0,16.0,9.0,11.0,15.0,11.0,8.0,15.0,10.0,20.0,14.0,14.0,17.0,10.0,16.0,10.0,13.0,15.0,15.0,15.0,14.0,18.0,15.0,13.0,6.0,30.0,18.0,2.0,0.0,0.0,184.0,79.0,2.0,2.0,2.0,1.0,2.0,2.0,3.0,1.0,3.0,1.0,1.0,13.0,16.0,15.0,10.0,13.0,12.0,9.0,11.0,11.0,10.0,14.0,12.0,8.0,14.0,14.0,10.0,15.0,10.0,12.0,12.0,11.0,15.0,12.0,14.0,14.0,11.0,13.0,14.0,15.0,14.0,15.0,11.0,7.0,15.0,15.0,20.0,15.0,14.0,13.0,13.0,13.0,11.0,14.0,12.0,14.0,14.0,10.0,13.0,14.0,11.0,9.0,21.0,0.0,0.0,6.0,1.0,181.0,78.0,1.0,3.0,3.0,2.0,1.0,3.0,2.0,2.0,3.0,2.0,1.0,13.0,12.0,16.0,8.0,15.0,13.0,9.0,12.0,5.0,4.0,13.0,12.0,3.0,16.0,12.0,8.0,10.0,8.0,8.0,14.0,10.0,11.0,15.0,6.0,11.0,5.0,9.0,12.0,13.0,14.0,14.0,9.0,10.0,12.0,14.0,20.0,12.0,15.0,9.0,12.0,10.0,10.0,13.0,5.0,16.0,12.0,12.0,7.0,12.0,11.0,11.0,27.0,0.0,0.0,0.0,0.0,186.0,0.0,2.0,3.0,3.0,1.0,2.0,1.0,2.0,3.0,4.0,3.0,3.0,7.0,4.0,13.0,13.0,11.0,7.0,11.0,8.0,1.0,6.0,5.0,9.0,4.0,11.0,7.0,12.0,7.0,10.0,5.0,6.0,13.0,4.0,11.0,10.0,12.0,6.0,7.0,8.0,13.0,13.0,8.0,13.0,9.0,12.0,13.0,20.0,13.0,10.0,10.0,5.0,10.0,10.0,9.0,13.0,10.0,14.0,12.0,11.0,10.0,12.0,2.0,23.0,20.0,3.0,5.0,3.0,178.0,72.0,3.0,3.0,3.0,3.0,2.0,2.0,1.0,2.0,1.0,2.0,1.0,11.0,12.0,15.0,15.0,15.0,11.0,8.0,13.0,7.0,4.0,13.0,14.0,6.0,15.0,9.0,15.0,11.0,14.0,12.0,13.0,14.0,13.0,16.0,7.0,17.0,7.0,10.0,11.0,15.0,15.0,11.0,8.0,10.0,10.0,16.0,20.0,12.0,10.0,11.0,6.0,13.0,12.0,14.0,10.0,16.0,12.0,9.0,12.0,15.0,15.0,8.0,25.0,0.0,0.0,0.0,0.0,191.0,87.0,2.0,1.0,2.0,2.0,3.0,1.0,1.0,3.0,2.0,3.0,1.0,5.0,8.0,10.0,14.0,13.0,8.0,17.0,12.0,4.0,6.0,13.0,14.0,6.0,13.0,12.0,13.0,16.0,13.0,14.0,11.0,13.0,15.0,9.0,12.0,15.0,9.0,15.0,14.0,11.0,12.0,15.0,17.0,10.0,14.0,13.0,20.0,14.0,15.0,12.0,6.0,13.0,7.0,6.0,11.0,13.0,14.0,12.0,16.0,15.0,14.0,7.0
0,0,33.0,101.0,0.0,0.0,0.0,182.0,87.0,12.0,11.0,15.0,12.0,14.0,13.0,14.0,15.0,15.0,13.0,12.0,9.0,2.0,3.0,8.0,9.0,11.0,10.0,11.0,1.0,3.0,12.0,15.0,8.0,10.0,8.0,14.0,14.0,14.0,12.0,9.0,12.0,16.0,9.0,15.0,2.0,13.0,12.0,6.0,12.0,13.0,14.0,13.0,8.0,13.0,10.0,20.0,12.0,15.0,13.0,8.0,15.0,5.0,1.0,13.0,15.0,13.0,15.0,18.0,18.0,15.0,5.0,33.0,37.0,2.0,0.0,0.0,190.0,86.0,3.0,3.0,1.0,2.0,1.0,1.0,1.0,3.0,1.0,3.0,3.0,4.0,9.0,9.0,8.0,12.0,5.0,16.0,9.0,7.0,15.0,12.0,8.0,15.0,12.0,12.0,15.0,16.0,14.0,14.0,11.0,12.0,14.0,8.0,12.0,8.0,15.0,13.0,12.0,11.0,9.0,15.0,15.0,10.0,12.0,10.0,20.0,12.0,15.0,14.0,12.0,14.0,15.0,8.0,13.0,12.0,13.0,14.0,14.0,14.0,13.0,11.0,32.0,0.0,0.0,0.0,0.0,195.0,89.0,3.0,2.0,3.0,1.0,4.0,2.0,4.0,2.0,3.0,1.0,2.0,3.0,5.0,5.0,11.0,8.0,8.0,14.0,9.0,11.0,15.0,12.0,9.0,13.0,8.0,16.0,13.0,19.0,10.0,14.0,8.0,13.0,16.0,5.0,15.0,10.0,15.0,15.0,14.0,8.0,8.0,16.0,17.0,5.0,11.0,10.0,20.0,13.0,17.0,13.0,12.0,15.0,7.0,5.0,12.0,14.0,14.0,12.0,15.0,8.0,8.0,7.0,25.0,0.0,0.0,26.0,3.0,176.0,64.0,3.0,2.0,2.0,1.0,3.0,3.0,3.0,2.0,1.0,1.0,1.0,12.0,13.0,12.0,7.0,13.0,13.0,11.0,11.0,11.0,14.0,13.0,11.0,14.0,13.0,13.0,13.0,14.0,13.0,13.0,11.0,13.0,17.0,12.0,11.0,10.0,12.0,14.0,14.0,14.0,14.0,12.0,8.0,8.0,17.0,14.0,20.0,15.0,12.0,14.0,12.0,13.0,5.0,12.0,17.0,15.0,15.0,14.0,16.0,15.0,15.0,7.0,23.0,0.0,0.0,1.0,0.0,182.0,71.0,3.0,1.0,2.0,3.0,4.0,2.0,3.0,1.0,2.0,1.0,3.0,9.0,13.0,14.0,8.0,14.0,13.0,12.0,10.0,13.0,14.0,14.0,13.0,15.0,13.0,14.0,14.0,13.0,11.0,12.0,12.0,13.0,16.0,12.0,12.0,15.0,13.0,14.0,15.0,15.0,13.0,14.0,12.0,9.0,16.0,15.0,20.0,15.0,15.0,15.0,10.0,14.0,6.0,12.0,8.0,15.0,14.0,16.0,15.0,15.0,16.0,6.0,32.0,13.0,0.0,19.0,1.0,172.0,72.0,3.0,1.0,3.0,2.0,1.0,2.0,2.0,2.0,3.0,1.0,1.0,7.0,12.0,12.0,5.0,13.0,7.0,6.0,9.0,9.0,12.0,14.0,9.0,14.0,12.0,13.0,14.0,14.0,15.0,15.0,10.0,13.0,17.0,7.0,18.0,8.0,15.0,18.0,15.0,12.0,14.0,12.0,6.0,10.0,16.0,13.0,20.0,15.0,12.0,15.0,9.0,15.0,5.0,10.0,12.0,16.0,14.0,13.0,15.0,18.0,18.0,5.0,33.0,14.0,0.0,0.0,0.0,172.0,68.0,3.0,3.0,1.0,1.0,1.0,1.0,1.0,3.0,1.0,2.0,1.0,14.0,11.0,13.0,8.0,14.0,13.0,7.0,13.0,4.0,10.0,13.0,10.0,12.0,14.0,11.0,13.0,14.0,13.0,13.0,12.0,14.0,15.0,10.0,13.0,12.0,13.0,16.0,17.0,13.0,13.0,12.0,7.0,10.0,14.0,12.0,20.0,14.0,9.0,14.0,11.0,15.0,10.0,12.0,20.0,13.0,13.0,15.0,14.0,13.0,12.0,8.0,36.0,0.0,0.0,3.0,0.0,168.0,72.0,3.0,2.0,1.0,3.0,1.0,3.0,3.0,1.0,3.0,3.0,1.0,11.0,8.0,12.0,5.0,13.0,11.0,8.0,13.0,6.0,12.0,13.0,8.0,14.0,13.0,17.0,14.0,17.0,14.0,15.0,13.0,14.0,17.0,12.0,16.0,10.0,15.0,16.0,14.0,10.0,13.0,14.0,4.0,8.0,16.0,8.0,20.0,12.0,13.0,17.0,14.0,14.0,7.0,10.0,19.0,15.0,14.0,16.0,15.0,9.0,9.0,7.0,28.0,0.0,0.0,0.0,0.0,168.0,65.0,3.0,4.0,1.0,1.0,2.0,3.0,1.0,2.0,2.0,1.0,2.0,14.0,14.0,15.0,8.0,14.0,14.0,9.0,8.0,7.0,8.0,13.0,10.0,7.0,14.0,12.0,12.0,12.0,13.0,13.0,13.0,12.0,15.0,13.0,6.0,11.0,7.0,14.0,14.0,16.0,14.0,10.0,6.0,20.0,13.0,15.0,5.0,13.0,9.0,12.0,12.0,14.0,9.0,6.0,18.0,14.0,14.0,14.0,14.0,13.0,13.0,6.0,22.0,2.0,0.0,0.0,0.0,169.0,59.0,3.0,1.0,3.0,1.0,1.0,1.0,1.0,1.0,3.0,3.0,2.0,13.0,13.0,15.0,13.0,15.0,13.0,7.0,13.0,8.0,6.0,13.0,13.0,5.0,16.0,10.0,10.0,8.0,13.0,11.0,14.0,12.0,12.0,14.0,10.0,12.0,6.0,10.0,8.0,16.0,15.0,17.0,6.0,12.0,12.0,15.0,20.0,13.0,9.0,12.0,8.0,12.0,8.0,12.0,13.0,13.0,13.0,14.0,12.0,10.0,13.0,9.0,21.0,0.0,0.0,0.0,0.0,189.0,77.0,2.0,1.0,1.0,1.0,3.0,3.0,3.0,3.0,3.0,3.0,1.0,5.0,11.0,12.0,10.0,13.0,6.0,13.0,11.0,6.0,5.0,12.0,11.0,5.0,12.0,8.0,12.0,13.0,11.0,10.0,10.0,10.0,13.0,10.0,6.0,13.0,8.0,13.0,14.0,12.0,12.0,15.0,14.0,7.0,14.0,13.0,20.0,13.0,14.0,12.0,8.0,10.0,8.0,8.0,8.0,14.0,13.0,11.0,14.0,15.0,16.0,6.0,20.0,0.0,0.0,0.0,0.0,184.0,88.0,12.0,10.0,12.0,13.0,11.0,13.0,12.0,14.0,8.0,13.0,13.0,9.0,3.0,3.0,1.0,9.0,11.0,2.0,1.0,3.0,3.0,11.0,4.0,1.0,10.0,10.0,13.0,16.0,11.0,11.0,12.0,11.0,14.0,9.0,12.0,1.0,12.0,12.0,12.0,15.0,13.0,14.0,11.0,20.0,13.0,12.0,8.0,13.0,15.0,12.0,11.0,15.0,6.0,1.0,19.0,14.0,16.0,14.0,8.0,7.0,6.0,15.0,25.0,0.0,0.0,0.0,0.0,191.0,81.0,1.0,1.0,3.0,2.0,3.0,2.0,3.0,4.0,2.0,1.0,2.0,4.0,3.0,10.0,8.0,6.0,6.0,11.0,6.0,10.0,11.0,10.0,5.0,12.0,7.0,16.0,13.0,16.0,11.0,13.0,7.0,10.0,14.0,5.0,12.0,10.0,13.0,13.0,12.0,13.0,13.0,16.0,16.0,7.0,16.0,14.0,20.0,14.0,14.0,13.0,13.0,15.0,6.0,12.0,13.0,6.0,14.0,8.0,8.0,13.0,7.0,4.0,28.0,0.0,0.0,0.0,0.0,190.0,85.0,3.0,2.0,3.0,3.0,2.0,2.0,2.0,4.0,3.0,1.0,2.0,5.0,9.0,8.0,9.0,8.0,7.0,14.0,10.0,9.0,15.0,9.0,6.0,14.0,9.0,16.0,13.0,16.0,10.0,13.0,10.0,12.0,15.0,6.0,13.0,7.0,13.0,14.0,16.0,12.0,11.0,17.0,13.0,20.0,15.0,13.0,8.0,15.0,15.0,12.0,14.0,14.0,9.0,8.0,14.0,13.0,14.0,11.0,12.0,13.0,16.0,14.0,29.0,0.0,0.0,0.0,0.0,182.0,76.0,1.0,4.0,2.0,3.0,1.0,1.0,1.0,2.0,2.0,1.0,1.0,7.0,12.0,11.0,9.0,11.0,12.0,7.0,12.0,8.0,12.0,13.0,8.0,12.0,13.0,14.0,12.0,14.0,10.0,13.0,12.0,12.0,13.0,15.0,8.0,11.0,12.0,13.0,13.0,11.0,12.0,11.0,12.0,20.0,10.0,11.0,10.0,14.0,11.0,13.0,11.0,10.0,11.0,10.0,14.0,15.0,13.0,9.0,14.0,12.0,13.0,6.0,23.0,0.0,0.0,0.0,0.0,179.0,71.0,2.0,1.0,3.0,3.0,2.0,3.0,2.0,2.0,1.0,3.0,1.0,8.0,10.0,12.0,6.0,12.0,10.0,5.0,10.0,13.0,11.0,11.0,6.0,12.0,11.0,9.0,11.0,12.0,12.0,7.0,10.0,9.0,15.0,12.0,5.0,13.0,8.0,12.0,14.0,16.0,13.0,13.0,10.0,20.0,16.0,15.0,8.0,14.0,14.0,13.0,9.0,14.0,7.0,10.0,7.0,14.0,14.0,13.0,15.0,13.0,13.0,5.0,28.0,1.0,0.0,7.0,0.0,181.0,71.0,2.0,2.0,1.0,3.0,1.0,3.0,3.0,2.0,3.0,3.0,3.0,12.0,11.0,10.0,5.0,13.0,11.0,8.0,10.0,8.0,9.0,14.0,11.0,12.0,13.0,14.0,14.0,12.0,12.0,13.0,12.0,13.0,12.0,8.0,9.0,9.0,12.0,17.0,15.0,11.0,13.0,14.0,10.0,12.0,13.0,12.0,20.0,16.0,12.0,13.0,14.0,16.0,12.0,9.0,10.0,14.0,16.0,14.0,13.0,12.0,12.0,14.0,18.0,0.0,0.0,0.0,0.0,183.0,76.0,1.0,2.0,2.0,2.0,3.0,3.0,1.0,3.0,2.0,1.0,2.0,13.0,10.0,12.0,9.0,12.0,13.0,10.0,13.0,9.0,5.0,12.0,12.0,6.0,14.0,6.0,10.0,7.0,11.0,8.0,12.0,7.0,8.0,8.0,6.0,12.0,8.0,8.0,8.0,13.0,10.0,9.0,9.0,8.0,14.0,14.0,20.0,8.0,8.0,9.0,5.0,8.0,9.0,12.0,16.0,11.0,13.0,10.0,7.0,12.0,17.0,1.0,22.0,1.0,0.0,0.0,0.0,177.0,73.0,3.0,2.0,1.0,3.0,3.0,3.0,1.0,3.0,2.0,2.0,1.0,12.0,13.0,14.0,10.0,14.0,12.0,10.0,14.0,2.0,5.0,13.0,14.0,7.0,15.0,12.0,10.0,6.0,10.0,7.0,8.0,8.0,7.0,15.0,8.0,13.0,8.0,5.0,8.0,16.0,15.0,14.0,8.0,8.0,10.0,15.0,20.0,12.0,11.0,8.0,9.0,11.0,12.0,12.0,13.0,13.0,13.0,12.0,6.0,9.0,6.0,14.0,25.0,9.0,0.0,0.0,0.0,173.0,70.0,1.0,2.0,1.0,2.0,3.0,2.0,1.0,2.0,1.0,4.0,3.0,6.0,8.0,13.0,10.0,14.0,13.0,13.0,13.0,5.0,10.0,13.0,11.0,9.0,15.0,7.0,13.0,13.0,12.0,12.0,12.0,13.0,13.0,15.0,12.0,13.0,7.0,14.0,15.0,13.0,13.0,12.0,10.0,12.0,11.0,13.0,20.0,14.0,13.0,13.0,7.0,13.0,13.0,13.0,8.0,15.0,13.0,12.0,13.0,15.0,15.0,6.0,21.0,0.0,0.0,4.0,1.0,184.0,79.0,1.0,2.0,3.0,1.0,2.0,1.0,3.0,2.0,2.0,1.0,3.0,3.0,6.0,10.0,12.0,12.0,7.0,15.0,8.0,4.0,5.0,13.0,10.0,8.0,12.0,18.0,12.0,19.0,13.0,10.0,13.0,12.0,14.0,13.0,10.0,12.0,9.0,16.0,15.0,12.0,14.0,14.0,14.0,12.0,13.0,10.0,20.0,14.0,14.0,11.0,14.0,14.0,11.0,5.0,10.0,13.0,14.0,15.0,10.0,8.0,4.0,15.0,31.0,0.0,0.0,0.0,0.0,182.0,76.0,3.0,2.0,3.0,4.0,2.0,1.0,2.0,3.0,1.0,2.0,2.0,10.0,13.0,15.0,6.0,14.0,9.0,11.0,8.0,7.0,4.0,12.0,10.0,3.0,14.0,7.0,13.0,10.0,12.0,12.0,12.0,10.0,11.0,12.0,6.0,15.0,6.0,13.0,13.0,14.0,14.0,12.0,10.0,20.0,13.0,13.0,8.0,12.0,11.0,8.0,7.0,14.0,13.0,8.0,8.0,13.0,14.0,12.0,12.0,14.0,14.0,6.0
0,4,36.0,0.0,0.0,0.0,0.0,185.0,78.0,11.0,14.0,12.0,7.0,13.0,12.0,14.0,15.0,13.0,14.0,10.0,4.0,1.0,3.0,1.0,8.0,8.0,11.0,8.0,3.0,3.0,7.0,2.0,1.0,8.0,11.0,13.0,15.0,11.0,12.0,7.0,13.0,9.0,5.0,14.0,3.0,13.0,15.0,8.0,11.0,14.0,13.0,12.0,5.0,15.0,11.0,20.0,12.0,14.0,13.0,11.0,13.0,8.0,1.0,19.0,14.0,16.0,10.0,17.0,9.0,9.0,11.0,28.0,0.0,0.0,0.0,0.0,183.0,81.0,1.0,2.0,4.0,1.0,1.0,3.0,2.0,3.0,3.0,3.0,1.0,5.0,5.0,6.0,10.0,12.0,6.0,14.0,8.0,6.0,15.0,11.0,6.0,13.0,12.0,13.0,14.0,16.0,14.0,14.0,10.0,12.0,14.0,5.0,14.0,8.0,14.0,15.0,15.0,9.0,12.0,15.0,13.0,7.0,11.0,12.0,20.0,15.0,15.0,14.0,14.0,14.0,9.0,8.0,14.0,14.0,11.0,13.0,15.0,13.0,15.0,6.0,27.0,25.0,1.0,0.0,0.0,189.0,82.0,3.0,1.0,3.0,4.0,3.0,1.0,3.0,3.0,1.0,2.0,3.0,6.0,7.0,5.0,8.0,9.0,8.0,12.0,8.0,6.0,14.0,13.0,11.0,14.0,5.0,12.0,14.0,15.0,13.0,13.0,8.0,13.0,12.0,5.0,11.0,5.0,13.0,15.0,14.0,12.0,12.0,14.0,15.0,6.0,16.0,12.0,20.0,13.0,14.0,11.0,10.0,12.0,5.0,8.0,11.0,13.0,14.0,17.0,8.0,6.0,8.0,13.0,24.0,0.0,0.0,0.0,0.0,179.0,68.0,3.0,2.0,3.0,2.0,1.0,3.0,3.0,1.0,3.0,3.0,1.0,4.0,13.0,9.0,6.0,12.0,9.0,12.0,7.0,8.0,12.0,14.0,8.0,14.0,12.0,15.0,14.0,13.0,14.0,13.0,10.0,12.0,14.0,10.0,9.0,9.0,10.0,13.0,14.0,14.0,12.0,13.0,9.0,9.0,8.0,14.0,20.0,15.0,14.0,11.0,11.0,13.0,10.0,14.0,13.0,14.0,14.0,11.0,16.0,15.0,15.0,6.0,24.0,9.0,0.0,0.0,0.0,173.0,66.0,1.0,1.0,2.0,3.0,2.0,1.0,3.0,2.0,1.0,2.0,3.0,8.0,11.0,11.0,6.0,11.0,7.0,12.0,6.0,10.0,9.0,12.0,10.0,13.0,12.0,12.0,12.0,12.0,12.0,10.0,12.0,10.0,15.0,11.0,6.0,8.0,11.0,13.0,13.0,14.0,14.0,12.0,9.0,8.0,13.0,13.0,20.0,13.0,11.0,13.0,12.0,14.0,8.0,10.0,7.0,12.0,18.0,13.0,14.0,14.0,13.0,5.0,27.0,14.0,1.0,0.0,0.0,183.0,77.0,1.0,2.0,1.0,2.0,3.0,2.0,3.0,2.0,2.0,1.0,1.0,5.0,12.0,9.0,8.0,13.0,10.0,13.0,10.0,6.0,14.0,13.0,6.0,13.0,12.0,14.0,13.0,15.0,11.0,11.0,11.0,11.0,13.0,9.0,8.0,9.0,12.0,14.0,16.0,14.0,12.0,14.0,12.0,7.0,14.0,12.0,20.0,15.0,14.0,14.0,14.0,15.0,7.0,10.0,12.0,13.0,14.0,12.0,13.0,11.0,11.0,7.0,30.0,0.0,0.0,0.0,0.0,167.0,60.0,3.0,1.0,1.0,2.0,3.0,1.0,1.0,3.0,1.0,1.0,3.0,10.0,11.0,12.0,8.0,13.0,10.0,6.0,9.0,10.0,12.0,14.0,9.0,10.0,14.0,11.0,14.0,14.0,14.0,14.0,13.0,14.0,12.0,14.0,11.0,13.0,12.0,15.0,15.0,15.0,14.0,11.0,5.0,11.0,11.0,15.0,20.0,11.0,8.0,14.0,10.0,12.0,13.0,11.0,11.0,12.0,11.0,10.0,12.0,11.0,11.0,2.0,23.0,27.0,1.0,0.0,0.0,178.0,70.0,1.0,2.0,1.0,4.0,1.0,1.0,1.0,3.0,2.0,1.0,1.0,8.0,11.0,13.0,11.0,13.0,12.0,7.0,14.0,6.0,5.0,12.0,10.0,5.0,14.0,11.0,11.0,12.0,11.0,9.0,13.0,10.0,14.0,14.0,5.0,13.0,7.0,10.0,12.0,15.0,14.0,12.0,9.0,20.0,13.0,13.0,8.0,13.0,13.0,12.0,11.0,11.0,10.0,11.0,12.0,12.0,12.0,11.0,10.0,10.0,10.0,6.0,33.0,0.0,0.0,0.0,0.0,187.0,76.0,2.0,2.0,3.0,1.0,1.0,3.0,2.0,1.0,2.0,3.0,2.0,15.0,14.0,14.0,10.0,15.0,13.0,10.0,12.0,7.0,4.0,15.0,13.0,7.0,15.0,6.0,12.0,9.0,14.0,11.0,15.0,12.0,12.0,14.0,12.0,13.0,7.0,13.0,12.0,11.0,12.0,14.0,12.0,14.0,15.0,12.0,20.0,11.0,12.0,12.0,6.0,14.0,6.0,11.0,14.0,13.0,12.0,12.0,15.0,15.0,13.0,9.0,30.0,0.0,0.0,0.0,0.0,178.0,73.0,3.0,4.0,1.0,1.0,2.0,4.0,3.0,2.0,2.0,2.0,3.0,13.0,14.0,12.0,7.0,13.0,12.0,7.0,13.0,5.0,10.0,13.0,9.0,10.0,13.0,11.0,11.0,12.0,12.0,13.0,11.0,14.0,14.0,11.0,7.0,11.0,10.0,13.0,15.0,13.0,15.0,15.0,8.0,20.0,14.0,14.0,8.0,14.0,11.0,13.0,11.0,14.0,8.0,10.0,19.0,12.0,12.0,9.0,12.0,12.0,10.0,10.0,24.0,0.0,0.0,0.0,0.0,182.0,82.0,3.0,3.0,2.0,1.0,1.0,3.0,2.0,2.0,3.0,2.0,2.0,4.0,7.0,13.0,14.0,13.0,12.0,14.0,12.0,5.0,7.0,10.0,14.0,6.0,15.0,13.0,13.0,16.0,8.0,12.0,11.0,11.0,12.0,14.0,7.0,13.0,8.0,12.0,13.0,14.0,14.0,15.0,12.0,10.0,10.0,12.0,20.0,16.0,15.0,12.0,13.0,14.0,10.0,8.0,8.0,13.0,5.0,10.0,11.0,9.0,9.0,13.0,25.0,4.0,0.0,11.0,0.0,184.0,81.0,14.0,14.0,13.0,9.0,15.0,12.0,16.0,16.0,13.0,7.0,11.0,8.0,1.0,2.0,1.0,11.0,12.0,6.0,1.0,3.0,3.0,11.0,5.0,3.0,11.0,8.0,15.0,15.0,13.0,14.0,10.0,11.0,14.0,8.0,13.0,5.0,13.0,10.0,10.0,14.0,16.0,14.0,13.0,20.0,14.0,12.0,5.0,14.0,14.0,15.0,9.0,16.0,6.0,1.0,17.0,11.0,15.0,13.0,14.0,12.0,12.0,4.0,27.0,4.0,0.0,5.0,1.0,184.0,83.0,2.0,4.0,3.0,1.0,1.0,2.0,1.0,2.0,4.0,2.0,3.0,4.0,8.0,11.0,4.0,10.0,4.0,14.0,4.0,4.0,15.0,12.0,5.0,16.0,11.0,14.0,14.0,16.0,14.0,10.0,11.0,12.0,17.0,7.0,10.0,9.0,13.0,14.0,15.0,14.0,13.0,16.0,13.0,10.0,15.0,13.0,20.0,15.0,16.0,12.0,12.0,14.0,6.0,12.0,11.0,13.0,12.0,12.0,16.0,15.0,14.0,6.0,22.0,3.0,0.0,7.0,1.0,182.0,75.0,3.0,3.0,1.0,3.0,2.0,3.0,1.0,1.0,2.0,2.0,1.0,4.0,11.0,10.0,6.0,14.0,7.0,13.0,10.0,9.0,16.0,14.0,8.0,15.0,14.0,13.0,17.0,15.0,16.0,14.0,11.0,14.0,15.0,8.0,11.0,10.0,15.0,16.0,14.0,14.0,14.0,14.0,11.0,20.0,15.0,14.0,10.0,15.0,15.0,15.0,12.0,15.0,8.0,11.0,12.0,14.0,16.0,15.0,14.0,14.0,14.0,5.0,37.0,0.0,0.0,0.0,0.0,185.0,83.0,1.0,1.0,2.0,1.0,3.0,2.0,3.0,1.0,1.0,3.0,1.0,6.0,8.0,9.0,12.0,10.0,8.0,13.0,9.0,4.0,5.0,10.0,14.0,4.0,11.0,11.0,10.0,11.0,13.0,12.0,12.0,13.0,15.0,14.0,12.0,11.0,7.0,12.0,8.0,7.0,7.0,12.0,12.0,11.0,11.0,7.0,20.0,8.0,14.0,12.0,8.0,13.0,9.0,12.0,12.0,12.0,19.0,14.0,15.0,14.0,8.0,8.0,32.0,0.0,0.0,0.0,0.0,172.0,71.0,2.0,1.0,3.0,1.0,2.0,3.0,2.0,3.0,2.0,2.0,2.0,8.0,9.0,7.0,6.0,10.0,6.0,10.0,9.0,10.0,14.0,11.0,6.0,14.0,11.0,10.0,16.0,15.0,12.0,12.0,7.0,12.0,15.0,9.0,13.0,8.0,14.0,15.0,15.0,14.0,14.0,14.0,10.0,20.0,14.0,14.0,8.0,15.0,13.0,13.0,11.0,13.0,7.0,13.0,17.0,14.0,17.0,8.0,13.0,15.0,15.0,6.0,27.0,8.0,0.0,6.0,0.0,187.0,76.0,3.0,2.0,3.0,2.0,2.0,1.0,1.0,3.0,3.0,1.0,2.0,5.0,7.0,11.0,5.0,14.0,5.0,14.0,9.0,5.0,15.0,15.0,8.0,14.0,13.0,15.0,16.0,15.0,14.0,12.0,14.0,14.0,18.0,8.0,17.0,9.0,12.0,18.0,15.0,13.0,14.0,15.0,14.0,10.0,17.0,12.0,20.0,17.0,15.0,14.0,13.0,16.0,4.0,12.0,10.0,14.0,17.0,12.0,15.0,13.0,13.0,6.0,21.0,0.0,0.0,15.0,3.0,181.0,78.0,3.0,3.0,4.0,2.0,1.0,2.0,2.0,4.0,2.0,1.0,1.0,5.0,7.0,11.0,10.0,14.0,5.0,14.0,10.0,6.0,13.0,14.0,8.0,14.0,14.0,12.0,14.0,12.0,11.0,10.0,12.0,11.0,16.0,11.0,12.0,14.0,14.0,14.0,14.0,14.0,13.0,14.0,13.0,10.0,16.0,14.0,20.0,16.0,14.0,12.0,10.0,11.0,5.0,19.0,8.0,11.0,14.0,11.0,16.0,13.0,13.0,10.0,24.0,0.0,0.0,6.0,1.0,172.0,70.0,3.0,1.0,1.0,3.0,1.0,2.0,3.0,1.0,1.0,3.0,3.0,11.0,12.0,11.0,8.0,12.0,10.0,6.0,14.0,7.0,11.0,15.0,8.0,12.0,13.0,14.0,14.0,18.0,13.0,12.0,13.0,13.0,15.0,12.0,12.0,12.0,11.0,18.0,18.0,13.0,14.0,13.0,7.0,10.0,16.0,12.0,20.0,14.0,12.0,14.0,14.0,15.0,4.0,8.0,7.0,14.0,14.0,13.0,14.0,12.0,10.0,6.0,31.0,52.0,8.0,0.0,0.0,167.0,58.0,1.0,2.0,2.0,1.0,3.0,2.0,4.0,2.0,1.0,2.0,3.0,15.0,15.0,14.0,7.0,15.0,15.0,6.0,11.0,3.0,4.0,15.0,14.0,7.0,15.0,13.0,12.0,15.0,13.0,14.0,16.0,11.0,17.0,14.0,11.0,12.0,10.0,12.0,14.0,15.0,18.0,10.0,5.0,10.0,16.0,14.0,20.0,13.0,7.0,14.0,13.0,16.0,8.0,12.0,13.0,16.0,14.0,15.0,13.0,9.0,11.0,14.0,22.0,5.0,1.0,1.0,0.0,173.0,72.0,1.0,3.0,1.0,3.0,3.0,3.0,3.0,3.0,3.0,2.0,2.0,14.0,13.0,16.0,14.0,16.0,14.0,5.0,11.0,5.0,5.0,15.0,11.0,5.0,16.0,8.0,13.0,9.0,14.0,13.0,15.0,13.0,15.0,16.0,5.0,13.0,5.0,9.0,10.0,15.0,16.0,14.0,5.0,20.0,14.0,15.0,5.0,12.0,14.0,13.0,11.0,13.0,8.0,14.0,10.0,15.0,14.0,10.0,13.0,10.0,10.0,13.0,28.0,2.0,1.0,0.0,0.0,174.0,66.0,2.0,2.0,2.0,1.0,1.0,3.0,2.0,3.0,3.0,1.0,4.0,6.0,11.0,13.0,15.0,13.0,11.0,14.0,11.0,6.0,5.0,10.0,12.0,5.0,13.0,8.0,14.0,10.0,13.0,14.0,8.0,12.0,12.0,12.0,5.0,14.0,8.0,12.0,11.0,17.0,15.0,11.0,12.0,7.0,14.0,15.0,20.0,13.0,10.0,12.0,8.0,14.0,8.0,8.0,19.0,15.0,12.0,10.0,11.0,13.0,13.0,12.0
0,3,31.0,25.0,0.0,6.0,0.0,191.0,84.0,11.0,14.0,13.0,12.0,15.0,14.0,15.0,16.0,13.0,14.0,14.0,8.0,2.0,10.0,5.0,11.0,11.0,7.0,10.0,2.0,5.0,10.0,11.0,11.0,9.0,12.0,13.0,15.0,13.0,13.0,8.0,13.0,16.0,12.0,14.0,1.0,16.0,13.0,11.0,12.0,13.0,16.0,16.0,8.0,16.0,13.0,20.0,15.0,15.0,17.0,8.0,15.0,7.0,2.0,15.0,15.0,17.0,15.0,17.0,16.0,15.0,6.0,32.0,0.0,0.0,3.0,0.0,187.0,82.0,1.0,2.0,2.0,3.0,2.0,1.0,1.0,2.0,2.0,3.0,1.0,5.0,11.0,8.0,7.0,10.0,6.0,15.0,9.0,13.0,15.0,10.0,8.0,16.0,9.0,16.0,14.0,17.0,12.0,15.0,8.0,12.0,17.0,9.0,14.0,11.0,13.0,15.0,13.0,12.0,11.0,16.0,14.0,6.0,13.0,14.0,20.0,13.0,16.0,15.0,14.0,14.0,8.0,14.0,14.0,14.0,15.0,16.0,15.0,12.0,10.0,7.0,38.0,89.0,6.0,14.0,1.0,183.0,79.0,3.0,3.0,2.0,3.0,2.0,3.0,2.0,4.0,3.0,2.0,3.0,4.0,8.0,8.0,7.0,12.0,6.0,14.0,8.0,11.0,17.0,12.0,11.0,16.0,12.0,15.0,16.0,17.0,15.0,17.0,10.0,16.0,18.0,6.0,15.0,8.0,16.0,17.0,13.0,8.0,8.0,12.0,11.0,10.0,13.0,8.0,20.0,10.0,11.0,16.0,12.0,16.0,11.0,7.0,15.0,16.0,16.0,15.0,18.0,16.0,14.0,4.0,28.0,54.0,3.0,5.0,1.0,184.0,76.0,1.0,3.0,3.0,3.0,2.0,2.0,2.0,1.0,2.0,2.0,1.0,8.0,13.0,11.0,7.0,10.0,7.0,13.0,9.0,14.0,12.0,11.0,8.0,14.0,11.0,13.0,12.0,14.0,11.0,12.0,9.0,11.0,12.0,8.0,7.0,13.0,11.0,14.0,14.0,14.0,13.0,15.0,12.0,20.0,14.0,15.0,5.0,12.0,16.0,10.0,11.0,11.0,8.0,10.0,4.0,13.0,13.0,11.0,12.0,12.0,11.0,9.0,31.0,0.0,0.0,6.0,0.0,174.0,80.0,1.0,1.0,1.0,1.0,1.0,5.0,1.0,1.0,1.0,1.0,1.0,14.0,12.0,11.0,7.0,12.0,13.0,9.0,7.0,10.0,11.0,11.0,10.0,10.0,12.0,11.0,11.0,11.0,10.0,6.0,10.0,9.0,12.0,12.0,12.0,10.0,12.0,12.0,14.0,12.0,15.0,10.0,9.0,20.0,12.0,12.0,7.0,12.0,9.0,9.0,10.0,12.0,7.0,9.0,11.0,14.0,9.0,7.0,14.0,8.0,9.0,9.0,32.0,36.0,0.0,12.0,2.0,183.0,77.0,1.0,3.0,2.0,1.0,3.0,1.0,1.0,2.0,1.0,1.0,3.0,6.0,11.0,8.0,6.0,13.0,11.0,13.0,10.0,6.0,15.0,14.0,10.0,17.0,12.0,15.0,16.0,18.0,14.0,17.0,12.0,15.0,17.0,11.0,17.0,7.0,17.0,20.0,16.0,9.0,11.0,15.0,11.0,8.0,15.0,10.0,20.0,14.0,14.0,17.0,10.0,16.0,10.0,13.0,15.0,15.0,15.0,14.0,18.0,15.0,13.0,6.0,20.0,0.0,0.0,7.0,1.0,170.0,58.0,1.0,2.0,2.0,2.0,2.0,2.0,2.0,4.0,1.0,3.0,2.0,16.0,14.0,16.0,13.0,16.0,17.0,5.0,14.0,2.0,6.0,15.0,13.0,4.0,17.0,9.0,12.0,14.0,12.0,12.0,14.0,13.0,15.0,16.0,7.0,13.0,9.0,13.0,15.0,15.0,16.0,11.0,7.0,20.0,14.0,15.0,8.0,14.0,8.0,15.0,5.0,15.0,7.0,16.0,15.0,15.0,15.0,14.0,16.0,18.0,16.0,3.0,21.0,7.0,0.0,14.0,6.0,173.0,64.0,3.0,2.0,3.0,2.0,3.0,3.0,3.0,2.0,3.0,3.0,3.0,14.0,14.0,18.0,14.0,17.0,14.0,7.0,11.0,2.0,6.0,15.0,14.0,6.0,18.0,12.0,14.0,14.0,15.0,13.0,16.0,14.0,17.0,17.0,12.0,13.0,9.0,13.0,17.0,15.0,17.0,13.0,7.0,20.0,14.0,14.0,9.0,14.0,9.0,15.0,7.0,16.0,7.0,14.0,15.0,17.0,15.0,16.0,17.0,16.0,15.0,4.0,27.0,0.0,0.0,0.0,0.0,186.0,0.0,2.0,3.0,3.0,1.0,2.0,1.0,2.0,3.0,4.0,3.0,3.0,7.0,4.0,13.0,13.0,11.0,7.0,11.0,8.0,1.0,6.0,5.0,9.0,4.0,11.0,7.0,12.0,7.0,10.0,5.0,6.0,13.0,4.0,11.0,10.0,12.0,6.0,7.0,8.0,13.0,13.0,8.0,13.0,9.0,12.0,13.0,20.0,13.0,10.0,10.0,5.0,10.0,10.0,9.0,13.0,10.0,14.0,12.0,11.0,10.0,12.0,2.0,23.0,20.0,3.0,5.0,3.0,178.0,72.0,3.0,3.0,3.0,3.0,2.0,2.0,1.0,2.0,1.0,2.0,1.0,11.0,12.0,15.0,15.0,15.0,11.0,8.0,13.0,7.0,4.0,13.0,14.0,6.0,15.0,9.0,15.0,11.0,14.0,12.0,13.0,14.0,13.0,16.0,7.0,17.0,7.0,10.0,11.0,15.0,15.0,11.0,8.0,10.0,10.0,16.0,20.0,12.0,10.0,11.0,6.0,13.0,12.0,14.0,10.0,16.0,12.0,9.0,12.0,15.0,15.0,8.0,20.0,12.0,0.0,12.0,4.0,181.0,76.0,4.0,4.0,3.0,2.0,2.0,3.0,3.0,3.0,3.0,3.0,4.0,5.0,10.0,17.0,15.0,15.0,7.0,10.0,11.0,2.0,2.0,12.0,14.0,3.0,15.0,8.0,12.0,12.0,13.0,11.0,10.0,12.0,15.0,14.0,5.0,15.0,5.0,12.0,14.0,18.0,16.0,14.0,10.0,11.0,14.0,17.0,20.0,14.0,14.0,12.0,8.0,13.0,8.0,11.0,12.0,18.0,12.0,15.0,16.0,15.0,18.0,7.0,25.0,0.0,0.0,11.0,0.0,189.0,83.0,12.0,12.0,11.0,7.0,13.0,12.0,17.0,17.0,16.0,12.0,13.0,6.0,2.0,1.0,1.0,10.0,10.0,7.0,1.0,1.0,1.0,9.0,5.0,1.0,10.0,8.0,15.0,14.0,14.0,12.0,7.0,13.0,12.0,6.0,9.0,3.0,16.0,17.0,10.0,13.0,16.0,14.0,12.0,8.0,15.0,10.0,20.0,13.0,14.0,14.0,5.0,14.0,4.0,12.0,15.0,15.0,13.0,13.0,17.0,15.0,17.0,4.0,29.0,56.0,3.0,0.0,0.0,189.0,84.0,3.0,2.0,2.0,1.0,2.0,2.0,2.0,2.0,2.0,1.0,3.0,8.0,9.0,13.0,12.0,13.0,14.0,14.0,12.0,18.0,17.0,12.0,15.0,16.0,13.0,17.0,16.0,16.0,12.0,10.0,10.0,11.0,17.0,12.0,15.0,12.0,11.0,13.0,16.0,17.0,15.0,16.0,16.0,10.0,16.0,15.0,20.0,14.0,13.0,10.0,12.0,13.0,10.0,13.0,15.0,16.0,18.0,13.0,16.0,11.0,10.0,7.0,31.0,0.0,0.0,0.0,0.0,171.0,65.0,1.0,3.0,1.0,3.0,2.0,2.0,3.0,1.0,2.0,2.0,3.0,8.0,9.0,11.0,7.0,5.0,6.0,5.0,6.0,7.0,14.0,14.0,6.0,14.0,13.0,14.0,12.0,13.0,12.0,11.0,11.0,12.0,12.0,11.0,7.0,12.0,12.0,12.0,10.0,15.0,15.0,7.0,9.0,9.0,12.0,14.0,20.0,12.0,13.0,11.0,13.0,11.0,9.0,10.0,15.0,14.0,12.0,11.0,14.0,13.0,12.0,7.0,28.0,0.0,0.0,0.0,0.0,169.0,0.0,3.0,3.0,2.0,3.0,3.0,1.0,1.0,3.0,2.0,1.0,3.0,5.0,8.0,11.0,9.0,8.0,8.0,7.0,8.0,4.0,2.0,9.0,5.0,3.0,11.0,11.0,11.0,13.0,9.0,11.0,8.0,15.0,14.0,11.0,7.0,10.0,8.0,8.0,10.0,11.0,11.0,6.0,5.0,14.0,11.0,12.0,20.0,14.0,5.0,9.0,12.0,9.0,5.0,6.0,9.0,12.0,11.0,9.0,9.0,10.0,12.0,11.0,23.0,25.0,0.0,0.0,0.0,174.0,74.0,2.0,1.0,1.0,1.0,3.0,3.0,3.0,3.0,3.0,1.0,2.0,8.0,13.0,12.0,8.0,12.0,8.0,14.0,9.0,13.0,14.0,12.0,6.0,16.0,13.0,13.0,14.0,15.0,13.0,11.0,10.0,12.0,15.0,9.0,10.0,14.0,11.0,14.0,17.0,16.0,13.0,14.0,10.0,8.0,17.0,15.0,20.0,18.0,15.0,14.0,13.0,14.0,8.0,12.0,12.0,14.0,13.0,13.0,12.0,12.0,15.0,13.0,33.0,30.0,1.0,0.0,0.0,187.0,83.0,1.0,3.0,4.0,2.0,1.0,1.0,2.0,3.0,1.0,1.0,3.0,13.0,13.0,12.0,8.0,16.0,10.0,16.0,13.0,10.0,14.0,16.0,13.0,16.0,15.0,13.0,15.0,14.0,16.0,15.0,14.0,14.0,13.0,11.0,13.0,10.0,17.0,18.0,10.0,10.0,12.0,17.0,14.0,20.0,12.0,12.0,10.0,13.0,16.0,16.0,16.0,15.0,13.0,11.0,16.0,16.0,13.0,15.0,12.0,8.0,8.0,11.0,23.0,15.0,1.0,7.0,0.0,165.0,60.0,2.0,3.0,2.0,1.0,1.0,1.0,3.0,3.0,2.0,1.0,3.0,14.0,14.0,16.0,8.0,16.0,13.0,6.0,10.0,6.0,11.0,18.0,15.0,12.0,18.0,16.0,15.0,15.0,17.0,13.0,17.0,15.0,14.0,18.0,12.0,10.0,12.0,15.0,16.0,14.0,16.0,16.0,6.0,12.0,13.0,14.0,20.0,15.0,11.0,16.0,14.0,15.0,10.0,12.0,14.0,15.0,16.0,14.0,14.0,13.0,10.0,6.0,29.0,51.0,8.0,24.0,0.0,175.0,70.0,3.0,4.0,2.0,3.0,2.0,3.0,2.0,2.0,2.0,1.0,3.0,6.0,12.0,12.0,10.0,13.0,7.0,12.0,12.0,8.0,14.0,13.0,9.0,16.0,13.0,14.0,16.0,16.0,15.0,16.0,11.0,14.0,16.0,8.0,14.0,14.0,15.0,18.0,18.0,15.0,14.0,16.0,8.0,20.0,16.0,14.0,8.0,18.0,14.0,16.0,13.0,14.0,7.0,14.0,15.0,14.0,14.0,14.0,16.0,16.0,16.0,5.0,16.0,0.0,0.0,0.0,0.0,173.0,0.0,3.0,1.0,1.0,1.0,2.0,1.0,4.0,1.0,2.0,3.0,1.0,1.0,1.0,4.0,4.0,5.0,4.0,4.0,4.0,1.0,5.0,6.0,5.0,8.0,9.0,10.0,6.0,6.0,3.0,5.0,4.0,10.0,7.0,8.0,8.0,3.0,11.0,13.0,9.0,7.0,5.0,14.0,4.0,20.0,6.0,5.0,8.0,6.0,9.0,5.0,7.0,8.0,5.0,7.0,6.0,11.0,7.0,10.0,18.0,19.0,15.0,9.0,34.0,116.0,62.0,7.0,6.0,195.0,95.0,1.0,1.0,3.0,1.0,1.0,3.0,4.0,1.0,2.0,3.0,2.0,5.0,12.0,15.0,16.0,18.0,14.0,14.0,16.0,8.0,6.0,15.0,18.0,6.0,18.0,16.0,16.0,15.0,13.0,13.0,16.0,14.0,14.0,19.0,16.0,15.0,4.0,13.0,8.0,12.0,15.0,20.0,18.0,16.0,16.0,14.0,20.0,15.0,18.0,16.0,13.0,11.0,11.0,8.0,15.0,20.0,11.0,15.0,14.0,7.0,7.0,13.0,29.0,76.0,27.0,13.0,9.0,188.0,72.0,2.0,3.0,1.0,2.0,3.0,3.0,1.0,3.0,3.0,3.0,3.0,5.0,10.0,13.0,16.0,13.0,11.0,17.0,13.0,5.0,10.0,13.0,14.0,10.0,13.0,15.0,16.0,18.0,14.0,15.0,10.0,13.0,14.0,13.0,10.0,18.0,12.0,14.0,19.0,15.0,14.0,16.0,14.0,10.0,18.0,16.0,20.0,18.0,14.0,14.0,8.0,15.0,5.0,16.0,10.0,16.0,12.0,14.0,16.0,14.0,10.0,10.0
2,2,25.0,0.0,0.0,11.0,0.0,189.0,83.0,12.0,12.0,11.0,7.0,13.0,12.0,17.0,17.0,16.0,12.0,13.0,6.0,2.0,1.0,1.0,10.0,10.0,7.0,1.0,1.0,1.0,9.0,5.0,1.0,10.0,8.0,15.0,14.0,14.0,12.0,7.0,13.0,12.0,6.0,9.0,3.0,16.0,17.0,10.0,13.0,16.0,14.0,12.0,8.0,15.0,10.0,20.0,13.0,14.0,14.0,5.0,14.0,4.0,12.0,15.0,15.0,13.0,13.0,17.0,15.0,17.0,4.0,31.0,0.0,0.0,0.0,0.0,171.0,65.0,1.0,3.0,1.0,3.0,2.0,2.0,3.0,1.0,2.0,2.0,3.0,8.0,9.0,11.0,7.0,5.0,6.0,5.0,6.0,7.0,14.0,14.0,6.0,14.0,13.0,14.0,12.0,13.0,12.0,11.0,11.0,12.0,12.0,11.0,7.0,12.0,12.0,12.0,10.0,15.0,15.0,7.0,9.0,9.0,12.0,14.0,20.0,12.0,13.0,11.0,13.0,11.0,9.0,10.0,15.0,14.0,12.0,11.0,14.0,13.0,12.0,7.0,29.0,0.0,0.0,0.0,0.0,170.0,65.0,2.0,1.0,3.0,3.0,1.0,3.0,2.0,1.0,2.0,3.0,2.0,5.0,11.0,4.0,6.0,7.0,4.0,7.0,5.0,6.0,6.0,6.0,2.0,6.0,7.0,9.0,10.0,13.0,8.0,12.0,8.0,13.0,15.0,2.0,7.0,5.0,9.0,8.0,8.0,12.0,12.0,14.0,4.0,9.0,12.0,11.0,20.0,12.0,5.0,9.0,9.0,9.0,9.0,9.0,10.0,12.0,12.0,12.0,12.0,7.0,5.0,8.0,28.0,0.0,0.0,0.0,0.0,169.0,0.0,3.0,3.0,2.0,3.0,3.0,1.0,1.0,3.0,2.0,1.0,3.0,5.0,8.0,11.0,9.0,8.0,8.0,7.0,8.0,4.0,2.0,9.0,5.0,3.0,11.0,11.0,11.0,13.0,9.0,11.0,8.0,15.0,14.0,11.0,7.0,10.0,8.0,8.0,10.0,11.0,11.0,6.0,5.0,14.0,11.0,12.0,20.0,14.0,5.0,9.0,12.0,9.0,5.0,6.0,9.0,12.0,11.0,9.0,9.0,10.0,12.0,11.0,23.0,25.0,0.0,0.0,0.0,174.0,74.0,2.0,1.0,1.0,1.0,3.0,3.0,3.0,3.0,3.0,1.0,2.0,8.0,13.0,12.0,8.0,12.0,8.0,14.0,9.0,13.0,14.0,12.0,6.0,16.0,13.0,13.0,14.0,15.0,13.0,11.0,10.0,12.0,15.0,9.0,10.0,14.0,11.0,14.0,17.0,16.0,13.0,14.0,10.0,8.0,17.0,15.0,20.0,18.0,15.0,14.0,13.0,14.0,8.0,12.0,12.0,14.0,13.0,13.0,12.0,12.0,15.0,13.0,33.0,30.0,1.0,0.0,0.0,187.0,83.0,1.0,3.0,4.0,2.0,1.0,1.0,2.0,3.0,1.0,1.0,3.0,13.0,13.0,12.0,8.0,16.0,10.0,16.0,13.0,10.0,14.0,16.0,13.0,16.0,15.0,13.0,15.0,14.0,16.0,15.0,14.0,14.0,13.0,11.0,13.0,10.0,17.0,18.0,10.0,10.0,12.0,17.0,14.0,20.0,12.0,12.0,10.0,13.0,16.0,16.0,16.0,15.0,13.0,11.0,16.0,16.0,13.0,15.0,12.0,8.0,8.0,11.0,29.0,51.0,8.0,24.0,0.0,175.0,70.0,3.0,4.0,2.0,3.0,2.0,3.0,2.0,2.0,2.0,1.0,3.0,6.0,12.0,12.0,10.0,13.0,7.0,12.0,12.0,8.0,14.0,13.0,9.0,16.0,13.0,14.0,16.0,16.0,15.0,16.0,11.0,14.0,16.0,8.0,14.0,14.0,15.0,18.0,18.0,15.0,14.0,16.0,8.0,20.0,16.0,14.0,8.0,18.0,14.0,16.0,13.0,14.0,7.0,14.0,15.0,14.0,14.0,14.0,16.0,16.0,16.0,5.0,23.0,15.0,1.0,7.0,0.0,165.0,60.0,2.0,3.0,2.0,1.0,1.0,1.0,3.0,3.0,2.0,1.0,3.0,14.0,14.0,16.0,8.0,16.0,13.0,6.0,10.0,6.0,11.0,18.0,15.0,12.0,18.0,16.0,15.0,15.0,17.0,13.0,17.0,15.0,14.0,18.0,12.0,10.0,12.0,15.0,16.0,14.0,16.0,16.0,6.0,12.0,13.0,14.0,20.0,15.0,11.0,16.0,14.0,15.0,10.0,12.0,14.0,15.0,16.0,14.0,14.0,13.0,10.0,6.0,16.0,0.0,0.0,0.0,0.0,173.0,0.0,3.0,1.0,1.0,1.0,2.0,1.0,4.0,1.0,2.0,3.0,1.0,1.0,1.0,4.0,4.0,5.0,4.0,4.0,4.0,1.0,5.0,6.0,5.0,8.0,9.0,10.0,6.0,6.0,3.0,5.0,4.0,10.0,7.0,8.0,8.0,3.0,11.0,13.0,9.0,7.0,5.0,14.0,4.0,20.0,6.0,5.0,8.0,6.0,9.0,5.0,7.0,8.0,5.0,7.0,6.0,11.0,7.0,10.0,18.0,19.0,15.0,9.0,28.0,66.0,15.0,13.0,3.0,180.0,70.0,2.0,2.0,1.0,2.0,1.0,1.0,3.0,2.0,3.0,3.0,1.0,14.0,15.0,16.0,13.0,17.0,15.0,6.0,15.0,4.0,5.0,16.0,14.0,8.0,17.0,13.0,16.0,11.0,15.0,13.0,16.0,14.0,13.0,17.0,10.0,14.0,9.0,13.0,13.0,16.0,18.0,12.0,10.0,20.0,14.0,15.0,8.0,16.0,9.0,13.0,14.0,12.0,10.0,15.0,14.0,15.0,10.0,16.0,14.0,6.0,12.0,10.0,29.0,76.0,27.0,13.0,9.0,188.0,72.0,2.0,3.0,1.0,2.0,3.0,3.0,1.0,3.0,3.0,3.0,3.0,5.0,10.0,13.0,16.0,13.0,11.0,17.0,13.0,5.0,10.0,13.0,14.0,10.0,13.0,15.0,16.0,18.0,14.0,15.0,10.0,13.0,14.0,13.0,10.0,18.0,12.0,14.0,19.0,15.0,14.0,16.0,14.0,10.0,18.0,16.0,20.0,18.0,14.0,14.0,8.0,15.0,5.0,16.0,10.0,16.0,12.0,14.0,16.0,14.0,10.0,10.0,34.0,1.0,0.0,0.0,0.0,187.0,87.0,13.0,14.0,15.0,7.0,13.0,11.0,14.0,15.0,11.0,17.0,12.0,2.0,1.0,1.0,3.0,8.0,7.0,2.0,1.0,2.0,1.0,9.0,8.0,2.0,6.0,12.0,15.0,17.0,14.0,15.0,8.0,13.0,17.0,7.0,14.0,6.0,14.0,12.0,6.0,7.0,13.0,14.0,13.0,8.0,13.0,8.0,20.0,11.0,16.0,14.0,10.0,14.0,6.0,1.0,12.0,12.0,15.0,16.0,16.0,14.0,15.0,6.0,34.0,0.0,0.0,0.0,0.0,191.0,81.0,14.0,10.0,8.0,3.0,9.0,14.0,13.0,10.0,9.0,3.0,12.0,4.0,3.0,3.0,1.0,1.0,6.0,1.0,1.0,2.0,1.0,2.0,3.0,3.0,3.0,8.0,6.0,10.0,8.0,9.0,5.0,10.0,2.0,1.0,10.0,2.0,10.0,8.0,7.0,10.0,8.0,8.0,16.0,9.0,14.0,9.0,20.0,3.0,9.0,9.0,9.0,1.0,9.0,9.0,20.0,9.0,13.0,12.0,10.0,10.0,12.0,7.0,28.0,0.0,0.0,0.0,0.0,190.0,85.0,3.0,2.0,3.0,3.0,2.0,2.0,2.0,4.0,3.0,1.0,2.0,5.0,9.0,8.0,9.0,8.0,7.0,14.0,10.0,9.0,15.0,9.0,6.0,14.0,9.0,16.0,13.0,16.0,10.0,13.0,10.0,12.0,15.0,6.0,13.0,7.0,13.0,14.0,16.0,12.0,11.0,17.0,13.0,20.0,15.0,13.0,8.0,15.0,15.0,12.0,14.0,14.0,9.0,8.0,14.0,13.0,14.0,11.0,12.0,13.0,16.0,14.0,21.0,0.0,0.0,1.0,0.0,177.0,68.0,4.0,1.0,2.0,1.0,1.0,1.0,1.0,1.0,2.0,1.0,2.0,5.0,12.0,9.0,7.0,12.0,8.0,13.0,10.0,16.0,13.0,12.0,8.0,14.0,12.0,12.0,13.0,12.0,12.0,12.0,10.0,13.0,15.0,11.0,13.0,11.0,13.0,13.0,14.0,13.0,14.0,13.0,11.0,10.0,14.0,12.0,20.0,12.0,14.0,12.0,11.0,12.0,8.0,14.0,13.0,10.0,14.0,12.0,14.0,12.0,11.0,5.0,23.0,0.0,0.0,0.0,0.0,179.0,71.0,2.0,1.0,3.0,3.0,2.0,3.0,2.0,2.0,1.0,3.0,1.0,8.0,10.0,12.0,6.0,12.0,10.0,5.0,10.0,13.0,11.0,11.0,6.0,12.0,11.0,9.0,11.0,12.0,12.0,7.0,10.0,9.0,15.0,12.0,5.0,13.0,8.0,12.0,14.0,16.0,13.0,13.0,10.0,20.0,16.0,15.0,8.0,14.0,14.0,13.0,9.0,14.0,7.0,10.0,7.0,14.0,14.0,13.0,15.0,13.0,13.0,5.0,27.0,27.0,3.0,0.0,0.0,170.0,64.0,2.0,3.0,3.0,3.0,2.0,1.0,3.0,3.0,2.0,2.0,2.0,9.0,11.0,15.0,12.0,13.0,12.0,9.0,12.0,6.0,7.0,12.0,5.0,8.0,15.0,11.0,10.0,9.0,13.0,10.0,11.0,10.0,13.0,16.0,5.0,13.0,8.0,13.0,12.0,15.0,17.0,10.0,7.0,20.0,13.0,13.0,12.0,9.0,10.0,12.0,9.0,12.0,7.0,15.0,11.0,15.0,8.0,12.0,12.0,10.0,12.0,12.0,23.0,39.0,1.0,5.0,2.0,174.0,73.0,3.0,4.0,2.0,1.0,1.0,2.0,4.0,1.0,3.0,2.0,4.0,7.0,6.0,10.0,5.0,11.0,7.0,6.0,8.0,5.0,11.0,12.0,6.0,13.0,11.0,15.0,9.0,16.0,8.0,12.0,10.0,10.0,14.0,10.0,6.0,12.0,11.0,16.0,20.0,15.0,16.0,15.0,9.0,6.0,13.0,14.0,20.0,16.0,14.0,9.0,13.0,13.0,7.0,14.0,14.0,12.0,13.0,12.0,14.0,12.0,14.0,3.0,25.0,19.0,6.0,0.0,0.0,182.0,78.0,1.0,4.0,3.0,1.0,2.0,1.0,2.0,2.0,4.0,1.0,4.0,16.0,13.0,12.0,11.0,12.0,13.0,8.0,12.0,5.0,5.0,13.0,13.0,5.0,15.0,11.0,12.0,12.0,13.0,12.0,15.0,12.0,15.0,14.0,6.0,15.0,9.0,11.0,14.0,15.0,14.0,14.0,10.0,11.0,11.0,14.0,20.0,12.0,13.0,10.0,11.0,15.0,5.0,12.0,10.0,15.0,16.0,11.0,13.0,16.0,16.0,7.0,21.0,0.0,0.0,4.0,1.0,184.0,79.0,1.0,2.0,3.0,1.0,2.0,1.0,3.0,2.0,2.0,1.0,3.0,3.0,6.0,10.0,12.0,12.0,7.0,15.0,8.0,4.0,5.0,13.0,10.0,8.0,12.0,18.0,12.0,19.0,13.0,10.0,13.0,12.0,14.0,13.0,10.0,12.0,9.0,16.0,15.0,12.0,14.0,14.0,14.0,12.0,13.0,10.0,20.0,14.0,14.0,11.0,14.0,14.0,11.0,5.0,10.0,13.0,14.0,15.0,10.0,8.0,4.0,15.0,31.0,0.0,0.0,0.0,0.0,182.0,76.0,3.0,2.0,3.0,4.0,2.0,1.0,2.0,3.0,1.0,2.0,2.0,10.0,13.0,15.0,6.0,14.0,9.0,11.0,8.0,7.0,4.0,12.0,10.0,3.0,14.0,7.0,13.0,10.0,12.0,12.0,12.0,10.0,11.0,12.0,6.0,15.0,6.0,13.0,13.0,14.0,14.0,12.0,10.0,20.0,13.0,13.0,8.0,12.0,11.0,8.0,7.0,14.0,13.0,8.0,8.0,13.0,14.0,12.0,12.0,14.0,14.0,6.0,25.0,9.0,0.0,0.0,0.0,173.0,70.0,1.0,2.0,1.0,2.0,3.0,2.0,1.0,2.0,1.0,4.0,3.0,6.0,8.0,13.0,10.0,14.0,13.0,13.0,13.0,5.0,10.0,13.0,11.0,9.0,15.0,7.0,13.0,13.0,12.0,12.0,12.0,13.0,13.0,15.0,12.0,13.0,7.0,14.0,15.0,13.0,13.0,12.0,10.0,12.0,11.0,13.0,20.0,14.0,13.0,13.0,7.0,13.0,13.0,13.0,8.0,15.0,13.0,12.0,13.0,15.0,15.0,6.0
0,0,25.0,4.0,0.0,11.0,0.0,184.0,81.0,14.0,14.0,13.0,9.0,15.0,12.0,16.0,16.0,13.0,7.0,11.0,8.0,1.0,2.0,1.0,11.0,12.0,6.0,1.0,3.0,3.0,11.0,5.0,3.0,11.0,8.0,15.0,15.0,13.0,14.0,10.0,11.0,14.0,8.0,13.0,5.0,13.0,10.0,10.0,14.0,16.0,14.0,13.0,20.0,14.0,12.0,5.0,14.0,14.0,15.0,9.0,16.0,6.0,1.0,17.0,11.0,15.0,13.0,14.0,12.0,12.0,4.0,22.0,3.0,0.0,7.0,1.0,182.0,75.0,3.0,3.0,1.0,3.0,2.0,3.0,1.0,1.0,2.0,2.0,1.0,4.0,11.0,10.0,6.0,14.0,7.0,13.0,10.0,9.0,16.0,14.0,8.0,15.0,14.0,13.0,17.0,15.0,16.0,14.0,11.0,14.0,15.0,8.0,11.0,10.0,15.0,16.0,14.0,14.0,14.0,14.0,11.0,20.0,15.0,14.0,10.0,15.0,15.0,15.0,12.0,15.0,8.0,11.0,12.0,14.0,16.0,15.0,14.0,14.0,14.0,5.0,27.0,4.0,0.0,5.0,1.0,184.0,83.0,2.0,4.0,3.0,1.0,1.0,2.0,1.0,2.0,4.0,2.0,3.0,4.0,8.0,11.0,4.0,10.0,4.0,14.0,4.0,4.0,15.0,12.0,5.0,16.0,11.0,14.0,14.0,16.0,14.0,10.0,11.0,12.0,17.0,7.0,10.0,9.0,13.0,14.0,15.0,14.0,13.0,16.0,13.0,10.0,15.0,13.0,20.0,15.0,16.0,12.0,12.0,14.0,6.0,12.0,11.0,13.0,12.0,12.0,16.0,15.0,14.0,6.0,32.0,11.0,1.0,0.0,0.0,176.0,68.0,2.0,1.0,3.0,2.0,2.0,2.0,2.0,3.0,3.0,2.0,2.0,8.0,10.0,10.0,7.0,11.0,8.0,10.0,11.0,12.0,11.0,13.0,12.0,14.0,12.0,9.0,14.0,15.0,13.0,12.0,11.0,12.0,17.0,8.0,14.0,14.0,11.0,18.0,18.0,14.0,14.0,12.0,10.0,10.0,14.0,13.0,20.0,17.0,13.0,15.0,9.0,13.0,8.0,13.0,17.0,13.0,15.0,16.0,16.0,16.0,18.0,5.0,32.0,52.0,1.0,0.0,0.0,180.0,80.0,2.0,3.0,2.0,2.0,1.0,4.0,1.0,2.0,3.0,4.0,3.0,7.0,12.0,12.0,6.0,12.0,7.0,12.0,11.0,13.0,13.0,11.0,9.0,13.0,12.0,13.0,13.0,15.0,12.0,10.0,11.0,12.0,16.0,12.0,10.0,13.0,11.0,13.0,14.0,15.0,13.0,14.0,10.0,20.0,12.0,14.0,5.0,15.0,14.0,10.0,13.0,12.0,7.0,8.0,12.0,15.0,13.0,12.0,13.0,14.0,14.0,9.0,27.0,8.0,0.0,6.0,0.0,187.0,76.0,3.0,2.0,3.0,2.0,2.0,1.0,1.0,3.0,3.0,1.0,2.0,5.0,7.0,11.0,5.0,14.0,5.0,14.0,9.0,5.0,15.0,15.0,8.0,14.0,13.0,15.0,16.0,15.0,14.0,12.0,14.0,14.0,18.0,8.0,17.0,9.0,12.0,18.0,15.0,13.0,14.0,15.0,14.0,10.0,17.0,12.0,20.0,17.0,15.0,14.0,13.0,16.0,4.0,12.0,10.0,14.0,17.0,12.0,15.0,13.0,13.0,6.0,24.0,0.0,0.0,6.0,1.0,172.0,70.0,3.0,1.0,1.0,3.0,1.0,2.0,3.0,1.0,1.0,3.0,3.0,11.0,12.0,11.0,8.0,12.0,10.0,6.0,14.0,7.0,11.0,15.0,8.0,12.0,13.0,14.0,14.0,18.0,13.0,12.0,13.0,13.0,15.0,12.0,12.0,12.0,11.0,18.0,18.0,13.0,14.0,13.0,7.0,10.0,16.0,12.0,20.0,14.0,12.0,14.0,14.0,15.0,4.0,8.0,7.0,14.0,14.0,13.0,14.0,12.0,10.0,6.0,21.0,0.0,0.0,15.0,3.0,181.0,78.0,3.0,3.0,4.0,2.0,1.0,2.0,2.0,4.0,2.0,1.0,1.0,5.0,7.0,11.0,10.0,14.0,5.0,14.0,10.0,6.0,13.0,14.0,8.0,14.0,14.0,12.0,14.0,12.0,11.0,10.0,12.0,11.0,16.0,11.0,12.0,14.0,14.0,14.0,14.0,14.0,13.0,14.0,13.0,10.0,16.0,14.0,20.0,16.0,14.0,12.0,10.0,11.0,5.0,19.0,8.0,11.0,14.0,11.0,16.0,13.0,13.0,10.0,31.0,52.0,8.0,0.0,0.0,167.0,58.0,1.0,2.0,2.0,1.0,3.0,2.0,4.0,2.0,1.0,2.0,3.0,15.0,15.0,14.0,7.0,15.0,15.0,6.0,11.0,3.0,4.0,15.0,14.0,7.0,15.0,13.0,12.0,15.0,13.0,14.0,16.0,11.0,17.0,14.0,11.0,12.0,10.0,12.0,14.0,15.0,18.0,10.0,5.0,10.0,16.0,14.0,20.0,13.0,7.0,14.0,13.0,16.0,8.0,12.0,13.0,16.0,14.0,15.0,13.0,9.0,11.0,14.0,28.0,2.0,1.0,0.0,0.0,174.0,66.0,2.0,2.0,2.0,1.0,1.0,3.0,2.0,3.0,3.0,1.0,4.0,6.0,11.0,13.0,15.0,13.0,11.0,14.0,11.0,6.0,5.0,10.0,12.0,5.0,13.0,8.0,14.0,10.0,13.0,14.0,8.0,12.0,12.0,12.0,5.0,14.0,8.0,12.0,11.0,17.0,15.0,11.0,12.0,7.0,14.0,15.0,20.0,13.0,10.0,12.0,8.0,14.0,8.0,8.0,19.0,15.0,12.0,10.0,11.0,13.0,13.0,12.0,25.0,10.0,1.0,11.0,4.0,175.0,73.0,1.0,3.0,3.0,3.0,3.0,3.0,3.0,1.0,2.0,3.0,1.0,5.0,10.0,15.0,17.0,15.0,10.0,11.0,12.0,5.0,5.0,14.0,15.0,5.0,16.0,8.0,15.0,12.0,15.0,14.0,13.0,15.0,15.0,15.0,14.0,14.0,10.0,10.0,12.0,16.0,16.0,15.0,9.0,10.0,15.0,16.0,20.0,13.0,15.0,14.0,8.0,14.0,7.0,10.0,8.0,16.0,17.0,13.0,15.0,15.0,14.0,5.0,33.0,101.0,0.0,0.0,0.0,182.0,87.0,12.0,11.0,15.0,12.0,14.0,13.0,14.0,15.0,15.0,13.0,12.0,9.0,2.0,3.0,8.0,9.0,11.0,10.0,11.0,1.0,3.0,12.0,15.0,8.0,10.0,8.0,14.0,14.0,14.0,12.0,9.0,12.0,16.0,9.0,15.0,2.0,13.0,12.0,6.0,12.0,13.0,14.0,13.0,8.0,13.0,10.0,20.0,12.0,15.0,13.0,8.0,15.0,5.0,1.0,13.0,15.0,13.0,15.0,18.0,18.0,15.0,5.0,33.0,37.0,2.0,0.0,0.0,190.0,86.0,3.0,3.0,1.0,2.0,1.0,1.0,1.0,3.0,1.0,3.0,3.0,4.0,9.0,9.0,8.0,12.0,5.0,16.0,9.0,7.0,15.0,12.0,8.0,15.0,12.0,12.0,15.0,16.0,14.0,14.0,11.0,12.0,14.0,8.0,12.0,8.0,15.0,13.0,12.0,11.0,9.0,15.0,15.0,10.0,12.0,10.0,20.0,12.0,15.0,14.0,12.0,14.0,15.0,8.0,13.0,12.0,13.0,14.0,14.0,14.0,13.0,11.0,32.0,0.0,0.0,0.0,0.0,195.0,89.0,3.0,2.0,3.0,1.0,4.0,2.0,4.0,2.0,3.0,1.0,2.0,3.0,5.0,5.0,11.0,8.0,8.0,14.0,9.0,11.0,15.0,12.0,9.0,13.0,8.0,16.0,13.0,19.0,10.0,14.0,8.0,13.0,16.0,5.0,15.0,10.0,15.0,15.0,14.0,8.0,8.0,16.0,17.0,5.0,11.0,10.0,20.0,13.0,17.0,13.0,12.0,15.0,7.0,5.0,12.0,14.0,14.0,12.0,15.0,8.0,8.0,7.0,24.0,0.0,0.0,0.0,0.0,187.0,93.0,4.0,3.0,2.0,1.0,2.0,2.0,2.0,2.0,1.0,2.0,1.0,4.0,5.0,6.0,6.0,12.0,6.0,15.0,8.0,6.0,15.0,10.0,6.0,13.0,9.0,14.0,13.0,16.0,12.0,14.0,7.0,12.0,15.0,5.0,8.0,6.0,12.0,14.0,15.0,9.0,10.0,18.0,13.0,6.0,14.0,12.0,20.0,15.0,17.0,13.0,14.0,14.0,11.0,10.0,19.0,14.0,15.0,11.0,13.0,14.0,14.0,5.0,25.0,0.0,0.0,26.0,3.0,176.0,64.0,3.0,2.0,2.0,1.0,3.0,3.0,3.0,2.0,1.0,1.0,1.0,12.0,13.0,12.0,7.0,13.0,13.0,11.0,11.0,11.0,14.0,13.0,11.0,14.0,13.0,13.0,13.0,14.0,13.0,13.0,11.0,13.0,17.0,12.0,11.0,10.0,12.0,14.0,14.0,14.0,14.0,12.0,8.0,8.0,17.0,14.0,20.0,15.0,12.0,14.0,12.0,13.0,5.0,12.0,17.0,15.0,15.0,14.0,16.0,15.0,15.0,7.0,23.0,0.0,0.0,1.0,0.0,182.0,71.0,3.0,1.0,2.0,3.0,4.0,2.0,3.0,1.0,2.0,1.0,3.0,9.0,13.0,14.0,8.0,14.0,13.0,12.0,10.0,13.0,14.0,14.0,13.0,15.0,13.0,14.0,14.0,13.0,11.0,12.0,12.0,13.0,16.0,12.0,12.0,15.0,13.0,14.0,15.0,15.0,13.0,14.0,12.0,9.0,16.0,15.0,20.0,15.0,15.0,15.0,10.0,14.0,6.0,12.0,8.0,15.0,14.0,16.0,15.0,15.0,16.0,6.0,32.0,13.0,0.0,19.0,1.0,172.0,72.0,3.0,1.0,3.0,2.0,1.0,2.0,2.0,2.0,3.0,1.0,1.0,7.0,12.0,12.0,5.0,13.0,7.0,6.0,9.0,9.0,12.0,14.0,9.0,14.0,12.0,13.0,14.0,14.0,15.0,15.0,10.0,13.0,17.0,7.0,18.0,8.0,15.0,18.0,15.0,12.0,14.0,12.0,6.0,10.0,16.0,13.0,20.0,15.0,12.0,15.0,9.0,15.0,5.0,10.0,12.0,16.0,14.0,13.0,15.0,18.0,18.0,5.0,36.0,0.0,0.0,3.0,0.0,168.0,72.0,3.0,2.0,1.0,3.0,1.0,3.0,3.0,1.0,3.0,3.0,1.0,11.0,8.0,12.0,5.0,13.0,11.0,8.0,13.0,6.0,12.0,13.0,8.0,14.0,13.0,17.0,14.0,17.0,14.0,15.0,13.0,14.0,17.0,12.0,16.0,10.0,15.0,16.0,14.0,10.0,13.0,14.0,4.0,8.0,16.0,8.0,20.0,12.0,13.0,17.0,14.0,14.0,7.0,10.0,19.0,15.0,14.0,16.0,15.0,9.0,9.0,7.0,28.0,0.0,0.0,0.0,0.0,168.0,65.0,3.0,4.0,1.0,1.0,2.0,3.0,1.0,2.0,2.0,1.0,2.0,14.0,14.0,15.0,8.0,14.0,14.0,9.0,8.0,7.0,8.0,13.0,10.0,7.0,14.0,12.0,12.0,12.0,13.0,13.0,13.0,12.0,15.0,13.0,6.0,11.0,7.0,14.0,14.0,16.0,14.0,10.0,6.0,20.0,13.0,15.0,5.0,13.0,9.0,12.0,12.0,14.0,9.0,6.0,18.0,14.0,14.0,14.0,14.0,13.0,13.0,6.0,21.0,0.0,0.0,9.0,6.0,178.0,72.0,1.0,1.0,1.0,1.0,2.0,3.0,2.0,3.0,3.0,4.0,3.0,5.0,8.0,15.0,13.0,15.0,6.0,11.0,10.0,5.0,3.0,10.0,13.0,3.0,14.0,10.0,12.0,11.0,12.0,10.0,12.0,9.0,12.0,16.0,5.0,14.0,7.0,7.0,11.0,13.0,14.0,13.0,9.0,12.0,13.0,12.0,20.0,13.0,11.0,10.0,10.0,8.0,7.0,8.0,8.0,11.0,11.0,9.0,7.0,13.0,10.0,5.0,23.0,0.0,0.0,1.0,0.0,187.0,77.0,3.0,1.0,3.0,1.0,2.0,2.0,3.0,1.0,3.0,1.0,3.0,6.0,8.0,12.0,12.0,13.0,10.0,12.0,9.0,5.0,6.0,11.0,12.0,6.0,12.0,8.0,11.0,10.0,12.0,8.0,9.0,10.0,5.0,9.0,7.0,14.0,7.0,13.0,9.0,15.0,13.0,14.0,10.0,8.0,12.0,14.0,20.0,12.0,13.0,12.0,8.0,10.0,9.0,11.0,13.0,13.0,12.0,11.0,13.0,11.0,11.0,13.0
1,3,28.0,0.0,0.0,0.0,0.0,186.0,80.0,11.0,13.0,11.0,9.0,13.0,12.0,13.0,15.0,11.0,10.0,7.0,7.0,2.0,3.0,1.0,8.0,10.0,1.0,2.0,3.0,2.0,7.0,2.0,7.0,8.0,8.0,12.0,14.0,11.0,13.0,8.0,13.0,14.0,5.0,11.0,1.0,15.0,11.0,8.0,11.0,13.0,14.0,13.0,20.0,12.0,8.0,5.0,14.0,14.0,13.0,8.0,14.0,10.0,1.0,7.0,13.0,14.0,13.0,16.0,14.0,14.0,6.0,30.0,0.0,0.0,0.0,0.0,187.0,82.0,3.0,3.0,2.0,3.0,3.0,3.0,4.0,3.0,3.0,2.0,2.0,7.0,9.0,5.0,8.0,8.0,6.0,14.0,9.0,11.0,13.0,10.0,3.0,13.0,7.0,15.0,12.0,16.0,8.0,11.0,7.0,12.0,6.0,4.0,8.0,7.0,13.0,13.0,14.0,10.0,11.0,13.0,14.0,5.0,13.0,11.0,20.0,15.0,15.0,12.0,13.0,11.0,11.0,11.0,17.0,11.0,10.0,10.0,13.0,11.0,18.0,5.0,26.0,0.0,0.0,0.0,0.0,181.0,77.0,1.0,3.0,1.0,1.0,3.0,3.0,3.0,1.0,1.0,2.0,3.0,5.0,8.0,8.0,6.0,12.0,6.0,13.0,7.0,7.0,13.0,14.0,7.0,12.0,13.0,12.0,13.0,11.0,14.0,14.0,13.0,13.0,13.0,6.0,10.0,7.0,14.0,13.0,13.0,12.0,11.0,14.0,11.0,7.0,8.0,11.0,20.0,13.0,14.0,12.0,9.0,14.0,14.0,10.0,15.0,13.0,14.0,15.0,15.0,15.0,15.0,6.0,25.0,0.0,0.0,9.0,0.0,183.0,78.0,1.0,3.0,1.0,1.0,1.0,2.0,3.0,2.0,1.0,3.0,2.0,5.0,12.0,10.0,5.0,11.0,6.0,13.0,8.0,10.0,13.0,10.0,6.0,12.0,12.0,13.0,11.0,13.0,10.0,10.0,10.0,9.0,12.0,8.0,7.0,12.0,11.0,12.0,12.0,16.0,13.0,13.0,11.0,20.0,14.0,15.0,7.0,14.0,11.0,11.0,13.0,12.0,6.0,8.0,13.0,15.0,12.0,10.0,8.0,14.0,14.0,10.0,22.0,0.0,0.0,0.0,0.0,180.0,74.0,2.0,4.0,2.0,1.0,3.0,1.0,2.0,1.0,1.0,2.0,3.0,7.0,8.0,10.0,7.0,13.0,10.0,8.0,11.0,5.0,13.0,13.0,12.0,10.0,13.0,12.0,13.0,12.0,12.0,14.0,12.0,12.0,14.0,11.0,7.0,8.0,12.0,14.0,14.0,12.0,12.0,13.0,9.0,14.0,14.0,12.0,20.0,14.0,11.0,14.0,10.0,14.0,8.0,10.0,14.0,14.0,12.0,9.0,12.0,10.0,7.0,7.0,31.0,3.0,1.0,0.0,0.0,180.0,68.0,2.0,1.0,2.0,2.0,1.0,1.0,3.0,2.0,1.0,3.0,2.0,14.0,12.0,13.0,10.0,15.0,13.0,8.0,14.0,7.0,6.0,14.0,6.0,6.0,16.0,9.0,10.0,11.0,12.0,9.0,14.0,11.0,14.0,13.0,7.0,13.0,6.0,10.0,10.0,12.0,12.0,10.0,9.0,12.0,14.0,12.0,20.0,9.0,10.0,12.0,9.0,15.0,8.0,14.0,14.0,8.0,12.0,11.0,10.0,14.0,15.0,5.0,28.0,0.0,0.0,0.0,0.0,170.0,72.0,1.0,2.0,2.0,1.0,2.0,3.0,2.0,2.0,3.0,3.0,1.0,10.0,12.0,13.0,6.0,14.0,8.0,7.0,11.0,8.0,4.0,13.0,11.0,4.0,14.0,8.0,11.0,12.0,11.0,11.0,12.0,12.0,15.0,13.0,6.0,12.0,8.0,12.0,14.0,15.0,15.0,10.0,6.0,5.0,13.0,14.0,20.0,12.0,10.0,14.0,8.0,14.0,9.0,10.0,9.0,12.0,14.0,14.0,14.0,15.0,15.0,6.0,32.0,40.0,5.0,0.0,0.0,176.0,72.0,1.0,3.0,3.0,2.0,2.0,2.0,3.0,4.0,2.0,3.0,3.0,12.0,12.0,13.0,8.0,13.0,13.0,7.0,12.0,5.0,2.0,13.0,12.0,3.0,14.0,6.0,12.0,8.0,11.0,10.0,13.0,10.0,11.0,15.0,5.0,11.0,6.0,11.0,10.0,13.0,13.0,12.0,8.0,20.0,11.0,13.0,10.0,12.0,12.0,12.0,6.0,14.0,12.0,10.0,12.0,10.0,16.0,15.0,13.0,17.0,17.0,5.0,39.0,0.0,0.0,0.0,0.0,178.0,75.0,4.0,3.0,1.0,2.0,2.0,2.0,3.0,3.0,2.0,2.0,1.0,12.0,12.0,13.0,12.0,15.0,12.0,12.0,11.0,6.0,6.0,15.0,15.0,8.0,16.0,7.0,12.0,12.0,13.0,14.0,14.0,12.0,14.0,11.0,12.0,9.0,12.0,12.0,14.0,11.0,12.0,14.0,8.0,10.0,15.0,10.0,20.0,10.0,12.0,15.0,7.0,16.0,6.0,10.0,14.0,14.0,14.0,14.0,14.0,14.0,14.0,6.0,26.0,0.0,0.0,0.0,0.0,173.0,70.0,4.0,3.0,3.0,3.0,2.0,1.0,2.0,2.0,1.0,2.0,3.0,13.0,12.0,12.0,8.0,13.0,11.0,6.0,10.0,6.0,5.0,12.0,10.0,7.0,14.0,12.0,12.0,12.0,12.0,13.0,11.0,11.0,14.0,13.0,7.0,12.0,9.0,12.0,15.0,12.0,14.0,12.0,7.0,20.0,13.0,13.0,6.0,15.0,9.0,13.0,11.0,16.0,7.0,12.0,20.0,13.0,13.0,16.0,14.0,12.0,12.0,6.0,20.0,0.0,0.0,8.0,0.0,170.0,65.0,3.0,1.0,1.0,3.0,2.0,3.0,2.0,2.0,2.0,1.0,3.0,10.0,10.0,13.0,13.0,13.0,10.0,9.0,10.0,3.0,4.0,11.0,12.0,4.0,13.0,12.0,12.0,14.0,11.0,11.0,11.0,11.0,15.0,12.0,7.0,14.0,7.0,12.0,15.0,16.0,16.0,12.0,7.0,7.0,14.0,15.0,20.0,14.0,11.0,13.0,9.0,13.0,8.0,12.0,9.0,13.0,14.0,14.0,15.0,15.0,14.0,6.0,36.0,0.0,0.0,0.0,0.0,185.0,78.0,11.0,14.0,12.0,7.0,13.0,12.0,14.0,15.0,13.0,14.0,10.0,4.0,1.0,3.0,1.0,8.0,8.0,11.0,8.0,3.0,3.0,7.0,2.0,1.0,8.0,11.0,13.0,15.0,11.0,12.0,7.0,13.0,9.0,5.0,14.0,3.0,13.0,15.0,8.0,11.0,14.0,13.0,12.0,5.0,15.0,11.0,20.0,12.0,14.0,13.0,11.0,13.0,8.0,1.0,19.0,14.0,16.0,10.0,17.0,9.0,9.0,11.0,34.0,23.0,1.0,0.0,0.0,186.0,81.0,3.0,3.0,1.0,2.0,1.0,3.0,2.0,3.0,1.0,3.0,3.0,4.0,8.0,6.0,10.0,7.0,8.0,17.0,12.0,10.0,14.0,7.0,9.0,15.0,7.0,15.0,13.0,17.0,8.0,12.0,7.0,12.0,15.0,6.0,17.0,7.0,14.0,15.0,14.0,8.0,10.0,16.0,13.0,12.0,13.0,9.0,20.0,13.0,15.0,11.0,15.0,14.0,9.0,10.0,10.0,14.0,11.0,13.0,15.0,11.0,11.0,12.0,27.0,25.0,1.0,0.0,0.0,189.0,82.0,3.0,1.0,3.0,4.0,3.0,1.0,3.0,3.0,1.0,2.0,3.0,6.0,7.0,5.0,8.0,9.0,8.0,12.0,8.0,6.0,14.0,13.0,11.0,14.0,5.0,12.0,14.0,15.0,13.0,13.0,8.0,13.0,12.0,5.0,11.0,5.0,13.0,15.0,14.0,12.0,12.0,14.0,15.0,6.0,16.0,12.0,20.0,13.0,14.0,11.0,10.0,12.0,5.0,8.0,11.0,13.0,14.0,17.0,8.0,6.0,8.0,13.0,27.0,10.0,0.0,0.0,0.0,181.0,69.0,1.0,1.0,3.0,3.0,3.0,3.0,2.0,3.0,3.0,3.0,1.0,5.0,13.0,10.0,7.0,13.0,9.0,10.0,10.0,12.0,12.0,11.0,7.0,12.0,11.0,11.0,13.0,12.0,11.0,13.0,9.0,9.0,12.0,8.0,7.0,12.0,11.0,11.0,13.0,15.0,13.0,13.0,10.0,20.0,12.0,15.0,8.0,15.0,12.0,13.0,11.0,14.0,13.0,12.0,10.0,14.0,12.0,10.0,11.0,15.0,15.0,7.0,24.0,0.0,0.0,0.0,0.0,179.0,68.0,3.0,2.0,3.0,2.0,1.0,3.0,3.0,1.0,3.0,3.0,1.0,4.0,13.0,9.0,6.0,12.0,9.0,12.0,7.0,8.0,12.0,14.0,8.0,14.0,12.0,15.0,14.0,13.0,14.0,13.0,10.0,12.0,14.0,10.0,9.0,9.0,10.0,13.0,14.0,14.0,12.0,13.0,9.0,9.0,8.0,14.0,20.0,15.0,14.0,11.0,11.0,13.0,10.0,14.0,13.0,14.0,14.0,11.0,16.0,15.0,15.0,6.0,27.0,14.0,1.0,0.0,0.0,183.0,77.0,1.0,2.0,1.0,2.0,3.0,2.0,3.0,2.0,2.0,1.0,1.0,5.0,12.0,9.0,8.0,13.0,10.0,13.0,10.0,6.0,14.0,13.0,6.0,13.0,12.0,14.0,13.0,15.0,11.0,11.0,11.0,11.0,13.0,9.0,8.0,9.0,12.0,14.0,16.0,14.0,12.0,14.0,12.0,7.0,14.0,12.0,20.0,15.0,14.0,14.0,14.0,15.0,7.0,10.0,12.0,13.0,14.0,12.0,13.0,11.0,11.0,7.0,30.0,0.0,0.0,0.0,0.0,167.0,60.0,3.0,1.0,1.0,2.0,3.0,1.0,1.0,3.0,1.0,1.0,3.0,10.0,11.0,12.0,8.0,13.0,10.0,6.0,9.0,10.0,12.0,14.0,9.0,10.0,14.0,11.0,14.0,14.0,14.0,14.0,13.0,14.0,12.0,14.0,11.0,13.0,12.0,15.0,15.0,15.0,14.0,11.0,5.0,11.0,11.0,15.0,20.0,11.0,8.0,14.0,10.0,12.0,13.0,11.0,11.0,12.0,11.0,10.0,12.0,11.0,11.0,2.0,33.0,0.0,0.0,0.0,0.0,187.0,76.0,2.0,2.0,3.0,1.0,1.0,3.0,2.0,1.0,2.0,3.0,2.0,15.0,14.0,14.0,10.0,15.0,13.0,10.0,12.0,7.0,4.0,15.0,13.0,7.0,15.0,6.0,12.0,9.0,14.0,11.0,15.0,12.0,12.0,14.0,12.0,13.0,7.0,13.0,12.0,11.0,12.0,14.0,12.0,14.0,15.0,12.0,20.0,11.0,12.0,12.0,6.0,14.0,6.0,11.0,14.0,13.0,12.0,12.0,15.0,15.0,13.0,9.0,30.0,0.0,0.0,0.0,0.0,178.0,73.0,3.0,4.0,1.0,1.0,2.0,4.0,3.0,2.0,2.0,2.0,3.0,13.0,14.0,12.0,7.0,13.0,12.0,7.0,13.0,5.0,10.0,13.0,9.0,10.0,13.0,11.0,11.0,12.0,12.0,13.0,11.0,14.0,14.0,11.0,7.0,11.0,10.0,13.0,15.0,13.0,15.0,15.0,8.0,20.0,14.0,14.0,8.0,14.0,11.0,13.0,11.0,14.0,8.0,10.0,19.0,12.0,12.0,9.0,12.0,12.0,10.0,10.0,26.0,0.0,0.0,0.0,0.0,193.0,81.0,1.0,3.0,3.0,3.0,3.0,1.0,2.0,2.0,2.0,3.0,3.0,4.0,9.0,14.0,10.0,13.0,12.0,14.0,14.0,5.0,5.0,10.0,12.0,3.0,14.0,8.0,13.0,12.0,9.0,10.0,11.0,11.0,12.0,16.0,5.0,14.0,6.0,9.0,12.0,14.0,13.0,14.0,16.0,14.0,13.0,13.0,20.0,13.0,14.0,10.0,8.0,14.0,9.0,8.0,16.0,16.0,11.0,13.0,11.0,13.0,13.0,10.0,24.0,0.0,0.0,0.0,0.0,182.0,82.0,3.0,3.0,2.0,1.0,1.0,3.0,2.0,2.0,3.0,2.0,2.0,4.0,7.0,13.0,14.0,13.0,12.0,14.0,12.0,5.0,7.0,10.0,14.0,6.0,15.0,13.0,13.0,16.0,8.0,12.0,11.0,11.0,12.0,14.0,7.0,13.0,8.0,12.0,13.0,14.0,14.0,15.0,12.0,10.0,10.0,12.0,20.0,16.0,15.0,12.0,13.0,14.0,10.0,8.0,8.0,13.0,5.0,10.0,11.0,9.0,9.0,13.0
2,0,25.0,0.0,0.0,0.0,0.0,187.0,83.0,11.0,14.0,12.0,8.0,13.0,11.0,14.0,15.0,13.0,13.0,9.0,8.0,1.0,1.0,1.0,11.0,11.0,1.0,2.0,2.0,1.0,10.0,3.0,2.0,11.0,8.0,12.0,14.0,12.0,12.0,10.0,12.0,14.0,6.0,14.0,2.0,12.0,12.0,8.0,13.0,15.0,14.0,13.0,20.0,15.0,11.0,5.0,14.0,13.0,13.0,8.0,8.0,10.0,1.0,9.0,13.0,14.0,12.0,15.0,15.0,15.0,5.0,26.0,11.0,0.0,4.0,0.0,183.0,79.0,3.0,2.0,1.0,2.0,2.0,2.0,3.0,2.0,2.0,2.0,1.0,5.0,7.0,9.0,6.0,10.0,11.0,15.0,11.0,7.0,14.0,10.0,7.0,13.0,10.0,14.0,13.0,15.0,13.0,12.0,10.0,12.0,17.0,8.0,11.0,10.0,13.0,15.0,16.0,13.0,13.0,16.0,13.0,5.0,15.0,13.0,20.0,16.0,15.0,13.0,14.0,15.0,7.0,14.0,16.0,12.0,14.0,14.0,15.0,14.0,14.0,5.0,28.0,0.0,0.0,0.0,0.0,184.0,85.0,2.0,3.0,2.0,1.0,1.0,3.0,2.0,2.0,3.0,1.0,3.0,4.0,8.0,8.0,6.0,12.0,6.0,14.0,8.0,5.0,13.0,12.0,6.0,14.0,12.0,11.0,13.0,14.0,13.0,12.0,11.0,11.0,13.0,7.0,14.0,10.0,15.0,16.0,12.0,12.0,11.0,15.0,12.0,20.0,13.0,11.0,7.0,14.0,16.0,13.0,11.0,13.0,13.0,12.0,15.0,13.0,13.0,14.0,15.0,14.0,14.0,6.0,26.0,0.0,0.0,0.0,0.0,177.0,68.0,4.0,2.0,1.0,2.0,3.0,1.0,1.0,2.0,3.0,3.0,3.0,12.0,13.0,11.0,8.0,13.0,11.0,8.0,10.0,8.0,10.0,13.0,10.0,12.0,13.0,7.0,12.0,10.0,13.0,11.0,15.0,13.0,14.0,11.0,7.0,14.0,10.0,14.0,14.0,13.0,15.0,12.0,9.0,20.0,15.0,14.0,5.0,15.0,8.0,13.0,7.0,14.0,6.0,12.0,11.0,12.0,14.0,13.0,16.0,16.0,16.0,5.0,26.0,14.0,0.0,0.0,0.0,181.0,74.0,2.0,1.0,1.0,1.0,3.0,2.0,3.0,1.0,3.0,3.0,2.0,6.0,13.0,8.0,5.0,12.0,7.0,12.0,8.0,11.0,13.0,12.0,6.0,14.0,10.0,14.0,12.0,14.0,10.0,12.0,8.0,8.0,14.0,6.0,6.0,12.0,11.0,14.0,15.0,16.0,14.0,14.0,11.0,5.0,14.0,14.0,20.0,16.0,14.0,12.0,13.0,14.0,8.0,10.0,8.0,14.0,12.0,13.0,15.0,15.0,15.0,6.0,29.0,0.0,0.0,0.0,0.0,188.0,74.0,1.0,2.0,3.0,3.0,2.0,3.0,1.0,3.0,2.0,1.0,1.0,4.0,8.0,10.0,6.0,13.0,7.0,14.0,9.0,6.0,13.0,12.0,8.0,13.0,13.0,12.0,14.0,13.0,14.0,11.0,13.0,12.0,14.0,6.0,13.0,8.0,14.0,15.0,15.0,9.0,12.0,14.0,14.0,10.0,13.0,10.0,20.0,16.0,12.0,13.0,12.0,15.0,9.0,11.0,11.0,14.0,14.0,12.0,15.0,13.0,13.0,6.0,22.0,18.0,0.0,0.0,0.0,179.0,75.0,1.0,4.0,2.0,1.0,1.0,1.0,3.0,1.0,1.0,3.0,2.0,7.0,8.0,12.0,8.0,13.0,10.0,11.0,12.0,11.0,11.0,11.0,10.0,14.0,13.0,15.0,12.0,15.0,8.0,12.0,10.0,12.0,14.0,12.0,10.0,13.0,12.0,13.0,17.0,14.0,14.0,13.0,10.0,9.0,15.0,15.0,20.0,15.0,14.0,13.0,13.0,12.0,11.0,12.0,13.0,15.0,9.0,10.0,12.0,10.0,10.0,4.0,31.0,0.0,0.0,0.0,0.0,175.0,65.0,3.0,4.0,1.0,1.0,3.0,3.0,3.0,2.0,4.0,3.0,3.0,14.0,13.0,13.0,7.0,14.0,12.0,7.0,12.0,7.0,6.0,14.0,15.0,8.0,15.0,11.0,12.0,13.0,13.0,11.0,14.0,12.0,15.0,13.0,9.0,11.0,10.0,12.0,13.0,14.0,15.0,12.0,7.0,20.0,10.0,13.0,10.0,12.0,9.0,12.0,11.0,15.0,16.0,13.0,8.0,14.0,14.0,14.0,13.0,13.0,13.0,7.0,27.0,0.0,0.0,0.0,0.0,173.0,68.0,2.0,2.0,1.0,1.0,3.0,3.0,1.0,2.0,3.0,4.0,2.0,12.0,12.0,13.0,8.0,13.0,10.0,7.0,8.0,9.0,7.0,12.0,10.0,9.0,14.0,7.0,10.0,8.0,11.0,12.0,12.0,11.0,12.0,13.0,5.0,13.0,10.0,10.0,12.0,14.0,14.0,11.0,7.0,20.0,12.0,15.0,10.0,13.0,8.0,12.0,7.0,13.0,9.0,12.0,18.0,12.0,14.0,11.0,14.0,15.0,15.0,6.0,24.0,24.0,4.0,0.0,0.0,172.0,74.0,2.0,4.0,3.0,2.0,2.0,1.0,2.0,2.0,3.0,2.0,4.0,8.0,9.0,14.0,13.0,14.0,9.0,11.0,10.0,7.0,5.0,12.0,12.0,3.0,13.0,10.0,12.0,12.0,13.0,12.0,11.0,10.0,14.0,13.0,7.0,14.0,9.0,9.0,13.0,16.0,15.0,13.0,6.0,8.0,13.0,16.0,20.0,14.0,12.0,11.0,11.0,13.0,9.0,8.0,9.0,13.0,9.0,11.0,12.0,13.0,10.0,9.0,27.0,33.0,4.0,3.0,0.0,180.0,75.0,2.0,1.0,2.0,1.0,4.0,2.0,1.0,3.0,1.0,1.0,2.0,12.0,11.0,13.0,13.0,11.0,11.0,11.0,10.0,7.0,5.0,10.0,14.0,5.0,14.0,9.0,11.0,12.0,10.0,11.0,12.0,12.0,14.0,13.0,8.0,14.0,8.0,11.0,14.0,16.0,14.0,13.0,10.0,7.0,12.0,15.0,20.0,14.0,12.0,12.0,9.0,13.0,10.0,10.0,9.0,15.0,8.0,9.0,13.0,14.0,14.0,7.0,36.0,0.0,0.0,0.0,0.0,185.0,78.0,11.0,14.0,12.0,7.0,13.0,12.0,14.0,15.0,13.0,14.0,10.0,4.0,1.0,3.0,1.0,8.0,8.0,11.0,8.0,3.0,3.0,7.0,2.0,1.0,8.0,11.0,13.0,15.0,11.0,12.0,7.0,13.0,9.0,5.0,14.0,3.0,13.0,15.0,8.0,11.0,14.0,13.0,12.0,5.0,15.0,11.0,20.0,12.0,14.0,13.0,11.0,13.0,8.0,1.0,19.0,14.0,16.0,10.0,17.0,9.0,9.0,11.0,28.0,0.0,0.0,0.0,0.0,183.0,81.0,1.0,2.0,4.0,1.0,1.0,3.0,2.0,3.0,3.0,3.0,1.0,5.0,5.0,6.0,10.0,12.0,6.0,14.0,8.0,6.0,15.0,11.0,6.0,13.0,12.0,13.0,14.0,16.0,14.0,14.0,10.0,12.0,14.0,5.0,14.0,8.0,14.0,15.0,15.0,9.0,12.0,15.0,13.0,7.0,11.0,12.0,20.0,15.0,15.0,14.0,14.0,14.0,9.0,8.0,14.0,14.0,11.0,13.0,15.0,13.0,15.0,6.0,27.0,25.0,1.0,0.0,0.0,189.0,82.0,3.0,1.0,3.0,4.0,3.0,1.0,3.0,3.0,1.0,2.0,3.0,6.0,7.0,5.0,8.0,9.0,8.0,12.0,8.0,6.0,14.0,13.0,11.0,14.0,5.0,12.0,14.0,15.0,13.0,13.0,8.0,13.0,12.0,5.0,11.0,5.0,13.0,15.0,14.0,12.0,12.0,14.0,15.0,6.0,16.0,12.0,20.0,13.0,14.0,11.0,10.0,12.0,5.0,8.0,11.0,13.0,14.0,17.0,8.0,6.0,8.0,13.0,27.0,10.0,0.0,0.0,0.0,181.0,69.0,1.0,1.0,3.0,3.0,3.0,3.0,2.0,3.0,3.0,3.0,1.0,5.0,13.0,10.0,7.0,13.0,9.0,10.0,10.0,12.0,12.0,11.0,7.0,12.0,11.0,11.0,13.0,12.0,11.0,13.0,9.0,9.0,12.0,8.0,7.0,12.0,11.0,11.0,13.0,15.0,13.0,13.0,10.0,20.0,12.0,15.0,8.0,15.0,12.0,13.0,11.0,14.0,13.0,12.0,10.0,14.0,12.0,10.0,11.0,15.0,15.0,7.0,24.0,0.0,0.0,0.0,0.0,179.0,68.0,3.0,2.0,3.0,2.0,1.0,3.0,3.0,1.0,3.0,3.0,1.0,4.0,13.0,9.0,6.0,12.0,9.0,12.0,7.0,8.0,12.0,14.0,8.0,14.0,12.0,15.0,14.0,13.0,14.0,13.0,10.0,12.0,14.0,10.0,9.0,9.0,10.0,13.0,14.0,14.0,12.0,13.0,9.0,9.0,8.0,14.0,20.0,15.0,14.0,11.0,11.0,13.0,10.0,14.0,13.0,14.0,14.0,11.0,16.0,15.0,15.0,6.0,27.0,14.0,1.0,0.0,0.0,183.0,77.0,1.0,2.0,1.0,2.0,3.0,2.0,3.0,2.0,2.0,1.0,1.0,5.0,12.0,9.0,8.0,13.0,10.0,13.0,10.0,6.0,14.0,13.0,6.0,13.0,12.0,14.0,13.0,15.0,11.0,11.0,11.0,11.0,13.0,9.0,8.0,9.0,12.0,14.0,16.0,14.0,12.0,14.0,12.0,7.0,14.0,12.0,20.0,15.0,14.0,14.0,14.0,15.0,7.0,10.0,12.0,13.0,14.0,12.0,13.0,11.0,11.0,7.0,33.0,0.0,0.0,0.0,0.0,187.0,76.0,2.0,2.0,3.0,1.0,1.0,3.0,2.0,1.0,2.0,3.0,2.0,15.0,14.0,14.0,10.0,15.0,13.0,10.0,12.0,7.0,4.0,15.0,13.0,7.0,15.0,6.0,12.0,9.0,14.0,11.0,15.0,12.0,12.0,14.0,12.0,13.0,7.0,13.0,12.0,11.0,12.0,14.0,12.0,14.0,15.0,12.0,20.0,11.0,12.0,12.0,6.0,14.0,6.0,11.0,14.0,13.0,12.0,12.0,15.0,15.0,13.0,9.0,23.0,27.0,1.0,0.0,0.0,178.0,70.0,1.0,2.0,1.0,4.0,1.0,1.0,1.0,3.0,2.0,1.0,1.0,8.0,11.0,13.0,11.0,13.0,12.0,7.0,14.0,6.0,5.0,12.0,10.0,5.0,14.0,11.0,11.0,12.0,11.0,9.0,13.0,10.0,14.0,14.0,5.0,13.0,7.0,10.0,12.0,15.0,14.0,12.0,9.0,20.0,13.0,13.0,8.0,13.0,13.0,12.0,11.0,11.0,10.0,11.0,12.0,12.0,12.0,11.0,10.0,10.0,10.0,6.0,30.0,0.0,0.0,0.0,0.0,178.0,73.0,3.0,4.0,1.0,1.0,2.0,4.0,3.0,2.0,2.0,2.0,3.0,13.0,14.0,12.0,7.0,13.0,12.0,7.0,13.0,5.0,10.0,13.0,9.0,10.0,13.0,11.0,11.0,12.0,12.0,13.0,11.0,14.0,14.0,11.0,7.0,11.0,10.0,13.0,15.0,13.0,15.0,15.0,8.0,20.0,14.0,14.0,8.0,14.0,11.0,13.0,11.0,14.0,8.0,10.0,19.0,12.0,12.0,9.0,12.0,12.0,10.0,10.0,26.0,0.0,0.0,0.0,0.0,193.0,81.0,1.0,3.0,3.0,3.0,3.0,1.0,2.0,2.0,2.0,3.0,3.0,4.0,9.0,14.0,10.0,13.0,12.0,14.0,14.0,5.0,5.0,10.0,12.0,3.0,14.0,8.0,13.0,12.0,9.0,10.0,11.0,11.0,12.0,16.0,5.0,14.0,6.0,9.0,12.0,14.0,13.0,14.0,16.0,14.0,13.0,13.0,20.0,13.0,14.0,10.0,8.0,14.0,9.0,8.0,16.0,16.0,11.0,13.0,11.0,13.0,13.0,10.0,26.0,1.0,0.0,0.0,0.0,180.0,73.0,2.0,3.0,2.0,1.0,3.0,1.0,1.0,1.0,2.0,3.0,3.0,6.0,12.0,13.0,12.0,13.0,12.0,7.0,11.0,6.0,4.0,11.0,12.0,5.0,14.0,7.0,12.0,9.0,12.0,12.0,8.0,10.0,16.0,13.0,5.0,13.0,7.0,9.0,14.0,16.0,14.0,13.0,10.0,20.0,13.0,15.0,6.0,13.0,13.0,10.0,7.0,13.0,7.0,8.0,12.0,14.0,15.0,13.0,12.0,14.0,14.0,9.0
1,4,28.0,0.0,0.0,6.0,0.0,191.0,81.0,11.0,10.0,14.0,8.0,13.0,12.0,14.0,15.0,11.0,8.0,13.0,4.0,3.0,2.0,1.0,9.0,9.0,3.0,10.0,1.0,1.0,8.0,3.0,3.0,9.0,8.0,12.0,14.0,12.0,13.0,8.0,11.0,12.0,6.0,14.0,2.0,12.0,10.0,7.0,13.0,14.0,16.0,15.0,6.0,14.0,11.0,20.0,15.0,14.0,12.0,9.0,14.0,7.0,1.0,9.0,15.0,13.0,11.0,15.0,15.0,14.0,8.0,32.0,67.0,9.0,7.0,0.0,191.0,85.0,1.0,1.0,1.0,3.0,2.0,2.0,4.0,3.0,3.0,2.0,3.0,7.0,7.0,6.0,9.0,12.0,3.0,16.0,7.0,3.0,15.0,11.0,7.0,13.0,12.0,14.0,11.0,14.0,10.0,11.0,10.0,14.0,11.0,8.0,13.0,13.0,13.0,13.0,15.0,9.0,7.0,14.0,16.0,8.0,7.0,10.0,20.0,12.0,15.0,13.0,14.0,5.0,6.0,11.0,8.0,11.0,9.0,12.0,11.0,6.0,9.0,11.0,32.0,93.0,1.0,0.0,0.0,186.0,85.0,3.0,2.0,3.0,2.0,1.0,2.0,2.0,1.0,2.0,1.0,2.0,5.0,8.0,8.0,9.0,10.0,10.0,15.0,13.0,14.0,11.0,13.0,11.0,14.0,11.0,17.0,14.0,19.0,15.0,14.0,10.0,11.0,20.0,8.0,18.0,11.0,15.0,17.0,15.0,10.0,9.0,13.0,13.0,8.0,15.0,11.0,20.0,12.0,13.0,11.0,18.0,15.0,4.0,14.0,18.0,15.0,14.0,15.0,17.0,12.0,12.0,7.0,27.0,0.0,0.0,0.0,0.0,172.0,67.0,3.0,3.0,2.0,3.0,3.0,4.0,1.0,3.0,3.0,3.0,2.0,8.0,12.0,11.0,5.0,11.0,7.0,8.0,10.0,11.0,7.0,11.0,8.0,12.0,12.0,13.0,11.0,13.0,9.0,8.0,11.0,11.0,13.0,8.0,6.0,12.0,10.0,12.0,14.0,16.0,13.0,11.0,7.0,20.0,14.0,15.0,8.0,14.0,8.0,13.0,13.0,15.0,11.0,12.0,11.0,12.0,12.0,12.0,16.0,16.0,16.0,7.0,26.0,10.0,1.0,0.0,0.0,175.0,65.0,4.0,1.0,2.0,2.0,2.0,3.0,3.0,1.0,3.0,2.0,3.0,11.0,13.0,13.0,7.0,13.0,7.0,6.0,11.0,13.0,10.0,12.0,8.0,11.0,14.0,12.0,11.0,12.0,10.0,10.0,12.0,10.0,10.0,13.0,10.0,13.0,10.0,13.0,12.0,14.0,15.0,13.0,10.0,20.0,12.0,13.0,8.0,14.0,7.0,12.0,6.0,10.0,5.0,13.0,10.0,13.0,8.0,11.0,14.0,11.0,13.0,7.0,21.0,0.0,0.0,0.0,0.0,178.0,65.0,2.0,3.0,3.0,3.0,3.0,1.0,1.0,1.0,1.0,3.0,1.0,9.0,13.0,11.0,6.0,12.0,7.0,9.0,8.0,8.0,13.0,12.0,7.0,13.0,12.0,8.0,12.0,13.0,12.0,12.0,13.0,13.0,14.0,9.0,8.0,12.0,12.0,13.0,13.0,12.0,14.0,13.0,11.0,8.0,15.0,12.0,20.0,13.0,12.0,14.0,8.0,11.0,7.0,10.0,19.0,10.0,13.0,10.0,11.0,15.0,15.0,6.0,24.0,8.0,0.0,0.0,0.0,182.0,76.0,2.0,3.0,2.0,1.0,2.0,3.0,3.0,3.0,2.0,1.0,2.0,8.0,11.0,10.0,8.0,12.0,9.0,13.0,11.0,5.0,13.0,13.0,10.0,12.0,12.0,10.0,14.0,12.0,13.0,12.0,13.0,12.0,14.0,6.0,10.0,12.0,14.0,15.0,14.0,13.0,12.0,11.0,12.0,7.0,15.0,13.0,20.0,14.0,14.0,14.0,10.0,14.0,7.0,8.0,2.0,12.0,16.0,13.0,14.0,14.0,14.0,6.0,21.0,0.0,0.0,0.0,0.0,172.0,66.0,2.0,3.0,2.0,2.0,1.0,1.0,1.0,3.0,2.0,1.0,1.0,10.0,10.0,13.0,9.0,14.0,9.0,8.0,10.0,7.0,13.0,13.0,9.0,12.0,13.0,10.0,12.0,13.0,13.0,12.0,14.0,13.0,13.0,11.0,9.0,14.0,13.0,14.0,14.0,14.0,13.0,12.0,8.0,8.0,12.0,12.0,20.0,13.0,12.0,14.0,10.0,11.0,8.0,12.0,15.0,10.0,15.0,8.0,11.0,14.0,14.0,6.0,29.0,52.0,2.0,0.0,0.0,178.0,75.0,1.0,1.0,1.0,1.0,3.0,3.0,2.0,3.0,1.0,2.0,2.0,10.0,12.0,12.0,11.0,12.0,11.0,8.0,11.0,7.0,11.0,13.0,12.0,9.0,13.0,12.0,9.0,13.0,9.0,12.0,13.0,10.0,16.0,7.0,9.0,14.0,13.0,15.0,16.0,13.0,13.0,12.0,10.0,8.0,15.0,13.0,20.0,15.0,11.0,10.0,13.0,14.0,3.0,13.0,13.0,15.0,8.0,13.0,16.0,12.0,14.0,3.0,24.0,0.0,0.0,0.0,0.0,172.0,72.0,1.0,1.0,3.0,2.0,2.0,1.0,1.0,1.0,1.0,3.0,1.0,10.0,11.0,12.0,10.0,11.0,8.0,8.0,10.0,7.0,7.0,11.0,11.0,6.0,12.0,8.0,11.0,11.0,10.0,10.0,11.0,12.0,15.0,12.0,5.0,10.0,11.0,13.0,15.0,15.0,13.0,10.0,9.0,8.0,14.0,13.0,20.0,14.0,11.0,11.0,8.0,13.0,7.0,12.0,18.0,13.0,10.0,10.0,11.0,11.0,11.0,6.0,24.0,4.0,1.0,0.0,0.0,188.0,79.0,2.0,3.0,2.0,1.0,2.0,1.0,1.0,2.0,1.0,2.0,2.0,10.0,11.0,13.0,12.0,11.0,9.0,13.0,9.0,5.0,8.0,11.0,11.0,7.0,13.0,10.0,12.0,11.0,11.0,12.0,13.0,11.0,14.0,12.0,9.0,12.0,12.0,14.0,14.0,12.0,13.0,15.0,14.0,8.0,13.0,12.0,20.0,13.0,14.0,11.0,9.0,10.0,5.0,10.0,14.0,12.0,13.0,10.0,14.0,13.0,12.0,10.0,25.0,0.0,0.0,11.0,0.0,189.0,83.0,12.0,12.0,11.0,7.0,13.0,12.0,17.0,17.0,16.0,12.0,13.0,6.0,2.0,1.0,1.0,10.0,10.0,7.0,1.0,1.0,1.0,9.0,5.0,1.0,10.0,8.0,15.0,14.0,14.0,12.0,7.0,13.0,12.0,6.0,9.0,3.0,16.0,17.0,10.0,13.0,16.0,14.0,12.0,8.0,15.0,10.0,20.0,13.0,14.0,14.0,5.0,14.0,4.0,12.0,15.0,15.0,13.0,13.0,17.0,15.0,17.0,4.0,29.0,0.0,0.0,0.0,0.0,170.0,65.0,2.0,1.0,3.0,3.0,1.0,3.0,2.0,1.0,2.0,3.0,2.0,5.0,11.0,4.0,6.0,7.0,4.0,7.0,5.0,6.0,6.0,6.0,2.0,6.0,7.0,9.0,10.0,13.0,8.0,12.0,8.0,13.0,15.0,2.0,7.0,5.0,9.0,8.0,8.0,12.0,12.0,14.0,4.0,9.0,12.0,11.0,20.0,12.0,5.0,9.0,9.0,9.0,9.0,9.0,10.0,12.0,12.0,12.0,12.0,7.0,5.0,8.0,31.0,0.0,0.0,0.0,0.0,171.0,65.0,1.0,3.0,1.0,3.0,2.0,2.0,3.0,1.0,2.0,2.0,3.0,8.0,9.0,11.0,7.0,5.0,6.0,5.0,6.0,7.0,14.0,14.0,6.0,14.0,13.0,14.0,12.0,13.0,12.0,11.0,11.0,12.0,12.0,11.0,7.0,12.0,12.0,12.0,10.0,15.0,15.0,7.0,9.0,9.0,12.0,14.0,20.0,12.0,13.0,11.0,13.0,11.0,9.0,10.0,15.0,14.0,12.0,11.0,14.0,13.0,12.0,7.0,23.0,25.0,0.0,0.0,0.0,174.0,74.0,2.0,1.0,1.0,1.0,3.0,3.0,3.0,3.0,3.0,1.0,2.0,8.0,13.0,12.0,8.0,12.0,8.0,14.0,9.0,13.0,14.0,12.0,6.0,16.0,13.0,13.0,14.0,15.0,13.0,11.0,10.0,12.0,15.0,9.0,10.0,14.0,11.0,14.0,17.0,16.0,13.0,14.0,10.0,8.0,17.0,15.0,20.0,18.0,15.0,14.0,13.0,14.0,8.0,12.0,12.0,14.0,13.0,13.0,12.0,12.0,15.0,13.0,23.0,2.0,0.0,5.0,3.0,182.0,73.0,3.0,1.0,1.0,1.0,2.0,1.0,2.0,1.0,3.0,4.0,2.0,12.0,14.0,14.0,10.0,13.0,12.0,16.0,11.0,13.0,12.0,13.0,13.0,14.0,14.0,12.0,11.0,14.0,13.0,11.0,13.0,11.0,15.0,15.0,9.0,15.0,10.0,14.0,15.0,16.0,15.0,13.0,13.0,20.0,14.0,15.0,6.0,15.0,12.0,13.0,9.0,13.0,14.0,15.0,17.0,15.0,13.0,12.0,12.0,15.0,13.0,9.0,25.0,0.0,0.0,14.0,0.0,180.0,82.0,1.0,3.0,3.0,1.0,3.0,2.0,3.0,1.0,1.0,3.0,1.0,5.0,10.0,10.0,7.0,13.0,7.0,12.0,8.0,10.0,14.0,12.0,8.0,17.0,13.0,13.0,16.0,16.0,14.0,15.0,10.0,12.0,15.0,8.0,13.0,10.0,14.0,18.0,15.0,10.0,12.0,16.0,11.0,10.0,15.0,12.0,20.0,16.0,15.0,17.0,10.0,16.0,6.0,10.0,12.0,16.0,12.0,13.0,17.0,14.0,14.0,5.0,23.0,15.0,1.0,7.0,0.0,165.0,60.0,2.0,3.0,2.0,1.0,1.0,1.0,3.0,3.0,2.0,1.0,3.0,14.0,14.0,16.0,8.0,16.0,13.0,6.0,10.0,6.0,11.0,18.0,15.0,12.0,18.0,16.0,15.0,15.0,17.0,13.0,17.0,15.0,14.0,18.0,12.0,10.0,12.0,15.0,16.0,14.0,16.0,16.0,6.0,12.0,13.0,14.0,20.0,15.0,11.0,16.0,14.0,15.0,10.0,12.0,14.0,15.0,16.0,14.0,14.0,13.0,10.0,6.0,28.0,66.0,15.0,13.0,3.0,180.0,70.0,2.0,2.0,1.0,2.0,1.0,1.0,3.0,2.0,3.0,3.0,1.0,14.0,15.0,16.0,13.0,17.0,15.0,6.0,15.0,4.0,5.0,16.0,14.0,8.0,17.0,13.0,16.0,11.0,15.0,13.0,16.0,14.0,13.0,17.0,10.0,14.0,9.0,13.0,13.0,16.0,18.0,12.0,10.0,20.0,14.0,15.0,8.0,16.0,9.0,13.0,14.0,12.0,10.0,15.0,14.0,15.0,10.0,16.0,14.0,6.0,12.0,10.0,16.0,0.0,0.0,0.0,0.0,173.0,0.0,3.0,1.0,1.0,1.0,2.0,1.0,4.0,1.0,2.0,3.0,1.0,1.0,1.0,4.0,4.0,5.0,4.0,4.0,4.0,1.0,5.0,6.0,5.0,8.0,9.0,10.0,6.0,6.0,3.0,5.0,4.0,10.0,7.0,8.0,8.0,3.0,11.0,13.0,9.0,7.0,5.0,14.0,4.0,20.0,6.0,5.0,8.0,6.0,9.0,5.0,7.0,8.0,5.0,7.0,6.0,11.0,7.0,10.0,18.0,19.0,15.0,9.0,27.0,10.0,0.0,0.0,0.0,187.0,75.0,2.0,2.0,4.0,3.0,3.0,3.0,2.0,3.0,4.0,2.0,1.0,13.0,13.0,15.0,11.0,18.0,13.0,8.0,13.0,4.0,3.0,17.0,14.0,4.0,17.0,10.0,13.0,9.0,14.0,12.0,17.0,13.0,12.0,18.0,8.0,14.0,6.0,14.0,9.0,15.0,16.0,12.0,12.0,14.0,12.0,14.0,20.0,12.0,11.0,13.0,8.0,13.0,13.0,10.0,11.0,17.0,13.0,12.0,14.0,15.0,15.0,8.0,34.0,116.0,62.0,7.0,6.0,195.0,95.0,1.0,1.0,3.0,1.0,1.0,3.0,4.0,1.0,2.0,3.0,2.0,5.0,12.0,15.0,16.0,18.0,14.0,14.0,16.0,8.0,6.0,15.0,18.0,6.0,18.0,16.0,16.0,15.0,13.0,13.0,16.0,14.0,14.0,19.0,16.0,15.0,4.0,13.0,8.0,12.0,15.0,20.0,18.0,16.0,16.0,14.0,20.0,15.0,18.0,16.0,13.0,11.0,11.0,8.0,15.0,20.0,11.0,15.0,14.0,7.0,7.0,13.0
3,1,34.0,1.0,0.0,0.0,0.0,187.0,87.0,13.0,14.0,15.0,7.0,13.0,11.0,14.0,15.0,11.0,17.0,12.0,2.0,1.0,1.0,3.0,8.0,7.0,2.0,1.0,2.0,1.0,9.0,8.0,2.0,6.0,12.0,15.0,17.0,14.0,15.0,8.0,13.0,17.0,7.0,14.0,6.0,14.0,12.0,6.0,7.0,13.0,14.0,13.0,8.0,13.0,8.0,20.0,11.0,16.0,14.0,10.0,14.0,6.0,1.0,12.0,12.0,15.0,16.0,16.0,14.0,15.0,6.0,34.0,0.0,0.0,0.0,0.0,191.0,81.0,14.0,10.0,8.0,3.0,9.0,14.0,13.0,10.0,9.0,3.0,12.0,4.0,3.0,3.0,1.0,1.0,6.0,1.0,1.0,2.0,1.0,2.0,3.0,3.0,3.0,8.0,6.0,10.0,8.0,9.0,5.0,10.0,2.0,1.0,10.0,2.0,10.0,8.0,7.0,10.0,8.0,8.0,16.0,9.0,14.0,9.0,20.0,3.0,9.0,9.0,9.0,1.0,9.0,9.0,20.0,9.0,13.0,12.0,10.0,10.0,12.0,7.0,28.0,0.0,0.0,0.0,0.0,190.0,85.0,3.0,2.0,3.0,3.0,2.0,2.0,2.0,4.0,3.0,1.0,2.0,5.0,9.0,8.0,9.0,8.0,7.0,14.0,10.0,9.0,15.0,9.0,6.0,14.0,9.0,16.0,13.0,16.0,10.0,13.0,10.0,12.0,15.0,6.0,13.0,7.0,13.0,14.0,16.0,12.0,11.0,17.0,13.0,20.0,15.0,13.0,8.0,15.0,15.0,12.0,14.0,14.0,9.0,8.0,14.0,13.0,14.0,11.0,12.0,13.0,16.0,14.0,29.0,0.0,0.0,0.0,0.0,182.0,76.0,1.0,4.0,2.0,3.0,1.0,1.0,1.0,2.0,2.0,1.0,1.0,7.0,12.0,11.0,9.0,11.0,12.0,7.0,12.0,8.0,12.0,13.0,8.0,12.0,13.0,14.0,12.0,14.0,10.0,13.0,12.0,12.0,13.0,15.0,8.0,11.0,12.0,13.0,13.0,11.0,12.0,11.0,12.0,20.0,10.0,11.0,10.0,14.0,11.0,13.0,11.0,10.0,11.0,10.0,14.0,15.0,13.0,9.0,14.0,12.0,13.0,6.0,23.0,0.0,0.0,0.0,0.0,179.0,71.0,2.0,1.0,3.0,3.0,2.0,3.0,2.0,2.0,1.0,3.0,1.0,8.0,10.0,12.0,6.0,12.0,10.0,5.0,10.0,13.0,11.0,11.0,6.0,12.0,11.0,9.0,11.0,12.0,12.0,7.0,10.0,9.0,15.0,12.0,5.0,13.0,8.0,12.0,14.0,16.0,13.0,13.0,10.0,20.0,16.0,15.0,8.0,14.0,14.0,13.0,9.0,14.0,7.0,10.0,7.0,14.0,14.0,13.0,15.0,13.0,13.0,5.0,34.0,103.0,7.0,16.0,1.0,182.0,72.0,2.0,1.0,1.0,1.0,3.0,1.0,4.0,3.0,3.0,2.0,1.0,11.0,13.0,12.0,8.0,15.0,13.0,9.0,13.0,6.0,8.0,15.0,12.0,8.0,15.0,11.0,14.0,13.0,15.0,15.0,14.0,16.0,17.0,15.0,14.0,11.0,13.0,17.0,13.0,8.0,11.0,10.0,11.0,16.0,13.0,8.0,20.0,12.0,10.0,15.0,11.0,12.0,12.0,15.0,14.0,12.0,15.0,15.0,18.0,14.0,14.0,7.0,28.0,1.0,0.0,7.0,0.0,181.0,71.0,2.0,2.0,1.0,3.0,1.0,3.0,3.0,2.0,3.0,3.0,3.0,12.0,11.0,10.0,5.0,13.0,11.0,8.0,10.0,8.0,9.0,14.0,11.0,12.0,13.0,14.0,14.0,12.0,12.0,13.0,12.0,13.0,12.0,8.0,9.0,9.0,12.0,17.0,15.0,11.0,13.0,14.0,10.0,12.0,13.0,12.0,20.0,16.0,12.0,13.0,14.0,16.0,12.0,9.0,10.0,14.0,16.0,14.0,13.0,12.0,12.0,14.0,25.0,19.0,6.0,0.0,0.0,182.0,78.0,1.0,4.0,3.0,1.0,2.0,1.0,2.0,2.0,4.0,1.0,4.0,16.0,13.0,12.0,11.0,12.0,13.0,8.0,12.0,5.0,5.0,13.0,13.0,5.0,15.0,11.0,12.0,12.0,13.0,12.0,15.0,12.0,15.0,14.0,6.0,15.0,9.0,11.0,14.0,15.0,14.0,14.0,10.0,11.0,11.0,14.0,20.0,12.0,13.0,10.0,11.0,15.0,5.0,12.0,10.0,15.0,16.0,11.0,13.0,16.0,16.0,7.0,23.0,21.0,3.0,9.0,4.0,176.0,69.0,1.0,2.0,1.0,3.0,3.0,1.0,2.0,1.0,1.0,2.0,3.0,9.0,9.0,14.0,13.0,14.0,10.0,10.0,9.0,3.0,5.0,12.0,14.0,6.0,15.0,9.0,13.0,9.0,11.0,10.0,12.0,12.0,13.0,14.0,10.0,13.0,8.0,8.0,10.0,16.0,15.0,10.0,8.0,10.0,12.0,15.0,20.0,13.0,10.0,9.0,8.0,13.0,11.0,13.0,7.0,14.0,12.0,13.0,8.0,14.0,13.0,8.0,31.0,0.0,0.0,0.0,0.0,182.0,76.0,3.0,2.0,3.0,4.0,2.0,1.0,2.0,3.0,1.0,2.0,2.0,10.0,13.0,15.0,6.0,14.0,9.0,11.0,8.0,7.0,4.0,12.0,10.0,3.0,14.0,7.0,13.0,10.0,12.0,12.0,12.0,10.0,11.0,12.0,6.0,15.0,6.0,13.0,13.0,14.0,14.0,12.0,10.0,20.0,13.0,13.0,8.0,12.0,11.0,8.0,7.0,14.0,13.0,8.0,8.0,13.0,14.0,12.0,12.0,14.0,14.0,6.0,25.0,9.0,0.0,0.0,0.0,173.0,70.0,1.0,2.0,1.0,2.0,3.0,2.0,1.0,2.0,1.0,4.0,3.0,6.0,8.0,13.0,10.0,14.0,13.0,13.0,13.0,5.0,10.0,13.0,11.0,9.0,15.0,7.0,13.0,13.0,12.0,12.0,12.0,13.0,13.0,15.0,12.0,13.0,7.0,14.0,15.0,13.0,13.0,12.0,10.0,12.0,11.0,13.0,20.0,14.0,13.0,13.0,7.0,13.0,13.0,13.0,8.0,15.0,13.0,12.0,13.0,15.0,15.0,6.0,25.0,4.0,0.0,11.0,0.0,184.0,81.0,14.0,14.0,13.0,9.0,15.0,12.0,16.0,16.0,13.0,7.0,11.0,8.0,1.0,2.0,1.0,11.0,12.0,6.0,1.0,3.0,3.0,11.0,5.0,3.0,11.0,8.0,15.0,15.0,13.0,14.0,10.0,11.0,14.0,8.0,13.0,5.0,13.0,10.0,10.0,14.0,16.0,14.0,13.0,20.0,14.0,12.0,5.0,14.0,14.0,15.0,9.0,16.0,6.0,1.0,17.0,11.0,15.0,13.0,14.0,12.0,12.0,4.0,24.0,0.0,0.0,4.0,0.0,186.0,88.0,1.0,2.0,1.0,3.0,2.0,1.0,1.0,2.0,1.0,2.0,1.0,4.0,8.0,8.0,6.0,12.0,6.0,14.0,9.0,11.0,14.0,12.0,6.0,12.0,12.0,14.0,13.0,14.0,12.0,13.0,8.0,12.0,13.0,8.0,8.0,9.0,12.0,12.0,13.0,13.0,11.0,15.0,13.0,8.0,15.0,14.0,20.0,14.0,15.0,13.0,14.0,15.0,8.0,12.0,14.0,14.0,12.0,9.0,12.0,13.0,13.0,8.0,22.0,3.0,0.0,7.0,1.0,182.0,75.0,3.0,3.0,1.0,3.0,2.0,3.0,1.0,1.0,2.0,2.0,1.0,4.0,11.0,10.0,6.0,14.0,7.0,13.0,10.0,9.0,16.0,14.0,8.0,15.0,14.0,13.0,17.0,15.0,16.0,14.0,11.0,14.0,15.0,8.0,11.0,10.0,15.0,16.0,14.0,14.0,14.0,14.0,11.0,20.0,15.0,14.0,10.0,15.0,15.0,15.0,12.0,15.0,8.0,11.0,12.0,14.0,16.0,15.0,14.0,14.0,14.0,5.0,19.0,0.0,0.0,3.0,1.0,181.0,69.0,3.0,2.0,3.0,3.0,2.0,1.0,1.0,1.0,3.0,3.0,4.0,10.0,10.0,12.0,12.0,12.0,7.0,8.0,11.0,5.0,7.0,10.0,10.0,7.0,11.0,8.0,10.0,10.0,12.0,8.0,11.0,8.0,14.0,13.0,6.0,14.0,8.0,13.0,13.0,16.0,14.0,13.0,9.0,20.0,15.0,16.0,10.0,15.0,13.0,12.0,8.0,11.0,7.0,12.0,11.0,11.0,15.0,10.0,12.0,14.0,14.0,1.0,32.0,11.0,1.0,0.0,0.0,176.0,68.0,2.0,1.0,3.0,2.0,2.0,2.0,2.0,3.0,3.0,2.0,2.0,8.0,10.0,10.0,7.0,11.0,8.0,10.0,11.0,12.0,11.0,13.0,12.0,14.0,12.0,9.0,14.0,15.0,13.0,12.0,11.0,12.0,17.0,8.0,14.0,14.0,11.0,18.0,18.0,14.0,14.0,12.0,10.0,10.0,14.0,13.0,20.0,17.0,13.0,15.0,9.0,13.0,8.0,13.0,17.0,13.0,15.0,16.0,16.0,16.0,18.0,5.0,32.0,0.0,0.0,0.0,0.0,172.0,71.0,2.0,1.0,3.0,1.0,2.0,3.0,2.0,3.0,2.0,2.0,2.0,8.0,9.0,7.0,6.0,10.0,6.0,10.0,9.0,10.0,14.0,11.0,6.0,14.0,11.0,10.0,16.0,15.0,12.0,12.0,7.0,12.0,15.0,9.0,13.0,8.0,14.0,15.0,15.0,14.0,14.0,14.0,10.0,20.0,14.0,14.0,8.0,15.0,13.0,13.0,11.0,13.0,7.0,13.0,17.0,14.0,17.0,8.0,13.0,15.0,15.0,6.0,21.0,0.0,0.0,15.0,3.0,181.0,78.0,3.0,3.0,4.0,2.0,1.0,2.0,2.0,4.0,2.0,1.0,1.0,5.0,7.0,11.0,10.0,14.0,5.0,14.0,10.0,6.0,13.0,14.0,8.0,14.0,14.0,12.0,14.0,12.0,11.0,10.0,12.0,11.0,16.0,11.0,12.0,14.0,14.0,14.0,14.0,14.0,13.0,14.0,13.0,10.0,16.0,14.0,20.0,16.0,14.0,12.0,10.0,11.0,5.0,19.0,8.0,11.0,14.0,11.0,16.0,13.0,13.0,10.0,24.0,0.0,0.0,6.0,1.0,172.0,70.0,3.0,1.0,1.0,3.0,1.0,2.0,3.0,1.0,1.0,3.0,3.0,11.0,12.0,11.0,8.0,12.0,10.0,6.0,14.0,7.0,11.0,15.0,8.0,12.0,13.0,14.0,14.0,18.0,13.0,12.0,13.0,13.0,15.0,12.0,12.0,12.0,11.0,18.0,18.0,13.0,14.0,13.0,7.0,10.0,16.0,12.0,20.0,14.0,12.0,14.0,14.0,15.0,4.0,8.0,7.0,14.0,14.0,13.0,14.0,12.0,10.0,6.0,31.0,0.0,0.0,4.0,0.0,174.0,72.0,2.0,1.0,4.0,2.0,2.0,3.0,1.0,1.0,3.0,3.0,4.0,12.0,9.0,11.0,6.0,14.0,11.0,7.0,10.0,6.0,8.0,16.0,12.0,9.0,14.0,9.0,14.0,10.0,13.0,12.0,12.0,11.0,14.0,8.0,8.0,11.0,12.0,14.0,12.0,13.0,14.0,12.0,7.0,12.0,14.0,12.0,20.0,15.0,11.0,11.0,9.0,12.0,8.0,10.0,10.0,14.0,13.0,10.0,12.0,14.0,14.0,9.0,31.0,52.0,8.0,0.0,0.0,167.0,58.0,1.0,2.0,2.0,1.0,3.0,2.0,4.0,2.0,1.0,2.0,3.0,15.0,15.0,14.0,7.0,15.0,15.0,6.0,11.0,3.0,4.0,15.0,14.0,7.0,15.0,13.0,12.0,15.0,13.0,14.0,16.0,11.0,17.0,14.0,11.0,12.0,10.0,12.0,14.0,15.0,18.0,10.0,5.0,10.0,16.0,14.0,20.0,13.0,7.0,14.0,13.0,16.0,8.0,12.0,13.0,16.0,14.0,15.0,13.0,9.0,11.0,14.0,28.0,2.0,1.0,0.0,0.0,174.0,66.0,2.0,2.0,2.0,1.0,1.0,3.0,2.0,3.0,3.0,1.0,4.0,6.0,11.0,13.0,15.0,13.0,11.0,14.0,11.0,6.0,5.0,10.0,12.0,5.0,13.0,8.0,14.0,10.0,13.0,14.0,8.0,12.0,12.0,12.0,5.0,14.0,8.0,12.0,11.0,17.0,15.0,11.0,12.0,7.0,14.0,15.0,20.0,13.0,10.0,12.0,8.0,14.0,8.0,8.0,19.0,15.0,12.0,10.0,11.0,13.0,13.0,12.0
3,0,30.0,0.0,0.0,0.0,0.0,180.0,75.0,11.0,13.0,13.0,9.0,13.0,11.0,12.0,15.0,15.0,14.0,13.0,6.0,1.0,2.0,3.0,7.0,8.0,1.0,1.0,1.0,2.0,7.0,2.0,1.0,7.0,8.0,12.0,14.0,13.0,14.0,7.0,12.0,14.0,5.0,12.0,3.0,13.0,15.0,9.0,13.0,14.0,13.0,10.0,5.0,14.0,11.0,20.0,12.0,13.0,12.0,8.0,14.0,6.0,1.0,9.0,13.0,14.0,13.0,16.0,15.0,15.0,5.0,35.0,21.0,0.0,0.0,0.0,185.0,80.0,2.0,2.0,3.0,4.0,2.0,2.0,3.0,1.0,1.0,1.0,1.0,5.0,10.0,7.0,8.0,11.0,5.0,15.0,9.0,9.0,14.0,11.0,12.0,15.0,10.0,16.0,14.0,15.0,15.0,11.0,8.0,13.0,15.0,7.0,14.0,8.0,14.0,14.0,14.0,10.0,10.0,15.0,13.0,9.0,13.0,11.0,20.0,13.0,14.0,13.0,11.0,12.0,8.0,7.0,10.0,14.0,10.0,15.0,12.0,13.0,14.0,13.0,25.0,0.0,0.0,3.0,0.0,184.0,80.0,2.0,2.0,4.0,2.0,1.0,3.0,2.0,1.0,1.0,2.0,1.0,5.0,8.0,7.0,6.0,9.0,6.0,14.0,6.0,6.0,14.0,7.0,6.0,13.0,9.0,12.0,14.0,13.0,11.0,13.0,7.0,12.0,14.0,8.0,10.0,7.0,14.0,13.0,14.0,15.0,12.0,14.0,12.0,8.0,15.0,15.0,20.0,14.0,14.0,13.0,12.0,14.0,5.0,10.0,16.0,13.0,15.0,15.0,12.0,14.0,14.0,8.0,29.0,0.0,0.0,0.0,0.0,170.0,66.0,1.0,1.0,1.0,1.0,4.0,3.0,1.0,2.0,3.0,1.0,1.0,11.0,13.0,12.0,7.0,12.0,10.0,7.0,12.0,9.0,13.0,12.0,8.0,12.0,13.0,14.0,11.0,15.0,12.0,14.0,10.0,12.0,14.0,12.0,10.0,13.0,8.0,13.0,15.0,14.0,13.0,10.0,7.0,20.0,15.0,13.0,10.0,15.0,7.0,14.0,14.0,14.0,6.0,16.0,9.0,13.0,14.0,14.0,16.0,11.0,9.0,9.0,30.0,0.0,0.0,6.0,0.0,181.0,78.0,2.0,1.0,1.0,1.0,2.0,3.0,1.0,1.0,2.0,1.0,3.0,8.0,13.0,10.0,6.0,11.0,9.0,12.0,14.0,13.0,14.0,10.0,8.0,14.0,12.0,10.0,12.0,13.0,13.0,13.0,10.0,11.0,10.0,6.0,13.0,8.0,15.0,14.0,13.0,13.0,12.0,14.0,10.0,20.0,15.0,11.0,8.0,13.0,14.0,11.0,10.0,13.0,6.0,8.0,10.0,12.0,14.0,8.0,15.0,15.0,15.0,9.0,31.0,0.0,0.0,0.0,0.0,178.0,70.0,3.0,1.0,3.0,3.0,2.0,2.0,2.0,1.0,2.0,1.0,2.0,5.0,8.0,7.0,7.0,12.0,5.0,8.0,8.0,7.0,14.0,13.0,8.0,13.0,12.0,15.0,14.0,17.0,12.0,13.0,9.0,13.0,16.0,10.0,15.0,8.0,13.0,18.0,15.0,13.0,14.0,12.0,9.0,10.0,15.0,13.0,20.0,16.0,13.0,14.0,12.0,14.0,5.0,16.0,13.0,12.0,16.0,13.0,13.0,13.0,13.0,6.0,32.0,25.0,0.0,0.0,0.0,181.0,82.0,2.0,3.0,3.0,1.0,1.0,1.0,1.0,3.0,1.0,2.0,3.0,5.0,10.0,6.0,7.0,10.0,7.0,14.0,9.0,8.0,11.0,12.0,7.0,13.0,10.0,15.0,14.0,16.0,11.0,13.0,10.0,12.0,16.0,9.0,15.0,8.0,11.0,16.0,18.0,11.0,12.0,14.0,11.0,8.0,13.0,11.0,20.0,17.0,15.0,13.0,15.0,11.0,6.0,14.0,18.0,12.0,13.0,13.0,14.0,11.0,11.0,8.0,21.0,0.0,0.0,0.0,0.0,185.0,74.0,2.0,4.0,4.0,3.0,2.0,3.0,3.0,1.0,1.0,3.0,2.0,8.0,9.0,14.0,11.0,14.0,13.0,10.0,14.0,6.0,12.0,15.0,11.0,12.0,12.0,13.0,13.0,11.0,13.0,12.0,9.0,12.0,6.0,8.0,10.0,12.0,13.0,13.0,15.0,16.0,14.0,15.0,13.0,8.0,15.0,15.0,20.0,15.0,15.0,13.0,8.0,9.0,7.0,10.0,8.0,13.0,7.0,5.0,10.0,13.0,11.0,6.0,25.0,24.0,7.0,0.0,0.0,180.0,75.0,1.0,2.0,1.0,1.0,1.0,2.0,3.0,1.0,3.0,1.0,3.0,6.0,10.0,14.0,11.0,14.0,10.0,9.0,12.0,6.0,3.0,13.0,11.0,2.0,16.0,7.0,12.0,12.0,12.0,10.0,12.0,11.0,13.0,16.0,6.0,13.0,5.0,8.0,8.0,16.0,14.0,13.0,10.0,10.0,13.0,14.0,20.0,13.0,12.0,12.0,7.0,14.0,11.0,8.0,17.0,14.0,13.0,13.0,12.0,15.0,15.0,7.0,34.0,0.0,0.0,0.0,0.0,176.0,65.0,2.0,3.0,3.0,3.0,2.0,2.0,1.0,2.0,1.0,1.0,2.0,14.0,15.0,13.0,10.0,15.0,13.0,6.0,15.0,10.0,3.0,14.0,13.0,6.0,14.0,8.0,12.0,9.0,13.0,12.0,14.0,13.0,11.0,12.0,7.0,13.0,8.0,14.0,15.0,14.0,13.0,12.0,8.0,20.0,14.0,13.0,10.0,12.0,7.0,13.0,8.0,15.0,7.0,6.0,13.0,14.0,14.0,9.0,14.0,14.0,11.0,10.0,25.0,0.0,0.0,0.0,0.0,183.0,77.0,3.0,1.0,1.0,4.0,1.0,2.0,1.0,2.0,2.0,3.0,1.0,6.0,10.0,12.0,12.0,11.0,6.0,11.0,7.0,1.0,5.0,2.0,4.0,4.0,12.0,7.0,11.0,4.0,11.0,7.0,3.0,12.0,10.0,16.0,13.0,11.0,7.0,7.0,8.0,13.0,9.0,7.0,10.0,10.0,11.0,12.0,20.0,12.0,12.0,9.0,10.0,4.0,10.0,9.0,13.0,9.0,11.0,11.0,14.0,7.0,7.0,3.0,28.0,0.0,0.0,6.0,0.0,186.0,82.0,12.0,12.0,12.0,13.0,11.0,13.0,13.0,13.0,14.0,16.0,15.0,8.0,1.0,3.0,1.0,11.0,11.0,1.0,2.0,1.0,1.0,10.0,3.0,2.0,10.0,7.0,13.0,12.0,9.0,8.0,8.0,10.0,12.0,3.0,10.0,2.0,11.0,11.0,13.0,13.0,15.0,15.0,11.0,9.0,17.0,14.0,20.0,14.0,11.0,10.0,7.0,13.0,11.0,11.0,8.0,5.0,7.0,12.0,13.0,14.0,14.0,5.0,23.0,5.0,0.0,13.0,0.0,186.0,82.0,3.0,3.0,1.0,4.0,3.0,1.0,2.0,1.0,2.0,1.0,2.0,4.0,8.0,8.0,5.0,11.0,6.0,13.0,8.0,6.0,14.0,10.0,7.0,13.0,11.0,14.0,13.0,14.0,11.0,11.0,9.0,11.0,14.0,8.0,11.0,9.0,15.0,12.0,12.0,14.0,12.0,14.0,13.0,8.0,15.0,14.0,20.0,14.0,14.0,15.0,14.0,13.0,6.0,10.0,15.0,13.0,12.0,12.0,14.0,11.0,13.0,9.0,26.0,5.0,0.0,0.0,0.0,184.0,86.0,3.0,3.0,2.0,1.0,2.0,2.0,4.0,1.0,3.0,1.0,3.0,4.0,10.0,9.0,6.0,10.0,7.0,14.0,8.0,8.0,14.0,9.0,6.0,14.0,9.0,14.0,14.0,16.0,9.0,15.0,7.0,11.0,13.0,8.0,10.0,9.0,13.0,12.0,12.0,12.0,12.0,17.0,12.0,5.0,15.0,15.0,20.0,14.0,17.0,11.0,14.0,13.0,7.0,10.0,13.0,16.0,14.0,11.0,11.0,12.0,9.0,14.0,23.0,1.0,0.0,4.0,0.0,190.0,80.0,1.0,4.0,1.0,3.0,3.0,1.0,1.0,1.0,2.0,4.0,2.0,6.0,11.0,13.0,7.0,13.0,6.0,11.0,8.0,10.0,15.0,12.0,5.0,15.0,12.0,14.0,14.0,16.0,9.0,11.0,10.0,10.0,16.0,12.0,12.0,9.0,12.0,10.0,14.0,14.0,12.0,15.0,17.0,8.0,15.0,16.0,20.0,13.0,14.0,13.0,8.0,13.0,6.0,14.0,11.0,14.0,12.0,13.0,16.0,14.0,12.0,6.0,26.0,17.0,0.0,19.0,1.0,191.0,79.0,3.0,2.0,1.0,1.0,1.0,1.0,2.0,2.0,3.0,3.0,4.0,4.0,8.0,11.0,9.0,12.0,7.0,14.0,10.0,6.0,12.0,13.0,7.0,11.0,12.0,14.0,13.0,14.0,12.0,10.0,11.0,12.0,15.0,9.0,7.0,11.0,12.0,12.0,15.0,14.0,13.0,16.0,15.0,8.0,15.0,13.0,20.0,19.0,15.0,11.0,14.0,14.0,7.0,12.0,12.0,14.0,12.0,10.0,9.0,14.0,14.0,14.0,21.0,0.0,0.0,0.0,0.0,188.0,80.0,1.0,2.0,2.0,3.0,2.0,2.0,2.0,2.0,1.0,1.0,1.0,6.0,9.0,12.0,6.0,12.0,12.0,12.0,11.0,3.0,12.0,13.0,8.0,13.0,13.0,13.0,13.0,13.0,13.0,13.0,13.0,13.0,13.0,8.0,11.0,11.0,13.0,15.0,13.0,12.0,12.0,13.0,14.0,20.0,14.0,11.0,5.0,13.0,14.0,12.0,11.0,3.0,6.0,8.0,17.0,12.0,13.0,13.0,14.0,14.0,14.0,6.0,19.0,0.0,0.0,0.0,0.0,184.0,78.0,3.0,1.0,2.0,1.0,2.0,2.0,2.0,3.0,3.0,4.0,2.0,6.0,8.0,9.0,5.0,13.0,6.0,11.0,8.0,5.0,13.0,13.0,8.0,12.0,13.0,13.0,13.0,15.0,12.0,12.0,13.0,12.0,14.0,7.0,11.0,8.0,15.0,14.0,15.0,13.0,12.0,14.0,11.0,5.0,15.0,12.0,20.0,16.0,14.0,13.0,12.0,11.0,7.0,10.0,19.0,13.0,15.0,12.0,14.0,13.0,12.0,6.0,23.0,11.0,0.0,0.0,0.0,180.0,71.0,2.0,1.0,2.0,3.0,3.0,1.0,1.0,2.0,2.0,1.0,1.0,6.0,11.0,10.0,8.0,10.0,7.0,11.0,9.0,12.0,13.0,11.0,6.0,13.0,11.0,12.0,11.0,13.0,12.0,9.0,11.0,11.0,14.0,12.0,11.0,12.0,11.0,13.0,15.0,15.0,13.0,13.0,11.0,7.0,14.0,15.0,20.0,12.0,11.0,12.0,12.0,13.0,10.0,15.0,10.0,13.0,16.0,12.0,15.0,14.0,14.0,7.0,24.0,1.0,0.0,0.0,0.0,168.0,66.0,2.0,3.0,1.0,1.0,2.0,1.0,3.0,1.0,1.0,1.0,2.0,10.0,15.0,15.0,6.0,14.0,12.0,5.0,12.0,5.0,5.0,14.0,8.0,3.0,15.0,7.0,9.0,8.0,12.0,12.0,13.0,12.0,15.0,16.0,5.0,15.0,5.0,9.0,13.0,16.0,17.0,9.0,5.0,8.0,14.0,12.0,20.0,11.0,5.0,12.0,7.0,14.0,7.0,11.0,17.0,14.0,14.0,11.0,11.0,14.0,14.0,7.0,25.0,0.0,0.0,3.0,0.0,170.0,68.0,2.0,1.0,3.0,1.0,3.0,1.0,3.0,2.0,2.0,4.0,1.0,12.0,11.0,15.0,16.0,16.0,13.0,11.0,12.0,4.0,5.0,12.0,14.0,4.0,17.0,7.0,14.0,7.0,15.0,13.0,13.0,14.0,14.0,15.0,7.0,16.0,8.0,10.0,13.0,15.0,15.0,12.0,6.0,11.0,14.0,14.0,20.0,13.0,11.0,12.0,7.0,15.0,7.0,8.0,12.0,14.0,13.0,14.0,13.0,16.0,16.0,8.0,25.0,14.0,1.0,2.0,0.0,177.0,77.0,3.0,3.0,1.0,2.0,3.0,3.0,1.0,3.0,3.0,4.0,1.0,8.0,11.0,13.0,12.0,12.0,10.0,11.0,10.0,2.0,3.0,11.0,10.0,5.0,13.0,12.0,12.0,13.0,11.0,10.0,11.0,10.0,14.0,16.0,14.0,15.0,5.0,13.0,14.0,15.0,14.0,12.0,12.0,12.0,14.0,16.0,20.0,13.0,14.0,13.0,7.0,14.0,11.0,13.0,14.0,11.0,12.0,8.0,12.0,13.0,15.0,6.0
1,1,31.0,25.0,0.0,6.0,0.0,191.0,84.0,11.0,14.0,13.0,12.0,15.0,14.0,15.0,16.0,13.0,14.0,14.0,8.0,2.0,10.0,5.0,11.0,11.0,7.0,10.0,2.0,5.0,10.0,11.0,11.0,9.0,12.0,13.0,15.0,13.0,13.0,8.0,13.0,16.0,12.0,14.0,1.0,16.0,13.0,11.0,12.0,13.0,16.0,16.0,8.0,16.0,13.0,20.0,15.0,15.0,17.0,8.0,15.0,7.0,2.0,15.0,15.0,17.0,15.0,17.0,16.0,15.0,6.0,26.0,0.0,0.0,0.0,0.0,167.0,0.0,3.0,2.0,1.0,2.0,2.0,3.0,3.0,3.0,2.0,3.0,2.0,11.0,12.0,12.0,11.0,12.0,13.0,8.0,10.0,7.0,5.0,12.0,11.0,6.0,12.0,11.0,10.0,11.0,10.0,10.0,13.0,11.0,9.0,10.0,9.0,11.0,6.0,10.0,11.0,11.0,11.0,10.0,6.0,5.0,13.0,11.0,20.0,12.0,9.0,12.0,5.0,10.0,9.0,8.0,12.0,11.0,9.0,9.0,11.0,4.0,1.0,5.0,28.0,54.0,3.0,5.0,1.0,184.0,76.0,1.0,3.0,3.0,3.0,2.0,2.0,2.0,1.0,2.0,2.0,1.0,8.0,13.0,11.0,7.0,10.0,7.0,13.0,9.0,14.0,12.0,11.0,8.0,14.0,11.0,13.0,12.0,14.0,11.0,12.0,9.0,11.0,12.0,8.0,7.0,13.0,11.0,14.0,14.0,14.0,13.0,15.0,12.0,20.0,14.0,15.0,5.0,12.0,16.0,10.0,11.0,11.0,8.0,10.0,4.0,13.0,13.0,11.0,12.0,12.0,11.0,9.0,31.0,0.0,0.0,6.0,0.0,174.0,80.0,1.0,1.0,1.0,1.0,1.0,5.0,1.0,1.0,1.0,1.0,1.0,14.0,12.0,11.0,7.0,12.0,13.0,9.0,7.0,10.0,11.0,11.0,10.0,10.0,12.0,11.0,11.0,11.0,10.0,6.0,10.0,9.0,12.0,12.0,12.0,10.0,12.0,12.0,14.0,12.0,15.0,10.0,9.0,20.0,12.0,12.0,7.0,12.0,9.0,9.0,10.0,12.0,7.0,9.0,11.0,14.0,9.0,7.0,14.0,8.0,9.0,9.0,32.0,36.0,0.0,12.0,2.0,183.0,77.0,1.0,3.0,2.0,1.0,3.0,1.0,1.0,2.0,1.0,1.0,3.0,6.0,11.0,8.0,6.0,13.0,11.0,13.0,10.0,6.0,15.0,14.0,10.0,17.0,12.0,15.0,16.0,18.0,14.0,17.0,12.0,15.0,17.0,11.0,17.0,7.0,17.0,20.0,16.0,9.0,11.0,15.0,11.0,8.0,15.0,10.0,20.0,14.0,14.0,17.0,10.0,16.0,10.0,13.0,15.0,15.0,15.0,14.0,18.0,15.0,13.0,6.0,29.0,90.0,4.0,16.0,2.0,170.0,61.0,2.0,3.0,3.0,1.0,3.0,1.0,2.0,2.0,2.0,2.0,1.0,15.0,14.0,15.0,9.0,17.0,16.0,7.0,12.0,4.0,11.0,18.0,15.0,12.0,17.0,15.0,15.0,16.0,13.0,16.0,17.0,14.0,16.0,15.0,14.0,12.0,14.0,18.0,16.0,13.0,14.0,12.0,8.0,10.0,14.0,11.0,20.0,14.0,10.0,14.0,9.0,17.0,10.0,14.0,13.0,17.0,15.0,16.0,17.0,15.0,16.0,7.0,21.0,2.0,0.0,13.0,6.0,186.0,78.0,4.0,1.0,3.0,1.0,3.0,3.0,2.0,3.0,3.0,2.0,2.0,10.0,10.0,11.0,12.0,12.0,11.0,14.0,13.0,6.0,10.0,14.0,13.0,11.0,13.0,12.0,13.0,11.0,12.0,11.0,12.0,11.0,14.0,12.0,11.0,13.0,11.0,13.0,13.0,12.0,11.0,12.0,13.0,20.0,13.0,12.0,17.0,13.0,12.0,11.0,8.0,13.0,8.0,16.0,12.0,16.0,15.0,13.0,15.0,12.0,15.0,6.0,21.0,7.0,0.0,14.0,6.0,173.0,64.0,3.0,2.0,3.0,2.0,3.0,3.0,3.0,2.0,3.0,3.0,3.0,14.0,14.0,18.0,14.0,17.0,14.0,7.0,11.0,2.0,6.0,15.0,14.0,6.0,18.0,12.0,14.0,14.0,15.0,13.0,16.0,14.0,17.0,17.0,12.0,13.0,9.0,13.0,17.0,15.0,17.0,13.0,7.0,20.0,14.0,14.0,9.0,14.0,9.0,15.0,7.0,16.0,7.0,14.0,15.0,17.0,15.0,16.0,17.0,16.0,15.0,4.0,20.0,0.0,0.0,7.0,1.0,170.0,58.0,1.0,2.0,2.0,2.0,2.0,2.0,2.0,4.0,1.0,3.0,2.0,16.0,14.0,16.0,13.0,16.0,17.0,5.0,14.0,2.0,6.0,15.0,13.0,4.0,17.0,9.0,12.0,14.0,12.0,12.0,14.0,13.0,15.0,16.0,7.0,13.0,9.0,13.0,15.0,15.0,16.0,11.0,7.0,20.0,14.0,15.0,8.0,14.0,8.0,15.0,5.0,15.0,7.0,16.0,15.0,15.0,15.0,14.0,16.0,18.0,16.0,3.0,26.0,13.0,4.0,5.0,3.0,203.0,87.0,3.0,4.0,4.0,1.0,1.0,2.0,3.0,1.0,3.0,4.0,2.0,5.0,8.0,10.0,13.0,13.0,10.0,9.0,12.0,11.0,6.0,9.0,13.0,5.0,14.0,13.0,10.0,13.0,13.0,10.0,9.0,11.0,12.0,12.0,9.0,12.0,7.0,11.0,13.0,13.0,11.0,15.0,18.0,20.0,13.0,14.0,12.0,12.0,16.0,6.0,15.0,13.0,14.0,7.0,11.0,13.0,11.0,10.0,10.0,11.0,13.0,12.0,22.0,2.0,0.0,14.0,7.0,175.0,73.0,2.0,3.0,1.0,1.0,1.0,3.0,1.0,3.0,2.0,3.0,3.0,12.0,14.0,15.0,12.0,14.0,11.0,10.0,13.0,3.0,3.0,12.0,14.0,4.0,15.0,13.0,11.0,14.0,11.0,10.0,12.0,9.0,16.0,16.0,8.0,15.0,7.0,11.0,11.0,15.0,14.0,11.0,8.0,9.0,10.0,16.0,20.0,13.0,12.0,11.0,10.0,13.0,11.0,8.0,11.0,14.0,12.0,11.0,14.0,14.0,13.0,8.0,25.0,4.0,0.0,11.0,0.0,184.0,81.0,14.0,14.0,13.0,9.0,15.0,12.0,16.0,16.0,13.0,7.0,11.0,8.0,1.0,2.0,1.0,11.0,12.0,6.0,1.0,3.0,3.0,11.0,5.0,3.0,11.0,8.0,15.0,15.0,13.0,14.0,10.0,11.0,14.0,8.0,13.0,5.0,13.0,10.0,10.0,14.0,16.0,14.0,13.0,20.0,14.0,12.0,5.0,14.0,14.0,15.0,9.0,16.0,6.0,1.0,17.0,11.0,15.0,13.0,14.0,12.0,12.0,4.0,27.0,4.0,0.0,5.0,1.0,184.0,83.0,2.0,4.0,3.0,1.0,1.0,2.0,1.0,2.0,4.0,2.0,3.0,4.0,8.0,11.0,4.0,10.0,4.0,14.0,4.0,4.0,15.0,12.0,5.0,16.0,11.0,14.0,14.0,16.0,14.0,10.0,11.0,12.0,17.0,7.0,10.0,9.0,13.0,14.0,15.0,14.0,13.0,16.0,13.0,10.0,15.0,13.0,20.0,15.0,16.0,12.0,12.0,14.0,6.0,12.0,11.0,13.0,12.0,12.0,16.0,15.0,14.0,6.0,22.0,3.0,0.0,7.0,1.0,182.0,75.0,3.0,3.0,1.0,3.0,2.0,3.0,1.0,1.0,2.0,2.0,1.0,4.0,11.0,10.0,6.0,14.0,7.0,13.0,10.0,9.0,16.0,14.0,8.0,15.0,14.0,13.0,17.0,15.0,16.0,14.0,11.0,14.0,15.0,8.0,11.0,10.0,15.0,16.0,14.0,14.0,14.0,14.0,11.0,20.0,15.0,14.0,10.0,15.0,15.0,15.0,12.0,15.0,8.0,11.0,12.0,14.0,16.0,15.0,14.0,14.0,14.0,5.0,32.0,11.0,1.0,0.0,0.0,176.0,68.0,2.0,1.0,3.0,2.0,2.0,2.0,2.0,3.0,3.0,2.0,2.0,8.0,10.0,10.0,7.0,11.0,8.0,10.0,11.0,12.0,11.0,13.0,12.0,14.0,12.0,9.0,14.0,15.0,13.0,12.0,11.0,12.0,17.0,8.0,14.0,14.0,11.0,18.0,18.0,14.0,14.0,12.0,10.0,10.0,14.0,13.0,20.0,17.0,13.0,15.0,9.0,13.0,8.0,13.0,17.0,13.0,15.0,16.0,16.0,16.0,18.0,5.0,37.0,0.0,0.0,0.0,0.0,185.0,83.0,1.0,1.0,2.0,1.0,3.0,2.0,3.0,1.0,1.0,3.0,1.0,6.0,8.0,9.0,12.0,10.0,8.0,13.0,9.0,4.0,5.0,10.0,14.0,4.0,11.0,11.0,10.0,11.0,13.0,12.0,12.0,13.0,15.0,14.0,12.0,11.0,7.0,12.0,8.0,7.0,7.0,12.0,12.0,11.0,11.0,7.0,20.0,8.0,14.0,12.0,8.0,13.0,9.0,12.0,12.0,12.0,19.0,14.0,15.0,14.0,8.0,8.0,27.0,8.0,0.0,6.0,0.0,187.0,76.0,3.0,2.0,3.0,2.0,2.0,1.0,1.0,3.0,3.0,1.0,2.0,5.0,7.0,11.0,5.0,14.0,5.0,14.0,9.0,5.0,15.0,15.0,8.0,14.0,13.0,15.0,16.0,15.0,14.0,12.0,14.0,14.0,18.0,8.0,17.0,9.0,12.0,18.0,15.0,13.0,14.0,15.0,14.0,10.0,17.0,12.0,20.0,17.0,15.0,14.0,13.0,16.0,4.0,12.0,10.0,14.0,17.0,12.0,15.0,13.0,13.0,6.0,22.0,0.0,0.0,4.0,0.0,180.0,80.0,4.0,1.0,1.0,3.0,2.0,3.0,1.0,3.0,3.0,3.0,4.0,7.0,10.0,11.0,8.0,15.0,11.0,10.0,14.0,5.0,14.0,15.0,10.0,15.0,15.0,13.0,14.0,13.0,12.0,14.0,15.0,13.0,16.0,12.0,8.0,15.0,13.0,13.0,13.0,13.0,13.0,12.0,10.0,12.0,12.0,12.0,20.0,13.0,12.0,13.0,10.0,12.0,7.0,11.0,12.0,15.0,12.0,16.0,15.0,10.0,10.0,7.0,21.0,0.0,0.0,15.0,3.0,181.0,78.0,3.0,3.0,4.0,2.0,1.0,2.0,2.0,4.0,2.0,1.0,1.0,5.0,7.0,11.0,10.0,14.0,5.0,14.0,10.0,6.0,13.0,14.0,8.0,14.0,14.0,12.0,14.0,12.0,11.0,10.0,12.0,11.0,16.0,11.0,12.0,14.0,14.0,14.0,14.0,14.0,13.0,14.0,13.0,10.0,16.0,14.0,20.0,16.0,14.0,12.0,10.0,11.0,5.0,19.0,8.0,11.0,14.0,11.0,16.0,13.0,13.0,10.0,31.0,52.0,8.0,0.0,0.0,167.0,58.0,1.0,2.0,2.0,1.0,3.0,2.0,4.0,2.0,1.0,2.0,3.0,15.0,15.0,14.0,7.0,15.0,15.0,6.0,11.0,3.0,4.0,15.0,14.0,7.0,15.0,13.0,12.0,15.0,13.0,14.0,16.0,11.0,17.0,14.0,11.0,12.0,10.0,12.0,14.0,15.0,18.0,10.0,5.0,10.0,16.0,14.0,20.0,13.0,7.0,14.0,13.0,16.0,8.0,12.0,13.0,16.0,14.0,15.0,13.0,9.0,11.0,14.0,28.0,2.0,1.0,0.0,0.0,174.0,66.0,2.0,2.0,2.0,1.0,1.0,3.0,2.0,3.0,3.0,1.0,4.0,6.0,11.0,13.0,15.0,13.0,11.0,14.0,11.0,6.0,5.0,10.0,12.0,5.0,13.0,8.0,14.0,10.0,13.0,14.0,8.0,12.0,12.0,12.0,5.0,14.0,8.0,12.0,11.0,17.0,15.0,11.0,12.0,7.0,14.0,15.0,20.0,13.0,10.0,12.0,8.0,14.0,8.0,8.0,19.0,15.0,12.0,10.0,11.0,13.0,13.0,12.0,25.0,10.0,1.0,11.0,4.0,175.0,73.0,1.0,3.0,3.0,3.0,3.0,3.0,3.0,1.0,2.0,3.0,1.0,5.0,10.0,15.0,17.0,15.0,10.0,11.0,12.0,5.0,5.0,14.0,15.0,5.0,16.0,8.0,15.0,12.0,15.0,14.0,13.0,15.0,15.0,15.0,14.0,14.0,10.0,10.0,12.0,16.0,16.0,15.0,9.0,10.0,15.0,16.0,20.0,13.0,15.0,14.0,8.0,14.0,7.0,10.0,8.0,16.0,17.0,13.0,15.0,15.0,14.0,5.0
0,2,30.0,0.0,0.0,0.0,0.0,180.0,75.0,11.0,13.0,13.0,9.0,13.0,11.0,12.0,15.0,15.0,14.0,13.0,6.0,1.0,2.0,3.0,7.0,8.0,1.0,1.0,1.0,2.0,7.0,2.0,1.0,7.0,8.0,12.0,14.0,13.0,14.0,7.0,12.0,14.0,5.0,12.0,3.0,13.0,15.0,9.0,13.0,14.0,13.0,10.0,5.0,14.0,11.0,20.0,12.0,13.0,12.0,8.0,14.0,6.0,1.0,9.0,13.0,14.0,13.0,16.0,15.0,15.0,5.0,35.0,21.0,0.0,0.0,0.0,185.0,80.0,2.0,2.0,3.0,4.0,2.0,2.0,3.0,1.0,1.0,1.0,1.0,5.0,10.0,7.0,8.0,11.0,5.0,15.0,9.0,9.0,14.0,11.0,12.0,15.0,10.0,16.0,14.0,15.0,15.0,11.0,8.0,13.0,15.0,7.0,14.0,8.0,14.0,14.0,14.0,10.0,10.0,15.0,13.0,9.0,13.0,11.0,20.0,13.0,14.0,13.0,11.0,12.0,8.0,7.0,10.0,14.0,10.0,15.0,12.0,13.0,14.0,13.0,25.0,0.0,0.0,3.0,0.0,184.0,80.0,2.0,2.0,4.0,2.0,1.0,3.0,2.0,1.0,1.0,2.0,1.0,5.0,8.0,7.0,6.0,9.0,6.0,14.0,6.0,6.0,14.0,7.0,6.0,13.0,9.0,12.0,14.0,13.0,11.0,13.0,7.0,12.0,14.0,8.0,10.0,7.0,14.0,13.0,14.0,15.0,12.0,14.0,12.0,8.0,15.0,15.0,20.0,14.0,14.0,13.0,12.0,14.0,5.0,10.0,16.0,13.0,15.0,15.0,12.0,14.0,14.0,8.0,32.0,0.0,0.0,0.0,0.0,165.0,65.0,1.0,2.0,3.0,1.0,3.0,1.0,3.0,2.0,1.0,4.0,4.0,7.0,12.0,10.0,5.0,13.0,8.0,9.0,8.0,11.0,13.0,12.0,10.0,14.0,11.0,14.0,13.0,15.0,12.0,12.0,8.0,11.0,14.0,5.0,8.0,7.0,10.0,15.0,17.0,14.0,13.0,14.0,4.0,10.0,13.0,13.0,20.0,15.0,12.0,14.0,5.0,13.0,7.0,8.0,7.0,12.0,17.0,13.0,15.0,13.0,13.0,7.0,29.0,0.0,0.0,0.0,0.0,170.0,66.0,1.0,1.0,1.0,1.0,4.0,3.0,1.0,2.0,3.0,1.0,1.0,11.0,13.0,12.0,7.0,12.0,10.0,7.0,12.0,9.0,13.0,12.0,8.0,12.0,13.0,14.0,11.0,15.0,12.0,14.0,10.0,12.0,14.0,12.0,10.0,13.0,8.0,13.0,15.0,14.0,13.0,10.0,7.0,20.0,15.0,13.0,10.0,15.0,7.0,14.0,14.0,14.0,6.0,16.0,9.0,13.0,14.0,14.0,16.0,11.0,9.0,9.0,31.0,0.0,0.0,0.0,0.0,178.0,70.0,3.0,1.0,3.0,3.0,2.0,2.0,2.0,1.0,2.0,1.0,2.0,5.0,8.0,7.0,7.0,12.0,5.0,8.0,8.0,7.0,14.0,13.0,8.0,13.0,12.0,15.0,14.0,17.0,12.0,13.0,9.0,13.0,16.0,10.0,15.0,8.0,13.0,18.0,15.0,13.0,14.0,12.0,9.0,10.0,15.0,13.0,20.0,16.0,13.0,14.0,12.0,14.0,5.0,16.0,13.0,12.0,16.0,13.0,13.0,13.0,13.0,6.0,21.0,0.0,0.0,0.0,0.0,185.0,74.0,2.0,4.0,4.0,3.0,2.0,3.0,3.0,1.0,1.0,3.0,2.0,8.0,9.0,14.0,11.0,14.0,13.0,10.0,14.0,6.0,12.0,15.0,11.0,12.0,12.0,13.0,13.0,11.0,13.0,12.0,9.0,12.0,6.0,8.0,10.0,12.0,13.0,13.0,15.0,16.0,14.0,15.0,13.0,8.0,15.0,15.0,20.0,15.0,15.0,13.0,8.0,9.0,7.0,10.0,8.0,13.0,7.0,5.0,10.0,13.0,11.0,6.0,22.0,0.0,0.0,4.0,0.0,179.0,71.0,1.0,3.0,1.0,3.0,2.0,1.0,3.0,2.0,1.0,2.0,4.0,11.0,13.0,12.0,8.0,15.0,11.0,6.0,11.0,6.0,4.0,14.0,12.0,6.0,16.0,7.0,12.0,10.0,12.0,11.0,13.0,13.0,13.0,9.0,6.0,12.0,9.0,15.0,12.0,13.0,14.0,12.0,9.0,20.0,14.0,12.0,10.0,13.0,10.0,13.0,7.0,14.0,7.0,8.0,18.0,13.0,14.0,14.0,16.0,15.0,15.0,5.0,25.0,24.0,7.0,0.0,0.0,180.0,75.0,1.0,2.0,1.0,1.0,1.0,2.0,3.0,1.0,3.0,1.0,3.0,6.0,10.0,14.0,11.0,14.0,10.0,9.0,12.0,6.0,3.0,13.0,11.0,2.0,16.0,7.0,12.0,12.0,12.0,10.0,12.0,11.0,13.0,16.0,6.0,13.0,5.0,8.0,8.0,16.0,14.0,13.0,10.0,10.0,13.0,14.0,20.0,13.0,12.0,12.0,7.0,14.0,11.0,8.0,17.0,14.0,13.0,13.0,12.0,15.0,15.0,7.0,34.0,0.0,0.0,0.0,0.0,176.0,65.0,2.0,3.0,3.0,3.0,2.0,2.0,1.0,2.0,1.0,1.0,2.0,14.0,15.0,13.0,10.0,15.0,13.0,6.0,15.0,10.0,3.0,14.0,13.0,6.0,14.0,8.0,12.0,9.0,13.0,12.0,14.0,13.0,11.0,12.0,7.0,13.0,8.0,14.0,15.0,14.0,13.0,12.0,8.0,20.0,14.0,13.0,10.0,12.0,7.0,13.0,8.0,15.0,7.0,6.0,13.0,14.0,14.0,9.0,14.0,14.0,11.0,10.0,27.0,27.0,5.0,0.0,0.0,174.0,68.0,1.0,3.0,3.0,2.0,3.0,2.0,1.0,3.0,3.0,1.0,2.0,11.0,10.0,15.0,12.0,14.0,13.0,7.0,13.0,6.0,4.0,12.0,11.0,7.0,15.0,9.0,13.0,12.0,11.0,12.0,12.0,10.0,14.0,13.0,6.0,14.0,7.0,8.0,10.0,16.0,14.0,12.0,9.0,10.0,13.0,15.0,20.0,14.0,11.0,13.0,9.0,14.0,10.0,15.0,14.0,14.0,13.0,11.0,12.0,14.0,14.0,8.0,29.0,17.0,0.0,4.0,0.0,192.0,80.0,13.0,11.0,14.0,5.0,17.0,12.0,15.0,15.0,13.0,13.0,12.0,3.0,2.0,6.0,3.0,9.0,7.0,7.0,1.0,2.0,3.0,9.0,4.0,2.0,8.0,10.0,14.0,16.0,15.0,14.0,8.0,14.0,15.0,7.0,13.0,3.0,15.0,16.0,9.0,11.0,14.0,15.0,15.0,5.0,13.0,12.0,20.0,13.0,13.0,18.0,8.0,15.0,7.0,12.0,15.0,18.0,15.0,14.0,16.0,16.0,13.0,2.0,31.0,0.0,0.0,0.0,0.0,171.0,65.0,1.0,3.0,1.0,3.0,2.0,2.0,3.0,1.0,2.0,2.0,3.0,8.0,9.0,11.0,7.0,5.0,6.0,5.0,6.0,7.0,14.0,14.0,6.0,14.0,13.0,14.0,12.0,13.0,12.0,11.0,11.0,12.0,12.0,11.0,7.0,12.0,12.0,12.0,10.0,15.0,15.0,7.0,9.0,9.0,12.0,14.0,20.0,12.0,13.0,11.0,13.0,11.0,9.0,10.0,15.0,14.0,12.0,11.0,14.0,13.0,12.0,7.0,29.0,0.0,0.0,0.0,0.0,170.0,65.0,2.0,1.0,3.0,3.0,1.0,3.0,2.0,1.0,2.0,3.0,2.0,5.0,11.0,4.0,6.0,7.0,4.0,7.0,5.0,6.0,6.0,6.0,2.0,6.0,7.0,9.0,10.0,13.0,8.0,12.0,8.0,13.0,15.0,2.0,7.0,5.0,9.0,8.0,8.0,12.0,12.0,14.0,4.0,9.0,12.0,11.0,20.0,12.0,5.0,9.0,9.0,9.0,9.0,9.0,10.0,12.0,12.0,12.0,12.0,7.0,5.0,8.0,28.0,0.0,0.0,0.0,0.0,169.0,0.0,3.0,3.0,2.0,3.0,3.0,1.0,1.0,3.0,2.0,1.0,3.0,5.0,8.0,11.0,9.0,8.0,8.0,7.0,8.0,4.0,2.0,9.0,5.0,3.0,11.0,11.0,11.0,13.0,9.0,11.0,8.0,15.0,14.0,11.0,7.0,10.0,8.0,8.0,10.0,11.0,11.0,6.0,5.0,14.0,11.0,12.0,20.0,14.0,5.0,9.0,12.0,9.0,5.0,6.0,9.0,12.0,11.0,9.0,9.0,10.0,12.0,11.0,23.0,25.0,0.0,0.0,0.0,174.0,74.0,2.0,1.0,1.0,1.0,3.0,3.0,3.0,3.0,3.0,1.0,2.0,8.0,13.0,12.0,8.0,12.0,8.0,14.0,9.0,13.0,14.0,12.0,6.0,16.0,13.0,13.0,14.0,15.0,13.0,11.0,10.0,12.0,15.0,9.0,10.0,14.0,11.0,14.0,17.0,16.0,13.0,14.0,10.0,8.0,17.0,15.0,20.0,18.0,15.0,14.0,13.0,14.0,8.0,12.0,12.0,14.0,13.0,13.0,12.0,12.0,15.0,13.0,25.0,0.0,0.0,14.0,0.0,180.0,82.0,1.0,3.0,3.0,1.0,3.0,2.0,3.0,1.0,1.0,3.0,1.0,5.0,10.0,10.0,7.0,13.0,7.0,12.0,8.0,10.0,14.0,12.0,8.0,17.0,13.0,13.0,16.0,16.0,14.0,15.0,10.0,12.0,15.0,8.0,13.0,10.0,14.0,18.0,15.0,10.0,12.0,16.0,11.0,10.0,15.0,12.0,20.0,16.0,15.0,17.0,10.0,16.0,6.0,10.0,12.0,16.0,12.0,13.0,17.0,14.0,14.0,5.0,21.0,0.0,0.0,15.0,1.0,189.0,75.0,3.0,3.0,3.0,3.0,1.0,1.0,3.0,3.0,3.0,2.0,3.0,10.0,12.0,13.0,7.0,14.0,8.0,14.0,12.0,5.0,13.0,15.0,8.0,15.0,14.0,14.0,14.0,15.0,14.0,14.0,13.0,14.0,15.0,12.0,10.0,12.0,14.0,15.0,16.0,12.0,13.0,15.0,14.0,20.0,14.0,13.0,10.0,16.0,13.0,14.0,11.0,14.0,7.0,10.0,8.0,16.0,10.0,12.0,13.0,13.0,11.0,14.0,16.0,0.0,0.0,0.0,0.0,173.0,0.0,3.0,1.0,1.0,1.0,2.0,1.0,4.0,1.0,2.0,3.0,1.0,1.0,1.0,4.0,4.0,5.0,4.0,4.0,4.0,1.0,5.0,6.0,5.0,8.0,9.0,10.0,6.0,6.0,3.0,5.0,4.0,10.0,7.0,8.0,8.0,3.0,11.0,13.0,9.0,7.0,5.0,14.0,4.0,20.0,6.0,5.0,8.0,6.0,9.0,5.0,7.0,8.0,5.0,7.0,6.0,11.0,7.0,10.0,18.0,19.0,15.0,9.0,27.0,10.0,0.0,0.0,0.0,187.0,75.0,2.0,2.0,4.0,3.0,3.0,3.0,2.0,3.0,4.0,2.0,1.0,13.0,13.0,15.0,11.0,18.0,13.0,8.0,13.0,4.0,3.0,17.0,14.0,4.0,17.0,10.0,13.0,9.0,14.0,12.0,17.0,13.0,12.0,18.0,8.0,14.0,6.0,14.0,9.0,15.0,16.0,12.0,12.0,14.0,12.0,14.0,20.0,12.0,11.0,13.0,8.0,13.0,13.0,10.0,11.0,17.0,13.0,12.0,14.0,15.0,15.0,8.0,34.0,116.0,62.0,7.0,6.0,195.0,95.0,1.0,1.0,3.0,1.0,1.0,3.0,4.0,1.0,2.0,3.0,2.0,5.0,12.0,15.0,16.0,18.0,14.0,14.0,16.0,8.0,6.0,15.0,18.0,6.0,18.0,16.0,16.0,15.0,13.0,13.0,16.0,14.0,14.0,19.0,16.0,15.0,4.0,13.0,8.0,12.0,15.0,20.0,18.0,16.0,16.0,14.0,20.0,15.0,18.0,16.0,13.0,11.0,11.0,8.0,15.0,20.0,11.0,15.0,14.0,7.0,7.0,13.0,29.0,76.0,27.0,13.0,9.0,188.0,72.0,2.0,3.0,1.0,2.0,3.0,3.0,1.0,3.0,3.0,3.0,3.0,5.0,10.0,13.0,16.0,13.0,11.0,17.0,13.0,5.0,10.0,13.0,14.0,10.0,13.0,15.0,16.0,18.0,14.0,15.0,10.0,13.0,14.0,13.0,10.0,18.0,12.0,14.0,19.0,15.0,14.0,16.0,14.0,10.0,18.0,16.0,20.0,18.0,14.0,14.0,8.0,15.0,5.0,16.0,10.0,16.0,12.0,14.0,16.0,14.0,10.0,10.0
3,0,28.0,0.0,0.0,6.0,0.0,191.0,81.0,11.0,10.0,14.0,8.0,13.0,12.0,14.0,15.0,11.0,8.0,13.0,4.0,3.0,2.0,1.0,9.0,9.0,3.0,10.0,1.0,1.0,8.0,3.0,3.0,9.0,8.0,12.0,14.0,12.0,13.0,8.0,11.0,12.0,6.0,14.0,2.0,12.0,10.0,7.0,13.0,14.0,16.0,15.0,6.0,14.0,11.0,20.0,15.0,14.0,12.0,9.0,14.0,7.0,1.0,9.0,15.0,13.0,11.0,15.0,15.0,14.0,8.0,23.0,0.0,0.0,0.0,0.0,184.0,71.0,1.0,2.0,1.0,2.0,2.0,2.0,2.0,4.0,2.0,1.0,3.0,4.0,10.0,10.0,6.0,11.0,6.0,14.0,8.0,7.0,14.0,11.0,6.0,13.0,11.0,12.0,12.0,13.0,12.0,11.0,12.0,12.0,14.0,6.0,8.0,10.0,13.0,13.0,14.0,15.0,13.0,14.0,13.0,8.0,12.0,14.0,20.0,13.0,14.0,13.0,12.0,14.0,15.0,8.0,11.0,13.0,13.0,10.0,8.0,9.0,16.0,7.0,27.0,0.0,0.0,0.0,0.0,172.0,67.0,3.0,3.0,2.0,3.0,3.0,4.0,1.0,3.0,3.0,3.0,2.0,8.0,12.0,11.0,5.0,11.0,7.0,8.0,10.0,11.0,7.0,11.0,8.0,12.0,12.0,13.0,11.0,13.0,9.0,8.0,11.0,11.0,13.0,8.0,6.0,12.0,10.0,12.0,14.0,16.0,13.0,11.0,7.0,20.0,14.0,15.0,8.0,14.0,8.0,13.0,13.0,15.0,11.0,12.0,11.0,12.0,12.0,12.0,16.0,16.0,16.0,7.0,23.0,0.0,0.0,0.0,0.0,174.0,64.0,4.0,3.0,1.0,1.0,3.0,3.0,2.0,3.0,3.0,2.0,3.0,8.0,12.0,10.0,8.0,11.0,7.0,10.0,9.0,12.0,14.0,9.0,10.0,13.0,12.0,12.0,12.0,12.0,11.0,12.0,10.0,12.0,13.0,8.0,9.0,12.0,11.0,13.0,14.0,15.0,14.0,11.0,10.0,10.0,14.0,14.0,20.0,15.0,10.0,14.0,12.0,12.0,8.0,13.0,10.0,12.0,15.0,12.0,13.0,10.0,17.0,6.0,21.0,0.0,0.0,0.0,0.0,172.0,66.0,2.0,3.0,2.0,2.0,1.0,1.0,1.0,3.0,2.0,1.0,1.0,10.0,10.0,13.0,9.0,14.0,9.0,8.0,10.0,7.0,13.0,13.0,9.0,12.0,13.0,10.0,12.0,13.0,13.0,12.0,14.0,13.0,13.0,11.0,9.0,14.0,13.0,14.0,14.0,14.0,13.0,12.0,8.0,8.0,12.0,12.0,20.0,13.0,12.0,14.0,10.0,11.0,8.0,12.0,15.0,10.0,15.0,8.0,11.0,14.0,14.0,6.0,27.0,0.0,0.0,0.0,0.0,188.0,77.0,1.0,4.0,1.0,1.0,3.0,1.0,2.0,1.0,2.0,2.0,2.0,4.0,7.0,8.0,7.0,13.0,6.0,15.0,9.0,6.0,13.0,12.0,6.0,12.0,11.0,14.0,14.0,15.0,10.0,12.0,11.0,13.0,16.0,7.0,12.0,9.0,12.0,15.0,16.0,14.0,10.0,14.0,15.0,9.0,13.0,12.0,20.0,14.0,16.0,12.0,14.0,13.0,6.0,12.0,4.0,13.0,18.0,13.0,14.0,14.0,13.0,7.0,24.0,8.0,0.0,0.0,0.0,182.0,76.0,2.0,3.0,2.0,1.0,2.0,3.0,3.0,3.0,2.0,1.0,2.0,8.0,11.0,10.0,8.0,12.0,9.0,13.0,11.0,5.0,13.0,13.0,10.0,12.0,12.0,10.0,14.0,12.0,13.0,12.0,13.0,12.0,14.0,6.0,10.0,12.0,14.0,15.0,14.0,13.0,12.0,11.0,12.0,7.0,15.0,13.0,20.0,14.0,14.0,14.0,10.0,14.0,7.0,8.0,2.0,12.0,16.0,13.0,14.0,14.0,14.0,6.0,24.0,0.0,0.0,0.0,0.0,172.0,72.0,1.0,1.0,3.0,2.0,2.0,1.0,1.0,1.0,1.0,3.0,1.0,10.0,11.0,12.0,10.0,11.0,8.0,8.0,10.0,7.0,7.0,11.0,11.0,6.0,12.0,8.0,11.0,11.0,10.0,10.0,11.0,12.0,15.0,12.0,5.0,10.0,11.0,13.0,15.0,15.0,13.0,10.0,9.0,8.0,14.0,13.0,20.0,14.0,11.0,11.0,8.0,13.0,7.0,12.0,18.0,13.0,10.0,10.0,11.0,11.0,11.0,6.0,22.0,0.0,0.0,0.0,0.0,177.0,72.0,2.0,1.0,2.0,4.0,2.0,2.0,1.0,3.0,4.0,2.0,3.0,10.0,12.0,13.0,11.0,12.0,10.0,12.0,12.0,4.0,10.0,13.0,11.0,11.0,13.0,11.0,12.0,11.0,13.0,9.0,13.0,12.0,3.0,12.0,8.0,14.0,12.0,12.0,13.0,16.0,13.0,12.0,9.0,8.0,15.0,14.0,20.0,14.0,13.0,10.0,4.0,11.0,11.0,12.0,19.0,9.0,12.0,13.0,12.0,11.0,14.0,7.0,24.0,4.0,1.0,0.0,0.0,188.0,79.0,2.0,3.0,2.0,1.0,2.0,1.0,1.0,2.0,1.0,2.0,2.0,10.0,11.0,13.0,12.0,11.0,9.0,13.0,9.0,5.0,8.0,11.0,11.0,7.0,13.0,10.0,12.0,11.0,11.0,12.0,13.0,11.0,14.0,12.0,9.0,12.0,12.0,14.0,14.0,12.0,13.0,15.0,14.0,8.0,13.0,12.0,20.0,13.0,14.0,11.0,9.0,10.0,5.0,10.0,14.0,12.0,13.0,10.0,14.0,13.0,12.0,10.0,25.0,0.0,0.0,0.0,0.0,187.0,83.0,2.0,1.0,3.0,3.0,1.0,3.0,3.0,3.0,1.0,1.0,3.0,4.0,8.0,10.0,14.0,12.0,8.0,14.0,9.0,5.0,7.0,11.0,13.0,5.0,12.0,11.0,13.0,13.0,13.0,11.0,10.0,12.0,16.0,9.0,8.0,13.0,11.0,13.0,16.0,14.0,13.0,15.0,13.0,20.0,14.0,12.0,8.0,14.0,16.0,13.0,11.0,13.0,7.0,5.0,13.0,14.0,13.0,14.0,14.0,13.0,13.0,6.0,28.0,0.0,0.0,0.0,0.0,186.0,80.0,11.0,13.0,11.0,9.0,13.0,12.0,13.0,15.0,11.0,10.0,7.0,7.0,2.0,3.0,1.0,8.0,10.0,1.0,2.0,3.0,2.0,7.0,2.0,7.0,8.0,8.0,12.0,14.0,11.0,13.0,8.0,13.0,14.0,5.0,11.0,1.0,15.0,11.0,8.0,11.0,13.0,14.0,13.0,20.0,12.0,8.0,5.0,14.0,14.0,13.0,8.0,14.0,10.0,1.0,7.0,13.0,14.0,13.0,16.0,14.0,14.0,6.0,30.0,0.0,0.0,0.0,0.0,187.0,82.0,3.0,3.0,2.0,3.0,3.0,3.0,4.0,3.0,3.0,2.0,2.0,7.0,9.0,5.0,8.0,8.0,6.0,14.0,9.0,11.0,13.0,10.0,3.0,13.0,7.0,15.0,12.0,16.0,8.0,11.0,7.0,12.0,6.0,4.0,8.0,7.0,13.0,13.0,14.0,10.0,11.0,13.0,14.0,5.0,13.0,11.0,20.0,15.0,15.0,12.0,13.0,11.0,11.0,11.0,17.0,11.0,10.0,10.0,13.0,11.0,18.0,5.0,30.0,0.0,0.0,0.0,0.0,182.0,71.0,3.0,2.0,1.0,3.0,3.0,2.0,3.0,2.0,1.0,2.0,1.0,5.0,12.0,12.0,7.0,12.0,7.0,13.0,7.0,11.0,12.0,11.0,6.0,13.0,13.0,14.0,13.0,14.0,8.0,12.0,9.0,11.0,14.0,11.0,9.0,11.0,10.0,13.0,15.0,14.0,13.0,14.0,11.0,8.0,13.0,13.0,20.0,14.0,14.0,13.0,14.0,14.0,10.0,8.0,12.0,13.0,13.0,12.0,14.0,11.0,11.0,7.0,25.0,0.0,0.0,9.0,0.0,183.0,78.0,1.0,3.0,1.0,1.0,1.0,2.0,3.0,2.0,1.0,3.0,2.0,5.0,12.0,10.0,5.0,11.0,6.0,13.0,8.0,10.0,13.0,10.0,6.0,12.0,12.0,13.0,11.0,13.0,10.0,10.0,10.0,9.0,12.0,8.0,7.0,12.0,11.0,12.0,12.0,16.0,13.0,13.0,11.0,20.0,14.0,15.0,7.0,14.0,11.0,11.0,13.0,12.0,6.0,8.0,13.0,15.0,12.0,10.0,8.0,14.0,14.0,10.0,28.0,0.0,0.0,1.0,0.0,163.0,66.0,2.0,3.0,1.0,1.0,1.0,3.0,3.0,1.0,1.0,2.0,2.0,10.0,12.0,10.0,4.0,11.0,11.0,5.0,9.0,10.0,9.0,11.0,7.0,11.0,11.0,10.0,12.0,12.0,11.0,10.0,10.0,10.0,17.0,7.0,10.0,7.0,10.0,13.0,14.0,13.0,13.0,9.0,4.0,20.0,13.0,12.0,5.0,13.0,7.0,13.0,10.0,14.0,12.0,12.0,15.0,14.0,15.0,14.0,16.0,15.0,15.0,6.0,22.0,0.0,0.0,0.0,0.0,180.0,74.0,2.0,4.0,2.0,1.0,3.0,1.0,2.0,1.0,1.0,2.0,3.0,7.0,8.0,10.0,7.0,13.0,10.0,8.0,11.0,5.0,13.0,13.0,12.0,10.0,13.0,12.0,13.0,12.0,12.0,14.0,12.0,12.0,14.0,11.0,7.0,8.0,12.0,14.0,14.0,12.0,12.0,13.0,9.0,14.0,14.0,12.0,20.0,14.0,11.0,14.0,10.0,14.0,8.0,10.0,14.0,14.0,12.0,9.0,12.0,10.0,7.0,7.0,31.0,3.0,1.0,0.0,0.0,180.0,68.0,2.0,1.0,2.0,2.0,1.0,1.0,3.0,2.0,1.0,3.0,2.0,14.0,12.0,13.0,10.0,15.0,13.0,8.0,14.0,7.0,6.0,14.0,6.0,6.0,16.0,9.0,10.0,11.0,12.0,9.0,14.0,11.0,14.0,13.0,7.0,13.0,6.0,10.0,10.0,12.0,12.0,10.0,9.0,12.0,14.0,12.0,20.0,9.0,10.0,12.0,9.0,15.0,8.0,14.0,14.0,8.0,12.0,11.0,10.0,14.0,15.0,5.0,26.0,0.0,0.0,0.0,0.0,173.0,70.0,4.0,3.0,3.0,3.0,2.0,1.0,2.0,2.0,1.0,2.0,3.0,13.0,12.0,12.0,8.0,13.0,11.0,6.0,10.0,6.0,5.0,12.0,10.0,7.0,14.0,12.0,12.0,12.0,12.0,13.0,11.0,11.0,14.0,13.0,7.0,12.0,9.0,12.0,15.0,12.0,14.0,12.0,7.0,20.0,13.0,13.0,6.0,15.0,9.0,13.0,11.0,16.0,7.0,12.0,20.0,13.0,13.0,16.0,14.0,12.0,12.0,6.0,39.0,0.0,0.0,0.0,0.0,178.0,75.0,4.0,3.0,1.0,2.0,2.0,2.0,3.0,3.0,2.0,2.0,1.0,12.0,12.0,13.0,12.0,15.0,12.0,12.0,11.0,6.0,6.0,15.0,15.0,8.0,16.0,7.0,12.0,12.0,13.0,14.0,14.0,12.0,14.0,11.0,12.0,9.0,12.0,12.0,14.0,11.0,12.0,14.0,8.0,10.0,15.0,10.0,20.0,10.0,12.0,15.0,7.0,16.0,6.0,10.0,14.0,14.0,14.0,14.0,14.0,14.0,14.0,6.0,28.0,0.0,0.0,0.0,0.0,170.0,72.0,1.0,2.0,2.0,1.0,2.0,3.0,2.0,2.0,3.0,3.0,1.0,10.0,12.0,13.0,6.0,14.0,8.0,7.0,11.0,8.0,4.0,13.0,11.0,4.0,14.0,8.0,11.0,12.0,11.0,11.0,12.0,12.0,15.0,13.0,6.0,12.0,8.0,12.0,14.0,15.0,15.0,10.0,6.0,5.0,13.0,14.0,20.0,12.0,10.0,14.0,8.0,14.0,9.0,10.0,9.0,12.0,14.0,14.0,14.0,15.0,15.0,6.0,20.0,0.0,0.0,8.0,0.0,170.0,65.0,3.0,1.0,1.0,3.0,2.0,3.0,2.0,2.0,2.0,1.0,3.0,10.0,10.0,13.0,13.0,13.0,10.0,9.0,10.0,3.0,4.0,11.0,12.0,4.0,13.0,12.0,12.0,14.0,11.0,11.0,11.0,11.0,15.0,12.0,7.0,14.0,7.0,12.0,15.0,16.0,16.0,12.0,7.0,7.0,14.0,15.0,20.0,14.0,11.0,13.0,9.0,13.0,8.0,12.0,9.0,13.0,14.0,14.0,15.0,15.0,14.0,6.0
0,2,36.0,0.0,0.0,0.0,0.0,185.0,78.0,11.0,14.0,12.0,7.0,13.0,12.0,14.0,15.0,13.0,14.0,10.0,4.0,1.0,3.0,1.0,8.0,8.0,11.0,8.0,3.0,3.0,7.0,2.0,1.0,8.0,11.0,13.0,15.0,11.0,12.0,7.0,13.0,9.0,5.0,14.0,3.0,13.0,15.0,8.0,11.0,14.0,13.0,12.0,5.0,15.0,11.0,20.0,12.0,14.0,13.0,11.0,13.0,8.0,1.0,19.0,14.0,16.0,10.0,17.0,9.0,9.0,11.0,34.0,23.0,1.0,0.0,0.0,186.0,81.0,3.0,3.0,1.0,2.0,1.0,3.0,2.0,3.0,1.0,3.0,3.0,4.0,8.0,6.0,10.0,7.0,8.0,17.0,12.0,10.0,14.0,7.0,9.0,15.0,7.0,15.0,13.0,17.0,8.0,12.0,7.0,12.0,15.0,6.0,17.0,7.0,14.0,15.0,14.0,8.0,10.0,16.0,13.0,12.0,13.0,9.0,20.0,13.0,15.0,11.0,15.0,14.0,9.0,10.0,10.0,14.0,11.0,13.0,15.0,11.0,11.0,12.0,28.0,0.0,0.0,0.0,0.0,183.0,81.0,1.0,2.0,4.0,1.0,1.0,3.0,2.0,3.0,3.0,3.0,1.0,5.0,5.0,6.0,10.0,12.0,6.0,14.0,8.0,6.0,15.0,11.0,6.0,13.0,12.0,13.0,14.0,16.0,14.0,14.0,10.0,12.0,14.0,5.0,14.0,8.0,14.0,15.0,15.0,9.0,12.0,15.0,13.0,7.0,11.0,12.0,20.0,15.0,15.0,14.0,14.0,14.0,9.0,8.0,14.0,14.0,11.0,13.0,15.0,13.0,15.0,6.0,27.0,10.0,0.0,0.0,0.0,181.0,69.0,1.0,1.0,3.0,3.0,3.0,3.0,2.0,3.0,3.0,3.0,1.0,5.0,13.0,10.0,7.0,13.0,9.0,10.0,10.0,12.0,12.0,11.0,7.0,12.0,11.0,11.0,13.0,12.0,11.0,13.0,9.0,9.0,12.0,8.0,7.0,12.0,11.0,11.0,13.0,15.0,13.0,13.0,10.0,20.0,12.0,15.0,8.0,15.0,12.0,13.0,11.0,14.0,13.0,12.0,10.0,14.0,12.0,10.0,11.0,15.0,15.0,7.0,24.0,0.0,0.0,0.0,0.0,179.0,68.0,3.0,2.0,3.0,2.0,1.0,3.0,3.0,1.0,3.0,3.0,1.0,4.0,13.0,9.0,6.0,12.0,9.0,12.0,7.0,8.0,12.0,14.0,8.0,14.0,12.0,15.0,14.0,13.0,14.0,13.0,10.0,12.0,14.0,10.0,9.0,9.0,10.0,13.0,14.0,14.0,12.0,13.0,9.0,9.0,8.0,14.0,20.0,15.0,14.0,11.0,11.0,13.0,10.0,14.0,13.0,14.0,14.0,11.0,16.0,15.0,15.0,6.0,36.0,0.0,0.0,0.0,0.0,180.0,72.0,1.0,2.0,4.0,1.0,1.0,2.0,2.0,1.0,1.0,1.0,2.0,6.0,10.0,8.0,6.0,11.0,8.0,13.0,10.0,7.0,11.0,11.0,8.0,13.0,11.0,13.0,13.0,14.0,14.0,13.0,11.0,12.0,13.0,7.0,10.0,10.0,13.0,13.0,15.0,11.0,12.0,14.0,10.0,10.0,14.0,10.0,20.0,12.0,11.0,12.0,14.0,14.0,5.0,15.0,20.0,12.0,20.0,14.0,16.0,15.0,15.0,5.0,23.0,27.0,1.0,0.0,0.0,178.0,70.0,1.0,2.0,1.0,4.0,1.0,1.0,1.0,3.0,2.0,1.0,1.0,8.0,11.0,13.0,11.0,13.0,12.0,7.0,14.0,6.0,5.0,12.0,10.0,5.0,14.0,11.0,11.0,12.0,11.0,9.0,13.0,10.0,14.0,14.0,5.0,13.0,7.0,10.0,12.0,15.0,14.0,12.0,9.0,20.0,13.0,13.0,8.0,13.0,13.0,12.0,11.0,11.0,10.0,11.0,12.0,12.0,12.0,11.0,10.0,10.0,10.0,6.0,33.0,0.0,0.0,0.0,0.0,187.0,76.0,2.0,2.0,3.0,1.0,1.0,3.0,2.0,1.0,2.0,3.0,2.0,15.0,14.0,14.0,10.0,15.0,13.0,10.0,12.0,7.0,4.0,15.0,13.0,7.0,15.0,6.0,12.0,9.0,14.0,11.0,15.0,12.0,12.0,14.0,12.0,13.0,7.0,13.0,12.0,11.0,12.0,14.0,12.0,14.0,15.0,12.0,20.0,11.0,12.0,12.0,6.0,14.0,6.0,11.0,14.0,13.0,12.0,12.0,15.0,15.0,13.0,9.0,30.0,0.0,0.0,0.0,0.0,178.0,73.0,3.0,4.0,1.0,1.0,2.0,4.0,3.0,2.0,2.0,2.0,3.0,13.0,14.0,12.0,7.0,13.0,12.0,7.0,13.0,5.0,10.0,13.0,9.0,10.0,13.0,11.0,11.0,12.0,12.0,13.0,11.0,14.0,14.0,11.0,7.0,11.0,10.0,13.0,15.0,13.0,15.0,15.0,8.0,20.0,14.0,14.0,8.0,14.0,11.0,13.0,11.0,14.0,8.0,10.0,19.0,12.0,12.0,9.0,12.0,12.0,10.0,10.0,26.0,0.0,0.0,0.0,0.0,193.0,81.0,1.0,3.0,3.0,3.0,3.0,1.0,2.0,2.0,2.0,3.0,3.0,4.0,9.0,14.0,10.0,13.0,12.0,14.0,14.0,5.0,5.0,10.0,12.0,3.0,14.0,8.0,13.0,12.0,9.0,10.0,11.0,11.0,12.0,16.0,5.0,14.0,6.0,9.0,12.0,14.0,13.0,14.0,16.0,14.0,13.0,13.0,20.0,13.0,14.0,10.0,8.0,14.0,9.0,8.0,16.0,16.0,11.0,13.0,11.0,13.0,13.0,10.0,24.0,0.0,0.0,0.0,0.0,182.0,82.0,3.0,3.0,2.0,1.0,1.0,3.0,2.0,2.0,3.0,2.0,2.0,4.0,7.0,13.0,14.0,13.0,12.0,14.0,12.0,5.0,7.0,10.0,14.0,6.0,15.0,13.0,13.0,16.0,8.0,12.0,11.0,11.0,12.0,14.0,7.0,13.0,8.0,12.0,13.0,14.0,14.0,15.0,12.0,10.0,10.0,12.0,20.0,16.0,15.0,12.0,13.0,14.0,10.0,8.0,8.0,13.0,5.0,10.0,11.0,9.0,9.0,13.0,28.0,0.0,0.0,6.0,0.0,191.0,81.0,11.0,10.0,14.0,8.0,13.0,12.0,14.0,15.0,11.0,8.0,13.0,4.0,3.0,2.0,1.0,9.0,9.0,3.0,10.0,1.0,1.0,8.0,3.0,3.0,9.0,8.0,12.0,14.0,12.0,13.0,8.0,11.0,12.0,6.0,14.0,2.0,12.0,10.0,7.0,13.0,14.0,16.0,15.0,6.0,14.0,11.0,20.0,15.0,14.0,12.0,9.0,14.0,7.0,1.0,9.0,15.0,13.0,11.0,15.0,15.0,14.0,8.0,32.0,93.0,1.0,0.0,0.0,186.0,85.0,3.0,2.0,3.0,2.0,1.0,2.0,2.0,1.0,2.0,1.0,2.0,5.0,8.0,8.0,9.0,10.0,10.0,15.0,13.0,14.0,11.0,13.0,11.0,14.0,11.0,17.0,14.0,19.0,15.0,14.0,10.0,11.0,20.0,8.0,18.0,11.0,15.0,17.0,15.0,10.0,9.0,13.0,13.0,8.0,15.0,11.0,20.0,12.0,13.0,11.0,18.0,15.0,4.0,14.0,18.0,15.0,14.0,15.0,17.0,12.0,12.0,7.0,32.0,67.0,9.0,7.0,0.0,191.0,85.0,1.0,1.0,1.0,3.0,2.0,2.0,4.0,3.0,3.0,2.0,3.0,7.0,7.0,6.0,9.0,12.0,3.0,16.0,7.0,3.0,15.0,11.0,7.0,13.0,12.0,14.0,11.0,14.0,10.0,11.0,10.0,14.0,11.0,8.0,13.0,13.0,13.0,13.0,15.0,9.0,7.0,14.0,16.0,8.0,7.0,10.0,20.0,12.0,15.0,13.0,14.0,5.0,6.0,11.0,8.0,11.0,9.0,12.0,11.0,6.0,9.0,11.0,23.0,0.0,0.0,0.0,0.0,174.0,64.0,4.0,3.0,1.0,1.0,3.0,3.0,2.0,3.0,3.0,2.0,3.0,8.0,12.0,10.0,8.0,11.0,7.0,10.0,9.0,12.0,14.0,9.0,10.0,13.0,12.0,12.0,12.0,12.0,11.0,12.0,10.0,12.0,13.0,8.0,9.0,12.0,11.0,13.0,14.0,15.0,14.0,11.0,10.0,10.0,14.0,14.0,20.0,15.0,10.0,14.0,12.0,12.0,8.0,13.0,10.0,12.0,15.0,12.0,13.0,10.0,17.0,6.0,27.0,0.0,0.0,0.0,0.0,172.0,67.0,3.0,3.0,2.0,3.0,3.0,4.0,1.0,3.0,3.0,3.0,2.0,8.0,12.0,11.0,5.0,11.0,7.0,8.0,10.0,11.0,7.0,11.0,8.0,12.0,12.0,13.0,11.0,13.0,9.0,8.0,11.0,11.0,13.0,8.0,6.0,12.0,10.0,12.0,14.0,16.0,13.0,11.0,7.0,20.0,14.0,15.0,8.0,14.0,8.0,13.0,13.0,15.0,11.0,12.0,11.0,12.0,12.0,12.0,16.0,16.0,16.0,7.0,21.0,0.0,0.0,0.0,0.0,172.0,66.0,2.0,3.0,2.0,2.0,1.0,1.0,1.0,3.0,2.0,1.0,1.0,10.0,10.0,13.0,9.0,14.0,9.0,8.0,10.0,7.0,13.0,13.0,9.0,12.0,13.0,10.0,12.0,13.0,13.0,12.0,14.0,13.0,13.0,11.0,9.0,14.0,13.0,14.0,14.0,14.0,13.0,12.0,8.0,8.0,12.0,12.0,20.0,13.0,12.0,14.0,10.0,11.0,8.0,12.0,15.0,10.0,15.0,8.0,11.0,14.0,14.0,6.0,24.0,8.0,0.0,0.0,0.0,182.0,76.0,2.0,3.0,2.0,1.0,2.0,3.0,3.0,3.0,2.0,1.0,2.0,8.0,11.0,10.0,8.0,12.0,9.0,13.0,11.0,5.0,13.0,13.0,10.0,12.0,12.0,10.0,14.0,12.0,13.0,12.0,13.0,12.0,14.0,6.0,10.0,12.0,14.0,15.0,14.0,13.0,12.0,11.0,12.0,7.0,15.0,13.0,20.0,14.0,14.0,14.0,10.0,14.0,7.0,8.0,2.0,12.0,16.0,13.0,14.0,14.0,14.0,6.0,22.0,0.0,0.0,0.0,0.0,177.0,72.0,2.0,1.0,2.0,4.0,2.0,2.0,1.0,3.0,4.0,2.0,3.0,10.0,12.0,13.0,11.0,12.0,10.0,12.0,12.0,4.0,10.0,13.0,11.0,11.0,13.0,11.0,12.0,11.0,13.0,9.0,13.0,12.0,3.0,12.0,8.0,14.0,12.0,12.0,13.0,16.0,13.0,12.0,9.0,8.0,15.0,14.0,20.0,14.0,13.0,10.0,4.0,11.0,11.0,12.0,19.0,9.0,12.0,13.0,12.0,11.0,14.0,7.0,32.0,1.0,1.0,0.0,0.0,180.0,73.0,4.0,3.0,2.0,2.0,2.0,4.0,3.0,2.0,3.0,1.0,2.0,7.0,14.0,14.0,12.0,14.0,8.0,12.0,10.0,5.0,4.0,10.0,13.0,4.0,15.0,9.0,10.0,12.0,11.0,12.0,10.0,12.0,15.0,14.0,8.0,13.0,7.0,10.0,14.0,15.0,14.0,13.0,10.0,20.0,13.0,14.0,8.0,12.0,11.0,14.0,9.0,15.0,16.0,8.0,11.0,15.0,13.0,14.0,14.0,12.0,12.0,8.0,25.0,0.0,0.0,0.0,0.0,187.0,83.0,2.0,1.0,3.0,3.0,1.0,3.0,3.0,3.0,1.0,1.0,3.0,4.0,8.0,10.0,14.0,12.0,8.0,14.0,9.0,5.0,7.0,11.0,13.0,5.0,12.0,11.0,13.0,13.0,13.0,11.0,10.0,12.0,16.0,9.0,8.0,13.0,11.0,13.0,16.0,14.0,13.0,15.0,13.0,20.0,14.0,12.0,8.0,14.0,16.0,13.0,11.0,13.0,7.0,5.0,13.0,14.0,13.0,14.0,14.0,13.0,13.0,6.0,24.0,4.0,1.0,0.0,0.0,188.0,79.0,2.0,3.0,2.0,1.0,2.0,1.0,1.0,2.0,1.0,2.0,2.0,10.0,11.0,13.0,12.0,11.0,9.0,13.0,9.0,5.0,8.0,11.0,11.0,7.0,13.0,10.0,12.0,11.0,11.0,12.0,13.0,11.0,14.0,12.0,9.0,12.0,12.0,14.0,14.0,12.0,13.0,15.0,14.0,8.0,13.0,12.0,20.0,13.0,14.0,11.0,9.0,10.0,5.0,10.0,14.0,12.0,13.0,10.0,14.0,13.0,12.0,10.0
3,0,25.0,4.0,0.0,11.0,0.0,184.0,81.0,14.0,14.0,13.0,9.0,15.0,12.0,16.0,16.0,13.0,7.0,11.0,8.0,1.0,2.0,1.0,11.0,12.0,6.0,1.0,3.0,3.0,11.0,5.0,3.0,11.0,8.0,15.0,15.0,13.0,14.0,10.0,11.0,14.0,8.0,13.0,5.0,13.0,10.0,10.0,14.0,16.0,14.0,13.0,20.0,14.0,12.0,5.0,14.0,14.0,15.0,9.0,16.0,6.0,1.0,17.0,11.0,15.0,13.0,14.0,12.0,12.0,4.0,22.0,3.0,0.0,7.0,1.0,182.0,75.0,3.0,3.0,1.0,3.0,2.0,3.0,1.0,1.0,2.0,2.0,1.0,4.0,11.0,10.0,6.0,14.0,7.0,13.0,10.0,9.0,16.0,14.0,8.0,15.0,14.0,13.0,17.0,15.0,16.0,14.0,11.0,14.0,15.0,8.0,11.0,10.0,15.0,16.0,14.0,14.0,14.0,14.0,11.0,20.0,15.0,14.0,10.0,15.0,15.0,15.0,12.0,15.0,8.0,11.0,12.0,14.0,16.0,15.0,14.0,14.0,14.0,5.0,32.0,0.0,0.0,0.0,0.0,172.0,71.0,2.0,1.0,3.0,1.0,2.0,3.0,2.0,3.0,2.0,2.0,2.0,8.0,9.0,7.0,6.0,10.0,6.0,10.0,9.0,10.0,14.0,11.0,6.0,14.0,11.0,10.0,16.0,15.0,12.0,12.0,7.0,12.0,15.0,9.0,13.0,8.0,14.0,15.0,15.0,14.0,14.0,14.0,10.0,20.0,14.0,14.0,8.0,15.0,13.0,13.0,11.0,13.0,7.0,13.0,17.0,14.0,17.0,8.0,13.0,15.0,15.0,6.0,32.0,11.0,1.0,0.0,0.0,176.0,68.0,2.0,1.0,3.0,2.0,2.0,2.0,2.0,3.0,3.0,2.0,2.0,8.0,10.0,10.0,7.0,11.0,8.0,10.0,11.0,12.0,11.0,13.0,12.0,14.0,12.0,9.0,14.0,15.0,13.0,12.0,11.0,12.0,17.0,8.0,14.0,14.0,11.0,18.0,18.0,14.0,14.0,12.0,10.0,10.0,14.0,13.0,20.0,17.0,13.0,15.0,9.0,13.0,8.0,13.0,17.0,13.0,15.0,16.0,16.0,16.0,18.0,5.0,27.0,8.0,0.0,6.0,0.0,187.0,76.0,3.0,2.0,3.0,2.0,2.0,1.0,1.0,3.0,3.0,1.0,2.0,5.0,7.0,11.0,5.0,14.0,5.0,14.0,9.0,5.0,15.0,15.0,8.0,14.0,13.0,15.0,16.0,15.0,14.0,12.0,14.0,14.0,18.0,8.0,17.0,9.0,12.0,18.0,15.0,13.0,14.0,15.0,14.0,10.0,17.0,12.0,20.0,17.0,15.0,14.0,13.0,16.0,4.0,12.0,10.0,14.0,17.0,12.0,15.0,13.0,13.0,6.0,24.0,0.0,0.0,6.0,1.0,172.0,70.0,3.0,1.0,1.0,3.0,1.0,2.0,3.0,1.0,1.0,3.0,3.0,11.0,12.0,11.0,8.0,12.0,10.0,6.0,14.0,7.0,11.0,15.0,8.0,12.0,13.0,14.0,14.0,18.0,13.0,12.0,13.0,13.0,15.0,12.0,12.0,12.0,11.0,18.0,18.0,13.0,14.0,13.0,7.0,10.0,16.0,12.0,20.0,14.0,12.0,14.0,14.0,15.0,4.0,8.0,7.0,14.0,14.0,13.0,14.0,12.0,10.0,6.0,22.0,0.0,0.0,4.0,0.0,180.0,80.0,4.0,1.0,1.0,3.0,2.0,3.0,1.0,3.0,3.0,3.0,4.0,7.0,10.0,11.0,8.0,15.0,11.0,10.0,14.0,5.0,14.0,15.0,10.0,15.0,15.0,13.0,14.0,13.0,12.0,14.0,15.0,13.0,16.0,12.0,8.0,15.0,13.0,13.0,13.0,13.0,13.0,12.0,10.0,12.0,12.0,12.0,20.0,13.0,12.0,13.0,10.0,12.0,7.0,11.0,12.0,15.0,12.0,16.0,15.0,10.0,10.0,7.0,21.0,0.0,0.0,15.0,3.0,181.0,78.0,3.0,3.0,4.0,2.0,1.0,2.0,2.0,4.0,2.0,1.0,1.0,5.0,7.0,11.0,10.0,14.0,5.0,14.0,10.0,6.0,13.0,14.0,8.0,14.0,14.0,12.0,14.0,12.0,11.0,10.0,12.0,11.0,16.0,11.0,12.0,14.0,14.0,14.0,14.0,14.0,13.0,14.0,13.0,10.0,16.0,14.0,20.0,16.0,14.0,12.0,10.0,11.0,5.0,19.0,8.0,11.0,14.0,11.0,16.0,13.0,13.0,10.0,31.0,52.0,8.0,0.0,0.0,167.0,58.0,1.0,2.0,2.0,1.0,3.0,2.0,4.0,2.0,1.0,2.0,3.0,15.0,15.0,14.0,7.0,15.0,15.0,6.0,11.0,3.0,4.0,15.0,14.0,7.0,15.0,13.0,12.0,15.0,13.0,14.0,16.0,11.0,17.0,14.0,11.0,12.0,10.0,12.0,14.0,15.0,18.0,10.0,5.0,10.0,16.0,14.0,20.0,13.0,7.0,14.0,13.0,16.0,8.0,12.0,13.0,16.0,14.0,15.0,13.0,9.0,11.0,14.0,28.0,2.0,1.0,0.0,0.0,174.0,66.0,2.0,2.0,2.0,1.0,1.0,3.0,2.0,3.0,3.0,1.0,4.0,6.0,11.0,13.0,15.0,13.0,11.0,14.0,11.0,6.0,5.0,10.0,12.0,5.0,13.0,8.0,14.0,10.0,13.0,14.0,8.0,12.0,12.0,12.0,5.0,14.0,8.0,12.0,11.0,17.0,15.0,11.0,12.0,7.0,14.0,15.0,20.0,13.0,10.0,12.0,8.0,14.0,8.0,8.0,19.0,15.0,12.0,10.0,11.0,13.0,13.0,12.0,25.0,10.0,1.0,11.0,4.0,175.0,73.0,1.0,3.0,3.0,3.0,3.0,3.0,3.0,1.0,2.0,3.0,1.0,5.0,10.0,15.0,17.0,15.0,10.0,11.0,12.0,5.0,5.0,14.0,15.0,5.0,16.0,8.0,15.0,12.0,15.0,14.0,13.0,15.0,15.0,15.0,14.0,14.0,10.0,10.0,12.0,16.0,16.0,15.0,9.0,10.0,15.0,16.0,20.0,13.0,15.0,14.0,8.0,14.0,7.0,10.0,8.0,16.0,17.0,13.0,15.0,15.0,14.0,5.0,24.0,2.0,0.0,0.0,0.0,189.0,86.0,13.0,12.0,11.0,9.0,14.0,12.0,14.0,16.0,9.0,14.0,7.0,3.0,2.0,3.0,6.0,8.0,8.0,5.0,12.0,2.0,3.0,9.0,3.0,1.0,8.0,8.0,12.0,12.0,12.0,12.0,7.0,9.0,13.0,8.0,8.0,2.0,11.0,10.0,8.0,14.0,15.0,16.0,14.0,5.0,15.0,12.0,20.0,14.0,16.0,13.0,8.0,16.0,7.0,10.0,12.0,13.0,14.0,16.0,14.0,15.0,15.0,7.0,23.0,0.0,0.0,0.0,0.0,180.0,77.0,2.0,1.0,3.0,2.0,3.0,2.0,2.0,2.0,3.0,1.0,2.0,6.0,11.0,11.0,6.0,13.0,7.0,11.0,5.0,8.0,14.0,12.0,9.0,12.0,9.0,15.0,14.0,17.0,10.0,14.0,8.0,13.0,14.0,7.0,8.0,7.0,10.0,13.0,15.0,15.0,13.0,13.0,10.0,5.0,14.0,14.0,20.0,15.0,14.0,14.0,15.0,6.0,7.0,11.0,18.0,13.0,14.0,15.0,13.0,12.0,14.0,2.0,26.0,5.0,0.0,0.0,0.0,184.0,86.0,3.0,3.0,2.0,1.0,2.0,2.0,4.0,1.0,3.0,1.0,3.0,4.0,10.0,9.0,6.0,10.0,7.0,14.0,8.0,8.0,14.0,9.0,6.0,14.0,9.0,14.0,14.0,16.0,9.0,15.0,7.0,11.0,13.0,8.0,10.0,9.0,13.0,12.0,12.0,12.0,12.0,17.0,12.0,5.0,15.0,15.0,20.0,14.0,17.0,11.0,14.0,13.0,7.0,10.0,13.0,16.0,14.0,11.0,11.0,12.0,9.0,14.0,23.0,1.0,0.0,4.0,0.0,190.0,80.0,1.0,4.0,1.0,3.0,3.0,1.0,1.0,1.0,2.0,4.0,2.0,6.0,11.0,13.0,7.0,13.0,6.0,11.0,8.0,10.0,15.0,12.0,5.0,15.0,12.0,14.0,14.0,16.0,9.0,11.0,10.0,10.0,16.0,12.0,12.0,9.0,12.0,10.0,14.0,14.0,12.0,15.0,17.0,8.0,15.0,16.0,20.0,13.0,14.0,13.0,8.0,13.0,6.0,14.0,11.0,14.0,12.0,13.0,16.0,14.0,12.0,6.0,26.0,4.0,0.0,2.0,0.0,180.0,74.0,3.0,3.0,1.0,2.0,2.0,1.0,3.0,4.0,1.0,2.0,1.0,8.0,13.0,13.0,6.0,13.0,9.0,12.0,7.0,11.0,13.0,13.0,11.0,12.0,12.0,16.0,14.0,14.0,9.0,12.0,11.0,13.0,4.0,4.0,6.0,11.0,12.0,8.0,12.0,14.0,14.0,13.0,9.0,20.0,16.0,13.0,5.0,15.0,13.0,12.0,6.0,9.0,10.0,12.0,8.0,14.0,8.0,11.0,12.0,11.0,13.0,2.0,26.0,17.0,0.0,19.0,1.0,191.0,79.0,3.0,2.0,1.0,1.0,1.0,1.0,2.0,2.0,3.0,3.0,4.0,4.0,8.0,11.0,9.0,12.0,7.0,14.0,10.0,6.0,12.0,13.0,7.0,11.0,12.0,14.0,13.0,14.0,12.0,10.0,11.0,12.0,15.0,9.0,7.0,11.0,12.0,12.0,15.0,14.0,13.0,16.0,15.0,8.0,15.0,13.0,20.0,19.0,15.0,11.0,14.0,14.0,7.0,12.0,12.0,14.0,12.0,10.0,9.0,14.0,14.0,14.0,21.0,0.0,0.0,0.0,0.0,188.0,80.0,1.0,2.0,2.0,3.0,2.0,2.0,2.0,2.0,1.0,1.0,1.0,6.0,9.0,12.0,6.0,12.0,12.0,12.0,11.0,3.0,12.0,13.0,8.0,13.0,13.0,13.0,13.0,13.0,13.0,13.0,13.0,13.0,13.0,8.0,11.0,11.0,13.0,15.0,13.0,12.0,12.0,13.0,14.0,20.0,14.0,11.0,5.0,13.0,14.0,12.0,11.0,3.0,6.0,8.0,17.0,12.0,13.0,13.0,14.0,14.0,14.0,6.0,23.0,11.0,0.0,0.0,0.0,180.0,71.0,2.0,1.0,2.0,3.0,3.0,1.0,1.0,2.0,2.0,1.0,1.0,6.0,11.0,10.0,8.0,10.0,7.0,11.0,9.0,12.0,13.0,11.0,6.0,13.0,11.0,12.0,11.0,13.0,12.0,9.0,11.0,11.0,14.0,12.0,11.0,12.0,11.0,13.0,15.0,15.0,13.0,13.0,11.0,7.0,14.0,15.0,20.0,12.0,11.0,12.0,12.0,13.0,10.0,15.0,10.0,13.0,16.0,12.0,15.0,14.0,14.0,7.0,28.0,0.0,0.0,0.0,0.0,180.0,79.0,3.0,2.0,3.0,3.0,2.0,2.0,2.0,1.0,3.0,2.0,3.0,8.0,11.0,15.0,12.0,15.0,12.0,7.0,10.0,7.0,8.0,13.0,13.0,6.0,16.0,11.0,11.0,10.0,13.0,10.0,15.0,12.0,3.0,15.0,6.0,13.0,13.0,12.0,12.0,15.0,16.0,14.0,8.0,12.0,12.0,14.0,20.0,12.0,12.0,13.0,6.0,13.0,6.0,6.0,8.0,9.0,13.0,10.0,12.0,12.0,2.0,2.0,25.0,0.0,0.0,3.0,0.0,170.0,68.0,2.0,1.0,3.0,1.0,3.0,1.0,3.0,2.0,2.0,4.0,1.0,12.0,11.0,15.0,16.0,16.0,13.0,11.0,12.0,4.0,5.0,12.0,14.0,4.0,17.0,7.0,14.0,7.0,15.0,13.0,13.0,14.0,14.0,15.0,7.0,16.0,8.0,10.0,13.0,15.0,15.0,12.0,6.0,11.0,14.0,14.0,20.0,13.0,11.0,12.0,7.0,15.0,7.0,8.0,12.0,14.0,13.0,14.0,13.0,16.0,16.0,8.0,25.0,14.0,1.0,2.0,0.0,177.0,77.0,3.0,3.0,1.0,2.0,3.0,3.0,1.0,3.0,3.0,4.0,1.0,8.0,11.0,13.0,12.0,12.0,10.0,11.0,10.0,2.0,3.0,11.0,10.0,5.0,13.0,12.0,12.0,13.0,11.0,10.0,11.0,10.0,14.0,16.0,14.0,15.0,5.0,13.0,14.0,15.0,14.0,12.0,12.0,12.0,14.0,16.0,20.0,13.0,14.0,13.0,7.0,14.0,11.0,13.0,14.0,11.0,12.0,8.0,12.0,13.0,15.0,6.0
1,0,34.0,1.0,0.0,0.0,0.0,187.0,87.0,13.0,14.0,15.0,7.0,13.0,11.0,14.0,15.0,11.0,17.0,12.0,2.0,1.0,1.0,3.0,8.0,7.0,2.0,1.0,2.0,1.0,9.0,8.0,2.0,6.0,12.0,15.0,17.0,14.0,15.0,8.0,13.0,17.0,7.0,14.0,6.0,14.0,12.0,6.0,7.0,13.0,14.0,13.0,8.0,13.0,8.0,20.0,11.0,16.0,14.0,10.0,14.0,6.0,1.0,12.0,12.0,15.0,16.0,16.0,14.0,15.0,6.0,29.0,35.0,0.0,0.0,0.0,192.0,77.0,1.0,3.0,2.0,2.0,2.0,2.0,2.0,3.0,1.0,3.0,3.0,5.0,8.0,8.0,7.0,9.0,6.0,11.0,9.0,12.0,14.0,10.0,7.0,15.0,10.0,14.0,13.0,17.0,9.0,13.0,10.0,11.0,13.0,7.0,14.0,8.0,12.0,10.0,13.0,13.0,11.0,17.0,18.0,6.0,12.0,15.0,20.0,13.0,16.0,13.0,14.0,16.0,14.0,12.0,9.0,12.0,15.0,10.0,10.0,11.0,8.0,15.0,34.0,0.0,0.0,0.0,0.0,191.0,81.0,14.0,10.0,8.0,3.0,9.0,14.0,13.0,10.0,9.0,3.0,12.0,4.0,3.0,3.0,1.0,1.0,6.0,1.0,1.0,2.0,1.0,2.0,3.0,3.0,3.0,8.0,6.0,10.0,8.0,9.0,5.0,10.0,2.0,1.0,10.0,2.0,10.0,8.0,7.0,10.0,8.0,8.0,16.0,9.0,14.0,9.0,20.0,3.0,9.0,9.0,9.0,1.0,9.0,9.0,20.0,9.0,13.0,12.0,10.0,10.0,12.0,7.0,21.0,0.0,0.0,1.0,0.0,177.0,68.0,4.0,1.0,2.0,1.0,1.0,1.0,1.0,1.0,2.0,1.0,2.0,5.0,12.0,9.0,7.0,12.0,8.0,13.0,10.0,16.0,13.0,12.0,8.0,14.0,12.0,12.0,13.0,12.0,12.0,12.0,10.0,13.0,15.0,11.0,13.0,11.0,13.0,13.0,14.0,13.0,14.0,13.0,11.0,10.0,14.0,12.0,20.0,12.0,14.0,12.0,11.0,12.0,8.0,14.0,13.0,10.0,14.0,12.0,14.0,12.0,11.0,5.0,23.0,0.0,0.0,0.0,0.0,179.0,71.0,2.0,1.0,3.0,3.0,2.0,3.0,2.0,2.0,1.0,3.0,1.0,8.0,10.0,12.0,6.0,12.0,10.0,5.0,10.0,13.0,11.0,11.0,6.0,12.0,11.0,9.0,11.0,12.0,12.0,7.0,10.0,9.0,15.0,12.0,5.0,13.0,8.0,12.0,14.0,16.0,13.0,13.0,10.0,20.0,16.0,15.0,8.0,14.0,14.0,13.0,9.0,14.0,7.0,10.0,7.0,14.0,14.0,13.0,15.0,13.0,13.0,5.0,34.0,103.0,7.0,16.0,1.0,182.0,72.0,2.0,1.0,1.0,1.0,3.0,1.0,4.0,3.0,3.0,2.0,1.0,11.0,13.0,12.0,8.0,15.0,13.0,9.0,13.0,6.0,8.0,15.0,12.0,8.0,15.0,11.0,14.0,13.0,15.0,15.0,14.0,16.0,17.0,15.0,14.0,11.0,13.0,17.0,13.0,8.0,11.0,10.0,11.0,16.0,13.0,8.0,20.0,12.0,10.0,15.0,11.0,12.0,12.0,15.0,14.0,12.0,15.0,15.0,18.0,14.0,14.0,7.0,28.0,1.0,0.0,7.0,0.0,181.0,71.0,2.0,2.0,1.0,3.0,1.0,3.0,3.0,2.0,3.0,3.0,3.0,12.0,11.0,10.0,5.0,13.0,11.0,8.0,10.0,8.0,9.0,14.0,11.0,12.0,13.0,14.0,14.0,12.0,12.0,13.0,12.0,13.0,12.0,8.0,9.0,9.0,12.0,17.0,15.0,11.0,13.0,14.0,10.0,12.0,13.0,12.0,20.0,16.0,12.0,13.0,14.0,16.0,12.0,9.0,10.0,14.0,16.0,14.0,13.0,12.0,12.0,14.0,25.0,19.0,6.0,0.0,0.0,182.0,78.0,1.0,4.0,3.0,1.0,2.0,1.0,2.0,2.0,4.0,1.0,4.0,16.0,13.0,12.0,11.0,12.0,13.0,8.0,12.0,5.0,5.0,13.0,13.0,5.0,15.0,11.0,12.0,12.0,13.0,12.0,15.0,12.0,15.0,14.0,6.0,15.0,9.0,11.0,14.0,15.0,14.0,14.0,10.0,11.0,11.0,14.0,20.0,12.0,13.0,10.0,11.0,15.0,5.0,12.0,10.0,15.0,16.0,11.0,13.0,16.0,16.0,7.0,23.0,21.0,3.0,9.0,4.0,176.0,69.0,1.0,2.0,1.0,3.0,3.0,1.0,2.0,1.0,1.0,2.0,3.0,9.0,9.0,14.0,13.0,14.0,10.0,10.0,9.0,3.0,5.0,12.0,14.0,6.0,15.0,9.0,13.0,9.0,11.0,10.0,12.0,12.0,13.0,14.0,10.0,13.0,8.0,8.0,10.0,16.0,15.0,10.0,8.0,10.0,12.0,15.0,20.0,13.0,10.0,9.0,8.0,13.0,11.0,13.0,7.0,14.0,12.0,13.0,8.0,14.0,13.0,8.0,25.0,9.0,0.0,0.0,0.0,173.0,70.0,1.0,2.0,1.0,2.0,3.0,2.0,1.0,2.0,1.0,4.0,3.0,6.0,8.0,13.0,10.0,14.0,13.0,13.0,13.0,5.0,10.0,13.0,11.0,9.0,15.0,7.0,13.0,13.0,12.0,12.0,12.0,13.0,13.0,15.0,12.0,13.0,7.0,14.0,15.0,13.0,13.0,12.0,10.0,12.0,11.0,13.0,20.0,14.0,13.0,13.0,7.0,13.0,13.0,13.0,8.0,15.0,13.0,12.0,13.0,15.0,15.0,6.0,21.0,0.0,0.0,4.0,1.0,184.0,79.0,1.0,2.0,3.0,1.0,2.0,1.0,3.0,2.0,2.0,1.0,3.0,3.0,6.0,10.0,12.0,12.0,7.0,15.0,8.0,4.0,5.0,13.0,10.0,8.0,12.0,18.0,12.0,19.0,13.0,10.0,13.0,12.0,14.0,13.0,10.0,12.0,9.0,16.0,15.0,12.0,14.0,14.0,14.0,12.0,13.0,10.0,20.0,14.0,14.0,11.0,14.0,14.0,11.0,5.0,10.0,13.0,14.0,15.0,10.0,8.0,4.0,15.0,19.0,0.0,0.0,0.0,0.0,190.0,78.0,13.0,12.0,11.0,14.0,13.0,6.0,11.0,13.0,13.0,12.0,7.0,3.0,3.0,1.0,3.0,8.0,8.0,3.0,1.0,2.0,3.0,7.0,3.0,1.0,7.0,8.0,13.0,13.0,12.0,13.0,7.0,11.0,11.0,3.0,14.0,2.0,11.0,11.0,10.0,12.0,13.0,11.0,15.0,20.0,10.0,13.0,5.0,13.0,13.0,9.0,10.0,6.0,10.0,10.0,10.0,12.0,11.0,14.0,14.0,12.0,13.0,3.0,30.0,0.0,0.0,0.0,0.0,187.0,82.0,3.0,3.0,2.0,3.0,3.0,3.0,4.0,3.0,3.0,2.0,2.0,7.0,9.0,5.0,8.0,8.0,6.0,14.0,9.0,11.0,13.0,10.0,3.0,13.0,7.0,15.0,12.0,16.0,8.0,11.0,7.0,12.0,6.0,4.0,8.0,7.0,13.0,13.0,14.0,10.0,11.0,13.0,14.0,5.0,13.0,11.0,20.0,15.0,15.0,12.0,13.0,11.0,11.0,11.0,17.0,11.0,10.0,10.0,13.0,11.0,18.0,5.0,29.0,0.0,0.0,8.0,0.0,176.0,67.0,1.0,3.0,2.0,1.0,1.0,1.0,2.0,2.0,3.0,2.0,1.0,8.0,11.0,10.0,5.0,9.0,8.0,9.0,7.0,11.0,11.0,11.0,8.0,12.0,10.0,12.0,11.0,13.0,12.0,11.0,9.0,10.0,16.0,11.0,8.0,9.0,11.0,13.0,14.0,14.0,13.0,13.0,8.0,10.0,12.0,14.0,20.0,15.0,11.0,14.0,12.0,15.0,8.0,16.0,14.0,16.0,11.0,14.0,15.0,14.0,14.0,9.0,25.0,0.0,0.0,9.0,0.0,183.0,78.0,1.0,3.0,1.0,1.0,1.0,2.0,3.0,2.0,1.0,3.0,2.0,5.0,12.0,10.0,5.0,11.0,6.0,13.0,8.0,10.0,13.0,10.0,6.0,12.0,12.0,13.0,11.0,13.0,10.0,10.0,10.0,9.0,12.0,8.0,7.0,12.0,11.0,12.0,12.0,16.0,13.0,13.0,11.0,20.0,14.0,15.0,7.0,14.0,11.0,11.0,13.0,12.0,6.0,8.0,13.0,15.0,12.0,10.0,8.0,14.0,14.0,10.0,30.0,0.0,0.0,0.0,0.0,182.0,71.0,3.0,2.0,1.0,3.0,3.0,2.0,3.0,2.0,1.0,2.0,1.0,5.0,12.0,12.0,7.0,12.0,7.0,13.0,7.0,11.0,12.0,11.0,6.0,13.0,13.0,14.0,13.0,14.0,8.0,12.0,9.0,11.0,14.0,11.0,9.0,11.0,10.0,13.0,15.0,14.0,13.0,14.0,11.0,8.0,13.0,13.0,20.0,14.0,14.0,13.0,14.0,14.0,10.0,8.0,12.0,13.0,13.0,12.0,14.0,11.0,11.0,7.0,22.0,0.0,0.0,0.0,0.0,180.0,74.0,2.0,4.0,2.0,1.0,3.0,1.0,2.0,1.0,1.0,2.0,3.0,7.0,8.0,10.0,7.0,13.0,10.0,8.0,11.0,5.0,13.0,13.0,12.0,10.0,13.0,12.0,13.0,12.0,12.0,14.0,12.0,12.0,14.0,11.0,7.0,8.0,12.0,14.0,14.0,12.0,12.0,13.0,9.0,14.0,14.0,12.0,20.0,14.0,11.0,14.0,10.0,14.0,8.0,10.0,14.0,14.0,12.0,9.0,12.0,10.0,7.0,7.0,29.0,0.0,0.0,0.0,0.0,183.0,81.0,2.0,1.0,1.0,3.0,3.0,3.0,2.0,3.0,2.0,2.0,2.0,5.0,8.0,9.0,9.0,12.0,10.0,11.0,13.0,7.0,11.0,12.0,8.0,13.0,11.0,12.0,14.0,15.0,13.0,13.0,10.0,12.0,16.0,8.0,14.0,10.0,12.0,17.0,15.0,10.0,12.0,14.0,11.0,5.0,15.0,12.0,20.0,16.0,14.0,14.0,12.0,13.0,8.0,10.0,10.0,14.0,12.0,14.0,15.0,14.0,11.0,7.0,32.0,0.0,0.0,0.0,0.0,183.0,77.0,2.0,2.0,3.0,2.0,1.0,2.0,2.0,1.0,2.0,2.0,3.0,13.0,14.0,12.0,11.0,14.0,14.0,10.0,13.0,8.0,6.0,13.0,14.0,5.0,14.0,7.0,12.0,11.0,13.0,13.0,13.0,13.0,12.0,12.0,9.0,12.0,8.0,14.0,13.0,11.0,12.0,13.0,11.0,20.0,11.0,11.0,8.0,14.0,13.0,13.0,7.0,12.0,8.0,8.0,6.0,14.0,12.0,12.0,14.0,13.0,13.0,7.0,31.0,3.0,1.0,0.0,0.0,180.0,68.0,2.0,1.0,2.0,2.0,1.0,1.0,3.0,2.0,1.0,3.0,2.0,14.0,12.0,13.0,10.0,15.0,13.0,8.0,14.0,7.0,6.0,14.0,6.0,6.0,16.0,9.0,10.0,11.0,12.0,9.0,14.0,11.0,14.0,13.0,7.0,13.0,6.0,10.0,10.0,12.0,12.0,10.0,9.0,12.0,14.0,12.0,20.0,9.0,10.0,12.0,9.0,15.0,8.0,14.0,14.0,8.0,12.0,11.0,10.0,14.0,15.0,5.0,39.0,0.0,0.0,0.0,0.0,178.0,75.0,4.0,3.0,1.0,2.0,2.0,2.0,3.0,3.0,2.0,2.0,1.0,12.0,12.0,13.0,12.0,15.0,12.0,12.0,11.0,6.0,6.0,15.0,15.0,8.0,16.0,7.0,12.0,12.0,13.0,14.0,14.0,12.0,14.0,11.0,12.0,9.0,12.0,12.0,14.0,11.0,12.0,14.0,8.0,10.0,15.0,10.0,20.0,10.0,12.0,15.0,7.0,16.0,6.0,10.0,14.0,14.0,14.0,14.0,14.0,14.0,14.0,6.0,20.0,0.0,0.0,8.0,0.0,170.0,65.0,3.0,1.0,1.0,3.0,2.0,3.0,2.0,2.0,2.0,1.0,3.0,10.0,10.0,13.0,13.0,13.0,10.0,9.0,10.0,3.0,4.0,11.0,12.0,4.0,13.0,12.0,12.0,14.0,11.0,11.0,11.0,11.0,15.0,12.0,7.0,14.0,7.0,12.0,15.0,16.0,16.0,12.0,7.0,7.0,14.0,15.0,20.0,14.0,11.0,13.0,9.0,13.0,8.0,12.0,9.0,13.0,14.0,14.0,15.0,15.0,14.0,6.0
5,0,25.0,0.0,0.0,11.0,0.0,189.0,83.0,12.0,12.0,11.0,7.0,13.0,12.0,17.0,17.0,16.0,12.0,13.0,6.0,2.0,1.0,1.0,10.0,10.0,7.0,1.0,1.0,1.0,9.0,5.0,1.0,10.0,8.0,15.0,14.0,14.0,12.0,7.0,13.0,12.0,6.0,9.0,3.0,16.0,17.0,10.0,13.0,16.0,14.0,12.0,8.0,15.0,10.0,20.0,13.0,14.0,14.0,5.0,14.0,4.0,12.0,15.0,15.0,13.0,13.0,17.0,15.0,17.0,4.0,29.0,56.0,3.0,0.0,0.0,189.0,84.0,3.0,2.0,2.0,1.0,2.0,2.0,2.0,2.0,2.0,1.0,3.0,8.0,9.0,13.0,12.0,13.0,14.0,14.0,12.0,18.0,17.0,12.0,15.0,16.0,13.0,17.0,16.0,16.0,12.0,10.0,10.0,11.0,17.0,12.0,15.0,12.0,11.0,13.0,16.0,17.0,15.0,16.0,16.0,10.0,16.0,15.0,20.0,14.0,13.0,10.0,12.0,13.0,10.0,13.0,15.0,16.0,18.0,13.0,16.0,11.0,10.0,7.0,31.0,0.0,0.0,0.0,0.0,171.0,65.0,1.0,3.0,1.0,3.0,2.0,2.0,3.0,1.0,2.0,2.0,3.0,8.0,9.0,11.0,7.0,5.0,6.0,5.0,6.0,7.0,14.0,14.0,6.0,14.0,13.0,14.0,12.0,13.0,12.0,11.0,11.0,12.0,12.0,11.0,7.0,12.0,12.0,12.0,10.0,15.0,15.0,7.0,9.0,9.0,12.0,14.0,20.0,12.0,13.0,11.0,13.0,11.0,9.0,10.0,15.0,14.0,12.0,11.0,14.0,13.0,12.0,7.0,28.0,46.0,0.0,5.0,0.0,183.0,69.0,1.0,1.0,1.0,1.0,1.0,1.0,3.0,3.0,2.0,1.0,3.0,10.0,14.0,14.0,7.0,14.0,5.0,11.0,11.0,12.0,13.0,14.0,6.0,14.0,15.0,15.0,12.0,13.0,12.0,13.0,14.0,12.0,5.0,11.0,8.0,14.0,10.0,13.0,13.0,15.0,14.0,13.0,11.0,9.0,15.0,14.0,20.0,15.0,12.0,13.0,10.0,15.0,9.0,12.0,9.0,4.0,13.0,15.0,5.0,13.0,12.0,7.0,23.0,2.0,0.0,5.0,3.0,182.0,73.0,3.0,1.0,1.0,1.0,2.0,1.0,2.0,1.0,3.0,4.0,2.0,12.0,14.0,14.0,10.0,13.0,12.0,16.0,11.0,13.0,12.0,13.0,13.0,14.0,14.0,12.0,11.0,14.0,13.0,11.0,13.0,11.0,15.0,15.0,9.0,15.0,10.0,14.0,15.0,16.0,15.0,13.0,13.0,20.0,14.0,15.0,6.0,15.0,12.0,13.0,9.0,13.0,14.0,15.0,17.0,15.0,13.0,12.0,12.0,15.0,13.0,9.0,33.0,30.0,1.0,0.0,0.0,187.0,83.0,1.0,3.0,4.0,2.0,1.0,1.0,2.0,3.0,1.0,1.0,3.0,13.0,13.0,12.0,8.0,16.0,10.0,16.0,13.0,10.0,14.0,16.0,13.0,16.0,15.0,13.0,15.0,14.0,16.0,15.0,14.0,14.0,13.0,11.0,13.0,10.0,17.0,18.0,10.0,10.0,12.0,17.0,14.0,20.0,12.0,12.0,10.0,13.0,16.0,16.0,16.0,15.0,13.0,11.0,16.0,16.0,13.0,15.0,12.0,8.0,8.0,11.0,29.0,51.0,8.0,24.0,0.0,175.0,70.0,3.0,4.0,2.0,3.0,2.0,3.0,2.0,2.0,2.0,1.0,3.0,6.0,12.0,12.0,10.0,13.0,7.0,12.0,12.0,8.0,14.0,13.0,9.0,16.0,13.0,14.0,16.0,16.0,15.0,16.0,11.0,14.0,16.0,8.0,14.0,14.0,15.0,18.0,18.0,15.0,14.0,16.0,8.0,20.0,16.0,14.0,8.0,18.0,14.0,16.0,13.0,14.0,7.0,14.0,15.0,14.0,14.0,14.0,16.0,16.0,16.0,5.0,21.0,0.0,0.0,15.0,1.0,189.0,75.0,3.0,3.0,3.0,3.0,1.0,1.0,3.0,3.0,3.0,2.0,3.0,10.0,12.0,13.0,7.0,14.0,8.0,14.0,12.0,5.0,13.0,15.0,8.0,15.0,14.0,14.0,14.0,15.0,14.0,14.0,13.0,14.0,15.0,12.0,10.0,12.0,14.0,15.0,16.0,12.0,13.0,15.0,14.0,20.0,14.0,13.0,10.0,16.0,13.0,14.0,11.0,14.0,7.0,10.0,8.0,16.0,10.0,12.0,13.0,13.0,11.0,14.0,28.0,66.0,15.0,13.0,3.0,180.0,70.0,2.0,2.0,1.0,2.0,1.0,1.0,3.0,2.0,3.0,3.0,1.0,14.0,15.0,16.0,13.0,17.0,15.0,6.0,15.0,4.0,5.0,16.0,14.0,8.0,17.0,13.0,16.0,11.0,15.0,13.0,16.0,14.0,13.0,17.0,10.0,14.0,9.0,13.0,13.0,16.0,18.0,12.0,10.0,20.0,14.0,15.0,8.0,16.0,9.0,13.0,14.0,12.0,10.0,15.0,14.0,15.0,10.0,16.0,14.0,6.0,12.0,10.0,29.0,76.0,27.0,13.0,9.0,188.0,72.0,2.0,3.0,1.0,2.0,3.0,3.0,1.0,3.0,3.0,3.0,3.0,5.0,10.0,13.0,16.0,13.0,11.0,17.0,13.0,5.0,10.0,13.0,14.0,10.0,13.0,15.0,16.0,18.0,14.0,15.0,10.0,13.0,14.0,13.0,10.0,18.0,12.0,14.0,19.0,15.0,14.0,16.0,14.0,10.0,18.0,16.0,20.0,18.0,14.0,14.0,8.0,15.0,5.0,16.0,10.0,16.0,12.0,14.0,16.0,14.0,10.0,10.0,34.0,116.0,62.0,7.0,6.0,195.0,95.0,1.0,1.0,3.0,1.0,1.0,3.0,4.0,1.0,2.0,3.0,2.0,5.0,12.0,15.0,16.0,18.0,14.0,14.0,16.0,8.0,6.0,15.0,18.0,6.0,18.0,16.0,16.0,15.0,13.0,13.0,16.0,14.0,14.0,19.0,16.0,15.0,4.0,13.0,8.0,12.0,15.0,20.0,18.0,16.0,16.0,14.0,20.0,15.0,18.0,16.0,13.0,11.0,11.0,8.0,15.0,20.0,11.0,15.0,14.0,7.0,7.0,13.0,24.0,2.0,0.0,0.0,0.0,189.0,86.0,13.0,12.0,11.0,9.0,14.0,12.0,14.0,16.0,9.0,14.0,7.0,3.0,2.0,3.0,6.0,8.0,8.0,5.0,12.0,2.0,3.0,9.0,3.0,1.0,8.0,8.0,12.0,12.0,12.0,12.0,7.0,9.0,13.0,8.0,8.0,2.0,11.0,10.0,8.0,14.0,15.0,16.0,14.0,5.0,15.0,12.0,20.0,14.0,16.0,13.0,8.0,16.0,7.0,10.0,12.0,13.0,14.0,16.0,14.0,15.0,15.0,7.0,26.0,5.0,0.0,0.0,0.0,184.0,86.0,3.0,3.0,2.0,1.0,2.0,2.0,4.0,1.0,3.0,1.0,3.0,4.0,10.0,9.0,6.0,10.0,7.0,14.0,8.0,8.0,14.0,9.0,6.0,14.0,9.0,14.0,14.0,16.0,9.0,15.0,7.0,11.0,13.0,8.0,10.0,9.0,13.0,12.0,12.0,12.0,12.0,17.0,12.0,5.0,15.0,15.0,20.0,14.0,17.0,11.0,14.0,13.0,7.0,10.0,13.0,16.0,14.0,11.0,11.0,12.0,9.0,14.0,23.0,1.0,0.0,4.0,0.0,190.0,80.0,1.0,4.0,1.0,3.0,3.0,1.0,1.0,1.0,2.0,4.0,2.0,6.0,11.0,13.0,7.0,13.0,6.0,11.0,8.0,10.0,15.0,12.0,5.0,15.0,12.0,14.0,14.0,16.0,9.0,11.0,10.0,10.0,16.0,12.0,12.0,9.0,12.0,10.0,14.0,14.0,12.0,15.0,17.0,8.0,15.0,16.0,20.0,13.0,14.0,13.0,8.0,13.0,6.0,14.0,11.0,14.0,12.0,13.0,16.0,14.0,12.0,6.0,26.0,0.0,0.0,0.0,0.0,187.0,78.0,2.0,1.0,2.0,3.0,2.0,1.0,1.0,1.0,3.0,3.0,1.0,10.0,12.0,14.0,9.0,11.0,11.0,13.0,8.0,14.0,13.0,11.0,9.0,12.0,14.0,13.0,13.0,13.0,13.0,12.0,12.0,11.0,15.0,12.0,8.0,13.0,13.0,13.0,14.0,15.0,12.0,8.0,14.0,20.0,12.0,14.0,6.0,14.0,12.0,12.0,13.0,11.0,12.0,15.0,8.0,15.0,9.0,15.0,14.0,12.0,15.0,10.0,31.0,9.0,0.0,0.0,0.0,181.0,80.0,1.0,1.0,1.0,3.0,1.0,3.0,1.0,3.0,1.0,3.0,3.0,10.0,15.0,9.0,7.0,12.0,8.0,13.0,6.0,13.0,12.0,11.0,12.0,13.0,11.0,13.0,11.0,14.0,11.0,11.0,10.0,11.0,13.0,10.0,12.0,12.0,11.0,13.0,15.0,13.0,12.0,14.0,11.0,9.0,13.0,12.0,20.0,16.0,14.0,12.0,13.0,12.0,12.0,8.0,13.0,15.0,12.0,9.0,13.0,11.0,11.0,9.0,20.0,0.0,0.0,0.0,0.0,170.0,77.0,3.0,2.0,2.0,3.0,1.0,2.0,2.0,3.0,1.0,3.0,2.0,11.0,13.0,12.0,7.0,12.0,11.0,7.0,12.0,6.0,9.0,11.0,10.0,11.0,13.0,14.0,12.0,13.0,8.0,9.0,11.0,12.0,11.0,14.0,3.0,12.0,7.0,9.0,13.0,13.0,13.0,14.0,7.0,10.0,10.0,13.0,20.0,11.0,14.0,10.0,15.0,11.0,11.0,10.0,10.0,10.0,10.0,10.0,11.0,6.0,19.0,6.0,32.0,0.0,0.0,13.0,0.0,175.0,65.0,2.0,1.0,1.0,2.0,3.0,3.0,1.0,2.0,3.0,2.0,3.0,15.0,13.0,11.0,6.0,14.0,13.0,10.0,12.0,8.0,8.0,16.0,8.0,12.0,13.0,11.0,14.0,15.0,14.0,15.0,14.0,14.0,14.0,6.0,13.0,9.0,15.0,18.0,13.0,12.0,13.0,13.0,8.0,8.0,13.0,10.0,20.0,13.0,13.0,12.0,11.0,15.0,12.0,10.0,17.0,14.0,15.0,14.0,16.0,14.0,14.0,6.0,23.0,11.0,0.0,0.0,0.0,180.0,71.0,2.0,1.0,2.0,3.0,3.0,1.0,1.0,2.0,2.0,1.0,1.0,6.0,11.0,10.0,8.0,10.0,7.0,11.0,9.0,12.0,13.0,11.0,6.0,13.0,11.0,12.0,11.0,13.0,12.0,9.0,11.0,11.0,14.0,12.0,11.0,12.0,11.0,13.0,15.0,15.0,13.0,13.0,11.0,7.0,14.0,15.0,20.0,12.0,11.0,12.0,12.0,13.0,10.0,15.0,10.0,13.0,16.0,12.0,15.0,14.0,14.0,7.0,28.0,0.0,0.0,0.0,0.0,180.0,79.0,3.0,2.0,3.0,3.0,2.0,2.0,2.0,1.0,3.0,2.0,3.0,8.0,11.0,15.0,12.0,15.0,12.0,7.0,10.0,7.0,8.0,13.0,13.0,6.0,16.0,11.0,11.0,10.0,13.0,10.0,15.0,12.0,3.0,15.0,6.0,13.0,13.0,12.0,12.0,15.0,16.0,14.0,8.0,12.0,12.0,14.0,20.0,12.0,12.0,13.0,6.0,13.0,6.0,6.0,8.0,9.0,13.0,10.0,12.0,12.0,2.0,2.0,25.0,14.0,1.0,2.0,0.0,177.0,77.0,3.0,3.0,1.0,2.0,3.0,3.0,1.0,3.0,3.0,4.0,1.0,8.0,11.0,13.0,12.0,12.0,10.0,11.0,10.0,2.0,3.0,11.0,10.0,5.0,13.0,12.0,12.0,13.0,11.0,10.0,11.0,10.0,14.0,16.0,14.0,15.0,5.0,13.0,14.0,15.0,14.0,12.0,12.0,12.0,14.0,16.0,20.0,13.0,14.0,13.0,7.0,14.0,11.0,13.0,14.0,11.0,12.0,8.0,12.0,13.0,15.0,6.0,32.0,0.0,0.0,0.0,0.0,183.0,67.0,1.0,2.0,3.0,2.0,3.0,2.0,3.0,1.0,2.0,2.0,2.0,4.0,12.0,11.0,6.0,5.0,5.0,4.0,8.0,11.0,13.0,11.0,5.0,13.0,11.0,11.0,11.0,12.0,11.0,11.0,9.0,12.0,11.0,12.0,10.0,12.0,11.0,12.0,12.0,14.0,13.0,13.0,8.0,8.0,13.0,13.0,20.0,14.0,14.0,10.0,12.0,11.0,8.0,11.0,11.0,10.0,10.0,12.0,11.0,9.0,10.0,12.0
3,1,34.0,1.0,0.0,0.0,0.0,187.0,87.0,13.0,14.0,15.0,7.0,13.0,11.0,14.0,15.0,11.0,17.0,12.0,2.0,1.0,1.0,3.0,8.0,7.0,2.0,1.0,2.0,1.0,9.0,8.0,2.0,6.0,12.0,15.0,17.0,14.0,15.0,8.0,13.0,17.0,7.0,14.0,6.0,14.0,12.0,6.0,7.0,13.0,14.0,13.0,8.0,13.0,8.0,20.0,11.0,16.0,14.0,10.0,14.0,6.0,1.0,12.0,12.0,15.0,16.0,16.0,14.0,15.0,6.0,28.0,0.0,0.0,0.0,0.0,190.0,85.0,3.0,2.0,3.0,3.0,2.0,2.0,2.0,4.0,3.0,1.0,2.0,5.0,9.0,8.0,9.0,8.0,7.0,14.0,10.0,9.0,15.0,9.0,6.0,14.0,9.0,16.0,13.0,16.0,10.0,13.0,10.0,12.0,15.0,6.0,13.0,7.0,13.0,14.0,16.0,12.0,11.0,17.0,13.0,20.0,15.0,13.0,8.0,15.0,15.0,12.0,14.0,14.0,9.0,8.0,14.0,13.0,14.0,11.0,12.0,13.0,16.0,14.0,29.0,35.0,0.0,0.0,0.0,192.0,77.0,1.0,3.0,2.0,2.0,2.0,2.0,2.0,3.0,1.0,3.0,3.0,5.0,8.0,8.0,7.0,9.0,6.0,11.0,9.0,12.0,14.0,10.0,7.0,15.0,10.0,14.0,13.0,17.0,9.0,13.0,10.0,11.0,13.0,7.0,14.0,8.0,12.0,10.0,13.0,13.0,11.0,17.0,18.0,6.0,12.0,15.0,20.0,13.0,16.0,13.0,14.0,16.0,14.0,12.0,9.0,12.0,15.0,10.0,10.0,11.0,8.0,15.0,25.0,0.0,0.0,0.0,0.0,191.0,81.0,1.0,1.0,3.0,2.0,3.0,2.0,3.0,4.0,2.0,1.0,2.0,4.0,3.0,10.0,8.0,6.0,6.0,11.0,6.0,10.0,11.0,10.0,5.0,12.0,7.0,16.0,13.0,16.0,11.0,13.0,7.0,10.0,14.0,5.0,12.0,10.0,13.0,13.0,12.0,13.0,13.0,16.0,16.0,7.0,16.0,14.0,20.0,14.0,14.0,13.0,13.0,15.0,6.0,12.0,13.0,6.0,14.0,8.0,8.0,13.0,7.0,4.0,26.0,0.0,0.0,0.0,0.0,176.0,70.0,2.0,1.0,4.0,3.0,3.0,3.0,1.0,3.0,3.0,2.0,1.0,10.0,11.0,11.0,6.0,13.0,9.0,5.0,12.0,11.0,13.0,13.0,7.0,14.0,13.0,15.0,11.0,14.0,12.0,11.0,9.0,12.0,13.0,9.0,9.0,13.0,12.0,15.0,14.0,12.0,16.0,12.0,7.0,20.0,13.0,13.0,10.0,15.0,11.0,13.0,14.0,13.0,11.0,9.0,8.0,9.0,17.0,12.0,14.0,14.0,15.0,3.0,23.0,39.0,1.0,5.0,2.0,174.0,73.0,3.0,4.0,2.0,1.0,1.0,2.0,4.0,1.0,3.0,2.0,4.0,7.0,6.0,10.0,5.0,11.0,7.0,6.0,8.0,5.0,11.0,12.0,6.0,13.0,11.0,15.0,9.0,16.0,8.0,12.0,10.0,10.0,14.0,10.0,6.0,12.0,11.0,16.0,20.0,15.0,16.0,15.0,9.0,6.0,13.0,14.0,20.0,16.0,14.0,9.0,13.0,13.0,7.0,14.0,14.0,12.0,13.0,12.0,14.0,12.0,14.0,3.0,34.0,103.0,7.0,16.0,1.0,182.0,72.0,2.0,1.0,1.0,1.0,3.0,1.0,4.0,3.0,3.0,2.0,1.0,11.0,13.0,12.0,8.0,15.0,13.0,9.0,13.0,6.0,8.0,15.0,12.0,8.0,15.0,11.0,14.0,13.0,15.0,15.0,14.0,16.0,17.0,15.0,14.0,11.0,13.0,17.0,13.0,8.0,11.0,10.0,11.0,16.0,13.0,8.0,20.0,12.0,10.0,15.0,11.0,12.0,12.0,15.0,14.0,12.0,15.0,15.0,18.0,14.0,14.0,7.0,25.0,19.0,6.0,0.0,0.0,182.0,78.0,1.0,4.0,3.0,1.0,2.0,1.0,2.0,2.0,4.0,1.0,4.0,16.0,13.0,12.0,11.0,12.0,13.0,8.0,12.0,5.0,5.0,13.0,13.0,5.0,15.0,11.0,12.0,12.0,13.0,12.0,15.0,12.0,15.0,14.0,6.0,15.0,9.0,11.0,14.0,15.0,14.0,14.0,10.0,11.0,11.0,14.0,20.0,12.0,13.0,10.0,11.0,15.0,5.0,12.0,10.0,15.0,16.0,11.0,13.0,16.0,16.0,7.0,21.0,0.0,0.0,4.0,1.0,184.0,79.0,1.0,2.0,3.0,1.0,2.0,1.0,3.0,2.0,2.0,1.0,3.0,3.0,6.0,10.0,12.0,12.0,7.0,15.0,8.0,4.0,5.0,13.0,10.0,8.0,12.0,18.0,12.0,19.0,13.0,10.0,13.0,12.0,14.0,13.0,10.0,12.0,9.0,16.0,15.0,12.0,14.0,14.0,14.0,12.0,13.0,10.0,20.0,14.0,14.0,11.0,14.0,14.0,11.0,5.0,10.0,13.0,14.0,15.0,10.0,8.0,4.0,15.0,31.0,0.0,0.0,0.0,0.0,182.0,76.0,3.0,2.0,3.0,4.0,2.0,1.0,2.0,3.0,1.0,2.0,2.0,10.0,13.0,15.0,6.0,14.0,9.0,11.0,8.0,7.0,4.0,12.0,10.0,3.0,14.0,7.0,13.0,10.0,12.0,12.0,12.0,10.0,11.0,12.0,6.0,15.0,6.0,13.0,13.0,14.0,14.0,12.0,10.0,20.0,13.0,13.0,8.0,12.0,11.0,8.0,7.0,14.0,13.0,8.0,8.0,13.0,14.0,12.0,12.0,14.0,14.0,6.0,25.0,9.0,0.0,0.0,0.0,173.0,70.0,1.0,2.0,1.0,2.0,3.0,2.0,1.0,2.0,1.0,4.0,3.0,6.0,8.0,13.0,10.0,14.0,13.0,13.0,13.0,5.0,10.0,13.0,11.0,9.0,15.0,7.0,13.0,13.0,12.0,12.0,12.0,13.0,13.0,15.0,12.0,13.0,7.0,14.0,15.0,13.0,13.0,12.0,10.0,12.0,11.0,13.0,20.0,14.0,13.0,13.0,7.0,13.0,13.0,13.0,8.0,15.0,13.0,12.0,13.0,15.0,15.0,6.0,31.0,25.0,0.0,6.0,0.0,191.0,84.0,11.0,14.0,13.0,12.0,15.0,14.0,15.0,16.0,13.0,14.0,14.0,8.0,2.0,10.0,5.0,11.0,11.0,7.0,10.0,2.0,5.0,10.0,11.0,11.0,9.0,12.0,13.0,15.0,13.0,13.0,8.0,13.0,16.0,12.0,14.0,1.0,16.0,13.0,11.0,12.0,13.0,16.0,16.0,8.0,16.0,13.0,20.0,15.0,15.0,17.0,8.0,15.0,7.0,2.0,15.0,15.0,17.0,15.0,17.0,16.0,15.0,6.0,38.0,89.0,6.0,14.0,1.0,183.0,79.0,3.0,3.0,2.0,3.0,2.0,3.0,2.0,4.0,3.0,2.0,3.0,4.0,8.0,8.0,7.0,12.0,6.0,14.0,8.0,11.0,17.0,12.0,11.0,16.0,12.0,15.0,16.0,17.0,15.0,17.0,10.0,16.0,18.0,6.0,15.0,8.0,16.0,17.0,13.0,8.0,8.0,12.0,11.0,10.0,13.0,8.0,20.0,10.0,11.0,16.0,12.0,16.0,11.0,7.0,15.0,16.0,16.0,15.0,18.0,16.0,14.0,4.0,32.0,0.0,0.0,3.0,0.0,187.0,82.0,1.0,2.0,2.0,3.0,2.0,1.0,1.0,2.0,2.0,3.0,1.0,5.0,11.0,8.0,7.0,10.0,6.0,15.0,9.0,13.0,15.0,10.0,8.0,16.0,9.0,16.0,14.0,17.0,12.0,15.0,8.0,12.0,17.0,9.0,14.0,11.0,13.0,15.0,13.0,12.0,11.0,16.0,14.0,6.0,13.0,14.0,20.0,13.0,16.0,15.0,14.0,14.0,8.0,14.0,14.0,14.0,15.0,16.0,15.0,12.0,10.0,7.0,28.0,54.0,3.0,5.0,1.0,184.0,76.0,1.0,3.0,3.0,3.0,2.0,2.0,2.0,1.0,2.0,2.0,1.0,8.0,13.0,11.0,7.0,10.0,7.0,13.0,9.0,14.0,12.0,11.0,8.0,14.0,11.0,13.0,12.0,14.0,11.0,12.0,9.0,11.0,12.0,8.0,7.0,13.0,11.0,14.0,14.0,14.0,13.0,15.0,12.0,20.0,14.0,15.0,5.0,12.0,16.0,10.0,11.0,11.0,8.0,10.0,4.0,13.0,13.0,11.0,12.0,12.0,11.0,9.0,31.0,0.0,0.0,6.0,0.0,174.0,80.0,1.0,1.0,1.0,1.0,1.0,5.0,1.0,1.0,1.0,1.0,1.0,14.0,12.0,11.0,7.0,12.0,13.0,9.0,7.0,10.0,11.0,11.0,10.0,10.0,12.0,11.0,11.0,11.0,10.0,6.0,10.0,9.0,12.0,12.0,12.0,10.0,12.0,12.0,14.0,12.0,15.0,10.0,9.0,20.0,12.0,12.0,7.0,12.0,9.0,9.0,10.0,12.0,7.0,9.0,11.0,14.0,9.0,7.0,14.0,8.0,9.0,9.0,32.0,36.0,0.0,12.0,2.0,183.0,77.0,1.0,3.0,2.0,1.0,3.0,1.0,1.0,2.0,1.0,1.0,3.0,6.0,11.0,8.0,6.0,13.0,11.0,13.0,10.0,6.0,15.0,14.0,10.0,17.0,12.0,15.0,16.0,18.0,14.0,17.0,12.0,15.0,17.0,11.0,17.0,7.0,17.0,20.0,16.0,9.0,11.0,15.0,11.0,8.0,15.0,10.0,20.0,14.0,14.0,17.0,10.0,16.0,10.0,13.0,15.0,15.0,15.0,14.0,18.0,15.0,13.0,6.0,29.0,90.0,4.0,16.0,2.0,170.0,61.0,2.0,3.0,3.0,1.0,3.0,1.0,2.0,2.0,2.0,2.0,1.0,15.0,14.0,15.0,9.0,17.0,16.0,7.0,12.0,4.0,11.0,18.0,15.0,12.0,17.0,15.0,15.0,16.0,13.0,16.0,17.0,14.0,16.0,15.0,14.0,12.0,14.0,18.0,16.0,13.0,14.0,12.0,8.0,10.0,14.0,11.0,20.0,14.0,10.0,14.0,9.0,17.0,10.0,14.0,13.0,17.0,15.0,16.0,17.0,15.0,16.0,7.0,21.0,2.0,0.0,13.0,6.0,186.0,78.0,4.0,1.0,3.0,1.0,3.0,3.0,2.0,3.0,3.0,2.0,2.0,10.0,10.0,11.0,12.0,12.0,11.0,14.0,13.0,6.0,10.0,14.0,13.0,11.0,13.0,12.0,13.0,11.0,12.0,11.0,12.0,11.0,14.0,12.0,11.0,13.0,11.0,13.0,13.0,12.0,11.0,12.0,13.0,20.0,13.0,12.0,17.0,13.0,12.0,11.0,8.0,13.0,8.0,16.0,12.0,16.0,15.0,13.0,15.0,12.0,15.0,6.0,21.0,7.0,0.0,14.0,6.0,173.0,64.0,3.0,2.0,3.0,2.0,3.0,3.0,3.0,2.0,3.0,3.0,3.0,14.0,14.0,18.0,14.0,17.0,14.0,7.0,11.0,2.0,6.0,15.0,14.0,6.0,18.0,12.0,14.0,14.0,15.0,13.0,16.0,14.0,17.0,17.0,12.0,13.0,9.0,13.0,17.0,15.0,17.0,13.0,7.0,20.0,14.0,14.0,9.0,14.0,9.0,15.0,7.0,16.0,7.0,14.0,15.0,17.0,15.0,16.0,17.0,16.0,15.0,4.0,22.0,0.0,0.0,7.0,3.0,178.0,73.0,1.0,2.0,1.0,3.0,2.0,3.0,3.0,1.0,3.0,2.0,2.0,12.0,14.0,16.0,12.0,13.0,12.0,6.0,13.0,4.0,5.0,12.0,11.0,5.0,15.0,12.0,12.0,12.0,13.0,13.0,13.0,11.0,14.0,14.0,7.0,14.0,6.0,11.0,13.0,16.0,16.0,9.0,8.0,20.0,14.0,15.0,12.0,13.0,7.0,14.0,10.0,14.0,8.0,15.0,13.0,12.0,15.0,13.0,11.0,15.0,14.0,5.0,25.0,0.0,0.0,0.0,0.0,191.0,87.0,2.0,1.0,2.0,2.0,3.0,1.0,1.0,3.0,2.0,3.0,1.0,5.0,8.0,10.0,14.0,13.0,8.0,17.0,12.0,4.0,6.0,13.0,14.0,6.0,13.0,12.0,13.0,16.0,13.0,14.0,11.0,13.0,15.0,9.0,12.0,15.0,9.0,15.0,14.0,11.0,12.0,15.0,17.0,10.0,14.0,13.0,20.0,14.0,15.0,12.0,6.0,13.0,7.0,6.0,11.0,13.0,14.0,12.0,16.0,15.0,14.0,7.0
3,0,25.0,4.0,0.0,11.0,0.0,184.0,81.0,14.0,14.0,13.0,9.0,15.0,12.0,16.0,16.0,13.0,7.0,11.0,8.0,1.0,2.0,1.0,11.0,12.0,6.0,1.0,3.0,3.0,11.0,5.0,3.0,11.0,8.0,15.0,15.0,13.0,14.0,10.0,11.0,14.0,8.0,13.0,5.0,13.0,10.0,10.0,14.0,16.0,14.0,13.0,20.0,14.0,12.0,5.0,14.0,14.0,15.0,9.0,16.0,6.0,1.0,17.0,11.0,15.0,13.0,14.0,12.0,12.0,4.0,22.0,3.0,0.0,7.0,1.0,182.0,75.0,3.0,3.0,1.0,3.0,2.0,3.0,1.0,1.0,2.0,2.0,1.0,4.0,11.0,10.0,6.0,14.0,7.0,13.0,10.0,9.0,16.0,14.0,8.0,15.0,14.0,13.0,17.0,15.0,16.0,14.0,11.0,14.0,15.0,8.0,11.0,10.0,15.0,16.0,14.0,14.0,14.0,14.0,11.0,20.0,15.0,14.0,10.0,15.0,15.0,15.0,12.0,15.0,8.0,11.0,12.0,14.0,16.0,15.0,14.0,14.0,14.0,5.0,27.0,4.0,0.0,5.0,1.0,184.0,83.0,2.0,4.0,3.0,1.0,1.0,2.0,1.0,2.0,4.0,2.0,3.0,4.0,8.0,11.0,4.0,10.0,4.0,14.0,4.0,4.0,15.0,12.0,5.0,16.0,11.0,14.0,14.0,16.0,14.0,10.0,11.0,12.0,17.0,7.0,10.0,9.0,13.0,14.0,15.0,14.0,13.0,16.0,13.0,10.0,15.0,13.0,20.0,15.0,16.0,12.0,12.0,14.0,6.0,12.0,11.0,13.0,12.0,12.0,16.0,15.0,14.0,6.0,37.0,0.0,0.0,0.0,0.0,185.0,83.0,1.0,1.0,2.0,1.0,3.0,2.0,3.0,1.0,1.0,3.0,1.0,6.0,8.0,9.0,12.0,10.0,8.0,13.0,9.0,4.0,5.0,10.0,14.0,4.0,11.0,11.0,10.0,11.0,13.0,12.0,12.0,13.0,15.0,14.0,12.0,11.0,7.0,12.0,8.0,7.0,7.0,12.0,12.0,11.0,11.0,7.0,20.0,8.0,14.0,12.0,8.0,13.0,9.0,12.0,12.0,12.0,19.0,14.0,15.0,14.0,8.0,8.0,32.0,0.0,0.0,0.0,0.0,172.0,71.0,2.0,1.0,3.0,1.0,2.0,3.0,2.0,3.0,2.0,2.0,2.0,8.0,9.0,7.0,6.0,10.0,6.0,10.0,9.0,10.0,14.0,11.0,6.0,14.0,11.0,10.0,16.0,15.0,12.0,12.0,7.0,12.0,15.0,9.0,13.0,8.0,14.0,15.0,15.0,14.0,14.0,14.0,10.0,20.0,14.0,14.0,8.0,15.0,13.0,13.0,11.0,13.0,7.0,13.0,17.0,14.0,17.0,8.0,13.0,15.0,15.0,6.0,27.0,8.0,0.0,6.0,0.0,187.0,76.0,3.0,2.0,3.0,2.0,2.0,1.0,1.0,3.0,3.0,1.0,2.0,5.0,7.0,11.0,5.0,14.0,5.0,14.0,9.0,5.0,15.0,15.0,8.0,14.0,13.0,15.0,16.0,15.0,14.0,12.0,14.0,14.0,18.0,8.0,17.0,9.0,12.0,18.0,15.0,13.0,14.0,15.0,14.0,10.0,17.0,12.0,20.0,17.0,15.0,14.0,13.0,16.0,4.0,12.0,10.0,14.0,17.0,12.0,15.0,13.0,13.0,6.0,24.0,0.0,0.0,6.0,1.0,172.0,70.0,3.0,1.0,1.0,3.0,1.0,2.0,3.0,1.0,1.0,3.0,3.0,11.0,12.0,11.0,8.0,12.0,10.0,6.0,14.0,7.0,11.0,15.0,8.0,12.0,13.0,14.0,14.0,18.0,13.0,12.0,13.0,13.0,15.0,12.0,12.0,12.0,11.0,18.0,18.0,13.0,14.0,13.0,7.0,10.0,16.0,12.0,20.0,14.0,12.0,14.0,14.0,15.0,4.0,8.0,7.0,14.0,14.0,13.0,14.0,12.0,10.0,6.0,21.0,0.0,0.0,15.0,3.0,181.0,78.0,3.0,3.0,4.0,2.0,1.0,2.0,2.0,4.0,2.0,1.0,1.0,5.0,7.0,11.0,10.0,14.0,5.0,14.0,10.0,6.0,13.0,14.0,8.0,14.0,14.0,12.0,14.0,12.0,11.0,10.0,12.0,11.0,16.0,11.0,12.0,14.0,14.0,14.0,14.0,14.0,13.0,14.0,13.0,10.0,16.0,14.0,20.0,16.0,14.0,12.0,10.0,11.0,5.0,19.0,8.0,11.0,14.0,11.0,16.0,13.0,13.0,10.0,31.0,52.0,8.0,0.0,0.0,167.0,58.0,1.0,2.0,2.0,1.0,3.0,2.0,4.0,2.0,1.0,2.0,3.0,15.0,15.0,14.0,7.0,15.0,15.0,6.0,11.0,3.0,4.0,15.0,14.0,7.0,15.0,13.0,12.0,15.0,13.0,14.0,16.0,11.0,17.0,14.0,11.0,12.0,10.0,12.0,14.0,15.0,18.0,10.0,5.0,10.0,16.0,14.0,20.0,13.0,7.0,14.0,13.0,16.0,8.0,12.0,13.0,16.0,14.0,15.0,13.0,9.0,11.0,14.0,28.0,2.0,1.0,0.0,0.0,174.0,66.0,2.0,2.0,2.0,1.0,1.0,3.0,2.0,3.0,3.0,1.0,4.0,6.0,11.0,13.0,15.0,13.0,11.0,14.0,11.0,6.0,5.0,10.0,12.0,5.0,13.0,8.0,14.0,10.0,13.0,14.0,8.0,12.0,12.0,12.0,5.0,14.0,8.0,12.0,11.0,17.0,15.0,11.0,12.0,7.0,14.0,15.0,20.0,13.0,10.0,12.0,8.0,14.0,8.0,8.0,19.0,15.0,12.0,10.0,11.0,13.0,13.0,12.0,25.0,10.0,1.0,11.0,4.0,175.0,73.0,1.0,3.0,3.0,3.0,3.0,3.0,3.0,1.0,2.0,3.0,1.0,5.0,10.0,15.0,17.0,15.0,10.0,11.0,12.0,5.0,5.0,14.0,15.0,5.0,16.0,8.0,15.0,12.0,15.0,14.0,13.0,15.0,15.0,15.0,14.0,14.0,10.0,10.0,12.0,16.0,16.0,15.0,9.0,10.0,15.0,16.0,20.0,13.0,15.0,14.0,8.0,14.0,7.0,10.0,8.0,16.0,17.0,13.0,15.0,15.0,14.0,5.0,29.0,3.0,0.0,3.0,0.0,188.0,89.0,13.0,13.0,15.0,9.0,14.0,12.0,15.0,17.0,14.0,15.0,8.0,6.0,3.0,3.0,2.0,7.0,10.0,3.0,2.0,1.0,3.0,8.0,1.0,1.0,9.0,12.0,14.0,16.0,13.0,14.0,9.0,13.0,18.0,6.0,13.0,2.0,15.0,12.0,8.0,12.0,14.0,16.0,14.0,6.0,16.0,11.0,20.0,14.0,16.0,16.0,12.0,13.0,3.0,1.0,10.0,15.0,17.0,13.0,16.0,12.0,8.0,10.0,25.0,13.0,0.0,0.0,0.0,188.0,87.0,4.0,1.0,3.0,2.0,1.0,3.0,1.0,1.0,3.0,2.0,1.0,5.0,13.0,9.0,8.0,12.0,12.0,15.0,10.0,8.0,12.0,9.0,6.0,11.0,12.0,11.0,12.0,14.0,11.0,12.0,11.0,10.0,15.0,7.0,7.0,10.0,12.0,13.0,14.0,15.0,12.0,16.0,14.0,20.0,14.0,14.0,6.0,14.0,16.0,13.0,11.0,13.0,7.0,10.0,11.0,14.0,12.0,13.0,12.0,14.0,14.0,7.0,30.0,0.0,0.0,0.0,0.0,180.0,76.0,1.0,2.0,2.0,2.0,3.0,2.0,2.0,1.0,2.0,3.0,3.0,5.0,12.0,10.0,8.0,12.0,9.0,14.0,11.0,10.0,14.0,12.0,7.0,15.0,11.0,11.0,14.0,13.0,15.0,14.0,12.0,13.0,14.0,6.0,16.0,7.0,15.0,16.0,15.0,12.0,12.0,14.0,11.0,8.0,14.0,10.0,20.0,15.0,13.0,15.0,8.0,14.0,11.0,17.0,18.0,14.0,19.0,13.0,16.0,15.0,15.0,5.0,32.0,23.0,0.0,0.0,0.0,178.0,77.0,3.0,2.0,3.0,1.0,3.0,1.0,3.0,2.0,1.0,3.0,1.0,9.0,12.0,12.0,6.0,13.0,12.0,10.0,10.0,10.0,13.0,12.0,7.0,14.0,13.0,15.0,14.0,13.0,13.0,10.0,10.0,12.0,5.0,12.0,11.0,12.0,13.0,14.0,14.0,14.0,13.0,12.0,9.0,20.0,14.0,14.0,10.0,13.0,12.0,13.0,6.0,14.0,6.0,10.0,13.0,5.0,11.0,8.0,10.0,14.0,9.0,15.0,33.0,13.0,0.0,4.0,0.0,186.0,77.0,1.0,3.0,1.0,2.0,3.0,3.0,1.0,3.0,3.0,2.0,3.0,8.0,13.0,11.0,5.0,12.0,9.0,13.0,12.0,13.0,12.0,11.0,8.0,14.0,13.0,7.0,13.0,13.0,12.0,12.0,11.0,12.0,15.0,12.0,9.0,11.0,13.0,12.0,13.0,12.0,11.0,15.0,13.0,8.0,11.0,13.0,20.0,12.0,13.0,13.0,7.0,14.0,11.0,13.0,13.0,14.0,13.0,14.0,15.0,14.0,14.0,8.0,29.0,0.0,0.0,1.0,0.0,175.0,67.0,3.0,2.0,1.0,1.0,1.0,4.0,1.0,2.0,4.0,4.0,1.0,11.0,11.0,8.0,6.0,12.0,12.0,8.0,11.0,6.0,12.0,14.0,7.0,13.0,12.0,13.0,14.0,15.0,12.0,13.0,13.0,13.0,15.0,7.0,13.0,7.0,14.0,16.0,17.0,14.0,12.0,13.0,8.0,10.0,13.0,13.0,20.0,15.0,11.0,14.0,13.0,15.0,10.0,8.0,17.0,13.0,16.0,14.0,16.0,13.0,13.0,7.0,31.0,0.0,0.0,6.0,0.0,174.0,61.0,1.0,4.0,1.0,2.0,1.0,3.0,3.0,1.0,3.0,3.0,3.0,8.0,9.0,10.0,6.0,12.0,9.0,13.0,11.0,7.0,12.0,12.0,8.0,15.0,12.0,14.0,14.0,15.0,12.0,14.0,8.0,12.0,16.0,7.0,13.0,7.0,13.0,16.0,17.0,13.0,12.0,13.0,7.0,20.0,15.0,13.0,9.0,17.0,10.0,15.0,16.0,14.0,8.0,7.0,12.0,14.0,14.0,12.0,16.0,14.0,14.0,7.0,25.0,0.0,0.0,15.0,1.0,176.0,64.0,2.0,2.0,3.0,3.0,1.0,1.0,3.0,3.0,2.0,1.0,3.0,9.0,9.0,11.0,7.0,13.0,11.0,14.0,9.0,6.0,12.0,14.0,6.0,13.0,13.0,13.0,14.0,15.0,14.0,14.0,13.0,13.0,15.0,8.0,11.0,9.0,12.0,15.0,18.0,14.0,14.0,12.0,10.0,5.0,15.0,11.0,20.0,16.0,10.0,15.0,13.0,15.0,5.0,10.0,11.0,14.0,14.0,14.0,17.0,13.0,13.0,5.0,29.0,0.0,0.0,0.0,0.0,177.0,74.0,1.0,2.0,3.0,2.0,2.0,2.0,2.0,1.0,3.0,2.0,1.0,12.0,13.0,14.0,12.0,15.0,11.0,6.0,11.0,4.0,3.0,12.0,8.0,4.0,15.0,9.0,11.0,11.0,12.0,11.0,13.0,12.0,14.0,14.0,7.0,14.0,6.0,10.0,12.0,16.0,14.0,12.0,8.0,10.0,14.0,15.0,20.0,14.0,11.0,11.0,9.0,14.0,8.0,10.0,9.0,13.0,14.0,14.0,13.0,15.0,15.0,6.0,25.0,11.0,1.0,13.0,4.0,188.0,80.0,3.0,1.0,2.0,2.0,3.0,3.0,1.0,3.0,2.0,3.0,1.0,8.0,9.0,11.0,14.0,12.0,11.0,14.0,10.0,10.0,7.0,12.0,11.0,9.0,13.0,14.0,14.0,10.0,13.0,13.0,11.0,12.0,15.0,10.0,10.0,14.0,12.0,15.0,17.0,14.0,12.0,13.0,13.0,12.0,16.0,13.0,20.0,14.0,14.0,13.0,8.0,13.0,10.0,10.0,13.0,15.0,7.0,12.0,14.0,14.0,12.0,9.0,28.0,0.0,0.0,2.0,2.0,182.0,79.0,1.0,1.0,2.0,2.0,3.0,1.0,2.0,3.0,1.0,2.0,2.0,8.0,11.0,14.0,12.0,14.0,11.0,12.0,13.0,6.0,4.0,11.0,13.0,5.0,14.0,11.0,12.0,13.0,10.0,12.0,11.0,11.0,15.0,13.0,7.0,14.0,7.0,12.0,14.0,15.0,14.0,14.0,12.0,8.0,15.0,14.0,20.0,15.0,14.0,12.0,11.0,15.0,8.0,8.0,16.0,15.0,12.0,11.0,14.0,13.0,12.0,8.0
1,2,25.0,0.0,0.0,0.0,0.0,187.0,83.0,11.0,14.0,12.0,8.0,13.0,11.0,14.0,15.0,13.0,13.0,9.0,8.0,1.0,1.0,1.0,11.0,11.0,1.0,2.0,2.0,1.0,10.0,3.0,2.0,11.0,8.0,12.0,14.0,12.0,12.0,10.0,12.0,14.0,6.0,14.0,2.0,12.0,12.0,8.0,13.0,15.0,14.0,13.0,20.0,15.0,11.0,5.0,14.0,13.0,13.0,8.0,8.0,10.0,1.0,9.0,13.0,14.0,12.0,15.0,15.0,15.0,5.0,27.0,1.0,0.0,3.0,0.0,186.0,83.0,2.0,2.0,2.0,2.0,1.0,4.0,2.0,3.0,3.0,3.0,2.0,5.0,9.0,9.0,8.0,10.0,6.0,16.0,8.0,7.0,14.0,11.0,6.0,15.0,12.0,14.0,15.0,16.0,13.0,12.0,8.0,13.0,14.0,8.0,11.0,8.0,14.0,15.0,15.0,15.0,9.0,15.0,12.0,8.0,13.0,14.0,20.0,14.0,17.0,15.0,13.0,13.0,10.0,8.0,9.0,14.0,9.0,13.0,15.0,15.0,15.0,6.0,26.0,11.0,0.0,4.0,0.0,183.0,79.0,3.0,2.0,1.0,2.0,2.0,2.0,3.0,2.0,2.0,2.0,1.0,5.0,7.0,9.0,6.0,10.0,11.0,15.0,11.0,7.0,14.0,10.0,7.0,13.0,10.0,14.0,13.0,15.0,13.0,12.0,10.0,12.0,17.0,8.0,11.0,10.0,13.0,15.0,16.0,13.0,13.0,16.0,13.0,5.0,15.0,13.0,20.0,16.0,15.0,13.0,14.0,15.0,7.0,14.0,16.0,12.0,14.0,14.0,15.0,14.0,14.0,5.0,26.0,0.0,0.0,0.0,0.0,177.0,68.0,4.0,2.0,1.0,2.0,3.0,1.0,1.0,2.0,3.0,3.0,3.0,12.0,13.0,11.0,8.0,13.0,11.0,8.0,10.0,8.0,10.0,13.0,10.0,12.0,13.0,7.0,12.0,10.0,13.0,11.0,15.0,13.0,14.0,11.0,7.0,14.0,10.0,14.0,14.0,13.0,15.0,12.0,9.0,20.0,15.0,14.0,5.0,15.0,8.0,13.0,7.0,14.0,6.0,12.0,11.0,12.0,14.0,13.0,16.0,16.0,16.0,5.0,22.0,12.0,2.0,13.0,0.0,170.0,71.0,2.0,2.0,1.0,3.0,2.0,2.0,1.0,1.0,1.0,3.0,2.0,15.0,15.0,12.0,10.0,14.0,15.0,8.0,13.0,12.0,9.0,13.0,10.0,10.0,14.0,14.0,16.0,10.0,17.0,14.0,12.0,16.0,14.0,12.0,8.0,14.0,10.0,17.0,16.0,16.0,17.0,10.0,6.0,20.0,17.0,13.0,8.0,15.0,7.0,15.0,6.0,15.0,8.0,17.0,13.0,13.0,12.0,12.0,14.0,16.0,16.0,8.0,26.0,14.0,0.0,0.0,0.0,181.0,74.0,2.0,1.0,1.0,1.0,3.0,2.0,3.0,1.0,3.0,3.0,2.0,6.0,13.0,8.0,5.0,12.0,7.0,12.0,8.0,11.0,13.0,12.0,6.0,14.0,10.0,14.0,12.0,14.0,10.0,12.0,8.0,8.0,14.0,6.0,6.0,12.0,11.0,14.0,15.0,16.0,14.0,14.0,11.0,5.0,14.0,14.0,20.0,16.0,14.0,12.0,13.0,14.0,8.0,10.0,8.0,14.0,12.0,13.0,15.0,15.0,15.0,6.0,29.0,0.0,0.0,0.0,0.0,188.0,74.0,1.0,2.0,3.0,3.0,2.0,3.0,1.0,3.0,2.0,1.0,1.0,4.0,8.0,10.0,6.0,13.0,7.0,14.0,9.0,6.0,13.0,12.0,8.0,13.0,13.0,12.0,14.0,13.0,14.0,11.0,13.0,12.0,14.0,6.0,13.0,8.0,14.0,15.0,15.0,9.0,12.0,14.0,14.0,10.0,13.0,10.0,20.0,16.0,12.0,13.0,12.0,15.0,9.0,11.0,11.0,14.0,14.0,12.0,15.0,13.0,13.0,6.0,22.0,18.0,0.0,0.0,0.0,179.0,75.0,1.0,4.0,2.0,1.0,1.0,1.0,3.0,1.0,1.0,3.0,2.0,7.0,8.0,12.0,8.0,13.0,10.0,11.0,12.0,11.0,11.0,11.0,10.0,14.0,13.0,15.0,12.0,15.0,8.0,12.0,10.0,12.0,14.0,12.0,10.0,13.0,12.0,13.0,17.0,14.0,14.0,13.0,10.0,9.0,15.0,15.0,20.0,15.0,14.0,13.0,13.0,12.0,11.0,12.0,13.0,15.0,9.0,10.0,12.0,10.0,10.0,4.0,27.0,0.0,0.0,0.0,0.0,173.0,68.0,2.0,2.0,1.0,1.0,3.0,3.0,1.0,2.0,3.0,4.0,2.0,12.0,12.0,13.0,8.0,13.0,10.0,7.0,8.0,9.0,7.0,12.0,10.0,9.0,14.0,7.0,10.0,8.0,11.0,12.0,12.0,11.0,12.0,13.0,5.0,13.0,10.0,10.0,12.0,14.0,14.0,11.0,7.0,20.0,12.0,15.0,10.0,13.0,8.0,12.0,7.0,13.0,9.0,12.0,18.0,12.0,14.0,11.0,14.0,15.0,15.0,6.0,24.0,0.0,0.0,5.0,0.0,183.0,79.0,4.0,4.0,3.0,3.0,1.0,3.0,2.0,1.0,3.0,2.0,3.0,4.0,7.0,12.0,13.0,12.0,8.0,13.0,12.0,5.0,6.0,11.0,12.0,4.0,13.0,11.0,12.0,14.0,9.0,12.0,10.0,10.0,13.0,12.0,6.0,14.0,12.0,13.0,14.0,15.0,14.0,14.0,11.0,10.0,13.0,14.0,20.0,14.0,14.0,12.0,12.0,14.0,9.0,5.0,7.0,13.0,15.0,11.0,14.0,14.0,14.0,6.0,27.0,33.0,4.0,3.0,0.0,180.0,75.0,2.0,1.0,2.0,1.0,4.0,2.0,1.0,3.0,1.0,1.0,2.0,12.0,11.0,13.0,13.0,11.0,11.0,11.0,10.0,7.0,5.0,10.0,14.0,5.0,14.0,9.0,11.0,12.0,10.0,11.0,12.0,12.0,14.0,13.0,8.0,14.0,8.0,11.0,14.0,16.0,14.0,13.0,10.0,7.0,12.0,15.0,20.0,14.0,12.0,12.0,9.0,13.0,10.0,10.0,9.0,15.0,8.0,9.0,13.0,14.0,14.0,7.0,25.0,0.0,0.0,11.0,0.0,189.0,83.0,12.0,12.0,11.0,7.0,13.0,12.0,17.0,17.0,16.0,12.0,13.0,6.0,2.0,1.0,1.0,10.0,10.0,7.0,1.0,1.0,1.0,9.0,5.0,1.0,10.0,8.0,15.0,14.0,14.0,12.0,7.0,13.0,12.0,6.0,9.0,3.0,16.0,17.0,10.0,13.0,16.0,14.0,12.0,8.0,15.0,10.0,20.0,13.0,14.0,14.0,5.0,14.0,4.0,12.0,15.0,15.0,13.0,13.0,17.0,15.0,17.0,4.0,20.0,0.0,0.0,7.0,0.0,186.0,72.0,3.0,3.0,2.0,3.0,3.0,4.0,3.0,3.0,2.0,2.0,2.0,4.0,9.0,8.0,6.0,13.0,6.0,14.0,6.0,7.0,14.0,12.0,8.0,13.0,13.0,11.0,13.0,14.0,14.0,14.0,9.0,13.0,13.0,8.0,8.0,8.0,13.0,14.0,14.0,13.0,13.0,15.0,13.0,20.0,15.0,14.0,8.0,14.0,13.0,12.0,8.0,12.0,4.0,10.0,8.0,15.0,14.0,12.0,14.0,15.0,14.0,7.0,31.0,0.0,0.0,0.0,0.0,171.0,65.0,1.0,3.0,1.0,3.0,2.0,2.0,3.0,1.0,2.0,2.0,3.0,8.0,9.0,11.0,7.0,5.0,6.0,5.0,6.0,7.0,14.0,14.0,6.0,14.0,13.0,14.0,12.0,13.0,12.0,11.0,11.0,12.0,12.0,11.0,7.0,12.0,12.0,12.0,10.0,15.0,15.0,7.0,9.0,9.0,12.0,14.0,20.0,12.0,13.0,11.0,13.0,11.0,9.0,10.0,15.0,14.0,12.0,11.0,14.0,13.0,12.0,7.0,28.0,46.0,0.0,5.0,0.0,183.0,69.0,1.0,1.0,1.0,1.0,1.0,1.0,3.0,3.0,2.0,1.0,3.0,10.0,14.0,14.0,7.0,14.0,5.0,11.0,11.0,12.0,13.0,14.0,6.0,14.0,15.0,15.0,12.0,13.0,12.0,13.0,14.0,12.0,5.0,11.0,8.0,14.0,10.0,13.0,13.0,15.0,14.0,13.0,11.0,9.0,15.0,14.0,20.0,15.0,12.0,13.0,10.0,15.0,9.0,12.0,9.0,4.0,13.0,15.0,5.0,13.0,12.0,7.0,28.0,0.0,0.0,0.0,0.0,169.0,0.0,3.0,3.0,2.0,3.0,3.0,1.0,1.0,3.0,2.0,1.0,3.0,5.0,8.0,11.0,9.0,8.0,8.0,7.0,8.0,4.0,2.0,9.0,5.0,3.0,11.0,11.0,11.0,13.0,9.0,11.0,8.0,15.0,14.0,11.0,7.0,10.0,8.0,8.0,10.0,11.0,11.0,6.0,5.0,14.0,11.0,12.0,20.0,14.0,5.0,9.0,12.0,9.0,5.0,6.0,9.0,12.0,11.0,9.0,9.0,10.0,12.0,11.0,33.0,30.0,1.0,0.0,0.0,187.0,83.0,1.0,3.0,4.0,2.0,1.0,1.0,2.0,3.0,1.0,1.0,3.0,13.0,13.0,12.0,8.0,16.0,10.0,16.0,13.0,10.0,14.0,16.0,13.0,16.0,15.0,13.0,15.0,14.0,16.0,15.0,14.0,14.0,13.0,11.0,13.0,10.0,17.0,18.0,10.0,10.0,12.0,17.0,14.0,20.0,12.0,12.0,10.0,13.0,16.0,16.0,16.0,15.0,13.0,11.0,16.0,16.0,13.0,15.0,12.0,8.0,8.0,11.0,21.0,0.0,0.0,15.0,1.0,189.0,75.0,3.0,3.0,3.0,3.0,1.0,1.0,3.0,3.0,3.0,2.0,3.0,10.0,12.0,13.0,7.0,14.0,8.0,14.0,12.0,5.0,13.0,15.0,8.0,15.0,14.0,14.0,14.0,15.0,14.0,14.0,13.0,14.0,15.0,12.0,10.0,12.0,14.0,15.0,16.0,12.0,13.0,15.0,14.0,20.0,14.0,13.0,10.0,16.0,13.0,14.0,11.0,14.0,7.0,10.0,8.0,16.0,10.0,12.0,13.0,13.0,11.0,14.0,29.0,51.0,8.0,24.0,0.0,175.0,70.0,3.0,4.0,2.0,3.0,2.0,3.0,2.0,2.0,2.0,1.0,3.0,6.0,12.0,12.0,10.0,13.0,7.0,12.0,12.0,8.0,14.0,13.0,9.0,16.0,13.0,14.0,16.0,16.0,15.0,16.0,11.0,14.0,16.0,8.0,14.0,14.0,15.0,18.0,18.0,15.0,14.0,16.0,8.0,20.0,16.0,14.0,8.0,18.0,14.0,16.0,13.0,14.0,7.0,14.0,15.0,14.0,14.0,14.0,16.0,16.0,16.0,5.0,16.0,0.0,0.0,0.0,0.0,173.0,0.0,3.0,1.0,1.0,1.0,2.0,1.0,4.0,1.0,2.0,3.0,1.0,1.0,1.0,4.0,4.0,5.0,4.0,4.0,4.0,1.0,5.0,6.0,5.0,8.0,9.0,10.0,6.0,6.0,3.0,5.0,4.0,10.0,7.0,8.0,8.0,3.0,11.0,13.0,9.0,7.0,5.0,14.0,4.0,20.0,6.0,5.0,8.0,6.0,9.0,5.0,7.0,8.0,5.0,7.0,6.0,11.0,7.0,10.0,18.0,19.0,15.0,9.0,21.0,0.0,0.0,1.0,0.0,170.0,65.0,1.0,3.0,2.0,3.0,3.0,3.0,3.0,3.0,2.0,3.0,3.0,11.0,11.0,14.0,12.0,14.0,8.0,11.0,8.0,5.0,8.0,12.0,11.0,6.0,13.0,9.0,12.0,9.0,10.0,9.0,10.0,11.0,13.0,15.0,10.0,13.0,7.0,6.0,11.0,16.0,16.0,14.0,5.0,8.0,14.0,15.0,20.0,13.0,9.0,10.0,6.0,14.0,7.0,10.0,19.0,13.0,8.0,14.0,12.0,12.0,14.0,5.0,34.0,116.0,62.0,7.0,6.0,195.0,95.0,1.0,1.0,3.0,1.0,1.0,3.0,4.0,1.0,2.0,3.0,2.0,5.0,12.0,15.0,16.0,18.0,14.0,14.0,16.0,8.0,6.0,15.0,18.0,6.0,18.0,16.0,16.0,15.0,13.0,13.0,16.0,14.0,14.0,19.0,16.0,15.0,4.0,13.0,8.0,12.0,15.0,20.0,18.0,16.0,16.0,14.0,20.0,15.0,18.0,16.0,13.0,11.0,11.0,8.0,15.0,20.0,11.0,15.0,14.0,7.0,7.0,13.0
2,2,28.0,0.0,0.0,0.0,0.0,188.0,86.0,14.0,13.0,15.0,8.0,14.0,11.0,14.0,16.0,13.0,12.0,8.0,6.0,2.0,1.0,3.0,8.0,8.0,1.0,1.0,3.0,1.0,8.0,4.0,1.0,8.0,8.0,13.0,13.0,14.0,14.0,11.0,12.0,15.0,7.0,10.0,2.0,14.0,12.0,11.0,13.0,14.0,16.0,13.0,5.0,16.0,12.0,20.0,14.0,15.0,14.0,8.0,15.0,5.0,1.0,11.0,15.0,14.0,14.0,16.0,14.0,11.0,6.0,35.0,0.0,0.0,9.0,0.0,182.0,82.0,1.0,1.0,1.0,3.0,1.0,1.0,3.0,3.0,1.0,2.0,3.0,9.0,12.0,9.0,7.0,11.0,13.0,15.0,13.0,12.0,13.0,11.0,12.0,15.0,11.0,12.0,15.0,16.0,13.0,13.0,9.0,13.0,14.0,6.0,14.0,7.0,15.0,17.0,10.0,7.0,11.0,15.0,12.0,20.0,14.0,8.0,8.0,12.0,14.0,14.0,12.0,14.0,6.0,12.0,13.0,14.0,16.0,12.0,16.0,14.0,13.0,7.0,26.0,1.0,0.0,0.0,0.0,185.0,80.0,3.0,1.0,3.0,3.0,3.0,3.0,2.0,3.0,4.0,2.0,1.0,5.0,9.0,11.0,8.0,11.0,6.0,12.0,8.0,10.0,15.0,11.0,12.0,14.0,12.0,16.0,12.0,17.0,14.0,9.0,9.0,10.0,15.0,13.0,9.0,7.0,10.0,8.0,12.0,15.0,13.0,17.0,14.0,8.0,13.0,18.0,20.0,13.0,14.0,11.0,12.0,11.0,4.0,10.0,12.0,12.0,13.0,10.0,10.0,8.0,7.0,14.0,21.0,0.0,0.0,4.0,0.0,178.0,72.0,2.0,3.0,1.0,2.0,2.0,3.0,3.0,1.0,2.0,2.0,3.0,6.0,12.0,10.0,7.0,11.0,7.0,9.0,8.0,11.0,12.0,11.0,8.0,13.0,11.0,10.0,12.0,11.0,12.0,13.0,11.0,11.0,13.0,8.0,11.0,12.0,12.0,13.0,14.0,15.0,13.0,13.0,9.0,7.0,14.0,14.0,20.0,14.0,12.0,13.0,10.0,12.0,9.0,14.0,16.0,15.0,8.0,10.0,12.0,16.0,17.0,10.0,30.0,0.0,0.0,0.0,0.0,176.0,75.0,2.0,3.0,2.0,1.0,3.0,2.0,1.0,2.0,1.0,3.0,1.0,9.0,14.0,11.0,6.0,12.0,9.0,11.0,10.0,12.0,11.0,11.0,10.0,12.0,12.0,13.0,13.0,14.0,10.0,10.0,11.0,11.0,12.0,8.0,10.0,9.0,12.0,13.0,15.0,15.0,13.0,12.0,9.0,20.0,15.0,14.0,6.0,17.0,12.0,12.0,13.0,13.0,6.0,14.0,11.0,14.0,14.0,12.0,14.0,13.0,13.0,9.0,25.0,0.0,0.0,7.0,0.0,180.0,76.0,2.0,1.0,3.0,3.0,3.0,3.0,4.0,2.0,1.0,1.0,3.0,10.0,12.0,11.0,8.0,14.0,9.0,12.0,13.0,8.0,10.0,14.0,8.0,12.0,14.0,13.0,13.0,15.0,13.0,14.0,13.0,13.0,15.0,10.0,7.0,11.0,12.0,15.0,16.0,14.0,15.0,14.0,10.0,8.0,14.0,13.0,20.0,15.0,13.0,14.0,13.0,14.0,9.0,16.0,12.0,13.0,15.0,13.0,14.0,12.0,11.0,8.0,29.0,59.0,2.0,9.0,0.0,179.0,70.0,2.0,3.0,2.0,1.0,1.0,1.0,1.0,1.0,4.0,3.0,3.0,6.0,8.0,8.0,7.0,12.0,6.0,10.0,8.0,12.0,14.0,12.0,7.0,14.0,11.0,18.0,14.0,16.0,10.0,16.0,8.0,12.0,17.0,6.0,14.0,8.0,14.0,18.0,19.0,13.0,12.0,14.0,11.0,10.0,18.0,15.0,20.0,18.0,13.0,15.0,13.0,15.0,7.0,15.0,18.0,14.0,8.0,13.0,18.0,12.0,14.0,5.0,23.0,0.0,0.0,1.0,0.0,183.0,70.0,2.0,4.0,2.0,1.0,3.0,2.0,1.0,3.0,4.0,2.0,1.0,5.0,10.0,12.0,9.0,12.0,7.0,12.0,11.0,5.0,9.0,12.0,8.0,10.0,12.0,11.0,13.0,12.0,12.0,14.0,11.0,11.0,14.0,11.0,11.0,15.0,12.0,14.0,16.0,15.0,13.0,14.0,12.0,8.0,15.0,13.0,20.0,18.0,14.0,13.0,11.0,14.0,9.0,10.0,20.0,13.0,14.0,14.0,15.0,15.0,15.0,5.0,19.0,0.0,0.0,2.0,0.0,178.0,67.0,3.0,3.0,1.0,3.0,2.0,1.0,3.0,1.0,2.0,2.0,1.0,14.0,14.0,17.0,14.0,15.0,12.0,7.0,13.0,6.0,4.0,13.0,11.0,5.0,16.0,10.0,11.0,7.0,10.0,9.0,12.0,8.0,11.0,17.0,5.0,12.0,6.0,8.0,10.0,17.0,15.0,10.0,9.0,20.0,14.0,18.0,19.0,12.0,8.0,11.0,5.0,11.0,5.0,13.0,13.0,16.0,10.0,13.0,12.0,9.0,15.0,14.0,23.0,2.0,0.0,15.0,9.0,180.0,82.0,3.0,4.0,1.0,3.0,3.0,2.0,2.0,3.0,3.0,1.0,3.0,10.0,13.0,15.0,12.0,12.0,11.0,8.0,14.0,7.0,5.0,12.0,11.0,5.0,14.0,9.0,11.0,13.0,10.0,10.0,13.0,11.0,14.0,16.0,6.0,12.0,5.0,11.0,10.0,18.0,13.0,15.0,10.0,10.0,14.0,16.0,20.0,13.0,13.0,10.0,5.0,14.0,12.0,10.0,9.0,16.0,11.0,13.0,12.0,10.0,8.0,14.0,27.0,17.0,2.0,0.0,0.0,180.0,78.0,2.0,3.0,2.0,1.0,1.0,2.0,1.0,1.0,2.0,3.0,2.0,7.0,10.0,13.0,12.0,13.0,11.0,12.0,12.0,7.0,5.0,12.0,9.0,4.0,12.0,12.0,13.0,14.0,10.0,11.0,11.0,10.0,12.0,14.0,5.0,13.0,7.0,10.0,14.0,16.0,15.0,14.0,11.0,20.0,12.0,15.0,8.0,14.0,14.0,11.0,12.0,15.0,9.0,10.0,6.0,14.0,12.0,11.0,13.0,13.0,13.0,10.0,34.0,1.0,0.0,0.0,0.0,187.0,87.0,13.0,14.0,15.0,7.0,13.0,11.0,14.0,15.0,11.0,17.0,12.0,2.0,1.0,1.0,3.0,8.0,7.0,2.0,1.0,2.0,1.0,9.0,8.0,2.0,6.0,12.0,15.0,17.0,14.0,15.0,8.0,13.0,17.0,7.0,14.0,6.0,14.0,12.0,6.0,7.0,13.0,14.0,13.0,8.0,13.0,8.0,20.0,11.0,16.0,14.0,10.0,14.0,6.0,1.0,12.0,12.0,15.0,16.0,16.0,14.0,15.0,6.0,29.0,35.0,0.0,0.0,0.0,192.0,77.0,1.0,3.0,2.0,2.0,2.0,2.0,2.0,3.0,1.0,3.0,3.0,5.0,8.0,8.0,7.0,9.0,6.0,11.0,9.0,12.0,14.0,10.0,7.0,15.0,10.0,14.0,13.0,17.0,9.0,13.0,10.0,11.0,13.0,7.0,14.0,8.0,12.0,10.0,13.0,13.0,11.0,17.0,18.0,6.0,12.0,15.0,20.0,13.0,16.0,13.0,14.0,16.0,14.0,12.0,9.0,12.0,15.0,10.0,10.0,11.0,8.0,15.0,28.0,0.0,0.0,0.0,0.0,190.0,85.0,3.0,2.0,3.0,3.0,2.0,2.0,2.0,4.0,3.0,1.0,2.0,5.0,9.0,8.0,9.0,8.0,7.0,14.0,10.0,9.0,15.0,9.0,6.0,14.0,9.0,16.0,13.0,16.0,10.0,13.0,10.0,12.0,15.0,6.0,13.0,7.0,13.0,14.0,16.0,12.0,11.0,17.0,13.0,20.0,15.0,13.0,8.0,15.0,15.0,12.0,14.0,14.0,9.0,8.0,14.0,13.0,14.0,11.0,12.0,13.0,16.0,14.0,25.0,0.0,0.0,0.0,0.0,191.0,81.0,1.0,1.0,3.0,2.0,3.0,2.0,3.0,4.0,2.0,1.0,2.0,4.0,3.0,10.0,8.0,6.0,6.0,11.0,6.0,10.0,11.0,10.0,5.0,12.0,7.0,16.0,13.0,16.0,11.0,13.0,7.0,10.0,14.0,5.0,12.0,10.0,13.0,13.0,12.0,13.0,13.0,16.0,16.0,7.0,16.0,14.0,20.0,14.0,14.0,13.0,13.0,15.0,6.0,12.0,13.0,6.0,14.0,8.0,8.0,13.0,7.0,4.0,21.0,0.0,0.0,1.0,0.0,177.0,68.0,4.0,1.0,2.0,1.0,1.0,1.0,1.0,1.0,2.0,1.0,2.0,5.0,12.0,9.0,7.0,12.0,8.0,13.0,10.0,16.0,13.0,12.0,8.0,14.0,12.0,12.0,13.0,12.0,12.0,12.0,10.0,13.0,15.0,11.0,13.0,11.0,13.0,13.0,14.0,13.0,14.0,13.0,11.0,10.0,14.0,12.0,20.0,12.0,14.0,12.0,11.0,12.0,8.0,14.0,13.0,10.0,14.0,12.0,14.0,12.0,11.0,5.0,26.0,0.0,0.0,0.0,0.0,176.0,70.0,2.0,1.0,4.0,3.0,3.0,3.0,1.0,3.0,3.0,2.0,1.0,10.0,11.0,11.0,6.0,13.0,9.0,5.0,12.0,11.0,13.0,13.0,7.0,14.0,13.0,15.0,11.0,14.0,12.0,11.0,9.0,12.0,13.0,9.0,9.0,13.0,12.0,15.0,14.0,12.0,16.0,12.0,7.0,20.0,13.0,13.0,10.0,15.0,11.0,13.0,14.0,13.0,11.0,9.0,8.0,9.0,17.0,12.0,14.0,14.0,15.0,3.0,28.0,1.0,0.0,7.0,0.0,181.0,71.0,2.0,2.0,1.0,3.0,1.0,3.0,3.0,2.0,3.0,3.0,3.0,12.0,11.0,10.0,5.0,13.0,11.0,8.0,10.0,8.0,9.0,14.0,11.0,12.0,13.0,14.0,14.0,12.0,12.0,13.0,12.0,13.0,12.0,8.0,9.0,9.0,12.0,17.0,15.0,11.0,13.0,14.0,10.0,12.0,13.0,12.0,20.0,16.0,12.0,13.0,14.0,16.0,12.0,9.0,10.0,14.0,16.0,14.0,13.0,12.0,12.0,14.0,25.0,19.0,6.0,0.0,0.0,182.0,78.0,1.0,4.0,3.0,1.0,2.0,1.0,2.0,2.0,4.0,1.0,4.0,16.0,13.0,12.0,11.0,12.0,13.0,8.0,12.0,5.0,5.0,13.0,13.0,5.0,15.0,11.0,12.0,12.0,13.0,12.0,15.0,12.0,15.0,14.0,6.0,15.0,9.0,11.0,14.0,15.0,14.0,14.0,10.0,11.0,11.0,14.0,20.0,12.0,13.0,10.0,11.0,15.0,5.0,12.0,10.0,15.0,16.0,11.0,13.0,16.0,16.0,7.0,21.0,0.0,0.0,4.0,1.0,184.0,79.0,1.0,2.0,3.0,1.0,2.0,1.0,3.0,2.0,2.0,1.0,3.0,3.0,6.0,10.0,12.0,12.0,7.0,15.0,8.0,4.0,5.0,13.0,10.0,8.0,12.0,18.0,12.0,19.0,13.0,10.0,13.0,12.0,14.0,13.0,10.0,12.0,9.0,16.0,15.0,12.0,14.0,14.0,14.0,12.0,13.0,10.0,20.0,14.0,14.0,11.0,14.0,14.0,11.0,5.0,10.0,13.0,14.0,15.0,10.0,8.0,4.0,15.0,31.0,0.0,0.0,0.0,0.0,182.0,76.0,3.0,2.0,3.0,4.0,2.0,1.0,2.0,3.0,1.0,2.0,2.0,10.0,13.0,15.0,6.0,14.0,9.0,11.0,8.0,7.0,4.0,12.0,10.0,3.0,14.0,7.0,13.0,10.0,12.0,12.0,12.0,10.0,11.0,12.0,6.0,15.0,6.0,13.0,13.0,14.0,14.0,12.0,10.0,20.0,13.0,13.0,8.0,12.0,11.0,8.0,7.0,14.0,13.0,8.0,8.0,13.0,14.0,12.0,12.0,14.0,14.0,6.0,25.0,9.0,0.0,0.0,0.0,173.0,70.0,1.0,2.0,1.0,2.0,3.0,2.0,1.0,2.0,1.0,4.0,3.0,6.0,8.0,13.0,10.0,14.0,13.0,13.0,13.0,5.0,10.0,13.0,11.0,9.0,15.0,7.0,13.0,13.0,12.0,12.0,12.0,13.0,13.0,15.0,12.0,13.0,7.0,14.0,15.0,13.0,13.0,12.0,10.0,12.0,11.0,13.0,20.0,14.0,13.0,13.0,7.0,13.0,13.0,13.0,8.0,15.0,13.0,12.0,13.0,15.0,15.0,6.0
4,1,25.0,0.0,0.0,11.0,0.0,189.0,83.0,12.0,12.0,11.0,7.0,13.0,12.0,17.0,17.0,16.0,12.0,13.0,6.0,2.0,1.0,1.0,10.0,10.0,7.0,1.0,1.0,1.0,9.0,5.0,1.0,10.0,8.0,15.0,14.0,14.0,12.0,7.0,13.0,12.0,6.0,9.0,3.0,16.0,17.0,10.0,13.0,16.0,14.0,12.0,8.0,15.0,10.0,20.0,13.0,14.0,14.0,5.0,14.0,4.0,12.0,15.0,15.0,13.0,13.0,17.0,15.0,17.0,4.0,29.0,56.0,3.0,0.0,0.0,189.0,84.0,3.0,2.0,2.0,1.0,2.0,2.0,2.0,2.0,2.0,1.0,3.0,8.0,9.0,13.0,12.0,13.0,14.0,14.0,12.0,18.0,17.0,12.0,15.0,16.0,13.0,17.0,16.0,16.0,12.0,10.0,10.0,11.0,17.0,12.0,15.0,12.0,11.0,13.0,16.0,17.0,15.0,16.0,16.0,10.0,16.0,15.0,20.0,14.0,13.0,10.0,12.0,13.0,10.0,13.0,15.0,16.0,18.0,13.0,16.0,11.0,10.0,7.0,31.0,0.0,0.0,0.0,0.0,171.0,65.0,1.0,3.0,1.0,3.0,2.0,2.0,3.0,1.0,2.0,2.0,3.0,8.0,9.0,11.0,7.0,5.0,6.0,5.0,6.0,7.0,14.0,14.0,6.0,14.0,13.0,14.0,12.0,13.0,12.0,11.0,11.0,12.0,12.0,11.0,7.0,12.0,12.0,12.0,10.0,15.0,15.0,7.0,9.0,9.0,12.0,14.0,20.0,12.0,13.0,11.0,13.0,11.0,9.0,10.0,15.0,14.0,12.0,11.0,14.0,13.0,12.0,7.0,28.0,46.0,0.0,5.0,0.0,183.0,69.0,1.0,1.0,1.0,1.0,1.0,1.0,3.0,3.0,2.0,1.0,3.0,10.0,14.0,14.0,7.0,14.0,5.0,11.0,11.0,12.0,13.0,14.0,6.0,14.0,15.0,15.0,12.0,13.0,12.0,13.0,14.0,12.0,5.0,11.0,8.0,14.0,10.0,13.0,13.0,15.0,14.0,13.0,11.0,9.0,15.0,14.0,20.0,15.0,12.0,13.0,10.0,15.0,9.0,12.0,9.0,4.0,13.0,15.0,5.0,13.0,12.0,7.0,23.0,2.0,0.0,5.0,3.0,182.0,73.0,3.0,1.0,1.0,1.0,2.0,1.0,2.0,1.0,3.0,4.0,2.0,12.0,14.0,14.0,10.0,13.0,12.0,16.0,11.0,13.0,12.0,13.0,13.0,14.0,14.0,12.0,11.0,14.0,13.0,11.0,13.0,11.0,15.0,15.0,9.0,15.0,10.0,14.0,15.0,16.0,15.0,13.0,13.0,20.0,14.0,15.0,6.0,15.0,12.0,13.0,9.0,13.0,14.0,15.0,17.0,15.0,13.0,12.0,12.0,15.0,13.0,9.0,25.0,0.0,0.0,14.0,0.0,180.0,82.0,1.0,3.0,3.0,1.0,3.0,2.0,3.0,1.0,1.0,3.0,1.0,5.0,10.0,10.0,7.0,13.0,7.0,12.0,8.0,10.0,14.0,12.0,8.0,17.0,13.0,13.0,16.0,16.0,14.0,15.0,10.0,12.0,15.0,8.0,13.0,10.0,14.0,18.0,15.0,10.0,12.0,16.0,11.0,10.0,15.0,12.0,20.0,16.0,15.0,17.0,10.0,16.0,6.0,10.0,12.0,16.0,12.0,13.0,17.0,14.0,14.0,5.0,21.0,0.0,0.0,15.0,1.0,189.0,75.0,3.0,3.0,3.0,3.0,1.0,1.0,3.0,3.0,3.0,2.0,3.0,10.0,12.0,13.0,7.0,14.0,8.0,14.0,12.0,5.0,13.0,15.0,8.0,15.0,14.0,14.0,14.0,15.0,14.0,14.0,13.0,14.0,15.0,12.0,10.0,12.0,14.0,15.0,16.0,12.0,13.0,15.0,14.0,20.0,14.0,13.0,10.0,16.0,13.0,14.0,11.0,14.0,7.0,10.0,8.0,16.0,10.0,12.0,13.0,13.0,11.0,14.0,16.0,0.0,0.0,0.0,0.0,173.0,0.0,3.0,1.0,1.0,1.0,2.0,1.0,4.0,1.0,2.0,3.0,1.0,1.0,1.0,4.0,4.0,5.0,4.0,4.0,4.0,1.0,5.0,6.0,5.0,8.0,9.0,10.0,6.0,6.0,3.0,5.0,4.0,10.0,7.0,8.0,8.0,3.0,11.0,13.0,9.0,7.0,5.0,14.0,4.0,20.0,6.0,5.0,8.0,6.0,9.0,5.0,7.0,8.0,5.0,7.0,6.0,11.0,7.0,10.0,18.0,19.0,15.0,9.0,28.0,66.0,15.0,13.0,3.0,180.0,70.0,2.0,2.0,1.0,2.0,1.0,1.0,3.0,2.0,3.0,3.0,1.0,14.0,15.0,16.0,13.0,17.0,15.0,6.0,15.0,4.0,5.0,16.0,14.0,8.0,17.0,13.0,16.0,11.0,15.0,13.0,16.0,14.0,13.0,17.0,10.0,14.0,9.0,13.0,13.0,16.0,18.0,12.0,10.0,20.0,14.0,15.0,8.0,16.0,9.0,13.0,14.0,12.0,10.0,15.0,14.0,15.0,10.0,16.0,14.0,6.0,12.0,10.0,29.0,76.0,27.0,13.0,9.0,188.0,72.0,2.0,3.0,1.0,2.0,3.0,3.0,1.0,3.0,3.0,3.0,3.0,5.0,10.0,13.0,16.0,13.0,11.0,17.0,13.0,5.0,10.0,13.0,14.0,10.0,13.0,15.0,16.0,18.0,14.0,15.0,10.0,13.0,14.0,13.0,10.0,18.0,12.0,14.0,19.0,15.0,14.0,16.0,14.0,10.0,18.0,16.0,20.0,18.0,14.0,14.0,8.0,15.0,5.0,16.0,10.0,16.0,12.0,14.0,16.0,14.0,10.0,10.0,34.0,116.0,62.0,7.0,6.0,195.0,95.0,1.0,1.0,3.0,1.0,1.0,3.0,4.0,1.0,2.0,3.0,2.0,5.0,12.0,15.0,16.0,18.0,14.0,14.0,16.0,8.0,6.0,15.0,18.0,6.0,18.0,16.0,16.0,15.0,13.0,13.0,16.0,14.0,14.0,19.0,16.0,15.0,4.0,13.0,8.0,12.0,15.0,20.0,18.0,16.0,16.0,14.0,20.0,15.0,18.0,16.0,13.0,11.0,11.0,8.0,15.0,20.0,11.0,15.0,14.0,7.0,7.0,13.0,19.0,0.0,0.0,0.0,0.0,190.0,78.0,13.0,12.0,11.0,14.0,13.0,6.0,11.0,13.0,13.0,12.0,7.0,3.0,3.0,1.0,3.0,8.0,8.0,3.0,1.0,2.0,3.0,7.0,3.0,1.0,7.0,8.0,13.0,13.0,12.0,13.0,7.0,11.0,11.0,3.0,14.0,2.0,11.0,11.0,10.0,12.0,13.0,11.0,15.0,20.0,10.0,13.0,5.0,13.0,13.0,9.0,10.0,6.0,10.0,10.0,10.0,12.0,11.0,14.0,14.0,12.0,13.0,3.0,25.0,0.0,0.0,0.0,0.0,184.0,76.0,2.0,3.0,1.0,2.0,2.0,2.0,2.0,2.0,1.0,3.0,3.0,3.0,7.0,7.0,6.0,9.0,5.0,15.0,7.0,5.0,13.0,11.0,6.0,15.0,11.0,13.0,13.0,14.0,12.0,10.0,9.0,11.0,11.0,6.0,9.0,8.0,13.0,12.0,12.0,14.0,13.0,15.0,13.0,5.0,10.0,13.0,20.0,12.0,15.0,12.0,13.0,15.0,8.0,6.0,20.0,14.0,13.0,12.0,7.0,13.0,13.0,9.0,26.0,0.0,0.0,0.0,0.0,181.0,77.0,1.0,3.0,1.0,1.0,3.0,3.0,3.0,1.0,1.0,2.0,3.0,5.0,8.0,8.0,6.0,12.0,6.0,13.0,7.0,7.0,13.0,14.0,7.0,12.0,13.0,12.0,13.0,11.0,14.0,14.0,13.0,13.0,13.0,6.0,10.0,7.0,14.0,13.0,13.0,12.0,11.0,14.0,11.0,7.0,8.0,11.0,20.0,13.0,14.0,12.0,9.0,14.0,14.0,10.0,15.0,13.0,14.0,15.0,15.0,15.0,15.0,6.0,25.0,0.0,0.0,9.0,0.0,183.0,78.0,1.0,3.0,1.0,1.0,1.0,2.0,3.0,2.0,1.0,3.0,2.0,5.0,12.0,10.0,5.0,11.0,6.0,13.0,8.0,10.0,13.0,10.0,6.0,12.0,12.0,13.0,11.0,13.0,10.0,10.0,10.0,9.0,12.0,8.0,7.0,12.0,11.0,12.0,12.0,16.0,13.0,13.0,11.0,20.0,14.0,15.0,7.0,14.0,11.0,11.0,13.0,12.0,6.0,8.0,13.0,15.0,12.0,10.0,8.0,14.0,14.0,10.0,30.0,0.0,0.0,0.0,0.0,182.0,71.0,3.0,2.0,1.0,3.0,3.0,2.0,3.0,2.0,1.0,2.0,1.0,5.0,12.0,12.0,7.0,12.0,7.0,13.0,7.0,11.0,12.0,11.0,6.0,13.0,13.0,14.0,13.0,14.0,8.0,12.0,9.0,11.0,14.0,11.0,9.0,11.0,10.0,13.0,15.0,14.0,13.0,14.0,11.0,8.0,13.0,13.0,20.0,14.0,14.0,13.0,14.0,14.0,10.0,8.0,12.0,13.0,13.0,12.0,14.0,11.0,11.0,7.0,22.0,0.0,0.0,0.0,0.0,180.0,74.0,2.0,4.0,2.0,1.0,3.0,1.0,2.0,1.0,1.0,2.0,3.0,7.0,8.0,10.0,7.0,13.0,10.0,8.0,11.0,5.0,13.0,13.0,12.0,10.0,13.0,12.0,13.0,12.0,12.0,14.0,12.0,12.0,14.0,11.0,7.0,8.0,12.0,14.0,14.0,12.0,12.0,13.0,9.0,14.0,14.0,12.0,20.0,14.0,11.0,14.0,10.0,14.0,8.0,10.0,14.0,14.0,12.0,9.0,12.0,10.0,7.0,7.0,29.0,0.0,0.0,0.0,0.0,183.0,81.0,2.0,1.0,1.0,3.0,3.0,3.0,2.0,3.0,2.0,2.0,2.0,5.0,8.0,9.0,9.0,12.0,10.0,11.0,13.0,7.0,11.0,12.0,8.0,13.0,11.0,12.0,14.0,15.0,13.0,13.0,10.0,12.0,16.0,8.0,14.0,10.0,12.0,17.0,15.0,10.0,12.0,14.0,11.0,5.0,15.0,12.0,20.0,16.0,14.0,14.0,12.0,13.0,8.0,10.0,10.0,14.0,12.0,14.0,15.0,14.0,11.0,7.0,31.0,3.0,1.0,0.0,0.0,180.0,68.0,2.0,1.0,2.0,2.0,1.0,1.0,3.0,2.0,1.0,3.0,2.0,14.0,12.0,13.0,10.0,15.0,13.0,8.0,14.0,7.0,6.0,14.0,6.0,6.0,16.0,9.0,10.0,11.0,12.0,9.0,14.0,11.0,14.0,13.0,7.0,13.0,6.0,10.0,10.0,12.0,12.0,10.0,9.0,12.0,14.0,12.0,20.0,9.0,10.0,12.0,9.0,15.0,8.0,14.0,14.0,8.0,12.0,11.0,10.0,14.0,15.0,5.0,39.0,0.0,0.0,0.0,0.0,178.0,75.0,4.0,3.0,1.0,2.0,2.0,2.0,3.0,3.0,2.0,2.0,1.0,12.0,12.0,13.0,12.0,15.0,12.0,12.0,11.0,6.0,6.0,15.0,15.0,8.0,16.0,7.0,12.0,12.0,13.0,14.0,14.0,12.0,14.0,11.0,12.0,9.0,12.0,12.0,14.0,11.0,12.0,14.0,8.0,10.0,15.0,10.0,20.0,10.0,12.0,15.0,7.0,16.0,6.0,10.0,14.0,14.0,14.0,14.0,14.0,14.0,14.0,6.0,32.0,0.0,0.0,0.0,0.0,183.0,77.0,2.0,2.0,3.0,2.0,1.0,2.0,2.0,1.0,2.0,2.0,3.0,13.0,14.0,12.0,11.0,14.0,14.0,10.0,13.0,8.0,6.0,13.0,14.0,5.0,14.0,7.0,12.0,11.0,13.0,13.0,13.0,13.0,12.0,12.0,9.0,12.0,8.0,14.0,13.0,11.0,12.0,13.0,11.0,20.0,11.0,11.0,8.0,14.0,13.0,13.0,7.0,12.0,8.0,8.0,6.0,14.0,12.0,12.0,14.0,13.0,13.0,7.0,20.0,0.0,0.0,8.0,0.0,170.0,65.0,3.0,1.0,1.0,3.0,2.0,3.0,2.0,2.0,2.0,1.0,3.0,10.0,10.0,13.0,13.0,13.0,10.0,9.0,10.0,3.0,4.0,11.0,12.0,4.0,13.0,12.0,12.0,14.0,11.0,11.0,11.0,11.0,15.0,12.0,7.0,14.0,7.0,12.0,15.0,16.0,16.0,12.0,7.0,7.0,14.0,15.0,20.0,14.0,11.0,13.0,9.0,13.0,8.0,12.0,9.0,13.0,14.0,14.0,15.0,15.0,14.0,6.0
1,4,34.0,1.0,0.0,0.0,0.0,187.0,87.0,13.0,14.0,15.0,7.0,13.0,11.0,14.0,15.0,11.0,17.0,12.0,2.0,1.0,1.0,3.0,8.0,7.0,2.0,1.0,2.0,1.0,9.0,8.0,2.0,6.0,12.0,15.0,17.0,14.0,15.0,8.0,13.0,17.0,7.0,14.0,6.0,14.0,12.0,6.0,7.0,13.0,14.0,13.0,8.0,13.0,8.0,20.0,11.0,16.0,14.0,10.0,14.0,6.0,1.0,12.0,12.0,15.0,16.0,16.0,14.0,15.0,6.0,25.0,0.0,0.0,0.0,0.0,191.0,81.0,1.0,1.0,3.0,2.0,3.0,2.0,3.0,4.0,2.0,1.0,2.0,4.0,3.0,10.0,8.0,6.0,6.0,11.0,6.0,10.0,11.0,10.0,5.0,12.0,7.0,16.0,13.0,16.0,11.0,13.0,7.0,10.0,14.0,5.0,12.0,10.0,13.0,13.0,12.0,13.0,13.0,16.0,16.0,7.0,16.0,14.0,20.0,14.0,14.0,13.0,13.0,15.0,6.0,12.0,13.0,6.0,14.0,8.0,8.0,13.0,7.0,4.0,29.0,35.0,0.0,0.0,0.0,192.0,77.0,1.0,3.0,2.0,2.0,2.0,2.0,2.0,3.0,1.0,3.0,3.0,5.0,8.0,8.0,7.0,9.0,6.0,11.0,9.0,12.0,14.0,10.0,7.0,15.0,10.0,14.0,13.0,17.0,9.0,13.0,10.0,11.0,13.0,7.0,14.0,8.0,12.0,10.0,13.0,13.0,11.0,17.0,18.0,6.0,12.0,15.0,20.0,13.0,16.0,13.0,14.0,16.0,14.0,12.0,9.0,12.0,15.0,10.0,10.0,11.0,8.0,15.0,21.0,0.0,0.0,1.0,0.0,177.0,68.0,4.0,1.0,2.0,1.0,1.0,1.0,1.0,1.0,2.0,1.0,2.0,5.0,12.0,9.0,7.0,12.0,8.0,13.0,10.0,16.0,13.0,12.0,8.0,14.0,12.0,12.0,13.0,12.0,12.0,12.0,10.0,13.0,15.0,11.0,13.0,11.0,13.0,13.0,14.0,13.0,14.0,13.0,11.0,10.0,14.0,12.0,20.0,12.0,14.0,12.0,11.0,12.0,8.0,14.0,13.0,10.0,14.0,12.0,14.0,12.0,11.0,5.0,26.0,0.0,0.0,0.0,0.0,176.0,70.0,2.0,1.0,4.0,3.0,3.0,3.0,1.0,3.0,3.0,2.0,1.0,10.0,11.0,11.0,6.0,13.0,9.0,5.0,12.0,11.0,13.0,13.0,7.0,14.0,13.0,15.0,11.0,14.0,12.0,11.0,9.0,12.0,13.0,9.0,9.0,13.0,12.0,15.0,14.0,12.0,16.0,12.0,7.0,20.0,13.0,13.0,10.0,15.0,11.0,13.0,14.0,13.0,11.0,9.0,8.0,9.0,17.0,12.0,14.0,14.0,15.0,3.0,28.0,1.0,0.0,7.0,0.0,181.0,71.0,2.0,2.0,1.0,3.0,1.0,3.0,3.0,2.0,3.0,3.0,3.0,12.0,11.0,10.0,5.0,13.0,11.0,8.0,10.0,8.0,9.0,14.0,11.0,12.0,13.0,14.0,14.0,12.0,12.0,13.0,12.0,13.0,12.0,8.0,9.0,9.0,12.0,17.0,15.0,11.0,13.0,14.0,10.0,12.0,13.0,12.0,20.0,16.0,12.0,13.0,14.0,16.0,12.0,9.0,10.0,14.0,16.0,14.0,13.0,12.0,12.0,14.0,23.0,39.0,1.0,5.0,2.0,174.0,73.0,3.0,4.0,2.0,1.0,1.0,2.0,4.0,1.0,3.0,2.0,4.0,7.0,6.0,10.0,5.0,11.0,7.0,6.0,8.0,5.0,11.0,12.0,6.0,13.0,11.0,15.0,9.0,16.0,8.0,12.0,10.0,10.0,14.0,10.0,6.0,12.0,11.0,16.0,20.0,15.0,16.0,15.0,9.0,6.0,13.0,14.0,20.0,16.0,14.0,9.0,13.0,13.0,7.0,14.0,14.0,12.0,13.0,12.0,14.0,12.0,14.0,3.0,25.0,19.0,6.0,0.0,0.0,182.0,78.0,1.0,4.0,3.0,1.0,2.0,1.0,2.0,2.0,4.0,1.0,4.0,16.0,13.0,12.0,11.0,12.0,13.0,8.0,12.0,5.0,5.0,13.0,13.0,5.0,15.0,11.0,12.0,12.0,13.0,12.0,15.0,12.0,15.0,14.0,6.0,15.0,9.0,11.0,14.0,15.0,14.0,14.0,10.0,11.0,11.0,14.0,20.0,12.0,13.0,10.0,11.0,15.0,5.0,12.0,10.0,15.0,16.0,11.0,13.0,16.0,16.0,7.0,28.0,37.0,15.0,1.0,0.0,194.0,88.0,2.0,1.0,2.0,1.0,1.0,2.0,3.0,1.0,3.0,2.0,2.0,4.0,6.0,12.0,15.0,12.0,7.0,16.0,11.0,3.0,6.0,10.0,14.0,4.0,11.0,10.0,14.0,15.0,13.0,10.0,8.0,9.0,13.0,12.0,6.0,14.0,8.0,11.0,16.0,13.0,12.0,18.0,17.0,9.0,12.0,12.0,20.0,14.0,18.0,13.0,10.0,15.0,15.0,6.0,20.0,17.0,12.0,15.0,14.0,11.0,14.0,7.0,25.0,9.0,0.0,0.0,0.0,173.0,70.0,1.0,2.0,1.0,2.0,3.0,2.0,1.0,2.0,1.0,4.0,3.0,6.0,8.0,13.0,10.0,14.0,13.0,13.0,13.0,5.0,10.0,13.0,11.0,9.0,15.0,7.0,13.0,13.0,12.0,12.0,12.0,13.0,13.0,15.0,12.0,13.0,7.0,14.0,15.0,13.0,13.0,12.0,10.0,12.0,11.0,13.0,20.0,14.0,13.0,13.0,7.0,13.0,13.0,13.0,8.0,15.0,13.0,12.0,13.0,15.0,15.0,6.0,31.0,0.0,0.0,0.0,0.0,182.0,76.0,3.0,2.0,3.0,4.0,2.0,1.0,2.0,3.0,1.0,2.0,2.0,10.0,13.0,15.0,6.0,14.0,9.0,11.0,8.0,7.0,4.0,12.0,10.0,3.0,14.0,7.0,13.0,10.0,12.0,12.0,12.0,10.0,11.0,12.0,6.0,15.0,6.0,13.0,13.0,14.0,14.0,12.0,10.0,20.0,13.0,13.0,8.0,12.0,11.0,8.0,7.0,14.0,13.0,8.0,8.0,13.0,14.0,12.0,12.0,14.0,14.0,6.0,36.0,0.0,0.0,0.0,0.0,185.0,78.0,11.0,14.0,12.0,7.0,13.0,12.0,14.0,15.0,13.0,14.0,10.0,4.0,1.0,3.0,1.0,8.0,8.0,11.0,8.0,3.0,3.0,7.0,2.0,1.0,8.0,11.0,13.0,15.0,11.0,12.0,7.0,13.0,9.0,5.0,14.0,3.0,13.0,15.0,8.0,11.0,14.0,13.0,12.0,5.0,15.0,11.0,20.0,12.0,14.0,13.0,11.0,13.0,8.0,1.0,19.0,14.0,16.0,10.0,17.0,9.0,9.0,11.0,28.0,0.0,0.0,0.0,0.0,183.0,81.0,1.0,2.0,4.0,1.0,1.0,3.0,2.0,3.0,3.0,3.0,1.0,5.0,5.0,6.0,10.0,12.0,6.0,14.0,8.0,6.0,15.0,11.0,6.0,13.0,12.0,13.0,14.0,16.0,14.0,14.0,10.0,12.0,14.0,5.0,14.0,8.0,14.0,15.0,15.0,9.0,12.0,15.0,13.0,7.0,11.0,12.0,20.0,15.0,15.0,14.0,14.0,14.0,9.0,8.0,14.0,14.0,11.0,13.0,15.0,13.0,15.0,6.0,27.0,25.0,1.0,0.0,0.0,189.0,82.0,3.0,1.0,3.0,4.0,3.0,1.0,3.0,3.0,1.0,2.0,3.0,6.0,7.0,5.0,8.0,9.0,8.0,12.0,8.0,6.0,14.0,13.0,11.0,14.0,5.0,12.0,14.0,15.0,13.0,13.0,8.0,13.0,12.0,5.0,11.0,5.0,13.0,15.0,14.0,12.0,12.0,14.0,15.0,6.0,16.0,12.0,20.0,13.0,14.0,11.0,10.0,12.0,5.0,8.0,11.0,13.0,14.0,17.0,8.0,6.0,8.0,13.0,24.0,9.0,0.0,0.0,0.0,173.0,66.0,1.0,1.0,2.0,3.0,2.0,1.0,3.0,2.0,1.0,2.0,3.0,8.0,11.0,11.0,6.0,11.0,7.0,12.0,6.0,10.0,9.0,12.0,10.0,13.0,12.0,12.0,12.0,12.0,12.0,10.0,12.0,10.0,15.0,11.0,6.0,8.0,11.0,13.0,13.0,14.0,14.0,12.0,9.0,8.0,13.0,13.0,20.0,13.0,11.0,13.0,12.0,14.0,8.0,10.0,7.0,12.0,18.0,13.0,14.0,14.0,13.0,5.0,24.0,0.0,0.0,0.0,0.0,179.0,68.0,3.0,2.0,3.0,2.0,1.0,3.0,3.0,1.0,3.0,3.0,1.0,4.0,13.0,9.0,6.0,12.0,9.0,12.0,7.0,8.0,12.0,14.0,8.0,14.0,12.0,15.0,14.0,13.0,14.0,13.0,10.0,12.0,14.0,10.0,9.0,9.0,10.0,13.0,14.0,14.0,12.0,13.0,9.0,9.0,8.0,14.0,20.0,15.0,14.0,11.0,11.0,13.0,10.0,14.0,13.0,14.0,14.0,11.0,16.0,15.0,15.0,6.0,36.0,0.0,0.0,0.0,0.0,180.0,72.0,1.0,2.0,4.0,1.0,1.0,2.0,2.0,1.0,1.0,1.0,2.0,6.0,10.0,8.0,6.0,11.0,8.0,13.0,10.0,7.0,11.0,11.0,8.0,13.0,11.0,13.0,13.0,14.0,14.0,13.0,11.0,12.0,13.0,7.0,10.0,10.0,13.0,13.0,15.0,11.0,12.0,14.0,10.0,10.0,14.0,10.0,20.0,12.0,11.0,12.0,14.0,14.0,5.0,15.0,20.0,12.0,20.0,14.0,16.0,15.0,15.0,5.0,30.0,0.0,0.0,0.0,0.0,167.0,60.0,3.0,1.0,1.0,2.0,3.0,1.0,1.0,3.0,1.0,1.0,3.0,10.0,11.0,12.0,8.0,13.0,10.0,6.0,9.0,10.0,12.0,14.0,9.0,10.0,14.0,11.0,14.0,14.0,14.0,14.0,13.0,14.0,12.0,14.0,11.0,13.0,12.0,15.0,15.0,15.0,14.0,11.0,5.0,11.0,11.0,15.0,20.0,11.0,8.0,14.0,10.0,12.0,13.0,11.0,11.0,12.0,11.0,10.0,12.0,11.0,11.0,2.0,33.0,0.0,0.0,0.0,0.0,187.0,76.0,2.0,2.0,3.0,1.0,1.0,3.0,2.0,1.0,2.0,3.0,2.0,15.0,14.0,14.0,10.0,15.0,13.0,10.0,12.0,7.0,4.0,15.0,13.0,7.0,15.0,6.0,12.0,9.0,14.0,11.0,15.0,12.0,12.0,14.0,12.0,13.0,7.0,13.0,12.0,11.0,12.0,14.0,12.0,14.0,15.0,12.0,20.0,11.0,12.0,12.0,6.0,14.0,6.0,11.0,14.0,13.0,12.0,12.0,15.0,15.0,13.0,9.0,30.0,0.0,0.0,0.0,0.0,178.0,73.0,3.0,4.0,1.0,1.0,2.0,4.0,3.0,2.0,2.0,2.0,3.0,13.0,14.0,12.0,7.0,13.0,12.0,7.0,13.0,5.0,10.0,13.0,9.0,10.0,13.0,11.0,11.0,12.0,12.0,13.0,11.0,14.0,14.0,11.0,7.0,11.0,10.0,13.0,15.0,13.0,15.0,15.0,8.0,20.0,14.0,14.0,8.0,14.0,11.0,13.0,11.0,14.0,8.0,10.0,19.0,12.0,12.0,9.0,12.0,12.0,10.0,10.0,26.0,0.0,0.0,0.0,0.0,193.0,81.0,1.0,3.0,3.0,3.0,3.0,1.0,2.0,2.0,2.0,3.0,3.0,4.0,9.0,14.0,10.0,13.0,12.0,14.0,14.0,5.0,5.0,10.0,12.0,3.0,14.0,8.0,13.0,12.0,9.0,10.0,11.0,11.0,12.0,16.0,5.0,14.0,6.0,9.0,12.0,14.0,13.0,14.0,16.0,14.0,13.0,13.0,20.0,13.0,14.0,10.0,8.0,14.0,9.0,8.0,16.0,16.0,11.0,13.0,11.0,13.0,13.0,10.0,24.0,0.0,0.0,0.0,0.0,182.0,82.0,3.0,3.0,2.0,1.0,1.0,3.0,2.0,2.0,3.0,2.0,2.0,4.0,7.0,13.0,14.0,13.0,12.0,14.0,12.0,5.0,7.0,10.0,14.0,6.0,15.0,13.0,13.0,16.0,8.0,12.0,11.0,11.0,12.0,14.0,7.0,13.0,8.0,12.0,13.0,14.0,14.0,15.0,12.0,10.0,10.0,12.0,20.0,16.0,15.0,12.0,13.0,14.0,10.0,8.0,8.0,13.0,5.0,10.0,11.0,9.0,9.0,13.0
0,0,23.0,0.0,0.0,0.0,0.0,188.0,85.0,14.0,12.0,12.0,7.0,13.0,10.0,11.0,14.0,7.0,13.0,12.0,2.0,3.0,1.0,3.0,8.0,6.0,2.0,1.0,2.0,2.0,8.0,3.0,1.0,8.0,7.0,10.0,12.0,9.0,11.0,8.0,11.0,14.0,2.0,9.0,1.0,12.0,11.0,8.0,7.0,12.0,14.0,14.0,6.0,14.0,10.0,20.0,12.0,14.0,13.0,7.0,10.0,7.0,1.0,14.0,14.0,9.0,13.0,13.0,10.0,12.0,6.0,32.0,67.0,9.0,7.0,0.0,191.0,85.0,1.0,1.0,1.0,3.0,2.0,2.0,4.0,3.0,3.0,2.0,3.0,7.0,7.0,6.0,9.0,12.0,3.0,16.0,7.0,3.0,15.0,11.0,7.0,13.0,12.0,14.0,11.0,14.0,10.0,11.0,10.0,14.0,11.0,8.0,13.0,13.0,13.0,13.0,15.0,9.0,7.0,14.0,16.0,8.0,7.0,10.0,20.0,12.0,15.0,13.0,14.0,5.0,6.0,11.0,8.0,11.0,9.0,12.0,11.0,6.0,9.0,11.0,23.0,0.0,0.0,0.0,0.0,184.0,71.0,1.0,2.0,1.0,2.0,2.0,2.0,2.0,4.0,2.0,1.0,3.0,4.0,10.0,10.0,6.0,11.0,6.0,14.0,8.0,7.0,14.0,11.0,6.0,13.0,11.0,12.0,12.0,13.0,12.0,11.0,12.0,12.0,14.0,6.0,8.0,10.0,13.0,13.0,14.0,15.0,13.0,14.0,13.0,8.0,12.0,14.0,20.0,13.0,14.0,13.0,12.0,14.0,15.0,8.0,11.0,13.0,13.0,10.0,8.0,9.0,16.0,7.0,26.0,10.0,1.0,0.0,0.0,175.0,65.0,4.0,1.0,2.0,2.0,2.0,3.0,3.0,1.0,3.0,2.0,3.0,11.0,13.0,13.0,7.0,13.0,7.0,6.0,11.0,13.0,10.0,12.0,8.0,11.0,14.0,12.0,11.0,12.0,10.0,10.0,12.0,10.0,10.0,13.0,10.0,13.0,10.0,13.0,12.0,14.0,15.0,13.0,10.0,20.0,12.0,13.0,8.0,14.0,7.0,12.0,6.0,10.0,5.0,13.0,10.0,13.0,8.0,11.0,14.0,11.0,13.0,7.0,23.0,0.0,0.0,0.0,0.0,174.0,64.0,4.0,3.0,1.0,1.0,3.0,3.0,2.0,3.0,3.0,2.0,3.0,8.0,12.0,10.0,8.0,11.0,7.0,10.0,9.0,12.0,14.0,9.0,10.0,13.0,12.0,12.0,12.0,12.0,11.0,12.0,10.0,12.0,13.0,8.0,9.0,12.0,11.0,13.0,14.0,15.0,14.0,11.0,10.0,10.0,14.0,14.0,20.0,15.0,10.0,14.0,12.0,12.0,8.0,13.0,10.0,12.0,15.0,12.0,13.0,10.0,17.0,6.0,21.0,0.0,0.0,0.0,0.0,178.0,65.0,2.0,3.0,3.0,3.0,3.0,1.0,1.0,1.0,1.0,3.0,1.0,9.0,13.0,11.0,6.0,12.0,7.0,9.0,8.0,8.0,13.0,12.0,7.0,13.0,12.0,8.0,12.0,13.0,12.0,12.0,13.0,13.0,14.0,9.0,8.0,12.0,12.0,13.0,13.0,12.0,14.0,13.0,11.0,8.0,15.0,12.0,20.0,13.0,12.0,14.0,8.0,11.0,7.0,10.0,19.0,10.0,13.0,10.0,11.0,15.0,15.0,6.0,27.0,0.0,0.0,0.0,0.0,188.0,77.0,1.0,4.0,1.0,1.0,3.0,1.0,2.0,1.0,2.0,2.0,2.0,4.0,7.0,8.0,7.0,13.0,6.0,15.0,9.0,6.0,13.0,12.0,6.0,12.0,11.0,14.0,14.0,15.0,10.0,12.0,11.0,13.0,16.0,7.0,12.0,9.0,12.0,15.0,16.0,14.0,10.0,14.0,15.0,9.0,13.0,12.0,20.0,14.0,16.0,12.0,14.0,13.0,6.0,12.0,4.0,13.0,18.0,13.0,14.0,14.0,13.0,7.0,22.0,0.0,0.0,0.0,0.0,187.0,84.0,2.0,2.0,1.0,2.0,3.0,2.0,2.0,3.0,3.0,2.0,2.0,4.0,7.0,10.0,6.0,9.0,10.0,13.0,12.0,5.0,11.0,11.0,7.0,10.0,12.0,12.0,11.0,13.0,10.0,9.0,11.0,9.0,15.0,8.0,7.0,9.0,11.0,11.0,14.0,13.0,10.0,15.0,14.0,8.0,15.0,11.0,20.0,14.0,15.0,11.0,12.0,7.0,9.0,8.0,7.0,13.0,15.0,13.0,11.0,14.0,14.0,7.0,24.0,0.0,0.0,0.0,0.0,172.0,72.0,1.0,1.0,3.0,2.0,2.0,1.0,1.0,1.0,1.0,3.0,1.0,10.0,11.0,12.0,10.0,11.0,8.0,8.0,10.0,7.0,7.0,11.0,11.0,6.0,12.0,8.0,11.0,11.0,10.0,10.0,11.0,12.0,15.0,12.0,5.0,10.0,11.0,13.0,15.0,15.0,13.0,10.0,9.0,8.0,14.0,13.0,20.0,14.0,11.0,11.0,8.0,13.0,7.0,12.0,18.0,13.0,10.0,10.0,11.0,11.0,11.0,6.0,21.0,0.0,0.0,3.0,0.0,175.0,71.0,3.0,3.0,2.0,1.0,3.0,1.0,2.0,2.0,3.0,3.0,2.0,9.0,13.0,14.0,12.0,14.0,14.0,8.0,13.0,5.0,6.0,14.0,11.0,6.0,15.0,8.0,13.0,8.0,12.0,11.0,13.0,14.0,12.0,15.0,9.0,14.0,7.0,11.0,12.0,13.0,13.0,8.0,7.0,10.0,14.0,13.0,20.0,13.0,8.0,10.0,9.0,12.0,8.0,10.0,10.0,10.0,9.0,10.0,12.0,5.0,10.0,9.0,25.0,0.0,0.0,0.0,0.0,187.0,83.0,2.0,1.0,3.0,3.0,1.0,3.0,3.0,3.0,1.0,1.0,3.0,4.0,8.0,10.0,14.0,12.0,8.0,14.0,9.0,5.0,7.0,11.0,13.0,5.0,12.0,11.0,13.0,13.0,13.0,11.0,10.0,12.0,16.0,9.0,8.0,13.0,11.0,13.0,16.0,14.0,13.0,15.0,13.0,20.0,14.0,12.0,8.0,14.0,16.0,13.0,11.0,13.0,7.0,5.0,13.0,14.0,13.0,14.0,14.0,13.0,13.0,6.0,25.0,0.0,0.0,3.0,0.0,187.0,83.0,15.0,9.0,12.0,8.0,13.0,11.0,12.0,14.0,7.0,12.0,8.0,4.0,2.0,3.0,2.0,9.0,9.0,6.0,2.0,2.0,1.0,9.0,2.0,1.0,9.0,8.0,13.0,15.0,12.0,10.0,7.0,9.0,15.0,5.0,9.0,3.0,12.0,13.0,8.0,12.0,12.0,15.0,14.0,20.0,13.0,9.0,5.0,14.0,14.0,12.0,8.0,10.0,7.0,1.0,14.0,11.0,16.0,11.0,14.0,14.0,14.0,6.0,27.0,0.0,0.0,0.0,0.0,169.0,60.0,3.0,2.0,1.0,3.0,3.0,2.0,1.0,3.0,3.0,2.0,2.0,11.0,11.0,13.0,9.0,13.0,12.0,8.0,10.0,4.0,5.0,14.0,8.0,5.0,13.0,12.0,9.0,9.0,10.0,10.0,10.0,9.0,16.0,13.0,4.0,14.0,8.0,11.0,8.0,16.0,16.0,9.0,9.0,5.0,13.0,15.0,20.0,11.0,11.0,10.0,8.0,7.0,5.0,11.0,14.0,10.0,12.0,11.0,12.0,10.0,13.0,8.0,37.0,0.0,0.0,0.0,0.0,185.0,83.0,1.0,1.0,2.0,1.0,3.0,2.0,3.0,1.0,1.0,3.0,1.0,6.0,8.0,9.0,12.0,10.0,8.0,13.0,9.0,4.0,5.0,10.0,14.0,4.0,11.0,11.0,10.0,11.0,13.0,12.0,12.0,13.0,15.0,14.0,12.0,11.0,7.0,12.0,8.0,7.0,7.0,12.0,12.0,11.0,11.0,7.0,20.0,8.0,14.0,12.0,8.0,13.0,9.0,12.0,12.0,12.0,19.0,14.0,15.0,14.0,8.0,8.0,32.0,52.0,1.0,0.0,0.0,180.0,80.0,2.0,3.0,2.0,2.0,1.0,4.0,1.0,2.0,3.0,4.0,3.0,7.0,12.0,12.0,6.0,12.0,7.0,12.0,11.0,13.0,13.0,11.0,9.0,13.0,12.0,13.0,13.0,15.0,12.0,10.0,11.0,12.0,16.0,12.0,10.0,13.0,11.0,13.0,14.0,15.0,13.0,14.0,10.0,20.0,12.0,14.0,5.0,15.0,14.0,10.0,13.0,12.0,7.0,8.0,12.0,15.0,13.0,12.0,13.0,14.0,14.0,9.0,32.0,0.0,0.0,0.0,0.0,172.0,71.0,2.0,1.0,3.0,1.0,2.0,3.0,2.0,3.0,2.0,2.0,2.0,8.0,9.0,7.0,6.0,10.0,6.0,10.0,9.0,10.0,14.0,11.0,6.0,14.0,11.0,10.0,16.0,15.0,12.0,12.0,7.0,12.0,15.0,9.0,13.0,8.0,14.0,15.0,15.0,14.0,14.0,14.0,10.0,20.0,14.0,14.0,8.0,15.0,13.0,13.0,11.0,13.0,7.0,13.0,17.0,14.0,17.0,8.0,13.0,15.0,15.0,6.0,27.0,8.0,0.0,6.0,0.0,187.0,76.0,3.0,2.0,3.0,2.0,2.0,1.0,1.0,3.0,3.0,1.0,2.0,5.0,7.0,11.0,5.0,14.0,5.0,14.0,9.0,5.0,15.0,15.0,8.0,14.0,13.0,15.0,16.0,15.0,14.0,12.0,14.0,14.0,18.0,8.0,17.0,9.0,12.0,18.0,15.0,13.0,14.0,15.0,14.0,10.0,17.0,12.0,20.0,17.0,15.0,14.0,13.0,16.0,4.0,12.0,10.0,14.0,17.0,12.0,15.0,13.0,13.0,6.0,31.0,0.0,0.0,4.0,0.0,174.0,72.0,2.0,1.0,4.0,2.0,2.0,3.0,1.0,1.0,3.0,3.0,4.0,12.0,9.0,11.0,6.0,14.0,11.0,7.0,10.0,6.0,8.0,16.0,12.0,9.0,14.0,9.0,14.0,10.0,13.0,12.0,12.0,11.0,14.0,8.0,8.0,11.0,12.0,14.0,12.0,13.0,14.0,12.0,7.0,12.0,14.0,12.0,20.0,15.0,11.0,11.0,9.0,12.0,8.0,10.0,10.0,14.0,13.0,10.0,12.0,14.0,14.0,9.0,24.0,0.0,0.0,6.0,1.0,172.0,70.0,3.0,1.0,1.0,3.0,1.0,2.0,3.0,1.0,1.0,3.0,3.0,11.0,12.0,11.0,8.0,12.0,10.0,6.0,14.0,7.0,11.0,15.0,8.0,12.0,13.0,14.0,14.0,18.0,13.0,12.0,13.0,13.0,15.0,12.0,12.0,12.0,11.0,18.0,18.0,13.0,14.0,13.0,7.0,10.0,16.0,12.0,20.0,14.0,12.0,14.0,14.0,15.0,4.0,8.0,7.0,14.0,14.0,13.0,14.0,12.0,10.0,6.0,36.0,0.0,0.0,7.0,2.0,171.0,74.0,1.0,1.0,2.0,3.0,2.0,3.0,2.0,4.0,1.0,1.0,2.0,12.0,12.0,10.0,5.0,15.0,12.0,4.0,10.0,4.0,8.0,16.0,11.0,12.0,14.0,10.0,15.0,13.0,13.0,14.0,16.0,12.0,11.0,11.0,12.0,10.0,13.0,17.0,13.0,9.0,9.0,9.0,6.0,14.0,13.0,9.0,20.0,9.0,9.0,13.0,10.0,13.0,14.0,12.0,14.0,13.0,14.0,12.0,15.0,16.0,16.0,6.0,28.0,2.0,1.0,0.0,0.0,174.0,66.0,2.0,2.0,2.0,1.0,1.0,3.0,2.0,3.0,3.0,1.0,4.0,6.0,11.0,13.0,15.0,13.0,11.0,14.0,11.0,6.0,5.0,10.0,12.0,5.0,13.0,8.0,14.0,10.0,13.0,14.0,8.0,12.0,12.0,12.0,5.0,14.0,8.0,12.0,11.0,17.0,15.0,11.0,12.0,7.0,14.0,15.0,20.0,13.0,10.0,12.0,8.0,14.0,8.0,8.0,19.0,15.0,12.0,10.0,11.0,13.0,13.0,12.0,25.0,10.0,1.0,11.0,4.0,175.0,73.0,1.0,3.0,3.0,3.0,3.0,3.0,3.0,1.0,2.0,3.0,1.0,5.0,10.0,15.0,17.0,15.0,10.0,11.0,12.0,5.0,5.0,14.0,15.0,5.0,16.0,8.0,15.0,12.0,15.0,14.0,13.0,15.0,15.0,15.0,14.0,14.0,10.0,10.0,12.0,16.0,16.0,15.0,9.0,10.0,15.0,16.0,20.0,13.0,15.0,14.0,8.0,14.0,7.0,10.0,8.0,16.0,17.0,13.0,15.0,15.0,14.0,5.0
1,1,31.0,25.0,0.0,6.0,0.0,191.0,84.0,11.0,14.0,13.0,12.0,15.0,14.0,15.0,16.0,13.0,14.0,14.0,8.0,2.0,10.0,5.0,11.0,11.0,7.0,10.0,2.0,5.0,10.0,11.0,11.0,9.0,12.0,13.0,15.0,13.0,13.0,8.0,13.0,16.0,12.0,14.0,1.0,16.0,13.0,11.0,12.0,13.0,16.0,16.0,8.0,16.0,13.0,20.0,15.0,15.0,17.0,8.0,15.0,7.0,2.0,15.0,15.0,17.0,15.0,17.0,16.0,15.0,6.0,38.0,89.0,6.0,14.0,1.0,183.0,79.0,3.0,3.0,2.0,3.0,2.0,3.0,2.0,4.0,3.0,2.0,3.0,4.0,8.0,8.0,7.0,12.0,6.0,14.0,8.0,11.0,17.0,12.0,11.0,16.0,12.0,15.0,16.0,17.0,15.0,17.0,10.0,16.0,18.0,6.0,15.0,8.0,16.0,17.0,13.0,8.0,8.0,12.0,11.0,10.0,13.0,8.0,20.0,10.0,11.0,16.0,12.0,16.0,11.0,7.0,15.0,16.0,16.0,15.0,18.0,16.0,14.0,4.0,26.0,0.0,0.0,0.0,0.0,167.0,0.0,3.0,2.0,1.0,2.0,2.0,3.0,3.0,3.0,2.0,3.0,2.0,11.0,12.0,12.0,11.0,12.0,13.0,8.0,10.0,7.0,5.0,12.0,11.0,6.0,12.0,11.0,10.0,11.0,10.0,10.0,13.0,11.0,9.0,10.0,9.0,11.0,6.0,10.0,11.0,11.0,11.0,10.0,6.0,5.0,13.0,11.0,20.0,12.0,9.0,12.0,5.0,10.0,9.0,8.0,12.0,11.0,9.0,9.0,11.0,4.0,1.0,5.0,28.0,52.0,5.0,8.0,6.0,179.0,70.0,3.0,3.0,2.0,3.0,2.0,3.0,1.0,1.0,2.0,3.0,1.0,13.0,15.0,15.0,11.0,14.0,12.0,12.0,12.0,14.0,13.0,14.0,12.0,16.0,14.0,14.0,15.0,15.0,12.0,14.0,13.0,14.0,12.0,13.0,11.0,16.0,13.0,13.0,15.0,14.0,13.0,14.0,10.0,20.0,9.0,14.0,8.0,13.0,11.0,13.0,14.0,17.0,15.0,15.0,12.0,14.0,14.0,13.0,8.0,11.0,12.0,14.0,31.0,0.0,0.0,6.0,0.0,174.0,80.0,1.0,1.0,1.0,1.0,1.0,5.0,1.0,1.0,1.0,1.0,1.0,14.0,12.0,11.0,7.0,12.0,13.0,9.0,7.0,10.0,11.0,11.0,10.0,10.0,12.0,11.0,11.0,11.0,10.0,6.0,10.0,9.0,12.0,12.0,12.0,10.0,12.0,12.0,14.0,12.0,15.0,10.0,9.0,20.0,12.0,12.0,7.0,12.0,9.0,9.0,10.0,12.0,7.0,9.0,11.0,14.0,9.0,7.0,14.0,8.0,9.0,9.0,20.0,0.0,0.0,0.0,0.0,184.0,80.0,1.0,4.0,4.0,1.0,3.0,1.0,4.0,3.0,3.0,3.0,2.0,7.0,14.0,13.0,8.0,12.0,7.0,16.0,7.0,12.0,13.0,13.0,11.0,12.0,13.0,12.0,13.0,14.0,13.0,12.0,12.0,12.0,15.0,12.0,10.0,14.0,13.0,14.0,13.0,14.0,12.0,14.0,12.0,6.0,13.0,14.0,20.0,13.0,14.0,14.0,8.0,15.0,10.0,13.0,9.0,16.0,15.0,14.0,16.0,16.0,17.0,5.0,29.0,90.0,4.0,16.0,2.0,170.0,61.0,2.0,3.0,3.0,1.0,3.0,1.0,2.0,2.0,2.0,2.0,1.0,15.0,14.0,15.0,9.0,17.0,16.0,7.0,12.0,4.0,11.0,18.0,15.0,12.0,17.0,15.0,15.0,16.0,13.0,16.0,17.0,14.0,16.0,15.0,14.0,12.0,14.0,18.0,16.0,13.0,14.0,12.0,8.0,10.0,14.0,11.0,20.0,14.0,10.0,14.0,9.0,17.0,10.0,14.0,13.0,17.0,15.0,16.0,17.0,15.0,16.0,7.0,21.0,2.0,0.0,13.0,6.0,186.0,78.0,4.0,1.0,3.0,1.0,3.0,3.0,2.0,3.0,3.0,2.0,2.0,10.0,10.0,11.0,12.0,12.0,11.0,14.0,13.0,6.0,10.0,14.0,13.0,11.0,13.0,12.0,13.0,11.0,12.0,11.0,12.0,11.0,14.0,12.0,11.0,13.0,11.0,13.0,13.0,12.0,11.0,12.0,13.0,20.0,13.0,12.0,17.0,13.0,12.0,11.0,8.0,13.0,8.0,16.0,12.0,16.0,15.0,13.0,15.0,12.0,15.0,6.0,21.0,7.0,0.0,14.0,6.0,173.0,64.0,3.0,2.0,3.0,2.0,3.0,3.0,3.0,2.0,3.0,3.0,3.0,14.0,14.0,18.0,14.0,17.0,14.0,7.0,11.0,2.0,6.0,15.0,14.0,6.0,18.0,12.0,14.0,14.0,15.0,13.0,16.0,14.0,17.0,17.0,12.0,13.0,9.0,13.0,17.0,15.0,17.0,13.0,7.0,20.0,14.0,14.0,9.0,14.0,9.0,15.0,7.0,16.0,7.0,14.0,15.0,17.0,15.0,16.0,17.0,16.0,15.0,4.0,23.0,20.0,3.0,5.0,3.0,178.0,72.0,3.0,3.0,3.0,3.0,2.0,2.0,1.0,2.0,1.0,2.0,1.0,11.0,12.0,15.0,15.0,15.0,11.0,8.0,13.0,7.0,4.0,13.0,14.0,6.0,15.0,9.0,15.0,11.0,14.0,12.0,13.0,14.0,13.0,16.0,7.0,17.0,7.0,10.0,11.0,15.0,15.0,11.0,8.0,10.0,10.0,16.0,20.0,12.0,10.0,11.0,6.0,13.0,12.0,14.0,10.0,16.0,12.0,9.0,12.0,15.0,15.0,8.0,25.0,0.0,0.0,0.0,0.0,191.0,87.0,2.0,1.0,2.0,2.0,3.0,1.0,1.0,3.0,2.0,3.0,1.0,5.0,8.0,10.0,14.0,13.0,8.0,17.0,12.0,4.0,6.0,13.0,14.0,6.0,13.0,12.0,13.0,16.0,13.0,14.0,11.0,13.0,15.0,9.0,12.0,15.0,9.0,15.0,14.0,11.0,12.0,15.0,17.0,10.0,14.0,13.0,20.0,14.0,15.0,12.0,6.0,13.0,7.0,6.0,11.0,13.0,14.0,12.0,16.0,15.0,14.0,7.0,36.0,0.0,0.0,0.0,0.0,185.0,78.0,11.0,14.0,12.0,7.0,13.0,12.0,14.0,15.0,13.0,14.0,10.0,4.0,1.0,3.0,1.0,8.0,8.0,11.0,8.0,3.0,3.0,7.0,2.0,1.0,8.0,11.0,13.0,15.0,11.0,12.0,7.0,13.0,9.0,5.0,14.0,3.0,13.0,15.0,8.0,11.0,14.0,13.0,12.0,5.0,15.0,11.0,20.0,12.0,14.0,13.0,11.0,13.0,8.0,1.0,19.0,14.0,16.0,10.0,17.0,9.0,9.0,11.0,28.0,0.0,0.0,0.0,0.0,183.0,81.0,1.0,2.0,4.0,1.0,1.0,3.0,2.0,3.0,3.0,3.0,1.0,5.0,5.0,6.0,10.0,12.0,6.0,14.0,8.0,6.0,15.0,11.0,6.0,13.0,12.0,13.0,14.0,16.0,14.0,14.0,10.0,12.0,14.0,5.0,14.0,8.0,14.0,15.0,15.0,9.0,12.0,15.0,13.0,7.0,11.0,12.0,20.0,15.0,15.0,14.0,14.0,14.0,9.0,8.0,14.0,14.0,11.0,13.0,15.0,13.0,15.0,6.0,27.0,25.0,1.0,0.0,0.0,189.0,82.0,3.0,1.0,3.0,4.0,3.0,1.0,3.0,3.0,1.0,2.0,3.0,6.0,7.0,5.0,8.0,9.0,8.0,12.0,8.0,6.0,14.0,13.0,11.0,14.0,5.0,12.0,14.0,15.0,13.0,13.0,8.0,13.0,12.0,5.0,11.0,5.0,13.0,15.0,14.0,12.0,12.0,14.0,15.0,6.0,16.0,12.0,20.0,13.0,14.0,11.0,10.0,12.0,5.0,8.0,11.0,13.0,14.0,17.0,8.0,6.0,8.0,13.0,24.0,9.0,0.0,0.0,0.0,173.0,66.0,1.0,1.0,2.0,3.0,2.0,1.0,3.0,2.0,1.0,2.0,3.0,8.0,11.0,11.0,6.0,11.0,7.0,12.0,6.0,10.0,9.0,12.0,10.0,13.0,12.0,12.0,12.0,12.0,12.0,10.0,12.0,10.0,15.0,11.0,6.0,8.0,11.0,13.0,13.0,14.0,14.0,12.0,9.0,8.0,13.0,13.0,20.0,13.0,11.0,13.0,12.0,14.0,8.0,10.0,7.0,12.0,18.0,13.0,14.0,14.0,13.0,5.0,24.0,0.0,0.0,0.0,0.0,179.0,68.0,3.0,2.0,3.0,2.0,1.0,3.0,3.0,1.0,3.0,3.0,1.0,4.0,13.0,9.0,6.0,12.0,9.0,12.0,7.0,8.0,12.0,14.0,8.0,14.0,12.0,15.0,14.0,13.0,14.0,13.0,10.0,12.0,14.0,10.0,9.0,9.0,10.0,13.0,14.0,14.0,12.0,13.0,9.0,9.0,8.0,14.0,20.0,15.0,14.0,11.0,11.0,13.0,10.0,14.0,13.0,14.0,14.0,11.0,16.0,15.0,15.0,6.0,36.0,0.0,0.0,0.0,0.0,180.0,72.0,1.0,2.0,4.0,1.0,1.0,2.0,2.0,1.0,1.0,1.0,2.0,6.0,10.0,8.0,6.0,11.0,8.0,13.0,10.0,7.0,11.0,11.0,8.0,13.0,11.0,13.0,13.0,14.0,14.0,13.0,11.0,12.0,13.0,7.0,10.0,10.0,13.0,13.0,15.0,11.0,12.0,14.0,10.0,10.0,14.0,10.0,20.0,12.0,11.0,12.0,14.0,14.0,5.0,15.0,20.0,12.0,20.0,14.0,16.0,15.0,15.0,5.0,30.0,0.0,0.0,0.0,0.0,167.0,60.0,3.0,1.0,1.0,2.0,3.0,1.0,1.0,3.0,1.0,1.0,3.0,10.0,11.0,12.0,8.0,13.0,10.0,6.0,9.0,10.0,12.0,14.0,9.0,10.0,14.0,11.0,14.0,14.0,14.0,14.0,13.0,14.0,12.0,14.0,11.0,13.0,12.0,15.0,15.0,15.0,14.0,11.0,5.0,11.0,11.0,15.0,20.0,11.0,8.0,14.0,10.0,12.0,13.0,11.0,11.0,12.0,11.0,10.0,12.0,11.0,11.0,2.0,33.0,0.0,0.0,0.0,0.0,187.0,76.0,2.0,2.0,3.0,1.0,1.0,3.0,2.0,1.0,2.0,3.0,2.0,15.0,14.0,14.0,10.0,15.0,13.0,10.0,12.0,7.0,4.0,15.0,13.0,7.0,15.0,6.0,12.0,9.0,14.0,11.0,15.0,12.0,12.0,14.0,12.0,13.0,7.0,13.0,12.0,11.0,12.0,14.0,12.0,14.0,15.0,12.0,20.0,11.0,12.0,12.0,6.0,14.0,6.0,11.0,14.0,13.0,12.0,12.0,15.0,15.0,13.0,9.0,30.0,0.0,0.0,0.0,0.0,178.0,73.0,3.0,4.0,1.0,1.0,2.0,4.0,3.0,2.0,2.0,2.0,3.0,13.0,14.0,12.0,7.0,13.0,12.0,7.0,13.0,5.0,10.0,13.0,9.0,10.0,13.0,11.0,11.0,12.0,12.0,13.0,11.0,14.0,14.0,11.0,7.0,11.0,10.0,13.0,15.0,13.0,15.0,15.0,8.0,20.0,14.0,14.0,8.0,14.0,11.0,13.0,11.0,14.0,8.0,10.0,19.0,12.0,12.0,9.0,12.0,12.0,10.0,10.0,26.0,0.0,0.0,0.0,0.0,193.0,81.0,1.0,3.0,3.0,3.0,3.0,1.0,2.0,2.0,2.0,3.0,3.0,4.0,9.0,14.0,10.0,13.0,12.0,14.0,14.0,5.0,5.0,10.0,12.0,3.0,14.0,8.0,13.0,12.0,9.0,10.0,11.0,11.0,12.0,16.0,5.0,14.0,6.0,9.0,12.0,14.0,13.0,14.0,16.0,14.0,13.0,13.0,20.0,13.0,14.0,10.0,8.0,14.0,9.0,8.0,16.0,16.0,11.0,13.0,11.0,13.0,13.0,10.0,24.0,0.0,0.0,0.0,0.0,182.0,82.0,3.0,3.0,2.0,1.0,1.0,3.0,2.0,2.0,3.0,2.0,2.0,4.0,7.0,13.0,14.0,13.0,12.0,14.0,12.0,5.0,7.0,10.0,14.0,6.0,15.0,13.0,13.0,16.0,8.0,12.0,11.0,11.0,12.0,14.0,7.0,13.0,8.0,12.0,13.0,14.0,14.0,15.0,12.0,10.0,10.0,12.0,20.0,16.0,15.0,12.0,13.0,14.0,10.0,8.0,8.0,13.0,5.0,10.0,11.0,9.0,9.0,13.0
0,3,19.0,0.0,0.0,0.0,0.0,190.0,78.0,13.0,12.0,11.0,14.0,13.0,6.0,11.0,13.0,13.0,12.0,7.0,3.0,3.0,1.0,3.0,8.0,8.0,3.0,1.0,2.0,3.0,7.0,3.0,1.0,7.0,8.0,13.0,13.0,12.0,13.0,7.0,11.0,11.0,3.0,14.0,2.0,11.0,11.0,10.0,12.0,13.0,11.0,15.0,20.0,10.0,13.0,5.0,13.0,13.0,9.0,10.0,6.0,10.0,10.0,10.0,12.0,11.0,14.0,14.0,12.0,13.0,3.0,25.0,0.0,0.0,0.0,0.0,184.0,76.0,2.0,3.0,1.0,2.0,2.0,2.0,2.0,2.0,1.0,3.0,3.0,3.0,7.0,7.0,6.0,9.0,5.0,15.0,7.0,5.0,13.0,11.0,6.0,15.0,11.0,13.0,13.0,14.0,12.0,10.0,9.0,11.0,11.0,6.0,9.0,8.0,13.0,12.0,12.0,14.0,13.0,15.0,13.0,5.0,10.0,13.0,20.0,12.0,15.0,12.0,13.0,15.0,8.0,6.0,20.0,14.0,13.0,12.0,7.0,13.0,13.0,9.0,26.0,0.0,0.0,0.0,0.0,181.0,77.0,1.0,3.0,1.0,1.0,3.0,3.0,3.0,1.0,1.0,2.0,3.0,5.0,8.0,8.0,6.0,12.0,6.0,13.0,7.0,7.0,13.0,14.0,7.0,12.0,13.0,12.0,13.0,11.0,14.0,14.0,13.0,13.0,13.0,6.0,10.0,7.0,14.0,13.0,13.0,12.0,11.0,14.0,11.0,7.0,8.0,11.0,20.0,13.0,14.0,12.0,9.0,14.0,14.0,10.0,15.0,13.0,14.0,15.0,15.0,15.0,15.0,6.0,30.0,0.0,0.0,0.0,0.0,182.0,71.0,3.0,2.0,1.0,3.0,3.0,2.0,3.0,2.0,1.0,2.0,1.0,5.0,12.0,12.0,7.0,12.0,7.0,13.0,7.0,11.0,12.0,11.0,6.0,13.0,13.0,14.0,13.0,14.0,8.0,12.0,9.0,11.0,14.0,11.0,9.0,11.0,10.0,13.0,15.0,14.0,13.0,14.0,11.0,8.0,13.0,13.0,20.0,14.0,14.0,13.0,14.0,14.0,10.0,8.0,12.0,13.0,13.0,12.0,14.0,11.0,11.0,7.0,29.0,0.0,0.0,8.0,0.0,176.0,67.0,1.0,3.0,2.0,1.0,1.0,1.0,2.0,2.0,3.0,2.0,1.0,8.0,11.0,10.0,5.0,9.0,8.0,9.0,7.0,11.0,11.0,11.0,8.0,12.0,10.0,12.0,11.0,13.0,12.0,11.0,9.0,10.0,16.0,11.0,8.0,9.0,11.0,13.0,14.0,14.0,13.0,13.0,8.0,10.0,12.0,14.0,20.0,15.0,11.0,14.0,12.0,15.0,8.0,16.0,14.0,16.0,11.0,14.0,15.0,14.0,14.0,9.0,22.0,0.0,0.0,0.0,0.0,180.0,74.0,2.0,4.0,2.0,1.0,3.0,1.0,2.0,1.0,1.0,2.0,3.0,7.0,8.0,10.0,7.0,13.0,10.0,8.0,11.0,5.0,13.0,13.0,12.0,10.0,13.0,12.0,13.0,12.0,12.0,14.0,12.0,12.0,14.0,11.0,7.0,8.0,12.0,14.0,14.0,12.0,12.0,13.0,9.0,14.0,14.0,12.0,20.0,14.0,11.0,14.0,10.0,14.0,8.0,10.0,14.0,14.0,12.0,9.0,12.0,10.0,7.0,7.0,29.0,0.0,0.0,0.0,0.0,183.0,81.0,2.0,1.0,1.0,3.0,3.0,3.0,2.0,3.0,2.0,2.0,2.0,5.0,8.0,9.0,9.0,12.0,10.0,11.0,13.0,7.0,11.0,12.0,8.0,13.0,11.0,12.0,14.0,15.0,13.0,13.0,10.0,12.0,16.0,8.0,14.0,10.0,12.0,17.0,15.0,10.0,12.0,14.0,11.0,5.0,15.0,12.0,20.0,16.0,14.0,14.0,12.0,13.0,8.0,10.0,10.0,14.0,12.0,14.0,15.0,14.0,11.0,7.0,31.0,3.0,1.0,0.0,0.0,180.0,68.0,2.0,1.0,2.0,2.0,1.0,1.0,3.0,2.0,1.0,3.0,2.0,14.0,12.0,13.0,10.0,15.0,13.0,8.0,14.0,7.0,6.0,14.0,6.0,6.0,16.0,9.0,10.0,11.0,12.0,9.0,14.0,11.0,14.0,13.0,7.0,13.0,6.0,10.0,10.0,12.0,12.0,10.0,9.0,12.0,14.0,12.0,20.0,9.0,10.0,12.0,9.0,15.0,8.0,14.0,14.0,8.0,12.0,11.0,10.0,14.0,15.0,5.0,28.0,0.0,0.0,0.0,0.0,170.0,72.0,1.0,2.0,2.0,1.0,2.0,3.0,2.0,2.0,3.0,3.0,1.0,10.0,12.0,13.0,6.0,14.0,8.0,7.0,11.0,8.0,4.0,13.0,11.0,4.0,14.0,8.0,11.0,12.0,11.0,11.0,12.0,12.0,15.0,13.0,6.0,12.0,8.0,12.0,14.0,15.0,15.0,10.0,6.0,5.0,13.0,14.0,20.0,12.0,10.0,14.0,8.0,14.0,9.0,10.0,9.0,12.0,14.0,14.0,14.0,15.0,15.0,6.0,32.0,0.0,0.0,0.0,0.0,183.0,77.0,2.0,2.0,3.0,2.0,1.0,2.0,2.0,1.0,2.0,2.0,3.0,13.0,14.0,12.0,11.0,14.0,14.0,10.0,13.0,8.0,6.0,13.0,14.0,5.0,14.0,7.0,12.0,11.0,13.0,13.0,13.0,13.0,12.0,12.0,9.0,12.0,8.0,14.0,13.0,11.0,12.0,13.0,11.0,20.0,11.0,11.0,8.0,14.0,13.0,13.0,7.0,12.0,8.0,8.0,6.0,14.0,12.0,12.0,14.0,13.0,13.0,7.0,20.0,0.0,0.0,8.0,0.0,170.0,65.0,3.0,1.0,1.0,3.0,2.0,3.0,2.0,2.0,2.0,1.0,3.0,10.0,10.0,13.0,13.0,13.0,10.0,9.0,10.0,3.0,4.0,11.0,12.0,4.0,13.0,12.0,12.0,14.0,11.0,11.0,11.0,11.0,15.0,12.0,7.0,14.0,7.0,12.0,15.0,16.0,16.0,12.0,7.0,7.0,14.0,15.0,20.0,14.0,11.0,13.0,9.0,13.0,8.0,12.0,9.0,13.0,14.0,14.0,15.0,15.0,14.0,6.0,17.0,0.0,0.0,0.0,0.0,193.0,82.0,13.0,11.0,12.0,2.0,12.0,10.0,14.0,15.0,14.0,12.0,10.0,3.0,1.0,1.0,3.0,5.0,6.0,2.0,2.0,1.0,3.0,9.0,3.0,1.0,8.0,7.0,12.0,13.0,13.0,13.0,11.0,11.0,15.0,3.0,8.0,3.0,12.0,12.0,11.0,10.0,12.0,14.0,17.0,5.0,15.0,11.0,20.0,13.0,12.0,13.0,8.0,11.0,5.0,11.0,13.0,15.0,15.0,17.0,14.0,15.0,15.0,5.0,19.0,0.0,0.0,0.0,0.0,194.0,92.0,2.0,1.0,3.0,3.0,3.0,3.0,1.0,3.0,3.0,2.0,1.0,3.0,3.0,5.0,6.0,10.0,5.0,16.0,10.0,8.0,12.0,9.0,4.0,15.0,11.0,14.0,11.0,12.0,10.0,11.0,10.0,12.0,15.0,3.0,13.0,13.0,12.0,14.0,14.0,11.0,8.0,15.0,17.0,5.0,16.0,12.0,20.0,12.0,16.0,12.0,13.0,12.0,5.0,7.0,10.0,14.0,13.0,8.0,10.0,11.0,18.0,6.0,26.0,0.0,0.0,0.0,0.0,187.0,78.0,2.0,1.0,2.0,3.0,2.0,1.0,1.0,1.0,3.0,3.0,1.0,10.0,12.0,14.0,9.0,11.0,11.0,13.0,8.0,14.0,13.0,11.0,9.0,12.0,14.0,13.0,13.0,13.0,13.0,12.0,12.0,11.0,15.0,12.0,8.0,13.0,13.0,13.0,14.0,15.0,12.0,8.0,14.0,20.0,12.0,14.0,6.0,14.0,12.0,12.0,13.0,11.0,12.0,15.0,8.0,15.0,9.0,15.0,14.0,12.0,15.0,10.0,23.0,1.0,0.0,4.0,0.0,190.0,80.0,1.0,4.0,1.0,3.0,3.0,1.0,1.0,1.0,2.0,4.0,2.0,6.0,11.0,13.0,7.0,13.0,6.0,11.0,8.0,10.0,15.0,12.0,5.0,15.0,12.0,14.0,14.0,16.0,9.0,11.0,10.0,10.0,16.0,12.0,12.0,9.0,12.0,10.0,14.0,14.0,12.0,15.0,17.0,8.0,15.0,16.0,20.0,13.0,14.0,13.0,8.0,13.0,6.0,14.0,11.0,14.0,12.0,13.0,16.0,14.0,12.0,6.0,21.0,0.0,0.0,0.0,0.0,188.0,80.0,1.0,2.0,2.0,3.0,2.0,2.0,2.0,2.0,1.0,1.0,1.0,6.0,9.0,12.0,6.0,12.0,12.0,12.0,11.0,3.0,12.0,13.0,8.0,13.0,13.0,13.0,13.0,13.0,13.0,13.0,13.0,13.0,13.0,8.0,11.0,11.0,13.0,15.0,13.0,12.0,12.0,13.0,14.0,20.0,14.0,11.0,5.0,13.0,14.0,12.0,11.0,3.0,6.0,8.0,17.0,12.0,13.0,13.0,14.0,14.0,14.0,6.0,20.0,0.0,0.0,0.0,0.0,170.0,77.0,3.0,2.0,2.0,3.0,1.0,2.0,2.0,3.0,1.0,3.0,2.0,11.0,13.0,12.0,7.0,12.0,11.0,7.0,12.0,6.0,9.0,11.0,10.0,11.0,13.0,14.0,12.0,13.0,8.0,9.0,11.0,12.0,11.0,14.0,3.0,12.0,7.0,9.0,13.0,13.0,13.0,14.0,7.0,10.0,10.0,13.0,20.0,11.0,14.0,10.0,15.0,11.0,11.0,10.0,10.0,10.0,10.0,10.0,11.0,6.0,19.0,6.0,23.0,11.0,0.0,0.0,0.0,180.0,71.0,2.0,1.0,2.0,3.0,3.0,1.0,1.0,2.0,2.0,1.0,1.0,6.0,11.0,10.0,8.0,10.0,7.0,11.0,9.0,12.0,13.0,11.0,6.0,13.0,11.0,12.0,11.0,13.0,12.0,9.0,11.0,11.0,14.0,12.0,11.0,12.0,11.0,13.0,15.0,15.0,13.0,13.0,11.0,7.0,14.0,15.0,20.0,12.0,11.0,12.0,12.0,13.0,10.0,15.0,10.0,13.0,16.0,12.0,15.0,14.0,14.0,7.0,28.0,0.0,0.0,0.0,0.0,180.0,79.0,3.0,2.0,3.0,3.0,2.0,2.0,2.0,1.0,3.0,2.0,3.0,8.0,11.0,15.0,12.0,15.0,12.0,7.0,10.0,7.0,8.0,13.0,13.0,6.0,16.0,11.0,11.0,10.0,13.0,10.0,15.0,12.0,3.0,15.0,6.0,13.0,13.0,12.0,12.0,15.0,16.0,14.0,8.0,12.0,12.0,14.0,20.0,12.0,12.0,13.0,6.0,13.0,6.0,6.0,8.0,9.0,13.0,10.0,12.0,12.0,2.0,2.0,25.0,0.0,0.0,3.0,0.0,170.0,68.0,2.0,1.0,3.0,1.0,3.0,1.0,3.0,2.0,2.0,4.0,1.0,12.0,11.0,15.0,16.0,16.0,13.0,11.0,12.0,4.0,5.0,12.0,14.0,4.0,17.0,7.0,14.0,7.0,15.0,13.0,13.0,14.0,14.0,15.0,7.0,16.0,8.0,10.0,13.0,15.0,15.0,12.0,6.0,11.0,14.0,14.0,20.0,13.0,11.0,12.0,7.0,15.0,7.0,8.0,12.0,14.0,13.0,14.0,13.0,16.0,16.0,8.0,25.0,14.0,1.0,2.0,0.0,177.0,77.0,3.0,3.0,1.0,2.0,3.0,3.0,1.0,3.0,3.0,4.0,1.0,8.0,11.0,13.0,12.0,12.0,10.0,11.0,10.0,2.0,3.0,11.0,10.0,5.0,13.0,12.0,12.0,13.0,11.0,10.0,11.0,10.0,14.0,16.0,14.0,15.0,5.0,13.0,14.0,15.0,14.0,12.0,12.0,12.0,14.0,16.0,20.0,13.0,14.0,13.0,7.0,14.0,11.0,13.0,14.0,11.0,12.0,8.0,12.0,13.0,15.0,6.0,32.0,0.0,0.0,0.0,0.0,183.0,67.0,1.0,2.0,3.0,2.0,3.0,2.0,3.0,1.0,2.0,2.0,2.0,4.0,12.0,11.0,6.0,5.0,5.0,4.0,8.0,11.0,13.0,11.0,5.0,13.0,11.0,11.0,11.0,12.0,11.0,11.0,9.0,12.0,11.0,12.0,10.0,12.0,11.0,12.0,12.0,14.0,13.0,13.0,8.0,8.0,13.0,13.0,20.0,14.0,14.0,10.0,12.0,11.0,8.0,11.0,11.0,10.0,10.0,12.0,11.0,9.0,10.0,12.0
1,0,33.0,101.0,0.0,0.0,0.0,182.0,87.0,12.0,11.0,15.0,12.0,14.0,13.0,14.0,15.0,15.0,13.0,12.0,9.0,2.0,3.0,8.0,9.0,11.0,10.0,11.0,1.0,3.0,12.0,15.0,8.0,10.0,8.0,14.0,14.0,14.0,12.0,9.0,12.0,16.0,9.0,15.0,2.0,13.0,12.0,6.0,12.0,13.0,14.0,13.0,8.0,13.0,10.0,20.0,12.0,15.0,13.0,8.0,15.0,5.0,1.0,13.0,15.0,13.0,15.0,18.0,18.0,15.0,5.0,24.0,0.0,0.0,0.0,0.0,187.0,93.0,4.0,3.0,2.0,1.0,2.0,2.0,2.0,2.0,1.0,2.0,1.0,4.0,5.0,6.0,6.0,12.0,6.0,15.0,8.0,6.0,15.0,10.0,6.0,13.0,9.0,14.0,13.0,16.0,12.0,14.0,7.0,12.0,15.0,5.0,8.0,6.0,12.0,14.0,15.0,9.0,10.0,18.0,13.0,6.0,14.0,12.0,20.0,15.0,17.0,13.0,14.0,14.0,11.0,10.0,19.0,14.0,15.0,11.0,13.0,14.0,14.0,5.0,27.0,59.0,3.0,3.0,0.0,189.0,80.0,3.0,3.0,1.0,3.0,2.0,3.0,2.0,2.0,2.0,1.0,2.0,4.0,8.0,8.0,7.0,11.0,6.0,15.0,8.0,8.0,15.0,9.0,5.0,14.0,11.0,15.0,13.0,16.0,10.0,11.0,8.0,10.0,14.0,8.0,13.0,8.0,12.0,13.0,14.0,13.0,12.0,15.0,15.0,5.0,15.0,13.0,20.0,15.0,15.0,13.0,15.0,15.0,7.0,11.0,14.0,14.0,11.0,12.0,13.0,11.0,13.0,7.0,25.0,0.0,0.0,26.0,3.0,176.0,64.0,3.0,2.0,2.0,1.0,3.0,3.0,3.0,2.0,1.0,1.0,1.0,12.0,13.0,12.0,7.0,13.0,13.0,11.0,11.0,11.0,14.0,13.0,11.0,14.0,13.0,13.0,13.0,14.0,13.0,13.0,11.0,13.0,17.0,12.0,11.0,10.0,12.0,14.0,14.0,14.0,14.0,12.0,8.0,8.0,17.0,14.0,20.0,15.0,12.0,14.0,12.0,13.0,5.0,12.0,17.0,15.0,15.0,14.0,16.0,15.0,15.0,7.0,23.0,0.0,0.0,1.0,0.0,182.0,71.0,3.0,1.0,2.0,3.0,4.0,2.0,3.0,1.0,2.0,1.0,3.0,9.0,13.0,14.0,8.0,14.0,13.0,12.0,10.0,13.0,14.0,14.0,13.0,15.0,13.0,14.0,14.0,13.0,11.0,12.0,12.0,13.0,16.0,12.0,12.0,15.0,13.0,14.0,15.0,15.0,13.0,14.0,12.0,9.0,16.0,15.0,20.0,15.0,15.0,15.0,10.0,14.0,6.0,12.0,8.0,15.0,14.0,16.0,15.0,15.0,16.0,6.0,32.0,13.0,0.0,19.0,1.0,172.0,72.0,3.0,1.0,3.0,2.0,1.0,2.0,2.0,2.0,3.0,1.0,1.0,7.0,12.0,12.0,5.0,13.0,7.0,6.0,9.0,9.0,12.0,14.0,9.0,14.0,12.0,13.0,14.0,14.0,15.0,15.0,10.0,13.0,17.0,7.0,18.0,8.0,15.0,18.0,15.0,12.0,14.0,12.0,6.0,10.0,16.0,13.0,20.0,15.0,12.0,15.0,9.0,15.0,5.0,10.0,12.0,16.0,14.0,13.0,15.0,18.0,18.0,5.0,36.0,0.0,0.0,3.0,0.0,168.0,72.0,3.0,2.0,1.0,3.0,1.0,3.0,3.0,1.0,3.0,3.0,1.0,11.0,8.0,12.0,5.0,13.0,11.0,8.0,13.0,6.0,12.0,13.0,8.0,14.0,13.0,17.0,14.0,17.0,14.0,15.0,13.0,14.0,17.0,12.0,16.0,10.0,15.0,16.0,14.0,10.0,13.0,14.0,4.0,8.0,16.0,8.0,20.0,12.0,13.0,17.0,14.0,14.0,7.0,10.0,19.0,15.0,14.0,16.0,15.0,9.0,9.0,7.0,28.0,15.0,2.0,8.0,1.0,171.0,68.0,3.0,1.0,4.0,2.0,3.0,1.0,3.0,2.0,3.0,2.0,1.0,14.0,14.0,14.0,7.0,14.0,14.0,7.0,13.0,6.0,4.0,15.0,12.0,7.0,14.0,11.0,13.0,10.0,13.0,11.0,14.0,12.0,14.0,12.0,8.0,13.0,9.0,15.0,10.0,14.0,15.0,12.0,6.0,12.0,12.0,13.0,20.0,12.0,8.0,12.0,11.0,13.0,15.0,10.0,20.0,15.0,15.0,9.0,13.0,16.0,16.0,7.0,28.0,0.0,0.0,0.0,0.0,168.0,65.0,3.0,4.0,1.0,1.0,2.0,3.0,1.0,2.0,2.0,1.0,2.0,14.0,14.0,15.0,8.0,14.0,14.0,9.0,8.0,7.0,8.0,13.0,10.0,7.0,14.0,12.0,12.0,12.0,13.0,13.0,13.0,12.0,15.0,13.0,6.0,11.0,7.0,14.0,14.0,16.0,14.0,10.0,6.0,20.0,13.0,15.0,5.0,13.0,9.0,12.0,12.0,14.0,9.0,6.0,18.0,14.0,14.0,14.0,14.0,13.0,13.0,6.0,23.0,0.0,0.0,1.0,0.0,187.0,77.0,3.0,1.0,3.0,1.0,2.0,2.0,3.0,1.0,3.0,1.0,3.0,6.0,8.0,12.0,12.0,13.0,10.0,12.0,9.0,5.0,6.0,11.0,12.0,6.0,12.0,8.0,11.0,10.0,12.0,8.0,9.0,10.0,5.0,9.0,7.0,14.0,7.0,13.0,9.0,15.0,13.0,14.0,10.0,8.0,12.0,14.0,20.0,12.0,13.0,12.0,8.0,10.0,9.0,11.0,13.0,13.0,12.0,11.0,13.0,11.0,11.0,13.0,21.0,0.0,0.0,9.0,6.0,178.0,72.0,1.0,1.0,1.0,1.0,2.0,3.0,2.0,3.0,3.0,4.0,3.0,5.0,8.0,15.0,13.0,15.0,6.0,11.0,10.0,5.0,3.0,10.0,13.0,3.0,14.0,10.0,12.0,11.0,12.0,10.0,12.0,9.0,12.0,16.0,5.0,14.0,7.0,7.0,11.0,13.0,14.0,13.0,9.0,12.0,13.0,12.0,20.0,13.0,11.0,10.0,10.0,8.0,7.0,8.0,8.0,11.0,11.0,9.0,7.0,13.0,10.0,5.0,29.0,3.0,0.0,3.0,0.0,188.0,89.0,13.0,13.0,15.0,9.0,14.0,12.0,15.0,17.0,14.0,15.0,8.0,6.0,3.0,3.0,2.0,7.0,10.0,3.0,2.0,1.0,3.0,8.0,1.0,1.0,9.0,12.0,14.0,16.0,13.0,14.0,9.0,13.0,18.0,6.0,13.0,2.0,15.0,12.0,8.0,12.0,14.0,16.0,14.0,6.0,16.0,11.0,20.0,14.0,16.0,16.0,12.0,13.0,3.0,1.0,10.0,15.0,17.0,13.0,16.0,12.0,8.0,10.0,30.0,0.0,0.0,0.0,0.0,180.0,76.0,1.0,2.0,2.0,2.0,3.0,2.0,2.0,1.0,2.0,3.0,3.0,5.0,12.0,10.0,8.0,12.0,9.0,14.0,11.0,10.0,14.0,12.0,7.0,15.0,11.0,11.0,14.0,13.0,15.0,14.0,12.0,13.0,14.0,6.0,16.0,7.0,15.0,16.0,15.0,12.0,12.0,14.0,11.0,8.0,14.0,10.0,20.0,15.0,13.0,15.0,8.0,14.0,11.0,17.0,18.0,14.0,19.0,13.0,16.0,15.0,15.0,5.0,25.0,13.0,0.0,0.0,0.0,188.0,87.0,4.0,1.0,3.0,2.0,1.0,3.0,1.0,1.0,3.0,2.0,1.0,5.0,13.0,9.0,8.0,12.0,12.0,15.0,10.0,8.0,12.0,9.0,6.0,11.0,12.0,11.0,12.0,14.0,11.0,12.0,11.0,10.0,15.0,7.0,7.0,10.0,12.0,13.0,14.0,15.0,12.0,16.0,14.0,20.0,14.0,14.0,6.0,14.0,16.0,13.0,11.0,13.0,7.0,10.0,11.0,14.0,12.0,13.0,12.0,14.0,14.0,7.0,32.0,23.0,0.0,0.0,0.0,178.0,77.0,3.0,2.0,3.0,1.0,3.0,1.0,3.0,2.0,1.0,3.0,1.0,9.0,12.0,12.0,6.0,13.0,12.0,10.0,10.0,10.0,13.0,12.0,7.0,14.0,13.0,15.0,14.0,13.0,13.0,10.0,10.0,12.0,5.0,12.0,11.0,12.0,13.0,14.0,14.0,14.0,13.0,12.0,9.0,20.0,14.0,14.0,10.0,13.0,12.0,13.0,6.0,14.0,6.0,10.0,13.0,5.0,11.0,8.0,10.0,14.0,9.0,15.0,33.0,13.0,0.0,4.0,0.0,186.0,77.0,1.0,3.0,1.0,2.0,3.0,3.0,1.0,3.0,3.0,2.0,3.0,8.0,13.0,11.0,5.0,12.0,9.0,13.0,12.0,13.0,12.0,11.0,8.0,14.0,13.0,7.0,13.0,13.0,12.0,12.0,11.0,12.0,15.0,12.0,9.0,11.0,13.0,12.0,13.0,12.0,11.0,15.0,13.0,8.0,11.0,13.0,20.0,12.0,13.0,13.0,7.0,14.0,11.0,13.0,13.0,14.0,13.0,14.0,15.0,14.0,14.0,8.0,31.0,0.0,0.0,6.0,0.0,174.0,61.0,1.0,4.0,1.0,2.0,1.0,3.0,3.0,1.0,3.0,3.0,3.0,8.0,9.0,10.0,6.0,12.0,9.0,13.0,11.0,7.0,12.0,12.0,8.0,15.0,12.0,14.0,14.0,15.0,12.0,14.0,8.0,12.0,16.0,7.0,13.0,7.0,13.0,16.0,17.0,13.0,12.0,13.0,7.0,20.0,15.0,13.0,9.0,17.0,10.0,15.0,16.0,14.0,8.0,7.0,12.0,14.0,14.0,12.0,16.0,14.0,14.0,7.0,25.0,0.0,0.0,15.0,1.0,176.0,64.0,2.0,2.0,3.0,3.0,1.0,1.0,3.0,3.0,2.0,1.0,3.0,9.0,9.0,11.0,7.0,13.0,11.0,14.0,9.0,6.0,12.0,14.0,6.0,13.0,13.0,13.0,14.0,15.0,14.0,14.0,13.0,13.0,15.0,8.0,11.0,9.0,12.0,15.0,18.0,14.0,14.0,12.0,10.0,5.0,15.0,11.0,20.0,16.0,10.0,15.0,13.0,15.0,5.0,10.0,11.0,14.0,14.0,14.0,17.0,13.0,13.0,5.0,20.0,0.0,0.0,0.0,0.0,173.0,67.0,2.0,2.0,4.0,3.0,3.0,2.0,3.0,3.0,2.0,1.0,1.0,11.0,12.0,12.0,9.0,12.0,8.0,5.0,10.0,7.0,4.0,8.0,10.0,4.0,14.0,12.0,7.0,11.0,8.0,6.0,10.0,10.0,3.0,11.0,5.0,10.0,11.0,8.0,13.0,15.0,14.0,14.0,6.0,5.0,14.0,15.0,20.0,12.0,8.0,10.0,5.0,10.0,10.0,10.0,17.0,12.0,12.0,10.0,7.0,10.0,19.0,8.0,27.0,0.0,0.0,6.0,0.0,183.0,73.0,2.0,1.0,1.0,1.0,1.0,1.0,2.0,1.0,2.0,3.0,3.0,10.0,11.0,14.0,9.0,14.0,10.0,7.0,11.0,5.0,4.0,12.0,12.0,5.0,14.0,8.0,12.0,12.0,10.0,12.0,9.0,10.0,11.0,13.0,6.0,13.0,7.0,11.0,13.0,17.0,13.0,12.0,10.0,5.0,15.0,15.0,20.0,15.0,12.0,12.0,8.0,14.0,6.0,9.0,13.0,14.0,16.0,8.0,14.0,15.0,15.0,8.0,24.0,0.0,0.0,4.0,0.0,181.0,73.0,3.0,2.0,2.0,2.0,2.0,2.0,3.0,2.0,1.0,2.0,2.0,13.0,12.0,13.0,8.0,14.0,13.0,8.0,13.0,7.0,4.0,13.0,12.0,3.0,14.0,8.0,12.0,9.0,13.0,11.0,13.0,12.0,13.0,14.0,6.0,14.0,6.0,10.0,11.0,15.0,14.0,12.0,11.0,12.0,12.0,14.0,20.0,13.0,11.0,13.0,8.0,10.0,9.0,8.0,7.0,14.0,13.0,12.0,12.0,13.0,13.0,9.0,28.0,0.0,0.0,2.0,2.0,182.0,79.0,1.0,1.0,2.0,2.0,3.0,1.0,2.0,3.0,1.0,2.0,2.0,8.0,11.0,14.0,12.0,14.0,11.0,12.0,13.0,6.0,4.0,11.0,13.0,5.0,14.0,11.0,12.0,13.0,10.0,12.0,11.0,11.0,15.0,13.0,7.0,14.0,7.0,12.0,14.0,15.0,14.0,14.0,12.0,8.0,15.0,14.0,20.0,15.0,14.0,12.0,11.0,15.0,8.0,8.0,16.0,15.0,12.0,11.0,14.0,13.0,12.0,8.0
1,2,36.0,0.0,0.0,0.0,0.0,185.0,78.0,11.0,14.0,12.0,7.0,13.0,12.0,14.0,15.0,13.0,14.0,10.0,4.0,1.0,3.0,1.0,8.0,8.0,11.0,8.0,3.0,3.0,7.0,2.0,1.0,8.0,11.0,13.0,15.0,11.0,12.0,7.0,13.0,9.0,5.0,14.0,3.0,13.0,15.0,8.0,11.0,14.0,13.0,12.0,5.0,15.0,11.0,20.0,12.0,14.0,13.0,11.0,13.0,8.0,1.0,19.0,14.0,16.0,10.0,17.0,9.0,9.0,11.0,28.0,0.0,0.0,0.0,0.0,183.0,81.0,1.0,2.0,4.0,1.0,1.0,3.0,2.0,3.0,3.0,3.0,1.0,5.0,5.0,6.0,10.0,12.0,6.0,14.0,8.0,6.0,15.0,11.0,6.0,13.0,12.0,13.0,14.0,16.0,14.0,14.0,10.0,12.0,14.0,5.0,14.0,8.0,14.0,15.0,15.0,9.0,12.0,15.0,13.0,7.0,11.0,12.0,20.0,15.0,15.0,14.0,14.0,14.0,9.0,8.0,14.0,14.0,11.0,13.0,15.0,13.0,15.0,6.0,34.0,23.0,1.0,0.0,0.0,186.0,81.0,3.0,3.0,1.0,2.0,1.0,3.0,2.0,3.0,1.0,3.0,3.0,4.0,8.0,6.0,10.0,7.0,8.0,17.0,12.0,10.0,14.0,7.0,9.0,15.0,7.0,15.0,13.0,17.0,8.0,12.0,7.0,12.0,15.0,6.0,17.0,7.0,14.0,15.0,14.0,8.0,10.0,16.0,13.0,12.0,13.0,9.0,20.0,13.0,15.0,11.0,15.0,14.0,9.0,10.0,10.0,14.0,11.0,13.0,15.0,11.0,11.0,12.0,27.0,10.0,0.0,0.0,0.0,181.0,69.0,1.0,1.0,3.0,3.0,3.0,3.0,2.0,3.0,3.0,3.0,1.0,5.0,13.0,10.0,7.0,13.0,9.0,10.0,10.0,12.0,12.0,11.0,7.0,12.0,11.0,11.0,13.0,12.0,11.0,13.0,9.0,9.0,12.0,8.0,7.0,12.0,11.0,11.0,13.0,15.0,13.0,13.0,10.0,20.0,12.0,15.0,8.0,15.0,12.0,13.0,11.0,14.0,13.0,12.0,10.0,14.0,12.0,10.0,11.0,15.0,15.0,7.0,24.0,0.0,0.0,0.0,0.0,179.0,68.0,3.0,2.0,3.0,2.0,1.0,3.0,3.0,1.0,3.0,3.0,1.0,4.0,13.0,9.0,6.0,12.0,9.0,12.0,7.0,8.0,12.0,14.0,8.0,14.0,12.0,15.0,14.0,13.0,14.0,13.0,10.0,12.0,14.0,10.0,9.0,9.0,10.0,13.0,14.0,14.0,12.0,13.0,9.0,9.0,8.0,14.0,20.0,15.0,14.0,11.0,11.0,13.0,10.0,14.0,13.0,14.0,14.0,11.0,16.0,15.0,15.0,6.0,36.0,0.0,0.0,0.0,0.0,180.0,72.0,1.0,2.0,4.0,1.0,1.0,2.0,2.0,1.0,1.0,1.0,2.0,6.0,10.0,8.0,6.0,11.0,8.0,13.0,10.0,7.0,11.0,11.0,8.0,13.0,11.0,13.0,13.0,14.0,14.0,13.0,11.0,12.0,13.0,7.0,10.0,10.0,13.0,13.0,15.0,11.0,12.0,14.0,10.0,10.0,14.0,10.0,20.0,12.0,11.0,12.0,14.0,14.0,5.0,15.0,20.0,12.0,20.0,14.0,16.0,15.0,15.0,5.0,30.0,0.0,0.0,0.0,0.0,167.0,60.0,3.0,1.0,1.0,2.0,3.0,1.0,1.0,3.0,1.0,1.0,3.0,10.0,11.0,12.0,8.0,13.0,10.0,6.0,9.0,10.0,12.0,14.0,9.0,10.0,14.0,11.0,14.0,14.0,14.0,14.0,13.0,14.0,12.0,14.0,11.0,13.0,12.0,15.0,15.0,15.0,14.0,11.0,5.0,11.0,11.0,15.0,20.0,11.0,8.0,14.0,10.0,12.0,13.0,11.0,11.0,12.0,11.0,10.0,12.0,11.0,11.0,2.0,33.0,0.0,0.0,0.0,0.0,187.0,76.0,2.0,2.0,3.0,1.0,1.0,3.0,2.0,1.0,2.0,3.0,2.0,15.0,14.0,14.0,10.0,15.0,13.0,10.0,12.0,7.0,4.0,15.0,13.0,7.0,15.0,6.0,12.0,9.0,14.0,11.0,15.0,12.0,12.0,14.0,12.0,13.0,7.0,13.0,12.0,11.0,12.0,14.0,12.0,14.0,15.0,12.0,20.0,11.0,12.0,12.0,6.0,14.0,6.0,11.0,14.0,13.0,12.0,12.0,15.0,15.0,13.0,9.0,26.0,1.0,0.0,0.0,0.0,180.0,73.0,2.0,3.0,2.0,1.0,3.0,1.0,1.0,1.0,2.0,3.0,3.0,6.0,12.0,13.0,12.0,13.0,12.0,7.0,11.0,6.0,4.0,11.0,12.0,5.0,14.0,7.0,12.0,9.0,12.0,12.0,8.0,10.0,16.0,13.0,5.0,13.0,7.0,9.0,14.0,16.0,14.0,13.0,10.0,20.0,13.0,15.0,6.0,13.0,13.0,10.0,7.0,13.0,7.0,8.0,12.0,14.0,15.0,13.0,12.0,14.0,14.0,9.0,24.0,0.0,0.0,0.0,0.0,182.0,82.0,3.0,3.0,2.0,1.0,1.0,3.0,2.0,2.0,3.0,2.0,2.0,4.0,7.0,13.0,14.0,13.0,12.0,14.0,12.0,5.0,7.0,10.0,14.0,6.0,15.0,13.0,13.0,16.0,8.0,12.0,11.0,11.0,12.0,14.0,7.0,13.0,8.0,12.0,13.0,14.0,14.0,15.0,12.0,10.0,10.0,12.0,20.0,16.0,15.0,12.0,13.0,14.0,10.0,8.0,8.0,13.0,5.0,10.0,11.0,9.0,9.0,13.0,26.0,0.0,0.0,0.0,0.0,193.0,81.0,1.0,3.0,3.0,3.0,3.0,1.0,2.0,2.0,2.0,3.0,3.0,4.0,9.0,14.0,10.0,13.0,12.0,14.0,14.0,5.0,5.0,10.0,12.0,3.0,14.0,8.0,13.0,12.0,9.0,10.0,11.0,11.0,12.0,16.0,5.0,14.0,6.0,9.0,12.0,14.0,13.0,14.0,16.0,14.0,13.0,13.0,20.0,13.0,14.0,10.0,8.0,14.0,9.0,8.0,16.0,16.0,11.0,13.0,11.0,13.0,13.0,10.0,33.0,101.0,0.0,0.0,0.0,182.0,87.0,12.0,11.0,15.0,12.0,14.0,13.0,14.0,15.0,15.0,13.0,12.0,9.0,2.0,3.0,8.0,9.0,11.0,10.0,11.0,1.0,3.0,12.0,15.0,8.0,10.0,8.0,14.0,14.0,14.0,12.0,9.0,12.0,16.0,9.0,15.0,2.0,13.0,12.0,6.0,12.0,13.0,14.0,13.0,8.0,13.0,10.0,20.0,12.0,15.0,13.0,8.0,15.0,5.0,1.0,13.0,15.0,13.0,15.0,18.0,18.0,15.0,5.0,32.0,0.0,0.0,0.0,0.0,195.0,89.0,3.0,2.0,3.0,1.0,4.0,2.0,4.0,2.0,3.0,1.0,2.0,3.0,5.0,5.0,11.0,8.0,8.0,14.0,9.0,11.0,15.0,12.0,9.0,13.0,8.0,16.0,13.0,19.0,10.0,14.0,8.0,13.0,16.0,5.0,15.0,10.0,15.0,15.0,14.0,8.0,8.0,16.0,17.0,5.0,11.0,10.0,20.0,13.0,17.0,13.0,12.0,15.0,7.0,5.0,12.0,14.0,14.0,12.0,15.0,8.0,8.0,7.0,24.0,0.0,0.0,0.0,0.0,187.0,93.0,4.0,3.0,2.0,1.0,2.0,2.0,2.0,2.0,1.0,2.0,1.0,4.0,5.0,6.0,6.0,12.0,6.0,15.0,8.0,6.0,15.0,10.0,6.0,13.0,9.0,14.0,13.0,16.0,12.0,14.0,7.0,12.0,15.0,5.0,8.0,6.0,12.0,14.0,15.0,9.0,10.0,18.0,13.0,6.0,14.0,12.0,20.0,15.0,17.0,13.0,14.0,14.0,11.0,10.0,19.0,14.0,15.0,11.0,13.0,14.0,14.0,5.0,25.0,0.0,0.0,26.0,3.0,176.0,64.0,3.0,2.0,2.0,1.0,3.0,3.0,3.0,2.0,1.0,1.0,1.0,12.0,13.0,12.0,7.0,13.0,13.0,11.0,11.0,11.0,14.0,13.0,11.0,14.0,13.0,13.0,13.0,14.0,13.0,13.0,11.0,13.0,17.0,12.0,11.0,10.0,12.0,14.0,14.0,14.0,14.0,12.0,8.0,8.0,17.0,14.0,20.0,15.0,12.0,14.0,12.0,13.0,5.0,12.0,17.0,15.0,15.0,14.0,16.0,15.0,15.0,7.0,23.0,0.0,0.0,1.0,0.0,182.0,71.0,3.0,1.0,2.0,3.0,4.0,2.0,3.0,1.0,2.0,1.0,3.0,9.0,13.0,14.0,8.0,14.0,13.0,12.0,10.0,13.0,14.0,14.0,13.0,15.0,13.0,14.0,14.0,13.0,11.0,12.0,12.0,13.0,16.0,12.0,12.0,15.0,13.0,14.0,15.0,15.0,13.0,14.0,12.0,9.0,16.0,15.0,20.0,15.0,15.0,15.0,10.0,14.0,6.0,12.0,8.0,15.0,14.0,16.0,15.0,15.0,16.0,6.0,32.0,13.0,0.0,19.0,1.0,172.0,72.0,3.0,1.0,3.0,2.0,1.0,2.0,2.0,2.0,3.0,1.0,1.0,7.0,12.0,12.0,5.0,13.0,7.0,6.0,9.0,9.0,12.0,14.0,9.0,14.0,12.0,13.0,14.0,14.0,15.0,15.0,10.0,13.0,17.0,7.0,18.0,8.0,15.0,18.0,15.0,12.0,14.0,12.0,6.0,10.0,16.0,13.0,20.0,15.0,12.0,15.0,9.0,15.0,5.0,10.0,12.0,16.0,14.0,13.0,15.0,18.0,18.0,5.0,36.0,0.0,0.0,3.0,0.0,168.0,72.0,3.0,2.0,1.0,3.0,1.0,3.0,3.0,1.0,3.0,3.0,1.0,11.0,8.0,12.0,5.0,13.0,11.0,8.0,13.0,6.0,12.0,13.0,8.0,14.0,13.0,17.0,14.0,17.0,14.0,15.0,13.0,14.0,17.0,12.0,16.0,10.0,15.0,16.0,14.0,10.0,13.0,14.0,4.0,8.0,16.0,8.0,20.0,12.0,13.0,17.0,14.0,14.0,7.0,10.0,19.0,15.0,14.0,16.0,15.0,9.0,9.0,7.0,28.0,15.0,2.0,8.0,1.0,171.0,68.0,3.0,1.0,4.0,2.0,3.0,1.0,3.0,2.0,3.0,2.0,1.0,14.0,14.0,14.0,7.0,14.0,14.0,7.0,13.0,6.0,4.0,15.0,12.0,7.0,14.0,11.0,13.0,10.0,13.0,11.0,14.0,12.0,14.0,12.0,8.0,13.0,9.0,15.0,10.0,14.0,15.0,12.0,6.0,12.0,12.0,13.0,20.0,12.0,8.0,12.0,11.0,13.0,15.0,10.0,20.0,15.0,15.0,9.0,13.0,16.0,16.0,7.0,28.0,0.0,0.0,0.0,0.0,168.0,65.0,3.0,4.0,1.0,1.0,2.0,3.0,1.0,2.0,2.0,1.0,2.0,14.0,14.0,15.0,8.0,14.0,14.0,9.0,8.0,7.0,8.0,13.0,10.0,7.0,14.0,12.0,12.0,12.0,13.0,13.0,13.0,12.0,15.0,13.0,6.0,11.0,7.0,14.0,14.0,16.0,14.0,10.0,6.0,20.0,13.0,15.0,5.0,13.0,9.0,12.0,12.0,14.0,9.0,6.0,18.0,14.0,14.0,14.0,14.0,13.0,13.0,6.0,22.0,2.0,0.0,0.0,0.0,169.0,59.0,3.0,1.0,3.0,1.0,1.0,1.0,1.0,1.0,3.0,3.0,2.0,13.0,13.0,15.0,13.0,15.0,13.0,7.0,13.0,8.0,6.0,13.0,13.0,5.0,16.0,10.0,10.0,8.0,13.0,11.0,14.0,12.0,12.0,14.0,10.0,12.0,6.0,10.0,8.0,16.0,15.0,17.0,6.0,12.0,12.0,15.0,20.0,13.0,9.0,12.0,8.0,12.0,8.0,12.0,13.0,13.0,13.0,14.0,12.0,10.0,13.0,9.0,21.0,0.0,0.0,9.0,6.0,178.0,72.0,1.0,1.0,1.0,1.0,2.0,3.0,2.0,3.0,3.0,4.0,3.0,5.0,8.0,15.0,13.0,15.0,6.0,11.0,10.0,5.0,3.0,10.0,13.0,3.0,14.0,10.0,12.0,11.0,12.0,10.0,12.0,9.0,12.0,16.0,5.0,14.0,7.0,7.0,11.0,13.0,14.0,13.0,9.0,12.0,13.0,12.0,20.0,13.0,11.0,10.0,10.0,8.0,7.0,8.0,8.0,11.0,11.0,9.0,7.0,13.0,10.0,5.0
2,3,17.0,0.0,0.0,0.0,0.0,193.0,82.0,13.0,11.0,12.0,2.0,12.0,10.0,14.0,15.0,14.0,12.0,10.0,3.0,1.0,1.0,3.0,5.0,6.0,2.0,2.0,1.0,3.0,9.0,3.0,1.0,8.0,7.0,12.0,13.0,13.0,13.0,11.0,11.0,15.0,3.0,8.0,3.0,12.0,12.0,11.0,10.0,12.0,14.0,17.0,5.0,15.0,11.0,20.0,13.0,12.0,13.0,8.0,11.0,5.0,11.0,13.0,15.0,15.0,17.0,14.0,15.0,15.0,5.0,19.0,0.0,0.0,0.0,0.0,194.0,92.0,2.0,1.0,3.0,3.0,3.0,3.0,1.0,3.0,3.0,2.0,1.0,3.0,3.0,5.0,6.0,10.0,5.0,16.0,10.0,8.0,12.0,9.0,4.0,15.0,11.0,14.0,11.0,12.0,10.0,11.0,10.0,12.0,15.0,3.0,13.0,13.0,12.0,14.0,14.0,11.0,8.0,15.0,17.0,5.0,16.0,12.0,20.0,12.0,16.0,12.0,13.0,12.0,5.0,7.0,10.0,14.0,13.0,8.0,10.0,11.0,18.0,6.0,26.0,5.0,0.0,0.0,0.0,184.0,86.0,3.0,3.0,2.0,1.0,2.0,2.0,4.0,1.0,3.0,1.0,3.0,4.0,10.0,9.0,6.0,10.0,7.0,14.0,8.0,8.0,14.0,9.0,6.0,14.0,9.0,14.0,14.0,16.0,9.0,15.0,7.0,11.0,13.0,8.0,10.0,9.0,13.0,12.0,12.0,12.0,12.0,17.0,12.0,5.0,15.0,15.0,20.0,14.0,17.0,11.0,14.0,13.0,7.0,10.0,13.0,16.0,14.0,11.0,11.0,12.0,9.0,14.0,26.0,0.0,0.0,0.0,0.0,187.0,78.0,2.0,1.0,2.0,3.0,2.0,1.0,1.0,1.0,3.0,3.0,1.0,10.0,12.0,14.0,9.0,11.0,11.0,13.0,8.0,14.0,13.0,11.0,9.0,12.0,14.0,13.0,13.0,13.0,13.0,12.0,12.0,11.0,15.0,12.0,8.0,13.0,13.0,13.0,14.0,15.0,12.0,8.0,14.0,20.0,12.0,14.0,6.0,14.0,12.0,12.0,13.0,11.0,12.0,15.0,8.0,15.0,9.0,15.0,14.0,12.0,15.0,10.0,21.0,0.0,0.0,0.0,0.0,188.0,80.0,1.0,2.0,2.0,3.0,2.0,2.0,2.0,2.0,1.0,1.0,1.0,6.0,9.0,12.0,6.0,12.0,12.0,12.0,11.0,3.0,12.0,13.0,8.0,13.0,13.0,13.0,13.0,13.0,13.0,13.0,13.0,13.0,13.0,8.0,11.0,11.0,13.0,15.0,13.0,12.0,12.0,13.0,14.0,20.0,14.0,11.0,5.0,13.0,14.0,12.0,11.0,3.0,6.0,8.0,17.0,12.0,13.0,13.0,14.0,14.0,14.0,6.0,20.0,0.0,0.0,0.0,0.0,170.0,77.0,3.0,2.0,2.0,3.0,1.0,2.0,2.0,3.0,1.0,3.0,2.0,11.0,13.0,12.0,7.0,12.0,11.0,7.0,12.0,6.0,9.0,11.0,10.0,11.0,13.0,14.0,12.0,13.0,8.0,9.0,11.0,12.0,11.0,14.0,3.0,12.0,7.0,9.0,13.0,13.0,13.0,14.0,7.0,10.0,10.0,13.0,20.0,11.0,14.0,10.0,15.0,11.0,11.0,10.0,10.0,10.0,10.0,10.0,11.0,6.0,19.0,6.0,23.0,11.0,0.0,0.0,0.0,180.0,71.0,2.0,1.0,2.0,3.0,3.0,1.0,1.0,2.0,2.0,1.0,1.0,6.0,11.0,10.0,8.0,10.0,7.0,11.0,9.0,12.0,13.0,11.0,6.0,13.0,11.0,12.0,11.0,13.0,12.0,9.0,11.0,11.0,14.0,12.0,11.0,12.0,11.0,13.0,15.0,15.0,13.0,13.0,11.0,7.0,14.0,15.0,20.0,12.0,11.0,12.0,12.0,13.0,10.0,15.0,10.0,13.0,16.0,12.0,15.0,14.0,14.0,7.0,28.0,0.0,0.0,0.0,0.0,180.0,79.0,3.0,2.0,3.0,3.0,2.0,2.0,2.0,1.0,3.0,2.0,3.0,8.0,11.0,15.0,12.0,15.0,12.0,7.0,10.0,7.0,8.0,13.0,13.0,6.0,16.0,11.0,11.0,10.0,13.0,10.0,15.0,12.0,3.0,15.0,6.0,13.0,13.0,12.0,12.0,15.0,16.0,14.0,8.0,12.0,12.0,14.0,20.0,12.0,12.0,13.0,6.0,13.0,6.0,6.0,8.0,9.0,13.0,10.0,12.0,12.0,2.0,2.0,24.0,0.0,0.0,15.0,3.0,190.0,87.0,1.0,3.0,2.0,2.0,3.0,3.0,2.0,2.0,1.0,1.0,2.0,8.0,9.0,13.0,12.0,12.0,8.0,12.0,14.0,8.0,7.0,11.0,12.0,10.0,11.0,8.0,12.0,11.0,12.0,11.0,11.0,11.0,12.0,12.0,7.0,12.0,9.0,8.0,10.0,12.0,13.0,12.0,13.0,12.0,14.0,12.0,20.0,12.0,12.0,12.0,6.0,12.0,9.0,8.0,10.0,17.0,7.0,8.0,6.0,7.0,10.0,14.0,25.0,0.0,0.0,3.0,0.0,170.0,68.0,2.0,1.0,3.0,1.0,3.0,1.0,3.0,2.0,2.0,4.0,1.0,12.0,11.0,15.0,16.0,16.0,13.0,11.0,12.0,4.0,5.0,12.0,14.0,4.0,17.0,7.0,14.0,7.0,15.0,13.0,13.0,14.0,14.0,15.0,7.0,16.0,8.0,10.0,13.0,15.0,15.0,12.0,6.0,11.0,14.0,14.0,20.0,13.0,11.0,12.0,7.0,15.0,7.0,8.0,12.0,14.0,13.0,14.0,13.0,16.0,16.0,8.0,32.0,0.0,0.0,0.0,0.0,183.0,67.0,1.0,2.0,3.0,2.0,3.0,2.0,3.0,1.0,2.0,2.0,2.0,4.0,12.0,11.0,6.0,5.0,5.0,4.0,8.0,11.0,13.0,11.0,5.0,13.0,11.0,11.0,11.0,12.0,11.0,11.0,9.0,12.0,11.0,12.0,10.0,12.0,11.0,12.0,12.0,14.0,13.0,13.0,8.0,8.0,13.0,13.0,20.0,14.0,14.0,10.0,12.0,11.0,8.0,11.0,11.0,10.0,10.0,12.0,11.0,9.0,10.0,12.0,25.0,0.0,0.0,0.0,0.0,187.0,83.0,11.0,14.0,12.0,8.0,13.0,11.0,14.0,15.0,13.0,13.0,9.0,8.0,1.0,1.0,1.0,11.0,11.0,1.0,2.0,2.0,1.0,10.0,3.0,2.0,11.0,8.0,12.0,14.0,12.0,12.0,10.0,12.0,14.0,6.0,14.0,2.0,12.0,12.0,8.0,13.0,15.0,14.0,13.0,20.0,15.0,11.0,5.0,14.0,13.0,13.0,8.0,8.0,10.0,1.0,9.0,13.0,14.0,12.0,15.0,15.0,15.0,5.0,27.0,1.0,0.0,3.0,0.0,186.0,83.0,2.0,2.0,2.0,2.0,1.0,4.0,2.0,3.0,3.0,3.0,2.0,5.0,9.0,9.0,8.0,10.0,6.0,16.0,8.0,7.0,14.0,11.0,6.0,15.0,12.0,14.0,15.0,16.0,13.0,12.0,8.0,13.0,14.0,8.0,11.0,8.0,14.0,15.0,15.0,15.0,9.0,15.0,12.0,8.0,13.0,14.0,20.0,14.0,17.0,15.0,13.0,13.0,10.0,8.0,9.0,14.0,9.0,13.0,15.0,15.0,15.0,6.0,26.0,11.0,0.0,4.0,0.0,183.0,79.0,3.0,2.0,1.0,2.0,2.0,2.0,3.0,2.0,2.0,2.0,1.0,5.0,7.0,9.0,6.0,10.0,11.0,15.0,11.0,7.0,14.0,10.0,7.0,13.0,10.0,14.0,13.0,15.0,13.0,12.0,10.0,12.0,17.0,8.0,11.0,10.0,13.0,15.0,16.0,13.0,13.0,16.0,13.0,5.0,15.0,13.0,20.0,16.0,15.0,13.0,14.0,15.0,7.0,14.0,16.0,12.0,14.0,14.0,15.0,14.0,14.0,5.0,26.0,14.0,0.0,0.0,0.0,181.0,74.0,2.0,1.0,1.0,1.0,3.0,2.0,3.0,1.0,3.0,3.0,2.0,6.0,13.0,8.0,5.0,12.0,7.0,12.0,8.0,11.0,13.0,12.0,6.0,14.0,10.0,14.0,12.0,14.0,10.0,12.0,8.0,8.0,14.0,6.0,6.0,12.0,11.0,14.0,15.0,16.0,14.0,14.0,11.0,5.0,14.0,14.0,20.0,16.0,14.0,12.0,13.0,14.0,8.0,10.0,8.0,14.0,12.0,13.0,15.0,15.0,15.0,6.0,26.0,0.0,0.0,0.0,0.0,177.0,68.0,4.0,2.0,1.0,2.0,3.0,1.0,1.0,2.0,3.0,3.0,3.0,12.0,13.0,11.0,8.0,13.0,11.0,8.0,10.0,8.0,10.0,13.0,10.0,12.0,13.0,7.0,12.0,10.0,13.0,11.0,15.0,13.0,14.0,11.0,7.0,14.0,10.0,14.0,14.0,13.0,15.0,12.0,9.0,20.0,15.0,14.0,5.0,15.0,8.0,13.0,7.0,14.0,6.0,12.0,11.0,12.0,14.0,13.0,16.0,16.0,16.0,5.0,29.0,0.0,0.0,0.0,0.0,188.0,74.0,1.0,2.0,3.0,3.0,2.0,3.0,1.0,3.0,2.0,1.0,1.0,4.0,8.0,10.0,6.0,13.0,7.0,14.0,9.0,6.0,13.0,12.0,8.0,13.0,13.0,12.0,14.0,13.0,14.0,11.0,13.0,12.0,14.0,6.0,13.0,8.0,14.0,15.0,15.0,9.0,12.0,14.0,14.0,10.0,13.0,10.0,20.0,16.0,12.0,13.0,12.0,15.0,9.0,11.0,11.0,14.0,14.0,12.0,15.0,13.0,13.0,6.0,30.0,7.0,0.0,0.0,0.0,181.0,72.0,1.0,3.0,3.0,1.0,2.0,3.0,2.0,1.0,3.0,2.0,2.0,12.0,11.0,14.0,8.0,14.0,12.0,8.0,12.0,6.0,5.0,13.0,13.0,5.0,14.0,8.0,12.0,10.0,11.0,12.0,15.0,11.0,13.0,14.0,9.0,13.0,10.0,12.0,13.0,12.0,14.0,12.0,10.0,12.0,15.0,13.0,20.0,15.0,9.0,10.0,8.0,13.0,5.0,8.0,12.0,14.0,14.0,12.0,11.0,14.0,14.0,8.0,22.0,18.0,0.0,0.0,0.0,179.0,75.0,1.0,4.0,2.0,1.0,1.0,1.0,3.0,1.0,1.0,3.0,2.0,7.0,8.0,12.0,8.0,13.0,10.0,11.0,12.0,11.0,11.0,11.0,10.0,14.0,13.0,15.0,12.0,15.0,8.0,12.0,10.0,12.0,14.0,12.0,10.0,13.0,12.0,13.0,17.0,14.0,14.0,13.0,10.0,9.0,15.0,15.0,20.0,15.0,14.0,13.0,13.0,12.0,11.0,12.0,13.0,15.0,9.0,10.0,12.0,10.0,10.0,4.0,27.0,0.0,0.0,0.0,0.0,173.0,68.0,2.0,2.0,1.0,1.0,3.0,3.0,1.0,2.0,3.0,4.0,2.0,12.0,12.0,13.0,8.0,13.0,10.0,7.0,8.0,9.0,7.0,12.0,10.0,9.0,14.0,7.0,10.0,8.0,11.0,12.0,12.0,11.0,12.0,13.0,5.0,13.0,10.0,10.0,12.0,14.0,14.0,11.0,7.0,20.0,12.0,15.0,10.0,13.0,8.0,12.0,7.0,13.0,9.0,12.0,18.0,12.0,14.0,11.0,14.0,15.0,15.0,6.0,28.0,0.0,0.0,0.0,0.0,170.0,67.0,2.0,3.0,3.0,4.0,3.0,2.0,1.0,1.0,2.0,2.0,3.0,8.0,12.0,12.0,10.0,14.0,7.0,5.0,10.0,6.0,5.0,12.0,5.0,4.0,13.0,7.0,16.0,12.0,9.0,11.0,12.0,10.0,3.0,12.0,6.0,13.0,6.0,8.0,13.0,16.0,13.0,10.0,5.0,5.0,13.0,16.0,20.0,15.0,7.0,12.0,4.0,9.0,7.0,10.0,20.0,13.0,12.0,10.0,13.0,11.0,10.0,2.0,24.0,0.0,0.0,5.0,0.0,183.0,79.0,4.0,4.0,3.0,3.0,1.0,3.0,2.0,1.0,3.0,2.0,3.0,4.0,7.0,12.0,13.0,12.0,8.0,13.0,12.0,5.0,6.0,11.0,12.0,4.0,13.0,11.0,12.0,14.0,9.0,12.0,10.0,10.0,13.0,12.0,6.0,14.0,12.0,13.0,14.0,15.0,14.0,14.0,11.0,10.0,13.0,14.0,20.0,14.0,14.0,12.0,12.0,14.0,9.0,5.0,7.0,13.0,15.0,11.0,14.0,14.0,14.0,6.0
1,0,34.0,1.0,0.0,0.0,0.0,187.0,87.0,13.0,14.0,15.0,7.0,13.0,11.0,14.0,15.0,11.0,17.0,12.0,2.0,1.0,1.0,3.0,8.0,7.0,2.0,1.0,2.0,1.0,9.0,8.0,2.0,6.0,12.0,15.0,17.0,14.0,15.0,8.0,13.0,17.0,7.0,14.0,6.0,14.0,12.0,6.0,7.0,13.0,14.0,13.0,8.0,13.0,8.0,20.0,11.0,16.0,14.0,10.0,14.0,6.0,1.0,12.0,12.0,15.0,16.0,16.0,14.0,15.0,6.0,34.0,0.0,0.0,0.0,0.0,191.0,81.0,14.0,10.0,8.0,3.0,9.0,14.0,13.0,10.0,9.0,3.0,12.0,4.0,3.0,3.0,1.0,1.0,6.0,1.0,1.0,2.0,1.0,2.0,3.0,3.0,3.0,8.0,6.0,10.0,8.0,9.0,5.0,10.0,2.0,1.0,10.0,2.0,10.0,8.0,7.0,10.0,8.0,8.0,16.0,9.0,14.0,9.0,20.0,3.0,9.0,9.0,9.0,1.0,9.0,9.0,20.0,9.0,13.0,12.0,10.0,10.0,12.0,7.0,25.0,0.0,0.0,0.0,0.0,191.0,81.0,1.0,1.0,3.0,2.0,3.0,2.0,3.0,4.0,2.0,1.0,2.0,4.0,3.0,10.0,8.0,6.0,6.0,11.0,6.0,10.0,11.0,10.0,5.0,12.0,7.0,16.0,13.0,16.0,11.0,13.0,7.0,10.0,14.0,5.0,12.0,10.0,13.0,13.0,12.0,13.0,13.0,16.0,16.0,7.0,16.0,14.0,20.0,14.0,14.0,13.0,13.0,15.0,6.0,12.0,13.0,6.0,14.0,8.0,8.0,13.0,7.0,4.0,26.0,0.0,0.0,0.0,0.0,176.0,70.0,2.0,1.0,4.0,3.0,3.0,3.0,1.0,3.0,3.0,2.0,1.0,10.0,11.0,11.0,6.0,13.0,9.0,5.0,12.0,11.0,13.0,13.0,7.0,14.0,13.0,15.0,11.0,14.0,12.0,11.0,9.0,12.0,13.0,9.0,9.0,13.0,12.0,15.0,14.0,12.0,16.0,12.0,7.0,20.0,13.0,13.0,10.0,15.0,11.0,13.0,14.0,13.0,11.0,9.0,8.0,9.0,17.0,12.0,14.0,14.0,15.0,3.0,21.0,0.0,0.0,1.0,0.0,177.0,68.0,4.0,1.0,2.0,1.0,1.0,1.0,1.0,1.0,2.0,1.0,2.0,5.0,12.0,9.0,7.0,12.0,8.0,13.0,10.0,16.0,13.0,12.0,8.0,14.0,12.0,12.0,13.0,12.0,12.0,12.0,10.0,13.0,15.0,11.0,13.0,11.0,13.0,13.0,14.0,13.0,14.0,13.0,11.0,10.0,14.0,12.0,20.0,12.0,14.0,12.0,11.0,12.0,8.0,14.0,13.0,10.0,14.0,12.0,14.0,12.0,11.0,5.0,34.0,103.0,7.0,16.0,1.0,182.0,72.0,2.0,1.0,1.0,1.0,3.0,1.0,4.0,3.0,3.0,2.0,1.0,11.0,13.0,12.0,8.0,15.0,13.0,9.0,13.0,6.0,8.0,15.0,12.0,8.0,15.0,11.0,14.0,13.0,15.0,15.0,14.0,16.0,17.0,15.0,14.0,11.0,13.0,17.0,13.0,8.0,11.0,10.0,11.0,16.0,13.0,8.0,20.0,12.0,10.0,15.0,11.0,12.0,12.0,15.0,14.0,12.0,15.0,15.0,18.0,14.0,14.0,7.0,25.0,19.0,6.0,0.0,0.0,182.0,78.0,1.0,4.0,3.0,1.0,2.0,1.0,2.0,2.0,4.0,1.0,4.0,16.0,13.0,12.0,11.0,12.0,13.0,8.0,12.0,5.0,5.0,13.0,13.0,5.0,15.0,11.0,12.0,12.0,13.0,12.0,15.0,12.0,15.0,14.0,6.0,15.0,9.0,11.0,14.0,15.0,14.0,14.0,10.0,11.0,11.0,14.0,20.0,12.0,13.0,10.0,11.0,15.0,5.0,12.0,10.0,15.0,16.0,11.0,13.0,16.0,16.0,7.0,19.0,0.0,0.0,0.0,0.0,172.0,64.0,1.0,3.0,2.0,2.0,4.0,2.0,1.0,2.0,3.0,3.0,1.0,13.0,13.0,15.0,12.0,15.0,12.0,6.0,12.0,3.0,2.0,13.0,11.0,3.0,16.0,8.0,10.0,9.0,12.0,9.0,13.0,10.0,12.0,15.0,8.0,13.0,4.0,5.0,7.0,17.0,16.0,14.0,5.0,20.0,11.0,15.0,12.0,10.0,8.0,8.0,10.0,14.0,8.0,10.0,17.0,14.0,9.0,10.0,9.0,4.0,10.0,10.0,31.0,0.0,0.0,0.0,0.0,182.0,76.0,3.0,2.0,3.0,4.0,2.0,1.0,2.0,3.0,1.0,2.0,2.0,10.0,13.0,15.0,6.0,14.0,9.0,11.0,8.0,7.0,4.0,12.0,10.0,3.0,14.0,7.0,13.0,10.0,12.0,12.0,12.0,10.0,11.0,12.0,6.0,15.0,6.0,13.0,13.0,14.0,14.0,12.0,10.0,20.0,13.0,13.0,8.0,12.0,11.0,8.0,7.0,14.0,13.0,8.0,8.0,13.0,14.0,12.0,12.0,14.0,14.0,6.0,25.0,9.0,0.0,0.0,0.0,173.0,70.0,1.0,2.0,1.0,2.0,3.0,2.0,1.0,2.0,1.0,4.0,3.0,6.0,8.0,13.0,10.0,14.0,13.0,13.0,13.0,5.0,10.0,13.0,11.0,9.0,15.0,7.0,13.0,13.0,12.0,12.0,12.0,13.0,13.0,15.0,12.0,13.0,7.0,14.0,15.0,13.0,13.0,12.0,10.0,12.0,11.0,13.0,20.0,14.0,13.0,13.0,7.0,13.0,13.0,13.0,8.0,15.0,13.0,12.0,13.0,15.0,15.0,6.0,28.0,37.0,15.0,1.0,0.0,194.0,88.0,2.0,1.0,2.0,1.0,1.0,2.0,3.0,1.0,3.0,2.0,2.0,4.0,6.0,12.0,15.0,12.0,7.0,16.0,11.0,3.0,6.0,10.0,14.0,4.0,11.0,10.0,14.0,15.0,13.0,10.0,8.0,9.0,13.0,12.0,6.0,14.0,8.0,11.0,16.0,13.0,12.0,18.0,17.0,9.0,12.0,12.0,20.0,14.0,18.0,13.0,10.0,15.0,15.0,6.0,20.0,17.0,12.0,15.0,14.0,11.0,14.0,7.0,27.0,1.0,0.0,15.0,0.0,195.0,88.0,15.0,16.0,12.0,8.0,14.0,10.0,16.0,14.0,14.0,10.0,11.0,6.0,2.0,3.0,3.0,10.0,8.0,7.0,1.0,2.0,3.0,10.0,2.0,2.0,9.0,10.0,12.0,14.0,10.0,14.0,7.0,10.0,13.0,1.0,12.0,1.0,12.0,15.0,10.0,9.0,13.0,15.0,17.0,8.0,13.0,10.0,20.0,10.0,17.0,16.0,5.0,14.0,6.0,3.0,12.0,15.0,13.0,11.0,16.0,14.0,17.0,5.0,32.0,0.0,0.0,0.0,0.0,183.0,79.0,1.0,1.0,1.0,3.0,1.0,3.0,1.0,1.0,2.0,1.0,1.0,5.0,10.0,6.0,6.0,9.0,6.0,15.0,7.0,11.0,14.0,10.0,7.0,13.0,10.0,13.0,15.0,15.0,15.0,14.0,9.0,13.0,16.0,6.0,14.0,8.0,12.0,13.0,16.0,11.0,12.0,16.0,11.0,8.0,16.0,12.0,20.0,15.0,14.0,14.0,11.0,12.0,5.0,15.0,18.0,15.0,14.0,13.0,17.0,14.0,14.0,5.0,29.0,17.0,1.0,4.0,0.0,183.0,72.0,2.0,2.0,1.0,2.0,4.0,3.0,3.0,2.0,1.0,1.0,2.0,4.0,9.0,6.0,6.0,8.0,5.0,15.0,7.0,10.0,15.0,8.0,6.0,14.0,8.0,13.0,13.0,16.0,11.0,13.0,9.0,11.0,13.0,9.0,8.0,8.0,12.0,15.0,14.0,11.0,12.0,14.0,12.0,10.0,13.0,14.0,20.0,15.0,14.0,14.0,13.0,13.0,8.0,12.0,14.0,12.0,13.0,13.0,14.0,11.0,11.0,7.0,29.0,0.0,0.0,0.0,0.0,183.0,74.0,3.0,3.0,3.0,3.0,3.0,2.0,2.0,2.0,1.0,3.0,1.0,5.0,12.0,7.0,6.0,10.0,7.0,14.0,12.0,5.0,14.0,12.0,6.0,13.0,11.0,14.0,13.0,17.0,13.0,16.0,12.0,12.0,13.0,9.0,8.0,9.0,14.0,14.0,15.0,13.0,12.0,15.0,12.0,6.0,17.0,11.0,20.0,17.0,13.0,14.0,14.0,15.0,5.0,13.0,9.0,14.0,19.0,15.0,14.0,11.0,11.0,6.0,23.0,0.0,0.0,0.0,0.0,178.0,72.0,1.0,1.0,1.0,3.0,2.0,3.0,3.0,2.0,2.0,1.0,1.0,9.0,7.0,4.0,5.0,8.0,9.0,10.0,8.0,7.0,12.0,10.0,2.0,11.0,11.0,10.0,12.0,10.0,11.0,11.0,11.0,15.0,5.0,10.0,12.0,9.0,10.0,11.0,13.0,12.0,15.0,13.0,9.0,6.0,14.0,15.0,20.0,13.0,13.0,12.0,5.0,3.0,9.0,10.0,11.0,10.0,12.0,11.0,12.0,11.0,17.0,7.0,34.0,0.0,0.0,0.0,0.0,176.0,71.0,2.0,1.0,3.0,1.0,2.0,2.0,3.0,2.0,1.0,3.0,1.0,10.0,11.0,8.0,8.0,12.0,13.0,7.0,11.0,6.0,8.0,13.0,11.0,12.0,12.0,11.0,13.0,13.0,12.0,11.0,12.0,11.0,15.0,6.0,14.0,9.0,13.0,16.0,15.0,11.0,11.0,13.0,8.0,10.0,14.0,12.0,20.0,15.0,12.0,12.0,11.0,13.0,9.0,8.0,19.0,13.0,14.0,14.0,14.0,13.0,13.0,7.0,26.0,0.0,0.0,0.0,0.0,184.0,76.0,3.0,1.0,3.0,1.0,3.0,2.0,3.0,2.0,1.0,1.0,3.0,10.0,11.0,13.0,9.0,13.0,12.0,13.0,10.0,6.0,11.0,13.0,9.0,14.0,12.0,12.0,13.0,12.0,12.0,11.0,13.0,12.0,13.0,13.0,10.0,12.0,13.0,12.0,16.0,15.0,13.0,15.0,13.0,20.0,15.0,14.0,5.0,16.0,15.0,13.0,12.0,14.0,5.0,12.0,18.0,14.0,10.0,7.0,11.0,11.0,13.0,10.0,35.0,0.0,0.0,0.0,0.0,172.0,65.0,1.0,2.0,2.0,3.0,2.0,3.0,2.0,1.0,3.0,4.0,3.0,14.0,13.0,12.0,10.0,14.0,15.0,7.0,13.0,8.0,4.0,13.0,17.0,7.0,14.0,7.0,13.0,10.0,13.0,15.0,15.0,13.0,14.0,13.0,12.0,13.0,8.0,14.0,13.0,12.0,13.0,12.0,5.0,20.0,13.0,11.0,8.0,13.0,7.0,14.0,7.0,13.0,9.0,8.0,10.0,12.0,15.0,11.0,16.0,16.0,14.0,5.0,25.0,0.0,0.0,3.0,2.0,170.0,61.0,2.0,3.0,2.0,2.0,1.0,3.0,2.0,2.0,1.0,2.0,1.0,11.0,12.0,13.0,10.0,13.0,8.0,5.0,8.0,7.0,4.0,14.0,10.0,4.0,15.0,11.0,10.0,9.0,7.0,10.0,14.0,8.0,13.0,13.0,6.0,12.0,8.0,8.0,12.0,16.0,14.0,7.0,5.0,12.0,15.0,16.0,20.0,14.0,6.0,12.0,11.0,13.0,8.0,8.0,8.0,13.0,15.0,10.0,10.0,14.0,14.0,8.0,18.0,0.0,0.0,0.0,0.0,179.0,67.0,3.0,3.0,2.0,4.0,2.0,4.0,3.0,1.0,3.0,4.0,1.0,5.0,7.0,12.0,9.0,12.0,12.0,10.0,12.0,6.0,4.0,12.0,12.0,3.0,14.0,11.0,12.0,11.0,11.0,8.0,13.0,12.0,12.0,12.0,6.0,12.0,5.0,10.0,12.0,15.0,11.0,12.0,10.0,20.0,13.0,14.0,8.0,14.0,8.0,9.0,6.0,14.0,5.0,10.0,16.0,13.0,12.0,12.0,13.0,9.0,15.0,2.0,27.0,6.0,0.0,0.0,0.0,184.0,82.0,3.0,2.0,1.0,3.0,1.0,1.0,2.0,2.0,2.0,1.0,2.0,6.0,9.0,12.0,12.0,11.0,7.0,13.0,11.0,5.0,4.0,10.0,13.0,4.0,12.0,10.0,12.0,13.0,11.0,10.0,10.0,9.0,13.0,12.0,6.0,13.0,7.0,9.0,11.0,15.0,13.0,13.0,12.0,8.0,15.0,14.0,20.0,14.0,11.0,13.0,10.0,13.0,7.0,8.0,19.0,12.0,12.0,11.0,12.0,14.0,14.0,7.0
1,2,36.0,0.0,0.0,0.0,0.0,185.0,78.0,11.0,14.0,12.0,7.0,13.0,12.0,14.0,15.0,13.0,14.0,10.0,4.0,1.0,3.0,1.0,8.0,8.0,11.0,8.0,3.0,3.0,7.0,2.0,1.0,8.0,11.0,13.0,15.0,11.0,12.0,7.0,13.0,9.0,5.0,14.0,3.0,13.0,15.0,8.0,11.0,14.0,13.0,12.0,5.0,15.0,11.0,20.0,12.0,14.0,13.0,11.0,13.0,8.0,1.0,19.0,14.0,16.0,10.0,17.0,9.0,9.0,11.0,34.0,23.0,1.0,0.0,0.0,186.0,81.0,3.0,3.0,1.0,2.0,1.0,3.0,2.0,3.0,1.0,3.0,3.0,4.0,8.0,6.0,10.0,7.0,8.0,17.0,12.0,10.0,14.0,7.0,9.0,15.0,7.0,15.0,13.0,17.0,8.0,12.0,7.0,12.0,15.0,6.0,17.0,7.0,14.0,15.0,14.0,8.0,10.0,16.0,13.0,12.0,13.0,9.0,20.0,13.0,15.0,11.0,15.0,14.0,9.0,10.0,10.0,14.0,11.0,13.0,15.0,11.0,11.0,12.0,28.0,0.0,0.0,0.0,0.0,183.0,81.0,1.0,2.0,4.0,1.0,1.0,3.0,2.0,3.0,3.0,3.0,1.0,5.0,5.0,6.0,10.0,12.0,6.0,14.0,8.0,6.0,15.0,11.0,6.0,13.0,12.0,13.0,14.0,16.0,14.0,14.0,10.0,12.0,14.0,5.0,14.0,8.0,14.0,15.0,15.0,9.0,12.0,15.0,13.0,7.0,11.0,12.0,20.0,15.0,15.0,14.0,14.0,14.0,9.0,8.0,14.0,14.0,11.0,13.0,15.0,13.0,15.0,6.0,27.0,10.0,0.0,0.0,0.0,181.0,69.0,1.0,1.0,3.0,3.0,3.0,3.0,2.0,3.0,3.0,3.0,1.0,5.0,13.0,10.0,7.0,13.0,9.0,10.0,10.0,12.0,12.0,11.0,7.0,12.0,11.0,11.0,13.0,12.0,11.0,13.0,9.0,9.0,12.0,8.0,7.0,12.0,11.0,11.0,13.0,15.0,13.0,13.0,10.0,20.0,12.0,15.0,8.0,15.0,12.0,13.0,11.0,14.0,13.0,12.0,10.0,14.0,12.0,10.0,11.0,15.0,15.0,7.0,24.0,0.0,0.0,0.0,0.0,179.0,68.0,3.0,2.0,3.0,2.0,1.0,3.0,3.0,1.0,3.0,3.0,1.0,4.0,13.0,9.0,6.0,12.0,9.0,12.0,7.0,8.0,12.0,14.0,8.0,14.0,12.0,15.0,14.0,13.0,14.0,13.0,10.0,12.0,14.0,10.0,9.0,9.0,10.0,13.0,14.0,14.0,12.0,13.0,9.0,9.0,8.0,14.0,20.0,15.0,14.0,11.0,11.0,13.0,10.0,14.0,13.0,14.0,14.0,11.0,16.0,15.0,15.0,6.0,36.0,0.0,0.0,0.0,0.0,180.0,72.0,1.0,2.0,4.0,1.0,1.0,2.0,2.0,1.0,1.0,1.0,2.0,6.0,10.0,8.0,6.0,11.0,8.0,13.0,10.0,7.0,11.0,11.0,8.0,13.0,11.0,13.0,13.0,14.0,14.0,13.0,11.0,12.0,13.0,7.0,10.0,10.0,13.0,13.0,15.0,11.0,12.0,14.0,10.0,10.0,14.0,10.0,20.0,12.0,11.0,12.0,14.0,14.0,5.0,15.0,20.0,12.0,20.0,14.0,16.0,15.0,15.0,5.0,30.0,0.0,0.0,0.0,0.0,167.0,60.0,3.0,1.0,1.0,2.0,3.0,1.0,1.0,3.0,1.0,1.0,3.0,10.0,11.0,12.0,8.0,13.0,10.0,6.0,9.0,10.0,12.0,14.0,9.0,10.0,14.0,11.0,14.0,14.0,14.0,14.0,13.0,14.0,12.0,14.0,11.0,13.0,12.0,15.0,15.0,15.0,14.0,11.0,5.0,11.0,11.0,15.0,20.0,11.0,8.0,14.0,10.0,12.0,13.0,11.0,11.0,12.0,11.0,10.0,12.0,11.0,11.0,2.0,33.0,0.0,0.0,0.0,0.0,187.0,76.0,2.0,2.0,3.0,1.0,1.0,3.0,2.0,1.0,2.0,3.0,2.0,15.0,14.0,14.0,10.0,15.0,13.0,10.0,12.0,7.0,4.0,15.0,13.0,7.0,15.0,6.0,12.0,9.0,14.0,11.0,15.0,12.0,12.0,14.0,12.0,13.0,7.0,13.0,12.0,11.0,12.0,14.0,12.0,14.0,15.0,12.0,20.0,11.0,12.0,12.0,6.0,14.0,6.0,11.0,14.0,13.0,12.0,12.0,15.0,15.0,13.0,9.0,26.0,1.0,0.0,0.0,0.0,180.0,73.0,2.0,3.0,2.0,1.0,3.0,1.0,1.0,1.0,2.0,3.0,3.0,6.0,12.0,13.0,12.0,13.0,12.0,7.0,11.0,6.0,4.0,11.0,12.0,5.0,14.0,7.0,12.0,9.0,12.0,12.0,8.0,10.0,16.0,13.0,5.0,13.0,7.0,9.0,14.0,16.0,14.0,13.0,10.0,20.0,13.0,15.0,6.0,13.0,13.0,10.0,7.0,13.0,7.0,8.0,12.0,14.0,15.0,13.0,12.0,14.0,14.0,9.0,26.0,0.0,0.0,0.0,0.0,193.0,81.0,1.0,3.0,3.0,3.0,3.0,1.0,2.0,2.0,2.0,3.0,3.0,4.0,9.0,14.0,10.0,13.0,12.0,14.0,14.0,5.0,5.0,10.0,12.0,3.0,14.0,8.0,13.0,12.0,9.0,10.0,11.0,11.0,12.0,16.0,5.0,14.0,6.0,9.0,12.0,14.0,13.0,14.0,16.0,14.0,13.0,13.0,20.0,13.0,14.0,10.0,8.0,14.0,9.0,8.0,16.0,16.0,11.0,13.0,11.0,13.0,13.0,10.0,24.0,0.0,0.0,0.0,0.0,182.0,82.0,3.0,3.0,2.0,1.0,1.0,3.0,2.0,2.0,3.0,2.0,2.0,4.0,7.0,13.0,14.0,13.0,12.0,14.0,12.0,5.0,7.0,10.0,14.0,6.0,15.0,13.0,13.0,16.0,8.0,12.0,11.0,11.0,12.0,14.0,7.0,13.0,8.0,12.0,13.0,14.0,14.0,15.0,12.0,10.0,10.0,12.0,20.0,16.0,15.0,12.0,13.0,14.0,10.0,8.0,8.0,13.0,5.0,10.0,11.0,9.0,9.0,13.0,33.0,101.0,0.0,0.0,0.0,182.0,87.0,12.0,11.0,15.0,12.0,14.0,13.0,14.0,15.0,15.0,13.0,12.0,9.0,2.0,3.0,8.0,9.0,11.0,10.0,11.0,1.0,3.0,12.0,15.0,8.0,10.0,8.0,14.0,14.0,14.0,12.0,9.0,12.0,16.0,9.0,15.0,2.0,13.0,12.0,6.0,12.0,13.0,14.0,13.0,8.0,13.0,10.0,20.0,12.0,15.0,13.0,8.0,15.0,5.0,1.0,13.0,15.0,13.0,15.0,18.0,18.0,15.0,5.0,32.0,0.0,0.0,0.0,0.0,195.0,89.0,3.0,2.0,3.0,1.0,4.0,2.0,4.0,2.0,3.0,1.0,2.0,3.0,5.0,5.0,11.0,8.0,8.0,14.0,9.0,11.0,15.0,12.0,9.0,13.0,8.0,16.0,13.0,19.0,10.0,14.0,8.0,13.0,16.0,5.0,15.0,10.0,15.0,15.0,14.0,8.0,8.0,16.0,17.0,5.0,11.0,10.0,20.0,13.0,17.0,13.0,12.0,15.0,7.0,5.0,12.0,14.0,14.0,12.0,15.0,8.0,8.0,7.0,24.0,0.0,0.0,0.0,0.0,187.0,93.0,4.0,3.0,2.0,1.0,2.0,2.0,2.0,2.0,1.0,2.0,1.0,4.0,5.0,6.0,6.0,12.0,6.0,15.0,8.0,6.0,15.0,10.0,6.0,13.0,9.0,14.0,13.0,16.0,12.0,14.0,7.0,12.0,15.0,5.0,8.0,6.0,12.0,14.0,15.0,9.0,10.0,18.0,13.0,6.0,14.0,12.0,20.0,15.0,17.0,13.0,14.0,14.0,11.0,10.0,19.0,14.0,15.0,11.0,13.0,14.0,14.0,5.0,25.0,0.0,0.0,26.0,3.0,176.0,64.0,3.0,2.0,2.0,1.0,3.0,3.0,3.0,2.0,1.0,1.0,1.0,12.0,13.0,12.0,7.0,13.0,13.0,11.0,11.0,11.0,14.0,13.0,11.0,14.0,13.0,13.0,13.0,14.0,13.0,13.0,11.0,13.0,17.0,12.0,11.0,10.0,12.0,14.0,14.0,14.0,14.0,12.0,8.0,8.0,17.0,14.0,20.0,15.0,12.0,14.0,12.0,13.0,5.0,12.0,17.0,15.0,15.0,14.0,16.0,15.0,15.0,7.0,23.0,0.0,0.0,1.0,0.0,182.0,71.0,3.0,1.0,2.0,3.0,4.0,2.0,3.0,1.0,2.0,1.0,3.0,9.0,13.0,14.0,8.0,14.0,13.0,12.0,10.0,13.0,14.0,14.0,13.0,15.0,13.0,14.0,14.0,13.0,11.0,12.0,12.0,13.0,16.0,12.0,12.0,15.0,13.0,14.0,15.0,15.0,13.0,14.0,12.0,9.0,16.0,15.0,20.0,15.0,15.0,15.0,10.0,14.0,6.0,12.0,8.0,15.0,14.0,16.0,15.0,15.0,16.0,6.0,32.0,13.0,0.0,19.0,1.0,172.0,72.0,3.0,1.0,3.0,2.0,1.0,2.0,2.0,2.0,3.0,1.0,1.0,7.0,12.0,12.0,5.0,13.0,7.0,6.0,9.0,9.0,12.0,14.0,9.0,14.0,12.0,13.0,14.0,14.0,15.0,15.0,10.0,13.0,17.0,7.0,18.0,8.0,15.0,18.0,15.0,12.0,14.0,12.0,6.0,10.0,16.0,13.0,20.0,15.0,12.0,15.0,9.0,15.0,5.0,10.0,12.0,16.0,14.0,13.0,15.0,18.0,18.0,5.0,36.0,0.0,0.0,3.0,0.0,168.0,72.0,3.0,2.0,1.0,3.0,1.0,3.0,3.0,1.0,3.0,3.0,1.0,11.0,8.0,12.0,5.0,13.0,11.0,8.0,13.0,6.0,12.0,13.0,8.0,14.0,13.0,17.0,14.0,17.0,14.0,15.0,13.0,14.0,17.0,12.0,16.0,10.0,15.0,16.0,14.0,10.0,13.0,14.0,4.0,8.0,16.0,8.0,20.0,12.0,13.0,17.0,14.0,14.0,7.0,10.0,19.0,15.0,14.0,16.0,15.0,9.0,9.0,7.0,28.0,15.0,2.0,8.0,1.0,171.0,68.0,3.0,1.0,4.0,2.0,3.0,1.0,3.0,2.0,3.0,2.0,1.0,14.0,14.0,14.0,7.0,14.0,14.0,7.0,13.0,6.0,4.0,15.0,12.0,7.0,14.0,11.0,13.0,10.0,13.0,11.0,14.0,12.0,14.0,12.0,8.0,13.0,9.0,15.0,10.0,14.0,15.0,12.0,6.0,12.0,12.0,13.0,20.0,12.0,8.0,12.0,11.0,13.0,15.0,10.0,20.0,15.0,15.0,9.0,13.0,16.0,16.0,7.0,28.0,0.0,0.0,0.0,0.0,168.0,65.0,3.0,4.0,1.0,1.0,2.0,3.0,1.0,2.0,2.0,1.0,2.0,14.0,14.0,15.0,8.0,14.0,14.0,9.0,8.0,7.0,8.0,13.0,10.0,7.0,14.0,12.0,12.0,12.0,13.0,13.0,13.0,12.0,15.0,13.0,6.0,11.0,7.0,14.0,14.0,16.0,14.0,10.0,6.0,20.0,13.0,15.0,5.0,13.0,9.0,12.0,12.0,14.0,9.0,6.0,18.0,14.0,14.0,14.0,14.0,13.0,13.0,6.0,22.0,2.0,0.0,0.0,0.0,169.0,59.0,3.0,1.0,3.0,1.0,1.0,1.0,1.0,1.0,3.0,3.0,2.0,13.0,13.0,15.0,13.0,15.0,13.0,7.0,13.0,8.0,6.0,13.0,13.0,5.0,16.0,10.0,10.0,8.0,13.0,11.0,14.0,12.0,12.0,14.0,10.0,12.0,6.0,10.0,8.0,16.0,15.0,17.0,6.0,12.0,12.0,15.0,20.0,13.0,9.0,12.0,8.0,12.0,8.0,12.0,13.0,13.0,13.0,14.0,12.0,10.0,13.0,9.0,21.0,0.0,0.0,9.0,6.0,178.0,72.0,1.0,1.0,1.0,1.0,2.0,3.0,2.0,3.0,3.0,4.0,3.0,5.0,8.0,15.0,13.0,15.0,6.0,11.0,10.0,5.0,3.0,10.0,13.0,3.0,14.0,10.0,12.0,11.0,12.0,10.0,12.0,9.0,12.0,16.0,5.0,14.0,7.0,7.0,11.0,13.0,14.0,13.0,9.0,12.0,13.0,12.0,20.0,13.0,11.0,10.0,10.0,8.0,7.0,8.0,8.0,11.0,11.0,9.0,7.0,13.0,10.0,5.0
2,3,17.0,0.0,0.0,0.0,0.0,193.0,82.0,13.0,11.0,12.0,2.0,12.0,10.0,14.0,15.0,14.0,12.0,10.0,3.0,1.0,1.0,3.0,5.0,6.0,2.0,2.0,1.0,3.0,9.0,3.0,1.0,8.0,7.0,12.0,13.0,13.0,13.0,11.0,11.0,15.0,3.0,8.0,3.0,12.0,12.0,11.0,10.0,12.0,14.0,17.0,5.0,15.0,11.0,20.0,13.0,12.0,13.0,8.0,11.0,5.0,11.0,13.0,15.0,15.0,17.0,14.0,15.0,15.0,5.0,26.0,5.0,0.0,0.0,0.0,184.0,86.0,3.0,3.0,2.0,1.0,2.0,2.0,4.0,1.0,3.0,1.0,3.0,4.0,10.0,9.0,6.0,10.0,7.0,14.0,8.0,8.0,14.0,9.0,6.0,14.0,9.0,14.0,14.0,16.0,9.0,15.0,7.0,11.0,13.0,8.0,10.0,9.0,13.0,12.0,12.0,12.0,12.0,17.0,12.0,5.0,15.0,15.0,20.0,14.0,17.0,11.0,14.0,13.0,7.0,10.0,13.0,16.0,14.0,11.0,11.0,12.0,9.0,14.0,19.0,0.0,0.0,0.0,0.0,194.0,92.0,2.0,1.0,3.0,3.0,3.0,3.0,1.0,3.0,3.0,2.0,1.0,3.0,3.0,5.0,6.0,10.0,5.0,16.0,10.0,8.0,12.0,9.0,4.0,15.0,11.0,14.0,11.0,12.0,10.0,11.0,10.0,12.0,15.0,3.0,13.0,13.0,12.0,14.0,14.0,11.0,8.0,15.0,17.0,5.0,16.0,12.0,20.0,12.0,16.0,12.0,13.0,12.0,5.0,7.0,10.0,14.0,13.0,8.0,10.0,11.0,18.0,6.0,26.0,0.0,0.0,0.0,0.0,187.0,78.0,2.0,1.0,2.0,3.0,2.0,1.0,1.0,1.0,3.0,3.0,1.0,10.0,12.0,14.0,9.0,11.0,11.0,13.0,8.0,14.0,13.0,11.0,9.0,12.0,14.0,13.0,13.0,13.0,13.0,12.0,12.0,11.0,15.0,12.0,8.0,13.0,13.0,13.0,14.0,15.0,12.0,8.0,14.0,20.0,12.0,14.0,6.0,14.0,12.0,12.0,13.0,11.0,12.0,15.0,8.0,15.0,9.0,15.0,14.0,12.0,15.0,10.0,21.0,0.0,0.0,0.0,0.0,188.0,80.0,1.0,2.0,2.0,3.0,2.0,2.0,2.0,2.0,1.0,1.0,1.0,6.0,9.0,12.0,6.0,12.0,12.0,12.0,11.0,3.0,12.0,13.0,8.0,13.0,13.0,13.0,13.0,13.0,13.0,13.0,13.0,13.0,13.0,8.0,11.0,11.0,13.0,15.0,13.0,12.0,12.0,13.0,14.0,20.0,14.0,11.0,5.0,13.0,14.0,12.0,11.0,3.0,6.0,8.0,17.0,12.0,13.0,13.0,14.0,14.0,14.0,6.0,23.0,11.0,0.0,0.0,0.0,180.0,71.0,2.0,1.0,2.0,3.0,3.0,1.0,1.0,2.0,2.0,1.0,1.0,6.0,11.0,10.0,8.0,10.0,7.0,11.0,9.0,12.0,13.0,11.0,6.0,13.0,11.0,12.0,11.0,13.0,12.0,9.0,11.0,11.0,14.0,12.0,11.0,12.0,11.0,13.0,15.0,15.0,13.0,13.0,11.0,7.0,14.0,15.0,20.0,12.0,11.0,12.0,12.0,13.0,10.0,15.0,10.0,13.0,16.0,12.0,15.0,14.0,14.0,7.0,20.0,0.0,0.0,0.0,0.0,170.0,77.0,3.0,2.0,2.0,3.0,1.0,2.0,2.0,3.0,1.0,3.0,2.0,11.0,13.0,12.0,7.0,12.0,11.0,7.0,12.0,6.0,9.0,11.0,10.0,11.0,13.0,14.0,12.0,13.0,8.0,9.0,11.0,12.0,11.0,14.0,3.0,12.0,7.0,9.0,13.0,13.0,13.0,14.0,7.0,10.0,10.0,13.0,20.0,11.0,14.0,10.0,15.0,11.0,11.0,10.0,10.0,10.0,10.0,10.0,11.0,6.0,19.0,6.0,28.0,0.0,0.0,0.0,0.0,180.0,79.0,3.0,2.0,3.0,3.0,2.0,2.0,2.0,1.0,3.0,2.0,3.0,8.0,11.0,15.0,12.0,15.0,12.0,7.0,10.0,7.0,8.0,13.0,13.0,6.0,16.0,11.0,11.0,10.0,13.0,10.0,15.0,12.0,3.0,15.0,6.0,13.0,13.0,12.0,12.0,15.0,16.0,14.0,8.0,12.0,12.0,14.0,20.0,12.0,12.0,13.0,6.0,13.0,6.0,6.0,8.0,9.0,13.0,10.0,12.0,12.0,2.0,2.0,24.0,0.0,0.0,15.0,3.0,190.0,87.0,1.0,3.0,2.0,2.0,3.0,3.0,2.0,2.0,1.0,1.0,2.0,8.0,9.0,13.0,12.0,12.0,8.0,12.0,14.0,8.0,7.0,11.0,12.0,10.0,11.0,8.0,12.0,11.0,12.0,11.0,11.0,11.0,12.0,12.0,7.0,12.0,9.0,8.0,10.0,12.0,13.0,12.0,13.0,12.0,14.0,12.0,20.0,12.0,12.0,12.0,6.0,12.0,9.0,8.0,10.0,17.0,7.0,8.0,6.0,7.0,10.0,14.0,25.0,0.0,0.0,3.0,0.0,170.0,68.0,2.0,1.0,3.0,1.0,3.0,1.0,3.0,2.0,2.0,4.0,1.0,12.0,11.0,15.0,16.0,16.0,13.0,11.0,12.0,4.0,5.0,12.0,14.0,4.0,17.0,7.0,14.0,7.0,15.0,13.0,13.0,14.0,14.0,15.0,7.0,16.0,8.0,10.0,13.0,15.0,15.0,12.0,6.0,11.0,14.0,14.0,20.0,13.0,11.0,12.0,7.0,15.0,7.0,8.0,12.0,14.0,13.0,14.0,13.0,16.0,16.0,8.0,32.0,0.0,0.0,0.0,0.0,183.0,67.0,1.0,2.0,3.0,2.0,3.0,2.0,3.0,1.0,2.0,2.0,2.0,4.0,12.0,11.0,6.0,5.0,5.0,4.0,8.0,11.0,13.0,11.0,5.0,13.0,11.0,11.0,11.0,12.0,11.0,11.0,9.0,12.0,11.0,12.0,10.0,12.0,11.0,12.0,12.0,14.0,13.0,13.0,8.0,8.0,13.0,13.0,20.0,14.0,14.0,10.0,12.0,11.0,8.0,11.0,11.0,10.0,10.0,12.0,11.0,9.0,10.0,12.0,25.0,0.0,0.0,0.0,0.0,187.0,83.0,11.0,14.0,12.0,8.0,13.0,11.0,14.0,15.0,13.0,13.0,9.0,8.0,1.0,1.0,1.0,11.0,11.0,1.0,2.0,2.0,1.0,10.0,3.0,2.0,11.0,8.0,12.0,14.0,12.0,12.0,10.0,12.0,14.0,6.0,14.0,2.0,12.0,12.0,8.0,13.0,15.0,14.0,13.0,20.0,15.0,11.0,5.0,14.0,13.0,13.0,8.0,8.0,10.0,1.0,9.0,13.0,14.0,12.0,15.0,15.0,15.0,5.0,27.0,1.0,0.0,3.0,0.0,186.0,83.0,2.0,2.0,2.0,2.0,1.0,4.0,2.0,3.0,3.0,3.0,2.0,5.0,9.0,9.0,8.0,10.0,6.0,16.0,8.0,7.0,14.0,11.0,6.0,15.0,12.0,14.0,15.0,16.0,13.0,12.0,8.0,13.0,14.0,8.0,11.0,8.0,14.0,15.0,15.0,15.0,9.0,15.0,12.0,8.0,13.0,14.0,20.0,14.0,17.0,15.0,13.0,13.0,10.0,8.0,9.0,14.0,9.0,13.0,15.0,15.0,15.0,6.0,26.0,11.0,0.0,4.0,0.0,183.0,79.0,3.0,2.0,1.0,2.0,2.0,2.0,3.0,2.0,2.0,2.0,1.0,5.0,7.0,9.0,6.0,10.0,11.0,15.0,11.0,7.0,14.0,10.0,7.0,13.0,10.0,14.0,13.0,15.0,13.0,12.0,10.0,12.0,17.0,8.0,11.0,10.0,13.0,15.0,16.0,13.0,13.0,16.0,13.0,5.0,15.0,13.0,20.0,16.0,15.0,13.0,14.0,15.0,7.0,14.0,16.0,12.0,14.0,14.0,15.0,14.0,14.0,5.0,26.0,14.0,0.0,0.0,0.0,181.0,74.0,2.0,1.0,1.0,1.0,3.0,2.0,3.0,1.0,3.0,3.0,2.0,6.0,13.0,8.0,5.0,12.0,7.0,12.0,8.0,11.0,13.0,12.0,6.0,14.0,10.0,14.0,12.0,14.0,10.0,12.0,8.0,8.0,14.0,6.0,6.0,12.0,11.0,14.0,15.0,16.0,14.0,14.0,11.0,5.0,14.0,14.0,20.0,16.0,14.0,12.0,13.0,14.0,8.0,10.0,8.0,14.0,12.0,13.0,15.0,15.0,15.0,6.0,26.0,0.0,0.0,0.0,0.0,177.0,68.0,4.0,2.0,1.0,2.0,3.0,1.0,1.0,2.0,3.0,3.0,3.0,12.0,13.0,11.0,8.0,13.0,11.0,8.0,10.0,8.0,10.0,13.0,10.0,12.0,13.0,7.0,12.0,10.0,13.0,11.0,15.0,13.0,14.0,11.0,7.0,14.0,10.0,14.0,14.0,13.0,15.0,12.0,9.0,20.0,15.0,14.0,5.0,15.0,8.0,13.0,7.0,14.0,6.0,12.0,11.0,12.0,14.0,13.0,16.0,16.0,16.0,5.0,29.0,0.0,0.0,0.0,0.0,188.0,74.0,1.0,2.0,3.0,3.0,2.0,3.0,1.0,3.0,2.0,1.0,1.0,4.0,8.0,10.0,6.0,13.0,7.0,14.0,9.0,6.0,13.0,12.0,8.0,13.0,13.0,12.0,14.0,13.0,14.0,11.0,13.0,12.0,14.0,6.0,13.0,8.0,14.0,15.0,15.0,9.0,12.0,14.0,14.0,10.0,13.0,10.0,20.0,16.0,12.0,13.0,12.0,15.0,9.0,11.0,11.0,14.0,14.0,12.0,15.0,13.0,13.0,6.0,30.0,7.0,0.0,0.0,0.0,181.0,72.0,1.0,3.0,3.0,1.0,2.0,3.0,2.0,1.0,3.0,2.0,2.0,12.0,11.0,14.0,8.0,14.0,12.0,8.0,12.0,6.0,5.0,13.0,13.0,5.0,14.0,8.0,12.0,10.0,11.0,12.0,15.0,11.0,13.0,14.0,9.0,13.0,10.0,12.0,13.0,12.0,14.0,12.0,10.0,12.0,15.0,13.0,20.0,15.0,9.0,10.0,8.0,13.0,5.0,8.0,12.0,14.0,14.0,12.0,11.0,14.0,14.0,8.0,22.0,18.0,0.0,0.0,0.0,179.0,75.0,1.0,4.0,2.0,1.0,1.0,1.0,3.0,1.0,1.0,3.0,2.0,7.0,8.0,12.0,8.0,13.0,10.0,11.0,12.0,11.0,11.0,11.0,10.0,14.0,13.0,15.0,12.0,15.0,8.0,12.0,10.0,12.0,14.0,12.0,10.0,13.0,12.0,13.0,17.0,14.0,14.0,13.0,10.0,9.0,15.0,15.0,20.0,15.0,14.0,13.0,13.0,12.0,11.0,12.0,13.0,15.0,9.0,10.0,12.0,10.0,10.0,4.0,27.0,0.0,0.0,0.0,0.0,173.0,68.0,2.0,2.0,1.0,1.0,3.0,3.0,1.0,2.0,3.0,4.0,2.0,12.0,12.0,13.0,8.0,13.0,10.0,7.0,8.0,9.0,7.0,12.0,10.0,9.0,14.0,7.0,10.0,8.0,11.0,12.0,12.0,11.0,12.0,13.0,5.0,13.0,10.0,10.0,12.0,14.0,14.0,11.0,7.0,20.0,12.0,15.0,10.0,13.0,8.0,12.0,7.0,13.0,9.0,12.0,18.0,12.0,14.0,11.0,14.0,15.0,15.0,6.0,28.0,0.0,0.0,0.0,0.0,170.0,67.0,2.0,3.0,3.0,4.0,3.0,2.0,1.0,1.0,2.0,2.0,3.0,8.0,12.0,12.0,10.0,14.0,7.0,5.0,10.0,6.0,5.0,12.0,5.0,4.0,13.0,7.0,16.0,12.0,9.0,11.0,12.0,10.0,3.0,12.0,6.0,13.0,6.0,8.0,13.0,16.0,13.0,10.0,5.0,5.0,13.0,16.0,20.0,15.0,7.0,12.0,4.0,9.0,7.0,10.0,20.0,13.0,12.0,10.0,13.0,11.0,10.0,2.0,24.0,0.0,0.0,5.0,0.0,183.0,79.0,4.0,4.0,3.0,3.0,1.0,3.0,2.0,1.0,3.0,2.0,3.0,4.0,7.0,12.0,13.0,12.0,8.0,13.0,12.0,5.0,6.0,11.0,12.0,4.0,13.0,11.0,12.0,14.0,9.0,12.0,10.0,10.0,13.0,12.0,6.0,14.0,12.0,13.0,14.0,15.0,14.0,14.0,11.0,10.0,13.0,14.0,20.0,14.0,14.0,12.0,12.0,14.0,9.0,5.0,7.0,13.0,15.0,11.0,14.0,14.0,14.0,6.0
1,0,34.0,1.0,0.0,0.0,0.0,187.0,87.0,13.0,14.0,15.0,7.0,13.0,11.0,14.0,15.0,11.0,17.0,12.0,2.0,1.0,1.0,3.0,8.0,7.0,2.0,1.0,2.0,1.0,9.0,8.0,2.0,6.0,12.0,15.0,17.0,14.0,15.0,8.0,13.0,17.0,7.0,14.0,6.0,14.0,12.0,6.0,7.0,13.0,14.0,13.0,8.0,13.0,8.0,20.0,11.0,16.0,14.0,10.0,14.0,6.0,1.0,12.0,12.0,15.0,16.0,16.0,14.0,15.0,6.0,34.0,0.0,0.0,0.0,0.0,191.0,81.0,14.0,10.0,8.0,3.0,9.0,14.0,13.0,10.0,9.0,3.0,12.0,4.0,3.0,3.0,1.0,1.0,6.0,1.0,1.0,2.0,1.0,2.0,3.0,3.0,3.0,8.0,6.0,10.0,8.0,9.0,5.0,10.0,2.0,1.0,10.0,2.0,10.0,8.0,7.0,10.0,8.0,8.0,16.0,9.0,14.0,9.0,20.0,3.0,9.0,9.0,9.0,1.0,9.0,9.0,20.0,9.0,13.0,12.0,10.0,10.0,12.0,7.0,25.0,0.0,0.0,0.0,0.0,191.0,81.0,1.0,1.0,3.0,2.0,3.0,2.0,3.0,4.0,2.0,1.0,2.0,4.0,3.0,10.0,8.0,6.0,6.0,11.0,6.0,10.0,11.0,10.0,5.0,12.0,7.0,16.0,13.0,16.0,11.0,13.0,7.0,10.0,14.0,5.0,12.0,10.0,13.0,13.0,12.0,13.0,13.0,16.0,16.0,7.0,16.0,14.0,20.0,14.0,14.0,13.0,13.0,15.0,6.0,12.0,13.0,6.0,14.0,8.0,8.0,13.0,7.0,4.0,26.0,0.0,0.0,0.0,0.0,176.0,70.0,2.0,1.0,4.0,3.0,3.0,3.0,1.0,3.0,3.0,2.0,1.0,10.0,11.0,11.0,6.0,13.0,9.0,5.0,12.0,11.0,13.0,13.0,7.0,14.0,13.0,15.0,11.0,14.0,12.0,11.0,9.0,12.0,13.0,9.0,9.0,13.0,12.0,15.0,14.0,12.0,16.0,12.0,7.0,20.0,13.0,13.0,10.0,15.0,11.0,13.0,14.0,13.0,11.0,9.0,8.0,9.0,17.0,12.0,14.0,14.0,15.0,3.0,21.0,0.0,0.0,1.0,0.0,177.0,68.0,4.0,1.0,2.0,1.0,1.0,1.0,1.0,1.0,2.0,1.0,2.0,5.0,12.0,9.0,7.0,12.0,8.0,13.0,10.0,16.0,13.0,12.0,8.0,14.0,12.0,12.0,13.0,12.0,12.0,12.0,10.0,13.0,15.0,11.0,13.0,11.0,13.0,13.0,14.0,13.0,14.0,13.0,11.0,10.0,14.0,12.0,20.0,12.0,14.0,12.0,11.0,12.0,8.0,14.0,13.0,10.0,14.0,12.0,14.0,12.0,11.0,5.0,34.0,103.0,7.0,16.0,1.0,182.0,72.0,2.0,1.0,1.0,1.0,3.0,1.0,4.0,3.0,3.0,2.0,1.0,11.0,13.0,12.0,8.0,15.0,13.0,9.0,13.0,6.0,8.0,15.0,12.0,8.0,15.0,11.0,14.0,13.0,15.0,15.0,14.0,16.0,17.0,15.0,14.0,11.0,13.0,17.0,13.0,8.0,11.0,10.0,11.0,16.0,13.0,8.0,20.0,12.0,10.0,15.0,11.0,12.0,12.0,15.0,14.0,12.0,15.0,15.0,18.0,14.0,14.0,7.0,25.0,19.0,6.0,0.0,0.0,182.0,78.0,1.0,4.0,3.0,1.0,2.0,1.0,2.0,2.0,4.0,1.0,4.0,16.0,13.0,12.0,11.0,12.0,13.0,8.0,12.0,5.0,5.0,13.0,13.0,5.0,15.0,11.0,12.0,12.0,13.0,12.0,15.0,12.0,15.0,14.0,6.0,15.0,9.0,11.0,14.0,15.0,14.0,14.0,10.0,11.0,11.0,14.0,20.0,12.0,13.0,10.0,11.0,15.0,5.0,12.0,10.0,15.0,16.0,11.0,13.0,16.0,16.0,7.0,31.0,0.0,0.0,0.0,0.0,182.0,76.0,3.0,2.0,3.0,4.0,2.0,1.0,2.0,3.0,1.0,2.0,2.0,10.0,13.0,15.0,6.0,14.0,9.0,11.0,8.0,7.0,4.0,12.0,10.0,3.0,14.0,7.0,13.0,10.0,12.0,12.0,12.0,10.0,11.0,12.0,6.0,15.0,6.0,13.0,13.0,14.0,14.0,12.0,10.0,20.0,13.0,13.0,8.0,12.0,11.0,8.0,7.0,14.0,13.0,8.0,8.0,13.0,14.0,12.0,12.0,14.0,14.0,6.0,19.0,0.0,0.0,0.0,0.0,172.0,64.0,1.0,3.0,2.0,2.0,4.0,2.0,1.0,2.0,3.0,3.0,1.0,13.0,13.0,15.0,12.0,15.0,12.0,6.0,12.0,3.0,2.0,13.0,11.0,3.0,16.0,8.0,10.0,9.0,12.0,9.0,13.0,10.0,12.0,15.0,8.0,13.0,4.0,5.0,7.0,17.0,16.0,14.0,5.0,20.0,11.0,15.0,12.0,10.0,8.0,8.0,10.0,14.0,8.0,10.0,17.0,14.0,9.0,10.0,9.0,4.0,10.0,10.0,25.0,9.0,0.0,0.0,0.0,173.0,70.0,1.0,2.0,1.0,2.0,3.0,2.0,1.0,2.0,1.0,4.0,3.0,6.0,8.0,13.0,10.0,14.0,13.0,13.0,13.0,5.0,10.0,13.0,11.0,9.0,15.0,7.0,13.0,13.0,12.0,12.0,12.0,13.0,13.0,15.0,12.0,13.0,7.0,14.0,15.0,13.0,13.0,12.0,10.0,12.0,11.0,13.0,20.0,14.0,13.0,13.0,7.0,13.0,13.0,13.0,8.0,15.0,13.0,12.0,13.0,15.0,15.0,6.0,28.0,37.0,15.0,1.0,0.0,194.0,88.0,2.0,1.0,2.0,1.0,1.0,2.0,3.0,1.0,3.0,2.0,2.0,4.0,6.0,12.0,15.0,12.0,7.0,16.0,11.0,3.0,6.0,10.0,14.0,4.0,11.0,10.0,14.0,15.0,13.0,10.0,8.0,9.0,13.0,12.0,6.0,14.0,8.0,11.0,16.0,13.0,12.0,18.0,17.0,9.0,12.0,12.0,20.0,14.0,18.0,13.0,10.0,15.0,15.0,6.0,20.0,17.0,12.0,15.0,14.0,11.0,14.0,7.0,27.0,1.0,0.0,15.0,0.0,195.0,88.0,15.0,16.0,12.0,8.0,14.0,10.0,16.0,14.0,14.0,10.0,11.0,6.0,2.0,3.0,3.0,10.0,8.0,7.0,1.0,2.0,3.0,10.0,2.0,2.0,9.0,10.0,12.0,14.0,10.0,14.0,7.0,10.0,13.0,1.0,12.0,1.0,12.0,15.0,10.0,9.0,13.0,15.0,17.0,8.0,13.0,10.0,20.0,10.0,17.0,16.0,5.0,14.0,6.0,3.0,12.0,15.0,13.0,11.0,16.0,14.0,17.0,5.0,32.0,0.0,0.0,0.0,0.0,183.0,79.0,1.0,1.0,1.0,3.0,1.0,3.0,1.0,1.0,2.0,1.0,1.0,5.0,10.0,6.0,6.0,9.0,6.0,15.0,7.0,11.0,14.0,10.0,7.0,13.0,10.0,13.0,15.0,15.0,15.0,14.0,9.0,13.0,16.0,6.0,14.0,8.0,12.0,13.0,16.0,11.0,12.0,16.0,11.0,8.0,16.0,12.0,20.0,15.0,14.0,14.0,11.0,12.0,5.0,15.0,18.0,15.0,14.0,13.0,17.0,14.0,14.0,5.0,29.0,17.0,1.0,4.0,0.0,183.0,72.0,2.0,2.0,1.0,2.0,4.0,3.0,3.0,2.0,1.0,1.0,2.0,4.0,9.0,6.0,6.0,8.0,5.0,15.0,7.0,10.0,15.0,8.0,6.0,14.0,8.0,13.0,13.0,16.0,11.0,13.0,9.0,11.0,13.0,9.0,8.0,8.0,12.0,15.0,14.0,11.0,12.0,14.0,12.0,10.0,13.0,14.0,20.0,15.0,14.0,14.0,13.0,13.0,8.0,12.0,14.0,12.0,13.0,13.0,14.0,11.0,11.0,7.0,29.0,0.0,0.0,0.0,0.0,183.0,74.0,3.0,3.0,3.0,3.0,3.0,2.0,2.0,2.0,1.0,3.0,1.0,5.0,12.0,7.0,6.0,10.0,7.0,14.0,12.0,5.0,14.0,12.0,6.0,13.0,11.0,14.0,13.0,17.0,13.0,16.0,12.0,12.0,13.0,9.0,8.0,9.0,14.0,14.0,15.0,13.0,12.0,15.0,12.0,6.0,17.0,11.0,20.0,17.0,13.0,14.0,14.0,15.0,5.0,13.0,9.0,14.0,19.0,15.0,14.0,11.0,11.0,6.0,23.0,0.0,0.0,0.0,0.0,178.0,72.0,1.0,1.0,1.0,3.0,2.0,3.0,3.0,2.0,2.0,1.0,1.0,9.0,7.0,4.0,5.0,8.0,9.0,10.0,8.0,7.0,12.0,10.0,2.0,11.0,11.0,10.0,12.0,10.0,11.0,11.0,11.0,15.0,5.0,10.0,12.0,9.0,10.0,11.0,13.0,12.0,15.0,13.0,9.0,6.0,14.0,15.0,20.0,13.0,13.0,12.0,5.0,3.0,9.0,10.0,11.0,10.0,12.0,11.0,12.0,11.0,17.0,7.0,34.0,0.0,0.0,0.0,0.0,176.0,71.0,2.0,1.0,3.0,1.0,2.0,2.0,3.0,2.0,1.0,3.0,1.0,10.0,11.0,8.0,8.0,12.0,13.0,7.0,11.0,6.0,8.0,13.0,11.0,12.0,12.0,11.0,13.0,13.0,12.0,11.0,12.0,11.0,15.0,6.0,14.0,9.0,13.0,16.0,15.0,11.0,11.0,13.0,8.0,10.0,14.0,12.0,20.0,15.0,12.0,12.0,11.0,13.0,9.0,8.0,19.0,13.0,14.0,14.0,14.0,13.0,13.0,7.0,26.0,0.0,0.0,0.0,0.0,184.0,76.0,3.0,1.0,3.0,1.0,3.0,2.0,3.0,2.0,1.0,1.0,3.0,10.0,11.0,13.0,9.0,13.0,12.0,13.0,10.0,6.0,11.0,13.0,9.0,14.0,12.0,12.0,13.0,12.0,12.0,11.0,13.0,12.0,13.0,13.0,10.0,12.0,13.0,12.0,16.0,15.0,13.0,15.0,13.0,20.0,15.0,14.0,5.0,16.0,15.0,13.0,12.0,14.0,5.0,12.0,18.0,14.0,10.0,7.0,11.0,11.0,13.0,10.0,35.0,0.0,0.0,0.0,0.0,172.0,65.0,1.0,2.0,2.0,3.0,2.0,3.0,2.0,1.0,3.0,4.0,3.0,14.0,13.0,12.0,10.0,14.0,15.0,7.0,13.0,8.0,4.0,13.0,17.0,7.0,14.0,7.0,13.0,10.0,13.0,15.0,15.0,13.0,14.0,13.0,12.0,13.0,8.0,14.0,13.0,12.0,13.0,12.0,5.0,20.0,13.0,11.0,8.0,13.0,7.0,14.0,7.0,13.0,9.0,8.0,10.0,12.0,15.0,11.0,16.0,16.0,14.0,5.0,25.0,0.0,0.0,3.0,2.0,170.0,61.0,2.0,3.0,2.0,2.0,1.0,3.0,2.0,2.0,1.0,2.0,1.0,11.0,12.0,13.0,10.0,13.0,8.0,5.0,8.0,7.0,4.0,14.0,10.0,4.0,15.0,11.0,10.0,9.0,7.0,10.0,14.0,8.0,13.0,13.0,6.0,12.0,8.0,8.0,12.0,16.0,14.0,7.0,5.0,12.0,15.0,16.0,20.0,14.0,6.0,12.0,11.0,13.0,8.0,8.0,8.0,13.0,15.0,10.0,10.0,14.0,14.0,8.0,18.0,0.0,0.0,0.0,0.0,179.0,67.0,3.0,3.0,2.0,4.0,2.0,4.0,3.0,1.0,3.0,4.0,1.0,5.0,7.0,12.0,9.0,12.0,12.0,10.0,12.0,6.0,4.0,12.0,12.0,3.0,14.0,11.0,12.0,11.0,11.0,8.0,13.0,12.0,12.0,12.0,6.0,12.0,5.0,10.0,12.0,15.0,11.0,12.0,10.0,20.0,13.0,14.0,8.0,14.0,8.0,9.0,6.0,14.0,5.0,10.0,16.0,13.0,12.0,12.0,13.0,9.0,15.0,2.0,27.0,6.0,0.0,0.0,0.0,184.0,82.0,3.0,2.0,1.0,3.0,1.0,1.0,2.0,2.0,2.0,1.0,2.0,6.0,9.0,12.0,12.0,11.0,7.0,13.0,11.0,5.0,4.0,10.0,13.0,4.0,12.0,10.0,12.0,13.0,11.0,10.0,10.0,9.0,13.0,12.0,6.0,13.0,7.0,9.0,11.0,15.0,13.0,13.0,12.0,8.0,15.0,14.0,20.0,14.0,11.0,13.0,10.0,13.0,7.0,8.0,19.0,12.0,12.0,11.0,12.0,14.0,14.0,7.0
1,1,28.0,0.0,0.0,6.0,0.0,191.0,81.0,11.0,10.0,14.0,8.0,13.0,12.0,14.0,15.0,11.0,8.0,13.0,4.0,3.0,2.0,1.0,9.0,9.0,3.0,10.0,1.0,1.0,8.0,3.0,3.0,9.0,8.0,12.0,14.0,12.0,13.0,8.0,11.0,12.0,6.0,14.0,2.0,12.0,10.0,7.0,13.0,14.0,16.0,15.0,6.0,14.0,11.0,20.0,15.0,14.0,12.0,9.0,14.0,7.0,1.0,9.0,15.0,13.0,11.0,15.0,15.0,14.0,8.0,23.0,0.0,0.0,0.0,0.0,184.0,71.0,1.0,2.0,1.0,2.0,2.0,2.0,2.0,4.0,2.0,1.0,3.0,4.0,10.0,10.0,6.0,11.0,6.0,14.0,8.0,7.0,14.0,11.0,6.0,13.0,11.0,12.0,12.0,13.0,12.0,11.0,12.0,12.0,14.0,6.0,8.0,10.0,13.0,13.0,14.0,15.0,13.0,14.0,13.0,8.0,12.0,14.0,20.0,13.0,14.0,13.0,12.0,14.0,15.0,8.0,11.0,13.0,13.0,10.0,8.0,9.0,16.0,7.0,32.0,67.0,9.0,7.0,0.0,191.0,85.0,1.0,1.0,1.0,3.0,2.0,2.0,4.0,3.0,3.0,2.0,3.0,7.0,7.0,6.0,9.0,12.0,3.0,16.0,7.0,3.0,15.0,11.0,7.0,13.0,12.0,14.0,11.0,14.0,10.0,11.0,10.0,14.0,11.0,8.0,13.0,13.0,13.0,13.0,15.0,9.0,7.0,14.0,16.0,8.0,7.0,10.0,20.0,12.0,15.0,13.0,14.0,5.0,6.0,11.0,8.0,11.0,9.0,12.0,11.0,6.0,9.0,11.0,21.0,0.0,0.0,0.0,0.0,178.0,65.0,2.0,3.0,3.0,3.0,3.0,1.0,1.0,1.0,1.0,3.0,1.0,9.0,13.0,11.0,6.0,12.0,7.0,9.0,8.0,8.0,13.0,12.0,7.0,13.0,12.0,8.0,12.0,13.0,12.0,12.0,13.0,13.0,14.0,9.0,8.0,12.0,12.0,13.0,13.0,12.0,14.0,13.0,11.0,8.0,15.0,12.0,20.0,13.0,12.0,14.0,8.0,11.0,7.0,10.0,19.0,10.0,13.0,10.0,11.0,15.0,15.0,6.0,23.0,0.0,0.0,0.0,0.0,174.0,64.0,4.0,3.0,1.0,1.0,3.0,3.0,2.0,3.0,3.0,2.0,3.0,8.0,12.0,10.0,8.0,11.0,7.0,10.0,9.0,12.0,14.0,9.0,10.0,13.0,12.0,12.0,12.0,12.0,11.0,12.0,10.0,12.0,13.0,8.0,9.0,12.0,11.0,13.0,14.0,15.0,14.0,11.0,10.0,10.0,14.0,14.0,20.0,15.0,10.0,14.0,12.0,12.0,8.0,13.0,10.0,12.0,15.0,12.0,13.0,10.0,17.0,6.0,29.0,52.0,2.0,0.0,0.0,178.0,75.0,1.0,1.0,1.0,1.0,3.0,3.0,2.0,3.0,1.0,2.0,2.0,10.0,12.0,12.0,11.0,12.0,11.0,8.0,11.0,7.0,11.0,13.0,12.0,9.0,13.0,12.0,9.0,13.0,9.0,12.0,13.0,10.0,16.0,7.0,9.0,14.0,13.0,15.0,16.0,13.0,13.0,12.0,10.0,8.0,15.0,13.0,20.0,15.0,11.0,10.0,13.0,14.0,3.0,13.0,13.0,15.0,8.0,13.0,16.0,12.0,14.0,3.0,27.0,0.0,0.0,0.0,0.0,188.0,77.0,1.0,4.0,1.0,1.0,3.0,1.0,2.0,1.0,2.0,2.0,2.0,4.0,7.0,8.0,7.0,13.0,6.0,15.0,9.0,6.0,13.0,12.0,6.0,12.0,11.0,14.0,14.0,15.0,10.0,12.0,11.0,13.0,16.0,7.0,12.0,9.0,12.0,15.0,16.0,14.0,10.0,14.0,15.0,9.0,13.0,12.0,20.0,14.0,16.0,12.0,14.0,13.0,6.0,12.0,4.0,13.0,18.0,13.0,14.0,14.0,13.0,7.0,21.0,0.0,0.0,3.0,0.0,175.0,71.0,3.0,3.0,2.0,1.0,3.0,1.0,2.0,2.0,3.0,3.0,2.0,9.0,13.0,14.0,12.0,14.0,14.0,8.0,13.0,5.0,6.0,14.0,11.0,6.0,15.0,8.0,13.0,8.0,12.0,11.0,13.0,14.0,12.0,15.0,9.0,14.0,7.0,11.0,12.0,13.0,13.0,8.0,7.0,10.0,14.0,13.0,20.0,13.0,8.0,10.0,9.0,12.0,8.0,10.0,10.0,10.0,9.0,10.0,12.0,5.0,10.0,9.0,22.0,0.0,0.0,0.0,0.0,177.0,72.0,2.0,1.0,2.0,4.0,2.0,2.0,1.0,3.0,4.0,2.0,3.0,10.0,12.0,13.0,11.0,12.0,10.0,12.0,12.0,4.0,10.0,13.0,11.0,11.0,13.0,11.0,12.0,11.0,13.0,9.0,13.0,12.0,3.0,12.0,8.0,14.0,12.0,12.0,13.0,16.0,13.0,12.0,9.0,8.0,15.0,14.0,20.0,14.0,13.0,10.0,4.0,11.0,11.0,12.0,19.0,9.0,12.0,13.0,12.0,11.0,14.0,7.0,25.0,0.0,0.0,0.0,0.0,187.0,83.0,2.0,1.0,3.0,3.0,1.0,3.0,3.0,3.0,1.0,1.0,3.0,4.0,8.0,10.0,14.0,12.0,8.0,14.0,9.0,5.0,7.0,11.0,13.0,5.0,12.0,11.0,13.0,13.0,13.0,11.0,10.0,12.0,16.0,9.0,8.0,13.0,11.0,13.0,16.0,14.0,13.0,15.0,13.0,20.0,14.0,12.0,8.0,14.0,16.0,13.0,11.0,13.0,7.0,5.0,13.0,14.0,13.0,14.0,14.0,13.0,13.0,6.0,32.0,1.0,1.0,0.0,0.0,180.0,73.0,4.0,3.0,2.0,2.0,2.0,4.0,3.0,2.0,3.0,1.0,2.0,7.0,14.0,14.0,12.0,14.0,8.0,12.0,10.0,5.0,4.0,10.0,13.0,4.0,15.0,9.0,10.0,12.0,11.0,12.0,10.0,12.0,15.0,14.0,8.0,13.0,7.0,10.0,14.0,15.0,14.0,13.0,10.0,20.0,13.0,14.0,8.0,12.0,11.0,14.0,9.0,15.0,16.0,8.0,11.0,15.0,13.0,14.0,14.0,12.0,12.0,8.0,17.0,0.0,0.0,0.0,0.0,193.0,82.0,13.0,11.0,12.0,2.0,12.0,10.0,14.0,15.0,14.0,12.0,10.0,3.0,1.0,1.0,3.0,5.0,6.0,2.0,2.0,1.0,3.0,9.0,3.0,1.0,8.0,7.0,12.0,13.0,13.0,13.0,11.0,11.0,15.0,3.0,8.0,3.0,12.0,12.0,11.0,10.0,12.0,14.0,17.0,5.0,15.0,11.0,20.0,13.0,12.0,13.0,8.0,11.0,5.0,11.0,13.0,15.0,15.0,17.0,14.0,15.0,15.0,5.0,23.0,5.0,0.0,13.0,0.0,186.0,82.0,3.0,3.0,1.0,4.0,3.0,1.0,2.0,1.0,2.0,1.0,2.0,4.0,8.0,8.0,5.0,11.0,6.0,13.0,8.0,6.0,14.0,10.0,7.0,13.0,11.0,14.0,13.0,14.0,11.0,11.0,9.0,11.0,14.0,8.0,11.0,9.0,15.0,12.0,12.0,14.0,12.0,14.0,13.0,8.0,15.0,14.0,20.0,14.0,14.0,15.0,14.0,13.0,6.0,10.0,15.0,13.0,12.0,12.0,14.0,11.0,13.0,9.0,19.0,0.0,0.0,0.0,0.0,194.0,92.0,2.0,1.0,3.0,3.0,3.0,3.0,1.0,3.0,3.0,2.0,1.0,3.0,3.0,5.0,6.0,10.0,5.0,16.0,10.0,8.0,12.0,9.0,4.0,15.0,11.0,14.0,11.0,12.0,10.0,11.0,10.0,12.0,15.0,3.0,13.0,13.0,12.0,14.0,14.0,11.0,8.0,15.0,17.0,5.0,16.0,12.0,20.0,12.0,16.0,12.0,13.0,12.0,5.0,7.0,10.0,14.0,13.0,8.0,10.0,11.0,18.0,6.0,26.0,0.0,0.0,0.0,0.0,187.0,78.0,2.0,1.0,2.0,3.0,2.0,1.0,1.0,1.0,3.0,3.0,1.0,10.0,12.0,14.0,9.0,11.0,11.0,13.0,8.0,14.0,13.0,11.0,9.0,12.0,14.0,13.0,13.0,13.0,13.0,12.0,12.0,11.0,15.0,12.0,8.0,13.0,13.0,13.0,14.0,15.0,12.0,8.0,14.0,20.0,12.0,14.0,6.0,14.0,12.0,12.0,13.0,11.0,12.0,15.0,8.0,15.0,9.0,15.0,14.0,12.0,15.0,10.0,26.0,17.0,0.0,19.0,1.0,191.0,79.0,3.0,2.0,1.0,1.0,1.0,1.0,2.0,2.0,3.0,3.0,4.0,4.0,8.0,11.0,9.0,12.0,7.0,14.0,10.0,6.0,12.0,13.0,7.0,11.0,12.0,14.0,13.0,14.0,12.0,10.0,11.0,12.0,15.0,9.0,7.0,11.0,12.0,12.0,15.0,14.0,13.0,16.0,15.0,8.0,15.0,13.0,20.0,19.0,15.0,11.0,14.0,14.0,7.0,12.0,12.0,14.0,12.0,10.0,9.0,14.0,14.0,14.0,21.0,0.0,0.0,0.0,0.0,188.0,80.0,1.0,2.0,2.0,3.0,2.0,2.0,2.0,2.0,1.0,1.0,1.0,6.0,9.0,12.0,6.0,12.0,12.0,12.0,11.0,3.0,12.0,13.0,8.0,13.0,13.0,13.0,13.0,13.0,13.0,13.0,13.0,13.0,13.0,8.0,11.0,11.0,13.0,15.0,13.0,12.0,12.0,13.0,14.0,20.0,14.0,11.0,5.0,13.0,14.0,12.0,11.0,3.0,6.0,8.0,17.0,12.0,13.0,13.0,14.0,14.0,14.0,6.0,23.0,11.0,0.0,0.0,0.0,180.0,71.0,2.0,1.0,2.0,3.0,3.0,1.0,1.0,2.0,2.0,1.0,1.0,6.0,11.0,10.0,8.0,10.0,7.0,11.0,9.0,12.0,13.0,11.0,6.0,13.0,11.0,12.0,11.0,13.0,12.0,9.0,11.0,11.0,14.0,12.0,11.0,12.0,11.0,13.0,15.0,15.0,13.0,13.0,11.0,7.0,14.0,15.0,20.0,12.0,11.0,12.0,12.0,13.0,10.0,15.0,10.0,13.0,16.0,12.0,15.0,14.0,14.0,7.0,28.0,0.0,0.0,0.0,0.0,180.0,79.0,3.0,2.0,3.0,3.0,2.0,2.0,2.0,1.0,3.0,2.0,3.0,8.0,11.0,15.0,12.0,15.0,12.0,7.0,10.0,7.0,8.0,13.0,13.0,6.0,16.0,11.0,11.0,10.0,13.0,10.0,15.0,12.0,3.0,15.0,6.0,13.0,13.0,12.0,12.0,15.0,16.0,14.0,8.0,12.0,12.0,14.0,20.0,12.0,12.0,13.0,6.0,13.0,6.0,6.0,8.0,9.0,13.0,10.0,12.0,12.0,2.0,2.0,25.0,0.0,0.0,3.0,0.0,170.0,68.0,2.0,1.0,3.0,1.0,3.0,1.0,3.0,2.0,2.0,4.0,1.0,12.0,11.0,15.0,16.0,16.0,13.0,11.0,12.0,4.0,5.0,12.0,14.0,4.0,17.0,7.0,14.0,7.0,15.0,13.0,13.0,14.0,14.0,15.0,7.0,16.0,8.0,10.0,13.0,15.0,15.0,12.0,6.0,11.0,14.0,14.0,20.0,13.0,11.0,12.0,7.0,15.0,7.0,8.0,12.0,14.0,13.0,14.0,13.0,16.0,16.0,8.0,32.0,0.0,0.0,0.0,0.0,183.0,67.0,1.0,2.0,3.0,2.0,3.0,2.0,3.0,1.0,2.0,2.0,2.0,4.0,12.0,11.0,6.0,5.0,5.0,4.0,8.0,11.0,13.0,11.0,5.0,13.0,11.0,11.0,11.0,12.0,11.0,11.0,9.0,12.0,11.0,12.0,10.0,12.0,11.0,12.0,12.0,14.0,13.0,13.0,8.0,8.0,13.0,13.0,20.0,14.0,14.0,10.0,12.0,11.0,8.0,11.0,11.0,10.0,10.0,12.0,11.0,9.0,10.0,12.0,24.0,0.0,0.0,15.0,3.0,190.0,87.0,1.0,3.0,2.0,2.0,3.0,3.0,2.0,2.0,1.0,1.0,2.0,8.0,9.0,13.0,12.0,12.0,8.0,12.0,14.0,8.0,7.0,11.0,12.0,10.0,11.0,8.0,12.0,11.0,12.0,11.0,11.0,11.0,12.0,12.0,7.0,12.0,9.0,8.0,10.0,12.0,13.0,12.0,13.0,12.0,14.0,12.0,20.0,12.0,12.0,12.0,6.0,12.0,9.0,8.0,10.0,17.0,7.0,8.0,6.0,7.0,10.0,14.0
3,0,33.0,101.0,0.0,0.0,0.0,182.0,87.0,12.0,11.0,15.0,12.0,14.0,13.0,14.0,15.0,15.0,13.0,12.0,9.0,2.0,3.0,8.0,9.0,11.0,10.0,11.0,1.0,3.0,12.0,15.0,8.0,10.0,8.0,14.0,14.0,14.0,12.0,9.0,12.0,16.0,9.0,15.0,2.0,13.0,12.0,6.0,12.0,13.0,14.0,13.0,8.0,13.0,10.0,20.0,12.0,15.0,13.0,8.0,15.0,5.0,1.0,13.0,15.0,13.0,15.0,18.0,18.0,15.0,5.0,20.0,0.0,0.0,7.0,0.0,186.0,76.0,3.0,1.0,2.0,4.0,3.0,1.0,1.0,2.0,3.0,3.0,1.0,5.0,9.0,12.0,6.0,12.0,5.0,11.0,9.0,10.0,13.0,14.0,10.0,12.0,14.0,14.0,16.0,14.0,16.0,11.0,12.0,13.0,13.0,9.0,10.0,8.0,13.0,15.0,10.0,10.0,11.0,13.0,13.0,10.0,14.0,12.0,20.0,12.0,11.0,13.0,8.0,11.0,6.0,15.0,7.0,14.0,13.0,10.0,14.0,15.0,17.0,6.0,24.0,0.0,0.0,0.0,0.0,187.0,93.0,4.0,3.0,2.0,1.0,2.0,2.0,2.0,2.0,1.0,2.0,1.0,4.0,5.0,6.0,6.0,12.0,6.0,15.0,8.0,6.0,15.0,10.0,6.0,13.0,9.0,14.0,13.0,16.0,12.0,14.0,7.0,12.0,15.0,5.0,8.0,6.0,12.0,14.0,15.0,9.0,10.0,18.0,13.0,6.0,14.0,12.0,20.0,15.0,17.0,13.0,14.0,14.0,11.0,10.0,19.0,14.0,15.0,11.0,13.0,14.0,14.0,5.0,32.0,0.0,0.0,0.0,0.0,195.0,89.0,3.0,2.0,3.0,1.0,4.0,2.0,4.0,2.0,3.0,1.0,2.0,3.0,5.0,5.0,11.0,8.0,8.0,14.0,9.0,11.0,15.0,12.0,9.0,13.0,8.0,16.0,13.0,19.0,10.0,14.0,8.0,13.0,16.0,5.0,15.0,10.0,15.0,15.0,14.0,8.0,8.0,16.0,17.0,5.0,11.0,10.0,20.0,13.0,17.0,13.0,12.0,15.0,7.0,5.0,12.0,14.0,14.0,12.0,15.0,8.0,8.0,7.0,23.0,0.0,0.0,1.0,0.0,182.0,71.0,3.0,1.0,2.0,3.0,4.0,2.0,3.0,1.0,2.0,1.0,3.0,9.0,13.0,14.0,8.0,14.0,13.0,12.0,10.0,13.0,14.0,14.0,13.0,15.0,13.0,14.0,14.0,13.0,11.0,12.0,12.0,13.0,16.0,12.0,12.0,15.0,13.0,14.0,15.0,15.0,13.0,14.0,12.0,9.0,16.0,15.0,20.0,15.0,15.0,15.0,10.0,14.0,6.0,12.0,8.0,15.0,14.0,16.0,15.0,15.0,16.0,6.0,32.0,13.0,0.0,19.0,1.0,172.0,72.0,3.0,1.0,3.0,2.0,1.0,2.0,2.0,2.0,3.0,1.0,1.0,7.0,12.0,12.0,5.0,13.0,7.0,6.0,9.0,9.0,12.0,14.0,9.0,14.0,12.0,13.0,14.0,14.0,15.0,15.0,10.0,13.0,17.0,7.0,18.0,8.0,15.0,18.0,15.0,12.0,14.0,12.0,6.0,10.0,16.0,13.0,20.0,15.0,12.0,15.0,9.0,15.0,5.0,10.0,12.0,16.0,14.0,13.0,15.0,18.0,18.0,5.0,33.0,14.0,0.0,0.0,0.0,172.0,68.0,3.0,3.0,1.0,1.0,1.0,1.0,1.0,3.0,1.0,2.0,1.0,14.0,11.0,13.0,8.0,14.0,13.0,7.0,13.0,4.0,10.0,13.0,10.0,12.0,14.0,11.0,13.0,14.0,13.0,13.0,12.0,14.0,15.0,10.0,13.0,12.0,13.0,16.0,17.0,13.0,13.0,12.0,7.0,10.0,14.0,12.0,20.0,14.0,9.0,14.0,11.0,15.0,10.0,12.0,20.0,13.0,13.0,15.0,14.0,13.0,12.0,8.0,36.0,0.0,0.0,3.0,0.0,168.0,72.0,3.0,2.0,1.0,3.0,1.0,3.0,3.0,1.0,3.0,3.0,1.0,11.0,8.0,12.0,5.0,13.0,11.0,8.0,13.0,6.0,12.0,13.0,8.0,14.0,13.0,17.0,14.0,17.0,14.0,15.0,13.0,14.0,17.0,12.0,16.0,10.0,15.0,16.0,14.0,10.0,13.0,14.0,4.0,8.0,16.0,8.0,20.0,12.0,13.0,17.0,14.0,14.0,7.0,10.0,19.0,15.0,14.0,16.0,15.0,9.0,9.0,7.0,28.0,0.0,0.0,0.0,0.0,168.0,65.0,3.0,4.0,1.0,1.0,2.0,3.0,1.0,2.0,2.0,1.0,2.0,14.0,14.0,15.0,8.0,14.0,14.0,9.0,8.0,7.0,8.0,13.0,10.0,7.0,14.0,12.0,12.0,12.0,13.0,13.0,13.0,12.0,15.0,13.0,6.0,11.0,7.0,14.0,14.0,16.0,14.0,10.0,6.0,20.0,13.0,15.0,5.0,13.0,9.0,12.0,12.0,14.0,9.0,6.0,18.0,14.0,14.0,14.0,14.0,13.0,13.0,6.0,22.0,2.0,0.0,0.0,0.0,169.0,59.0,3.0,1.0,3.0,1.0,1.0,1.0,1.0,1.0,3.0,3.0,2.0,13.0,13.0,15.0,13.0,15.0,13.0,7.0,13.0,8.0,6.0,13.0,13.0,5.0,16.0,10.0,10.0,8.0,13.0,11.0,14.0,12.0,12.0,14.0,10.0,12.0,6.0,10.0,8.0,16.0,15.0,17.0,6.0,12.0,12.0,15.0,20.0,13.0,9.0,12.0,8.0,12.0,8.0,12.0,13.0,13.0,13.0,14.0,12.0,10.0,13.0,9.0,21.0,0.0,0.0,9.0,6.0,178.0,72.0,1.0,1.0,1.0,1.0,2.0,3.0,2.0,3.0,3.0,4.0,3.0,5.0,8.0,15.0,13.0,15.0,6.0,11.0,10.0,5.0,3.0,10.0,13.0,3.0,14.0,10.0,12.0,11.0,12.0,10.0,12.0,9.0,12.0,16.0,5.0,14.0,7.0,7.0,11.0,13.0,14.0,13.0,9.0,12.0,13.0,12.0,20.0,13.0,11.0,10.0,10.0,8.0,7.0,8.0,8.0,11.0,11.0,9.0,7.0,13.0,10.0,5.0,25.0,0.0,0.0,0.0,0.0,187.0,83.0,11.0,14.0,12.0,8.0,13.0,11.0,14.0,15.0,13.0,13.0,9.0,8.0,1.0,1.0,1.0,11.0,11.0,1.0,2.0,2.0,1.0,10.0,3.0,2.0,11.0,8.0,12.0,14.0,12.0,12.0,10.0,12.0,14.0,6.0,14.0,2.0,12.0,12.0,8.0,13.0,15.0,14.0,13.0,20.0,15.0,11.0,5.0,14.0,13.0,13.0,8.0,8.0,10.0,1.0,9.0,13.0,14.0,12.0,15.0,15.0,15.0,5.0,27.0,1.0,0.0,3.0,0.0,186.0,83.0,2.0,2.0,2.0,2.0,1.0,4.0,2.0,3.0,3.0,3.0,2.0,5.0,9.0,9.0,8.0,10.0,6.0,16.0,8.0,7.0,14.0,11.0,6.0,15.0,12.0,14.0,15.0,16.0,13.0,12.0,8.0,13.0,14.0,8.0,11.0,8.0,14.0,15.0,15.0,15.0,9.0,15.0,12.0,8.0,13.0,14.0,20.0,14.0,17.0,15.0,13.0,13.0,10.0,8.0,9.0,14.0,9.0,13.0,15.0,15.0,15.0,6.0,26.0,11.0,0.0,4.0,0.0,183.0,79.0,3.0,2.0,1.0,2.0,2.0,2.0,3.0,2.0,2.0,2.0,1.0,5.0,7.0,9.0,6.0,10.0,11.0,15.0,11.0,7.0,14.0,10.0,7.0,13.0,10.0,14.0,13.0,15.0,13.0,12.0,10.0,12.0,17.0,8.0,11.0,10.0,13.0,15.0,16.0,13.0,13.0,16.0,13.0,5.0,15.0,13.0,20.0,16.0,15.0,13.0,14.0,15.0,7.0,14.0,16.0,12.0,14.0,14.0,15.0,14.0,14.0,5.0,26.0,14.0,0.0,0.0,0.0,181.0,74.0,2.0,1.0,1.0,1.0,3.0,2.0,3.0,1.0,3.0,3.0,2.0,6.0,13.0,8.0,5.0,12.0,7.0,12.0,8.0,11.0,13.0,12.0,6.0,14.0,10.0,14.0,12.0,14.0,10.0,12.0,8.0,8.0,14.0,6.0,6.0,12.0,11.0,14.0,15.0,16.0,14.0,14.0,11.0,5.0,14.0,14.0,20.0,16.0,14.0,12.0,13.0,14.0,8.0,10.0,8.0,14.0,12.0,13.0,15.0,15.0,15.0,6.0,22.0,12.0,2.0,13.0,0.0,170.0,71.0,2.0,2.0,1.0,3.0,2.0,2.0,1.0,1.0,1.0,3.0,2.0,15.0,15.0,12.0,10.0,14.0,15.0,8.0,13.0,12.0,9.0,13.0,10.0,10.0,14.0,14.0,16.0,10.0,17.0,14.0,12.0,16.0,14.0,12.0,8.0,14.0,10.0,17.0,16.0,16.0,17.0,10.0,6.0,20.0,17.0,13.0,8.0,15.0,7.0,15.0,6.0,15.0,8.0,17.0,13.0,13.0,12.0,12.0,14.0,16.0,16.0,8.0,26.0,0.0,0.0,0.0,0.0,177.0,68.0,4.0,2.0,1.0,2.0,3.0,1.0,1.0,2.0,3.0,3.0,3.0,12.0,13.0,11.0,8.0,13.0,11.0,8.0,10.0,8.0,10.0,13.0,10.0,12.0,13.0,7.0,12.0,10.0,13.0,11.0,15.0,13.0,14.0,11.0,7.0,14.0,10.0,14.0,14.0,13.0,15.0,12.0,9.0,20.0,15.0,14.0,5.0,15.0,8.0,13.0,7.0,14.0,6.0,12.0,11.0,12.0,14.0,13.0,16.0,16.0,16.0,5.0,29.0,0.0,0.0,0.0,0.0,188.0,74.0,1.0,2.0,3.0,3.0,2.0,3.0,1.0,3.0,2.0,1.0,1.0,4.0,8.0,10.0,6.0,13.0,7.0,14.0,9.0,6.0,13.0,12.0,8.0,13.0,13.0,12.0,14.0,13.0,14.0,11.0,13.0,12.0,14.0,6.0,13.0,8.0,14.0,15.0,15.0,9.0,12.0,14.0,14.0,10.0,13.0,10.0,20.0,16.0,12.0,13.0,12.0,15.0,9.0,11.0,11.0,14.0,14.0,12.0,15.0,13.0,13.0,6.0,22.0,18.0,0.0,0.0,0.0,179.0,75.0,1.0,4.0,2.0,1.0,1.0,1.0,3.0,1.0,1.0,3.0,2.0,7.0,8.0,12.0,8.0,13.0,10.0,11.0,12.0,11.0,11.0,11.0,10.0,14.0,13.0,15.0,12.0,15.0,8.0,12.0,10.0,12.0,14.0,12.0,10.0,13.0,12.0,13.0,17.0,14.0,14.0,13.0,10.0,9.0,15.0,15.0,20.0,15.0,14.0,13.0,13.0,12.0,11.0,12.0,13.0,15.0,9.0,10.0,12.0,10.0,10.0,4.0,31.0,0.0,0.0,0.0,0.0,175.0,65.0,3.0,4.0,1.0,1.0,3.0,3.0,3.0,2.0,4.0,3.0,3.0,14.0,13.0,13.0,7.0,14.0,12.0,7.0,12.0,7.0,6.0,14.0,15.0,8.0,15.0,11.0,12.0,13.0,13.0,11.0,14.0,12.0,15.0,13.0,9.0,11.0,10.0,12.0,13.0,14.0,15.0,12.0,7.0,20.0,10.0,13.0,10.0,12.0,9.0,12.0,11.0,15.0,16.0,13.0,8.0,14.0,14.0,14.0,13.0,13.0,13.0,7.0,22.0,0.0,0.0,0.0,0.0,180.0,72.0,2.0,1.0,1.0,3.0,4.0,3.0,2.0,1.0,3.0,3.0,2.0,6.0,10.0,11.0,13.0,12.0,10.0,9.0,11.0,6.0,7.0,12.0,10.0,3.0,13.0,12.0,12.0,7.0,12.0,12.0,10.0,13.0,10.0,11.0,8.0,11.0,6.0,13.0,14.0,14.0,12.0,13.0,10.0,5.0,13.0,14.0,20.0,10.0,11.0,10.0,7.0,10.0,5.0,10.0,9.0,11.0,15.0,11.0,12.0,10.0,16.0,4.0,27.0,33.0,4.0,3.0,0.0,180.0,75.0,2.0,1.0,2.0,1.0,4.0,2.0,1.0,3.0,1.0,1.0,2.0,12.0,11.0,13.0,13.0,11.0,11.0,11.0,10.0,7.0,5.0,10.0,14.0,5.0,14.0,9.0,11.0,12.0,10.0,11.0,12.0,12.0,14.0,13.0,8.0,14.0,8.0,11.0,14.0,16.0,14.0,13.0,10.0,7.0,12.0,15.0,20.0,14.0,12.0,12.0,9.0,13.0,10.0,10.0,9.0,15.0,8.0,9.0,13.0,14.0,14.0,7.0
5,1,25.0,0.0,0.0,11.0,0.0,189.0,83.0,12.0,12.0,11.0,7.0,13.0,12.0,17.0,17.0,16.0,12.0,13.0,6.0,2.0,1.0,1.0,10.0,10.0,7.0,1.0,1.0,1.0,9.0,5.0,1.0,10.0,8.0,15.0,14.0,14.0,12.0,7.0,13.0,12.0,6.0,9.0,3.0,16.0,17.0,10.0,13.0,16.0,14.0,12.0,8.0,15.0,10.0,20.0,13.0,14.0,14.0,5.0,14.0,4.0,12.0,15.0,15.0,13.0,13.0,17.0,15.0,17.0,4.0,31.0,0.0,0.0,0.0,0.0,171.0,65.0,1.0,3.0,1.0,3.0,2.0,2.0,3.0,1.0,2.0,2.0,3.0,8.0,9.0,11.0,7.0,5.0,6.0,5.0,6.0,7.0,14.0,14.0,6.0,14.0,13.0,14.0,12.0,13.0,12.0,11.0,11.0,12.0,12.0,11.0,7.0,12.0,12.0,12.0,10.0,15.0,15.0,7.0,9.0,9.0,12.0,14.0,20.0,12.0,13.0,11.0,13.0,11.0,9.0,10.0,15.0,14.0,12.0,11.0,14.0,13.0,12.0,7.0,29.0,56.0,3.0,0.0,0.0,189.0,84.0,3.0,2.0,2.0,1.0,2.0,2.0,2.0,2.0,2.0,1.0,3.0,8.0,9.0,13.0,12.0,13.0,14.0,14.0,12.0,18.0,17.0,12.0,15.0,16.0,13.0,17.0,16.0,16.0,12.0,10.0,10.0,11.0,17.0,12.0,15.0,12.0,11.0,13.0,16.0,17.0,15.0,16.0,16.0,10.0,16.0,15.0,20.0,14.0,13.0,10.0,12.0,13.0,10.0,13.0,15.0,16.0,18.0,13.0,16.0,11.0,10.0,7.0,28.0,0.0,0.0,0.0,0.0,169.0,0.0,3.0,3.0,2.0,3.0,3.0,1.0,1.0,3.0,2.0,1.0,3.0,5.0,8.0,11.0,9.0,8.0,8.0,7.0,8.0,4.0,2.0,9.0,5.0,3.0,11.0,11.0,11.0,13.0,9.0,11.0,8.0,15.0,14.0,11.0,7.0,10.0,8.0,8.0,10.0,11.0,11.0,6.0,5.0,14.0,11.0,12.0,20.0,14.0,5.0,9.0,12.0,9.0,5.0,6.0,9.0,12.0,11.0,9.0,9.0,10.0,12.0,11.0,23.0,25.0,0.0,0.0,0.0,174.0,74.0,2.0,1.0,1.0,1.0,3.0,3.0,3.0,3.0,3.0,1.0,2.0,8.0,13.0,12.0,8.0,12.0,8.0,14.0,9.0,13.0,14.0,12.0,6.0,16.0,13.0,13.0,14.0,15.0,13.0,11.0,10.0,12.0,15.0,9.0,10.0,14.0,11.0,14.0,17.0,16.0,13.0,14.0,10.0,8.0,17.0,15.0,20.0,18.0,15.0,14.0,13.0,14.0,8.0,12.0,12.0,14.0,13.0,13.0,12.0,12.0,15.0,13.0,33.0,30.0,1.0,0.0,0.0,187.0,83.0,1.0,3.0,4.0,2.0,1.0,1.0,2.0,3.0,1.0,1.0,3.0,13.0,13.0,12.0,8.0,16.0,10.0,16.0,13.0,10.0,14.0,16.0,13.0,16.0,15.0,13.0,15.0,14.0,16.0,15.0,14.0,14.0,13.0,11.0,13.0,10.0,17.0,18.0,10.0,10.0,12.0,17.0,14.0,20.0,12.0,12.0,10.0,13.0,16.0,16.0,16.0,15.0,13.0,11.0,16.0,16.0,13.0,15.0,12.0,8.0,8.0,11.0,21.0,0.0,0.0,15.0,1.0,189.0,75.0,3.0,3.0,3.0,3.0,1.0,1.0,3.0,3.0,3.0,2.0,3.0,10.0,12.0,13.0,7.0,14.0,8.0,14.0,12.0,5.0,13.0,15.0,8.0,15.0,14.0,14.0,14.0,15.0,14.0,14.0,13.0,14.0,15.0,12.0,10.0,12.0,14.0,15.0,16.0,12.0,13.0,15.0,14.0,20.0,14.0,13.0,10.0,16.0,13.0,14.0,11.0,14.0,7.0,10.0,8.0,16.0,10.0,12.0,13.0,13.0,11.0,14.0,29.0,51.0,8.0,24.0,0.0,175.0,70.0,3.0,4.0,2.0,3.0,2.0,3.0,2.0,2.0,2.0,1.0,3.0,6.0,12.0,12.0,10.0,13.0,7.0,12.0,12.0,8.0,14.0,13.0,9.0,16.0,13.0,14.0,16.0,16.0,15.0,16.0,11.0,14.0,16.0,8.0,14.0,14.0,15.0,18.0,18.0,15.0,14.0,16.0,8.0,20.0,16.0,14.0,8.0,18.0,14.0,16.0,13.0,14.0,7.0,14.0,15.0,14.0,14.0,14.0,16.0,16.0,16.0,5.0,28.0,66.0,15.0,13.0,3.0,180.0,70.0,2.0,2.0,1.0,2.0,1.0,1.0,3.0,2.0,3.0,3.0,1.0,14.0,15.0,16.0,13.0,17.0,15.0,6.0,15.0,4.0,5.0,16.0,14.0,8.0,17.0,13.0,16.0,11.0,15.0,13.0,16.0,14.0,13.0,17.0,10.0,14.0,9.0,13.0,13.0,16.0,18.0,12.0,10.0,20.0,14.0,15.0,8.0,16.0,9.0,13.0,14.0,12.0,10.0,15.0,14.0,15.0,10.0,16.0,14.0,6.0,12.0,10.0,34.0,116.0,62.0,7.0,6.0,195.0,95.0,1.0,1.0,3.0,1.0,1.0,3.0,4.0,1.0,2.0,3.0,2.0,5.0,12.0,15.0,16.0,18.0,14.0,14.0,16.0,8.0,6.0,15.0,18.0,6.0,18.0,16.0,16.0,15.0,13.0,13.0,16.0,14.0,14.0,19.0,16.0,15.0,4.0,13.0,8.0,12.0,15.0,20.0,18.0,16.0,16.0,14.0,20.0,15.0,18.0,16.0,13.0,11.0,11.0,8.0,15.0,20.0,11.0,15.0,14.0,7.0,7.0,13.0,29.0,76.0,27.0,13.0,9.0,188.0,72.0,2.0,3.0,1.0,2.0,3.0,3.0,1.0,3.0,3.0,3.0,3.0,5.0,10.0,13.0,16.0,13.0,11.0,17.0,13.0,5.0,10.0,13.0,14.0,10.0,13.0,15.0,16.0,18.0,14.0,15.0,10.0,13.0,14.0,13.0,10.0,18.0,12.0,14.0,19.0,15.0,14.0,16.0,14.0,10.0,18.0,16.0,20.0,18.0,14.0,14.0,8.0,15.0,5.0,16.0,10.0,16.0,12.0,14.0,16.0,14.0,10.0,10.0,25.0,4.0,0.0,11.0,0.0,184.0,81.0,14.0,14.0,13.0,9.0,15.0,12.0,16.0,16.0,13.0,7.0,11.0,8.0,1.0,2.0,1.0,11.0,12.0,6.0,1.0,3.0,3.0,11.0,5.0,3.0,11.0,8.0,15.0,15.0,13.0,14.0,10.0,11.0,14.0,8.0,13.0,5.0,13.0,10.0,10.0,14.0,16.0,14.0,13.0,20.0,14.0,12.0,5.0,14.0,14.0,15.0,9.0,16.0,6.0,1.0,17.0,11.0,15.0,13.0,14.0,12.0,12.0,4.0,27.0,4.0,0.0,5.0,1.0,184.0,83.0,2.0,4.0,3.0,1.0,1.0,2.0,1.0,2.0,4.0,2.0,3.0,4.0,8.0,11.0,4.0,10.0,4.0,14.0,4.0,4.0,15.0,12.0,5.0,16.0,11.0,14.0,14.0,16.0,14.0,10.0,11.0,12.0,17.0,7.0,10.0,9.0,13.0,14.0,15.0,14.0,13.0,16.0,13.0,10.0,15.0,13.0,20.0,15.0,16.0,12.0,12.0,14.0,6.0,12.0,11.0,13.0,12.0,12.0,16.0,15.0,14.0,6.0,19.0,0.0,0.0,3.0,1.0,181.0,69.0,3.0,2.0,3.0,3.0,2.0,1.0,1.0,1.0,3.0,3.0,4.0,10.0,10.0,12.0,12.0,12.0,7.0,8.0,11.0,5.0,7.0,10.0,10.0,7.0,11.0,8.0,10.0,10.0,12.0,8.0,11.0,8.0,14.0,13.0,6.0,14.0,8.0,13.0,13.0,16.0,14.0,13.0,9.0,20.0,15.0,16.0,10.0,15.0,13.0,12.0,8.0,11.0,7.0,12.0,11.0,11.0,15.0,10.0,12.0,14.0,14.0,1.0,32.0,52.0,1.0,0.0,0.0,180.0,80.0,2.0,3.0,2.0,2.0,1.0,4.0,1.0,2.0,3.0,4.0,3.0,7.0,12.0,12.0,6.0,12.0,7.0,12.0,11.0,13.0,13.0,11.0,9.0,13.0,12.0,13.0,13.0,15.0,12.0,10.0,11.0,12.0,16.0,12.0,10.0,13.0,11.0,13.0,14.0,15.0,13.0,14.0,10.0,20.0,12.0,14.0,5.0,15.0,14.0,10.0,13.0,12.0,7.0,8.0,12.0,15.0,13.0,12.0,13.0,14.0,14.0,9.0,37.0,0.0,0.0,0.0,0.0,185.0,83.0,1.0,1.0,2.0,1.0,3.0,2.0,3.0,1.0,1.0,3.0,1.0,6.0,8.0,9.0,12.0,10.0,8.0,13.0,9.0,4.0,5.0,10.0,14.0,4.0,11.0,11.0,10.0,11.0,13.0,12.0,12.0,13.0,15.0,14.0,12.0,11.0,7.0,12.0,8.0,7.0,7.0,12.0,12.0,11.0,11.0,7.0,20.0,8.0,14.0,12.0,8.0,13.0,9.0,12.0,12.0,12.0,19.0,14.0,15.0,14.0,8.0,8.0,32.0,0.0,0.0,0.0,0.0,172.0,71.0,2.0,1.0,3.0,1.0,2.0,3.0,2.0,3.0,2.0,2.0,2.0,8.0,9.0,7.0,6.0,10.0,6.0,10.0,9.0,10.0,14.0,11.0,6.0,14.0,11.0,10.0,16.0,15.0,12.0,12.0,7.0,12.0,15.0,9.0,13.0,8.0,14.0,15.0,15.0,14.0,14.0,14.0,10.0,20.0,14.0,14.0,8.0,15.0,13.0,13.0,11.0,13.0,7.0,13.0,17.0,14.0,17.0,8.0,13.0,15.0,15.0,6.0,27.0,8.0,0.0,6.0,0.0,187.0,76.0,3.0,2.0,3.0,2.0,2.0,1.0,1.0,3.0,3.0,1.0,2.0,5.0,7.0,11.0,5.0,14.0,5.0,14.0,9.0,5.0,15.0,15.0,8.0,14.0,13.0,15.0,16.0,15.0,14.0,12.0,14.0,14.0,18.0,8.0,17.0,9.0,12.0,18.0,15.0,13.0,14.0,15.0,14.0,10.0,17.0,12.0,20.0,17.0,15.0,14.0,13.0,16.0,4.0,12.0,10.0,14.0,17.0,12.0,15.0,13.0,13.0,6.0,24.0,0.0,0.0,6.0,1.0,172.0,70.0,3.0,1.0,1.0,3.0,1.0,2.0,3.0,1.0,1.0,3.0,3.0,11.0,12.0,11.0,8.0,12.0,10.0,6.0,14.0,7.0,11.0,15.0,8.0,12.0,13.0,14.0,14.0,18.0,13.0,12.0,13.0,13.0,15.0,12.0,12.0,12.0,11.0,18.0,18.0,13.0,14.0,13.0,7.0,10.0,16.0,12.0,20.0,14.0,12.0,14.0,14.0,15.0,4.0,8.0,7.0,14.0,14.0,13.0,14.0,12.0,10.0,6.0,21.0,0.0,0.0,15.0,3.0,181.0,78.0,3.0,3.0,4.0,2.0,1.0,2.0,2.0,4.0,2.0,1.0,1.0,5.0,7.0,11.0,10.0,14.0,5.0,14.0,10.0,6.0,13.0,14.0,8.0,14.0,14.0,12.0,14.0,12.0,11.0,10.0,12.0,11.0,16.0,11.0,12.0,14.0,14.0,14.0,14.0,14.0,13.0,14.0,13.0,10.0,16.0,14.0,20.0,16.0,14.0,12.0,10.0,11.0,5.0,19.0,8.0,11.0,14.0,11.0,16.0,13.0,13.0,10.0,25.0,5.0,0.0,5.0,0.0,186.0,72.0,1.0,2.0,1.0,2.0,2.0,3.0,3.0,3.0,3.0,3.0,2.0,13.0,12.0,14.0,9.0,16.0,15.0,11.0,12.0,5.0,8.0,16.0,11.0,10.0,15.0,8.0,13.0,11.0,14.0,13.0,15.0,14.0,15.0,14.0,11.0,13.0,10.0,12.0,12.0,13.0,14.0,14.0,10.0,10.0,13.0,11.0,20.0,11.0,11.0,13.0,9.0,15.0,13.0,7.0,15.0,17.0,14.0,13.0,15.0,15.0,15.0,7.0,28.0,2.0,1.0,0.0,0.0,174.0,66.0,2.0,2.0,2.0,1.0,1.0,3.0,2.0,3.0,3.0,1.0,4.0,6.0,11.0,13.0,15.0,13.0,11.0,14.0,11.0,6.0,5.0,10.0,12.0,5.0,13.0,8.0,14.0,10.0,13.0,14.0,8.0,12.0,12.0,12.0,5.0,14.0,8.0,12.0,11.0,17.0,15.0,11.0,12.0,7.0,14.0,15.0,20.0,13.0,10.0,12.0,8.0,14.0,8.0,8.0,19.0,15.0,12.0,10.0,11.0,13.0,13.0,12.0
0,3,36.0,0.0,0.0,0.0,0.0,185.0,78.0,11.0,14.0,12.0,7.0,13.0,12.0,14.0,15.0,13.0,14.0,10.0,4.0,1.0,3.0,1.0,8.0,8.0,11.0,8.0,3.0,3.0,7.0,2.0,1.0,8.0,11.0,13.0,15.0,11.0,12.0,7.0,13.0,9.0,5.0,14.0,3.0,13.0,15.0,8.0,11.0,14.0,13.0,12.0,5.0,15.0,11.0,20.0,12.0,14.0,13.0,11.0,13.0,8.0,1.0,19.0,14.0,16.0,10.0,17.0,9.0,9.0,11.0,28.0,0.0,0.0,0.0,0.0,183.0,81.0,1.0,2.0,4.0,1.0,1.0,3.0,2.0,3.0,3.0,3.0,1.0,5.0,5.0,6.0,10.0,12.0,6.0,14.0,8.0,6.0,15.0,11.0,6.0,13.0,12.0,13.0,14.0,16.0,14.0,14.0,10.0,12.0,14.0,5.0,14.0,8.0,14.0,15.0,15.0,9.0,12.0,15.0,13.0,7.0,11.0,12.0,20.0,15.0,15.0,14.0,14.0,14.0,9.0,8.0,14.0,14.0,11.0,13.0,15.0,13.0,15.0,6.0,27.0,25.0,1.0,0.0,0.0,189.0,82.0,3.0,1.0,3.0,4.0,3.0,1.0,3.0,3.0,1.0,2.0,3.0,6.0,7.0,5.0,8.0,9.0,8.0,12.0,8.0,6.0,14.0,13.0,11.0,14.0,5.0,12.0,14.0,15.0,13.0,13.0,8.0,13.0,12.0,5.0,11.0,5.0,13.0,15.0,14.0,12.0,12.0,14.0,15.0,6.0,16.0,12.0,20.0,13.0,14.0,11.0,10.0,12.0,5.0,8.0,11.0,13.0,14.0,17.0,8.0,6.0,8.0,13.0,24.0,9.0,0.0,0.0,0.0,173.0,66.0,1.0,1.0,2.0,3.0,2.0,1.0,3.0,2.0,1.0,2.0,3.0,8.0,11.0,11.0,6.0,11.0,7.0,12.0,6.0,10.0,9.0,12.0,10.0,13.0,12.0,12.0,12.0,12.0,12.0,10.0,12.0,10.0,15.0,11.0,6.0,8.0,11.0,13.0,13.0,14.0,14.0,12.0,9.0,8.0,13.0,13.0,20.0,13.0,11.0,13.0,12.0,14.0,8.0,10.0,7.0,12.0,18.0,13.0,14.0,14.0,13.0,5.0,24.0,0.0,0.0,0.0,0.0,179.0,68.0,3.0,2.0,3.0,2.0,1.0,3.0,3.0,1.0,3.0,3.0,1.0,4.0,13.0,9.0,6.0,12.0,9.0,12.0,7.0,8.0,12.0,14.0,8.0,14.0,12.0,15.0,14.0,13.0,14.0,13.0,10.0,12.0,14.0,10.0,9.0,9.0,10.0,13.0,14.0,14.0,12.0,13.0,9.0,9.0,8.0,14.0,20.0,15.0,14.0,11.0,11.0,13.0,10.0,14.0,13.0,14.0,14.0,11.0,16.0,15.0,15.0,6.0,36.0,0.0,0.0,0.0,0.0,180.0,72.0,1.0,2.0,4.0,1.0,1.0,2.0,2.0,1.0,1.0,1.0,2.0,6.0,10.0,8.0,6.0,11.0,8.0,13.0,10.0,7.0,11.0,11.0,8.0,13.0,11.0,13.0,13.0,14.0,14.0,13.0,11.0,12.0,13.0,7.0,10.0,10.0,13.0,13.0,15.0,11.0,12.0,14.0,10.0,10.0,14.0,10.0,20.0,12.0,11.0,12.0,14.0,14.0,5.0,15.0,20.0,12.0,20.0,14.0,16.0,15.0,15.0,5.0,30.0,0.0,0.0,0.0,0.0,167.0,60.0,3.0,1.0,1.0,2.0,3.0,1.0,1.0,3.0,1.0,1.0,3.0,10.0,11.0,12.0,8.0,13.0,10.0,6.0,9.0,10.0,12.0,14.0,9.0,10.0,14.0,11.0,14.0,14.0,14.0,14.0,13.0,14.0,12.0,14.0,11.0,13.0,12.0,15.0,15.0,15.0,14.0,11.0,5.0,11.0,11.0,15.0,20.0,11.0,8.0,14.0,10.0,12.0,13.0,11.0,11.0,12.0,11.0,10.0,12.0,11.0,11.0,2.0,33.0,0.0,0.0,0.0,0.0,187.0,76.0,2.0,2.0,3.0,1.0,1.0,3.0,2.0,1.0,2.0,3.0,2.0,15.0,14.0,14.0,10.0,15.0,13.0,10.0,12.0,7.0,4.0,15.0,13.0,7.0,15.0,6.0,12.0,9.0,14.0,11.0,15.0,12.0,12.0,14.0,12.0,13.0,7.0,13.0,12.0,11.0,12.0,14.0,12.0,14.0,15.0,12.0,20.0,11.0,12.0,12.0,6.0,14.0,6.0,11.0,14.0,13.0,12.0,12.0,15.0,15.0,13.0,9.0,30.0,0.0,0.0,0.0,0.0,178.0,73.0,3.0,4.0,1.0,1.0,2.0,4.0,3.0,2.0,2.0,2.0,3.0,13.0,14.0,12.0,7.0,13.0,12.0,7.0,13.0,5.0,10.0,13.0,9.0,10.0,13.0,11.0,11.0,12.0,12.0,13.0,11.0,14.0,14.0,11.0,7.0,11.0,10.0,13.0,15.0,13.0,15.0,15.0,8.0,20.0,14.0,14.0,8.0,14.0,11.0,13.0,11.0,14.0,8.0,10.0,19.0,12.0,12.0,9.0,12.0,12.0,10.0,10.0,26.0,0.0,0.0,0.0,0.0,193.0,81.0,1.0,3.0,3.0,3.0,3.0,1.0,2.0,2.0,2.0,3.0,3.0,4.0,9.0,14.0,10.0,13.0,12.0,14.0,14.0,5.0,5.0,10.0,12.0,3.0,14.0,8.0,13.0,12.0,9.0,10.0,11.0,11.0,12.0,16.0,5.0,14.0,6.0,9.0,12.0,14.0,13.0,14.0,16.0,14.0,13.0,13.0,20.0,13.0,14.0,10.0,8.0,14.0,9.0,8.0,16.0,16.0,11.0,13.0,11.0,13.0,13.0,10.0,24.0,0.0,0.0,0.0,0.0,182.0,82.0,3.0,3.0,2.0,1.0,1.0,3.0,2.0,2.0,3.0,2.0,2.0,4.0,7.0,13.0,14.0,13.0,12.0,14.0,12.0,5.0,7.0,10.0,14.0,6.0,15.0,13.0,13.0,16.0,8.0,12.0,11.0,11.0,12.0,14.0,7.0,13.0,8.0,12.0,13.0,14.0,14.0,15.0,12.0,10.0,10.0,12.0,20.0,16.0,15.0,12.0,13.0,14.0,10.0,8.0,8.0,13.0,5.0,10.0,11.0,9.0,9.0,13.0,25.0,0.0,0.0,11.0,0.0,189.0,83.0,12.0,12.0,11.0,7.0,13.0,12.0,17.0,17.0,16.0,12.0,13.0,6.0,2.0,1.0,1.0,10.0,10.0,7.0,1.0,1.0,1.0,9.0,5.0,1.0,10.0,8.0,15.0,14.0,14.0,12.0,7.0,13.0,12.0,6.0,9.0,3.0,16.0,17.0,10.0,13.0,16.0,14.0,12.0,8.0,15.0,10.0,20.0,13.0,14.0,14.0,5.0,14.0,4.0,12.0,15.0,15.0,13.0,13.0,17.0,15.0,17.0,4.0,29.0,56.0,3.0,0.0,0.0,189.0,84.0,3.0,2.0,2.0,1.0,2.0,2.0,2.0,2.0,2.0,1.0,3.0,8.0,9.0,13.0,12.0,13.0,14.0,14.0,12.0,18.0,17.0,12.0,15.0,16.0,13.0,17.0,16.0,16.0,12.0,10.0,10.0,11.0,17.0,12.0,15.0,12.0,11.0,13.0,16.0,17.0,15.0,16.0,16.0,10.0,16.0,15.0,20.0,14.0,13.0,10.0,12.0,13.0,10.0,13.0,15.0,16.0,18.0,13.0,16.0,11.0,10.0,7.0,31.0,0.0,0.0,0.0,0.0,171.0,65.0,1.0,3.0,1.0,3.0,2.0,2.0,3.0,1.0,2.0,2.0,3.0,8.0,9.0,11.0,7.0,5.0,6.0,5.0,6.0,7.0,14.0,14.0,6.0,14.0,13.0,14.0,12.0,13.0,12.0,11.0,11.0,12.0,12.0,11.0,7.0,12.0,12.0,12.0,10.0,15.0,15.0,7.0,9.0,9.0,12.0,14.0,20.0,12.0,13.0,11.0,13.0,11.0,9.0,10.0,15.0,14.0,12.0,11.0,14.0,13.0,12.0,7.0,28.0,0.0,0.0,0.0,0.0,169.0,0.0,3.0,3.0,2.0,3.0,3.0,1.0,1.0,3.0,2.0,1.0,3.0,5.0,8.0,11.0,9.0,8.0,8.0,7.0,8.0,4.0,2.0,9.0,5.0,3.0,11.0,11.0,11.0,13.0,9.0,11.0,8.0,15.0,14.0,11.0,7.0,10.0,8.0,8.0,10.0,11.0,11.0,6.0,5.0,14.0,11.0,12.0,20.0,14.0,5.0,9.0,12.0,9.0,5.0,6.0,9.0,12.0,11.0,9.0,9.0,10.0,12.0,11.0,23.0,25.0,0.0,0.0,0.0,174.0,74.0,2.0,1.0,1.0,1.0,3.0,3.0,3.0,3.0,3.0,1.0,2.0,8.0,13.0,12.0,8.0,12.0,8.0,14.0,9.0,13.0,14.0,12.0,6.0,16.0,13.0,13.0,14.0,15.0,13.0,11.0,10.0,12.0,15.0,9.0,10.0,14.0,11.0,14.0,17.0,16.0,13.0,14.0,10.0,8.0,17.0,15.0,20.0,18.0,15.0,14.0,13.0,14.0,8.0,12.0,12.0,14.0,13.0,13.0,12.0,12.0,15.0,13.0,33.0,30.0,1.0,0.0,0.0,187.0,83.0,1.0,3.0,4.0,2.0,1.0,1.0,2.0,3.0,1.0,1.0,3.0,13.0,13.0,12.0,8.0,16.0,10.0,16.0,13.0,10.0,14.0,16.0,13.0,16.0,15.0,13.0,15.0,14.0,16.0,15.0,14.0,14.0,13.0,11.0,13.0,10.0,17.0,18.0,10.0,10.0,12.0,17.0,14.0,20.0,12.0,12.0,10.0,13.0,16.0,16.0,16.0,15.0,13.0,11.0,16.0,16.0,13.0,15.0,12.0,8.0,8.0,11.0,23.0,15.0,1.0,7.0,0.0,165.0,60.0,2.0,3.0,2.0,1.0,1.0,1.0,3.0,3.0,2.0,1.0,3.0,14.0,14.0,16.0,8.0,16.0,13.0,6.0,10.0,6.0,11.0,18.0,15.0,12.0,18.0,16.0,15.0,15.0,17.0,13.0,17.0,15.0,14.0,18.0,12.0,10.0,12.0,15.0,16.0,14.0,16.0,16.0,6.0,12.0,13.0,14.0,20.0,15.0,11.0,16.0,14.0,15.0,10.0,12.0,14.0,15.0,16.0,14.0,14.0,13.0,10.0,6.0,29.0,51.0,8.0,24.0,0.0,175.0,70.0,3.0,4.0,2.0,3.0,2.0,3.0,2.0,2.0,2.0,1.0,3.0,6.0,12.0,12.0,10.0,13.0,7.0,12.0,12.0,8.0,14.0,13.0,9.0,16.0,13.0,14.0,16.0,16.0,15.0,16.0,11.0,14.0,16.0,8.0,14.0,14.0,15.0,18.0,18.0,15.0,14.0,16.0,8.0,20.0,16.0,14.0,8.0,18.0,14.0,16.0,13.0,14.0,7.0,14.0,15.0,14.0,14.0,14.0,16.0,16.0,16.0,5.0,16.0,0.0,0.0,0.0,0.0,173.0,0.0,3.0,1.0,1.0,1.0,2.0,1.0,4.0,1.0,2.0,3.0,1.0,1.0,1.0,4.0,4.0,5.0,4.0,4.0,4.0,1.0,5.0,6.0,5.0,8.0,9.0,10.0,6.0,6.0,3.0,5.0,4.0,10.0,7.0,8.0,8.0,3.0,11.0,13.0,9.0,7.0,5.0,14.0,4.0,20.0,6.0,5.0,8.0,6.0,9.0,5.0,7.0,8.0,5.0,7.0,6.0,11.0,7.0,10.0,18.0,19.0,15.0,9.0,28.0,66.0,15.0,13.0,3.0,180.0,70.0,2.0,2.0,1.0,2.0,1.0,1.0,3.0,2.0,3.0,3.0,1.0,14.0,15.0,16.0,13.0,17.0,15.0,6.0,15.0,4.0,5.0,16.0,14.0,8.0,17.0,13.0,16.0,11.0,15.0,13.0,16.0,14.0,13.0,17.0,10.0,14.0,9.0,13.0,13.0,16.0,18.0,12.0,10.0,20.0,14.0,15.0,8.0,16.0,9.0,13.0,14.0,12.0,10.0,15.0,14.0,15.0,10.0,16.0,14.0,6.0,12.0,10.0,34.0,116.0,62.0,7.0,6.0,195.0,95.0,1.0,1.0,3.0,1.0,1.0,3.0,4.0,1.0,2.0,3.0,2.0,5.0,12.0,15.0,16.0,18.0,14.0,14.0,16.0,8.0,6.0,15.0,18.0,6.0,18.0,16.0,16.0,15.0,13.0,13.0,16.0,14.0,14.0,19.0,16.0,15.0,4.0,13.0,8.0,12.0,15.0,20.0,18.0,16.0,16.0,14.0,20.0,15.0,18.0,16.0,13.0,11.0,11.0,8.0,15.0,20.0,11.0,15.0,14.0,7.0,7.0,13.0
0,0,25.0,0.0,0.0,0.0,0.0,187.0,83.0,11.0,14.0,12.0,8.0,13.0,11.0,14.0,15.0,13.0,13.0,9.0,8.0,1.0,1.0,1.0,11.0,11.0,1.0,2.0,2.0,1.0,10.0,3.0,2.0,11.0,8.0,12.0,14.0,12.0,12.0,10.0,12.0,14.0,6.0,14.0,2.0,12.0,12.0,8.0,13.0,15.0,14.0,13.0,20.0,15.0,11.0,5.0,14.0,13.0,13.0,8.0,8.0,10.0,1.0,9.0,13.0,14.0,12.0,15.0,15.0,15.0,5.0,27.0,1.0,0.0,3.0,0.0,186.0,83.0,2.0,2.0,2.0,2.0,1.0,4.0,2.0,3.0,3.0,3.0,2.0,5.0,9.0,9.0,8.0,10.0,6.0,16.0,8.0,7.0,14.0,11.0,6.0,15.0,12.0,14.0,15.0,16.0,13.0,12.0,8.0,13.0,14.0,8.0,11.0,8.0,14.0,15.0,15.0,15.0,9.0,15.0,12.0,8.0,13.0,14.0,20.0,14.0,17.0,15.0,13.0,13.0,10.0,8.0,9.0,14.0,9.0,13.0,15.0,15.0,15.0,6.0,26.0,11.0,0.0,4.0,0.0,183.0,79.0,3.0,2.0,1.0,2.0,2.0,2.0,3.0,2.0,2.0,2.0,1.0,5.0,7.0,9.0,6.0,10.0,11.0,15.0,11.0,7.0,14.0,10.0,7.0,13.0,10.0,14.0,13.0,15.0,13.0,12.0,10.0,12.0,17.0,8.0,11.0,10.0,13.0,15.0,16.0,13.0,13.0,16.0,13.0,5.0,15.0,13.0,20.0,16.0,15.0,13.0,14.0,15.0,7.0,14.0,16.0,12.0,14.0,14.0,15.0,14.0,14.0,5.0,26.0,0.0,0.0,0.0,0.0,169.0,70.0,3.0,3.0,2.0,2.0,3.0,3.0,2.0,2.0,1.0,3.0,3.0,6.0,10.0,10.0,7.0,11.0,7.0,13.0,11.0,16.0,10.0,11.0,8.0,12.0,12.0,12.0,14.0,13.0,12.0,11.0,10.0,10.0,13.0,9.0,6.0,11.0,9.0,14.0,15.0,15.0,15.0,11.0,5.0,5.0,13.0,14.0,20.0,14.0,11.0,14.0,12.0,13.0,7.0,12.0,18.0,12.0,13.0,12.0,13.0,14.0,15.0,6.0,22.0,12.0,2.0,13.0,0.0,170.0,71.0,2.0,2.0,1.0,3.0,2.0,2.0,1.0,1.0,1.0,3.0,2.0,15.0,15.0,12.0,10.0,14.0,15.0,8.0,13.0,12.0,9.0,13.0,10.0,10.0,14.0,14.0,16.0,10.0,17.0,14.0,12.0,16.0,14.0,12.0,8.0,14.0,10.0,17.0,16.0,16.0,17.0,10.0,6.0,20.0,17.0,13.0,8.0,15.0,7.0,15.0,6.0,15.0,8.0,17.0,13.0,13.0,12.0,12.0,14.0,16.0,16.0,8.0,22.0,18.0,0.0,0.0,0.0,179.0,75.0,1.0,4.0,2.0,1.0,1.0,1.0,3.0,1.0,1.0,3.0,2.0,7.0,8.0,12.0,8.0,13.0,10.0,11.0,12.0,11.0,11.0,11.0,10.0,14.0,13.0,15.0,12.0,15.0,8.0,12.0,10.0,12.0,14.0,12.0,10.0,13.0,12.0,13.0,17.0,14.0,14.0,13.0,10.0,9.0,15.0,15.0,20.0,15.0,14.0,13.0,13.0,12.0,11.0,12.0,13.0,15.0,9.0,10.0,12.0,10.0,10.0,4.0,30.0,7.0,0.0,0.0,0.0,181.0,72.0,1.0,3.0,3.0,1.0,2.0,3.0,2.0,1.0,3.0,2.0,2.0,12.0,11.0,14.0,8.0,14.0,12.0,8.0,12.0,6.0,5.0,13.0,13.0,5.0,14.0,8.0,12.0,10.0,11.0,12.0,15.0,11.0,13.0,14.0,9.0,13.0,10.0,12.0,13.0,12.0,14.0,12.0,10.0,12.0,15.0,13.0,20.0,15.0,9.0,10.0,8.0,13.0,5.0,8.0,12.0,14.0,14.0,12.0,11.0,14.0,14.0,8.0,28.0,0.0,0.0,0.0,0.0,170.0,67.0,2.0,3.0,3.0,4.0,3.0,2.0,1.0,1.0,2.0,2.0,3.0,8.0,12.0,12.0,10.0,14.0,7.0,5.0,10.0,6.0,5.0,12.0,5.0,4.0,13.0,7.0,16.0,12.0,9.0,11.0,12.0,10.0,3.0,12.0,6.0,13.0,6.0,8.0,13.0,16.0,13.0,10.0,5.0,5.0,13.0,16.0,20.0,15.0,7.0,12.0,4.0,9.0,7.0,10.0,20.0,13.0,12.0,10.0,13.0,11.0,10.0,2.0,31.0,0.0,0.0,0.0,0.0,175.0,65.0,3.0,4.0,1.0,1.0,3.0,3.0,3.0,2.0,4.0,3.0,3.0,14.0,13.0,13.0,7.0,14.0,12.0,7.0,12.0,7.0,6.0,14.0,15.0,8.0,15.0,11.0,12.0,13.0,13.0,11.0,14.0,12.0,15.0,13.0,9.0,11.0,10.0,12.0,13.0,14.0,15.0,12.0,7.0,20.0,10.0,13.0,10.0,12.0,9.0,12.0,11.0,15.0,16.0,13.0,8.0,14.0,14.0,14.0,13.0,13.0,13.0,7.0,27.0,33.0,4.0,3.0,0.0,180.0,75.0,2.0,1.0,2.0,1.0,4.0,2.0,1.0,3.0,1.0,1.0,2.0,12.0,11.0,13.0,13.0,11.0,11.0,11.0,10.0,7.0,5.0,10.0,14.0,5.0,14.0,9.0,11.0,12.0,10.0,11.0,12.0,12.0,14.0,13.0,8.0,14.0,8.0,11.0,14.0,16.0,14.0,13.0,10.0,7.0,12.0,15.0,20.0,14.0,12.0,12.0,9.0,13.0,10.0,10.0,9.0,15.0,8.0,9.0,13.0,14.0,14.0,7.0,24.0,24.0,4.0,0.0,0.0,172.0,74.0,2.0,4.0,3.0,2.0,2.0,1.0,2.0,2.0,3.0,2.0,4.0,8.0,9.0,14.0,13.0,14.0,9.0,11.0,10.0,7.0,5.0,12.0,12.0,3.0,13.0,10.0,12.0,12.0,13.0,12.0,11.0,10.0,14.0,13.0,7.0,14.0,9.0,9.0,13.0,16.0,15.0,13.0,6.0,8.0,13.0,16.0,20.0,14.0,12.0,11.0,11.0,13.0,9.0,8.0,9.0,13.0,9.0,11.0,12.0,13.0,10.0,9.0,28.0,0.0,0.0,6.0,0.0,191.0,81.0,11.0,10.0,14.0,8.0,13.0,12.0,14.0,15.0,11.0,8.0,13.0,4.0,3.0,2.0,1.0,9.0,9.0,3.0,10.0,1.0,1.0,8.0,3.0,3.0,9.0,8.0,12.0,14.0,12.0,13.0,8.0,11.0,12.0,6.0,14.0,2.0,12.0,10.0,7.0,13.0,14.0,16.0,15.0,6.0,14.0,11.0,20.0,15.0,14.0,12.0,9.0,14.0,7.0,1.0,9.0,15.0,13.0,11.0,15.0,15.0,14.0,8.0,32.0,67.0,9.0,7.0,0.0,191.0,85.0,1.0,1.0,1.0,3.0,2.0,2.0,4.0,3.0,3.0,2.0,3.0,7.0,7.0,6.0,9.0,12.0,3.0,16.0,7.0,3.0,15.0,11.0,7.0,13.0,12.0,14.0,11.0,14.0,10.0,11.0,10.0,14.0,11.0,8.0,13.0,13.0,13.0,13.0,15.0,9.0,7.0,14.0,16.0,8.0,7.0,10.0,20.0,12.0,15.0,13.0,14.0,5.0,6.0,11.0,8.0,11.0,9.0,12.0,11.0,6.0,9.0,11.0,23.0,0.0,0.0,0.0,0.0,184.0,71.0,1.0,2.0,1.0,2.0,2.0,2.0,2.0,4.0,2.0,1.0,3.0,4.0,10.0,10.0,6.0,11.0,6.0,14.0,8.0,7.0,14.0,11.0,6.0,13.0,11.0,12.0,12.0,13.0,12.0,11.0,12.0,12.0,14.0,6.0,8.0,10.0,13.0,13.0,14.0,15.0,13.0,14.0,13.0,8.0,12.0,14.0,20.0,13.0,14.0,13.0,12.0,14.0,15.0,8.0,11.0,13.0,13.0,10.0,8.0,9.0,16.0,7.0,26.0,10.0,1.0,0.0,0.0,175.0,65.0,4.0,1.0,2.0,2.0,2.0,3.0,3.0,1.0,3.0,2.0,3.0,11.0,13.0,13.0,7.0,13.0,7.0,6.0,11.0,13.0,10.0,12.0,8.0,11.0,14.0,12.0,11.0,12.0,10.0,10.0,12.0,10.0,10.0,13.0,10.0,13.0,10.0,13.0,12.0,14.0,15.0,13.0,10.0,20.0,12.0,13.0,8.0,14.0,7.0,12.0,6.0,10.0,5.0,13.0,10.0,13.0,8.0,11.0,14.0,11.0,13.0,7.0,21.0,0.0,0.0,0.0,0.0,178.0,65.0,2.0,3.0,3.0,3.0,3.0,1.0,1.0,1.0,1.0,3.0,1.0,9.0,13.0,11.0,6.0,12.0,7.0,9.0,8.0,8.0,13.0,12.0,7.0,13.0,12.0,8.0,12.0,13.0,12.0,12.0,13.0,13.0,14.0,9.0,8.0,12.0,12.0,13.0,13.0,12.0,14.0,13.0,11.0,8.0,15.0,12.0,20.0,13.0,12.0,14.0,8.0,11.0,7.0,10.0,19.0,10.0,13.0,10.0,11.0,15.0,15.0,6.0,29.0,52.0,2.0,0.0,0.0,178.0,75.0,1.0,1.0,1.0,1.0,3.0,3.0,2.0,3.0,1.0,2.0,2.0,10.0,12.0,12.0,11.0,12.0,11.0,8.0,11.0,7.0,11.0,13.0,12.0,9.0,13.0,12.0,9.0,13.0,9.0,12.0,13.0,10.0,16.0,7.0,9.0,14.0,13.0,15.0,16.0,13.0,13.0,12.0,10.0,8.0,15.0,13.0,20.0,15.0,11.0,10.0,13.0,14.0,3.0,13.0,13.0,15.0,8.0,13.0,16.0,12.0,14.0,3.0,27.0,0.0,0.0,0.0,0.0,188.0,77.0,1.0,4.0,1.0,1.0,3.0,1.0,2.0,1.0,2.0,2.0,2.0,4.0,7.0,8.0,7.0,13.0,6.0,15.0,9.0,6.0,13.0,12.0,6.0,12.0,11.0,14.0,14.0,15.0,10.0,12.0,11.0,13.0,16.0,7.0,12.0,9.0,12.0,15.0,16.0,14.0,10.0,14.0,15.0,9.0,13.0,12.0,20.0,14.0,16.0,12.0,14.0,13.0,6.0,12.0,4.0,13.0,18.0,13.0,14.0,14.0,13.0,7.0,22.0,0.0,0.0,0.0,0.0,177.0,72.0,2.0,1.0,2.0,4.0,2.0,2.0,1.0,3.0,4.0,2.0,3.0,10.0,12.0,13.0,11.0,12.0,10.0,12.0,12.0,4.0,10.0,13.0,11.0,11.0,13.0,11.0,12.0,11.0,13.0,9.0,13.0,12.0,3.0,12.0,8.0,14.0,12.0,12.0,13.0,16.0,13.0,12.0,9.0,8.0,15.0,14.0,20.0,14.0,13.0,10.0,4.0,11.0,11.0,12.0,19.0,9.0,12.0,13.0,12.0,11.0,14.0,7.0,32.0,1.0,1.0,0.0,0.0,180.0,73.0,4.0,3.0,2.0,2.0,2.0,4.0,3.0,2.0,3.0,1.0,2.0,7.0,14.0,14.0,12.0,14.0,8.0,12.0,10.0,5.0,4.0,10.0,13.0,4.0,15.0,9.0,10.0,12.0,11.0,12.0,10.0,12.0,15.0,14.0,8.0,13.0,7.0,10.0,14.0,15.0,14.0,13.0,10.0,20.0,13.0,14.0,8.0,12.0,11.0,14.0,9.0,15.0,16.0,8.0,11.0,15.0,13.0,14.0,14.0,12.0,12.0,8.0,24.0,4.0,1.0,0.0,0.0,188.0,79.0,2.0,3.0,2.0,1.0,2.0,1.0,1.0,2.0,1.0,2.0,2.0,10.0,11.0,13.0,12.0,11.0,9.0,13.0,9.0,5.0,8.0,11.0,11.0,7.0,13.0,10.0,12.0,11.0,11.0,12.0,13.0,11.0,14.0,12.0,9.0,12.0,12.0,14.0,14.0,12.0,13.0,15.0,14.0,8.0,13.0,12.0,20.0,13.0,14.0,11.0,9.0,10.0,5.0,10.0,14.0,12.0,13.0,10.0,14.0,13.0,12.0,10.0,25.0,0.0,0.0,0.0,0.0,187.0,83.0,2.0,1.0,3.0,3.0,1.0,3.0,3.0,3.0,1.0,1.0,3.0,4.0,8.0,10.0,14.0,12.0,8.0,14.0,9.0,5.0,7.0,11.0,13.0,5.0,12.0,11.0,13.0,13.0,13.0,11.0,10.0,12.0,16.0,9.0,8.0,13.0,11.0,13.0,16.0,14.0,13.0,15.0,13.0,20.0,14.0,12.0,8.0,14.0,16.0,13.0,11.0,13.0,7.0,5.0,13.0,14.0,13.0,14.0,14.0,13.0,13.0,6.0
1,1,17.0,0.0,0.0,0.0,0.0,193.0,82.0,13.0,11.0,12.0,2.0,12.0,10.0,14.0,15.0,14.0,12.0,10.0,3.0,1.0,1.0,3.0,5.0,6.0,2.0,2.0,1.0,3.0,9.0,3.0,1.0,8.0,7.0,12.0,13.0,13.0,13.0,11.0,11.0,15.0,3.0,8.0,3.0,12.0,12.0,11.0,10.0,12.0,14.0,17.0,5.0,15.0,11.0,20.0,13.0,12.0,13.0,8.0,11.0,5.0,11.0,13.0,15.0,15.0,17.0,14.0,15.0,15.0,5.0,19.0,0.0,0.0,0.0,0.0,194.0,92.0,2.0,1.0,3.0,3.0,3.0,3.0,1.0,3.0,3.0,2.0,1.0,3.0,3.0,5.0,6.0,10.0,5.0,16.0,10.0,8.0,12.0,9.0,4.0,15.0,11.0,14.0,11.0,12.0,10.0,11.0,10.0,12.0,15.0,3.0,13.0,13.0,12.0,14.0,14.0,11.0,8.0,15.0,17.0,5.0,16.0,12.0,20.0,12.0,16.0,12.0,13.0,12.0,5.0,7.0,10.0,14.0,13.0,8.0,10.0,11.0,18.0,6.0,26.0,0.0,0.0,0.0,0.0,187.0,78.0,2.0,1.0,2.0,3.0,2.0,1.0,1.0,1.0,3.0,3.0,1.0,10.0,12.0,14.0,9.0,11.0,11.0,13.0,8.0,14.0,13.0,11.0,9.0,12.0,14.0,13.0,13.0,13.0,13.0,12.0,12.0,11.0,15.0,12.0,8.0,13.0,13.0,13.0,14.0,15.0,12.0,8.0,14.0,20.0,12.0,14.0,6.0,14.0,12.0,12.0,13.0,11.0,12.0,15.0,8.0,15.0,9.0,15.0,14.0,12.0,15.0,10.0,23.0,1.0,0.0,4.0,0.0,190.0,80.0,1.0,4.0,1.0,3.0,3.0,1.0,1.0,1.0,2.0,4.0,2.0,6.0,11.0,13.0,7.0,13.0,6.0,11.0,8.0,10.0,15.0,12.0,5.0,15.0,12.0,14.0,14.0,16.0,9.0,11.0,10.0,10.0,16.0,12.0,12.0,9.0,12.0,10.0,14.0,14.0,12.0,15.0,17.0,8.0,15.0,16.0,20.0,13.0,14.0,13.0,8.0,13.0,6.0,14.0,11.0,14.0,12.0,13.0,16.0,14.0,12.0,6.0,21.0,0.0,0.0,0.0,0.0,188.0,80.0,1.0,2.0,2.0,3.0,2.0,2.0,2.0,2.0,1.0,1.0,1.0,6.0,9.0,12.0,6.0,12.0,12.0,12.0,11.0,3.0,12.0,13.0,8.0,13.0,13.0,13.0,13.0,13.0,13.0,13.0,13.0,13.0,13.0,8.0,11.0,11.0,13.0,15.0,13.0,12.0,12.0,13.0,14.0,20.0,14.0,11.0,5.0,13.0,14.0,12.0,11.0,3.0,6.0,8.0,17.0,12.0,13.0,13.0,14.0,14.0,14.0,6.0,23.0,11.0,0.0,0.0,0.0,180.0,71.0,2.0,1.0,2.0,3.0,3.0,1.0,1.0,2.0,2.0,1.0,1.0,6.0,11.0,10.0,8.0,10.0,7.0,11.0,9.0,12.0,13.0,11.0,6.0,13.0,11.0,12.0,11.0,13.0,12.0,9.0,11.0,11.0,14.0,12.0,11.0,12.0,11.0,13.0,15.0,15.0,13.0,13.0,11.0,7.0,14.0,15.0,20.0,12.0,11.0,12.0,12.0,13.0,10.0,15.0,10.0,13.0,16.0,12.0,15.0,14.0,14.0,7.0,20.0,0.0,0.0,0.0,0.0,170.0,77.0,3.0,2.0,2.0,3.0,1.0,2.0,2.0,3.0,1.0,3.0,2.0,11.0,13.0,12.0,7.0,12.0,11.0,7.0,12.0,6.0,9.0,11.0,10.0,11.0,13.0,14.0,12.0,13.0,8.0,9.0,11.0,12.0,11.0,14.0,3.0,12.0,7.0,9.0,13.0,13.0,13.0,14.0,7.0,10.0,10.0,13.0,20.0,11.0,14.0,10.0,15.0,11.0,11.0,10.0,10.0,10.0,10.0,10.0,11.0,6.0,19.0,6.0,28.0,0.0,0.0,0.0,0.0,180.0,79.0,3.0,2.0,3.0,3.0,2.0,2.0,2.0,1.0,3.0,2.0,3.0,8.0,11.0,15.0,12.0,15.0,12.0,7.0,10.0,7.0,8.0,13.0,13.0,6.0,16.0,11.0,11.0,10.0,13.0,10.0,15.0,12.0,3.0,15.0,6.0,13.0,13.0,12.0,12.0,15.0,16.0,14.0,8.0,12.0,12.0,14.0,20.0,12.0,12.0,13.0,6.0,13.0,6.0,6.0,8.0,9.0,13.0,10.0,12.0,12.0,2.0,2.0,25.0,0.0,0.0,3.0,0.0,170.0,68.0,2.0,1.0,3.0,1.0,3.0,1.0,3.0,2.0,2.0,4.0,1.0,12.0,11.0,15.0,16.0,16.0,13.0,11.0,12.0,4.0,5.0,12.0,14.0,4.0,17.0,7.0,14.0,7.0,15.0,13.0,13.0,14.0,14.0,15.0,7.0,16.0,8.0,10.0,13.0,15.0,15.0,12.0,6.0,11.0,14.0,14.0,20.0,13.0,11.0,12.0,7.0,15.0,7.0,8.0,12.0,14.0,13.0,14.0,13.0,16.0,16.0,8.0,25.0,14.0,1.0,2.0,0.0,177.0,77.0,3.0,3.0,1.0,2.0,3.0,3.0,1.0,3.0,3.0,4.0,1.0,8.0,11.0,13.0,12.0,12.0,10.0,11.0,10.0,2.0,3.0,11.0,10.0,5.0,13.0,12.0,12.0,13.0,11.0,10.0,11.0,10.0,14.0,16.0,14.0,15.0,5.0,13.0,14.0,15.0,14.0,12.0,12.0,12.0,14.0,16.0,20.0,13.0,14.0,13.0,7.0,14.0,11.0,13.0,14.0,11.0,12.0,8.0,12.0,13.0,15.0,6.0,32.0,0.0,0.0,0.0,0.0,183.0,67.0,1.0,2.0,3.0,2.0,3.0,2.0,3.0,1.0,2.0,2.0,2.0,4.0,12.0,11.0,6.0,5.0,5.0,4.0,8.0,11.0,13.0,11.0,5.0,13.0,11.0,11.0,11.0,12.0,11.0,11.0,9.0,12.0,11.0,12.0,10.0,12.0,11.0,12.0,12.0,14.0,13.0,13.0,8.0,8.0,13.0,13.0,20.0,14.0,14.0,10.0,12.0,11.0,8.0,11.0,11.0,10.0,10.0,12.0,11.0,9.0,10.0,12.0,33.0,101.0,0.0,0.0,0.0,182.0,87.0,12.0,11.0,15.0,12.0,14.0,13.0,14.0,15.0,15.0,13.0,12.0,9.0,2.0,3.0,8.0,9.0,11.0,10.0,11.0,1.0,3.0,12.0,15.0,8.0,10.0,8.0,14.0,14.0,14.0,12.0,9.0,12.0,16.0,9.0,15.0,2.0,13.0,12.0,6.0,12.0,13.0,14.0,13.0,8.0,13.0,10.0,20.0,12.0,15.0,13.0,8.0,15.0,5.0,1.0,13.0,15.0,13.0,15.0,18.0,18.0,15.0,5.0,32.0,0.0,0.0,0.0,0.0,195.0,89.0,3.0,2.0,3.0,1.0,4.0,2.0,4.0,2.0,3.0,1.0,2.0,3.0,5.0,5.0,11.0,8.0,8.0,14.0,9.0,11.0,15.0,12.0,9.0,13.0,8.0,16.0,13.0,19.0,10.0,14.0,8.0,13.0,16.0,5.0,15.0,10.0,15.0,15.0,14.0,8.0,8.0,16.0,17.0,5.0,11.0,10.0,20.0,13.0,17.0,13.0,12.0,15.0,7.0,5.0,12.0,14.0,14.0,12.0,15.0,8.0,8.0,7.0,24.0,0.0,0.0,0.0,0.0,187.0,93.0,4.0,3.0,2.0,1.0,2.0,2.0,2.0,2.0,1.0,2.0,1.0,4.0,5.0,6.0,6.0,12.0,6.0,15.0,8.0,6.0,15.0,10.0,6.0,13.0,9.0,14.0,13.0,16.0,12.0,14.0,7.0,12.0,15.0,5.0,8.0,6.0,12.0,14.0,15.0,9.0,10.0,18.0,13.0,6.0,14.0,12.0,20.0,15.0,17.0,13.0,14.0,14.0,11.0,10.0,19.0,14.0,15.0,11.0,13.0,14.0,14.0,5.0,25.0,0.0,0.0,26.0,3.0,176.0,64.0,3.0,2.0,2.0,1.0,3.0,3.0,3.0,2.0,1.0,1.0,1.0,12.0,13.0,12.0,7.0,13.0,13.0,11.0,11.0,11.0,14.0,13.0,11.0,14.0,13.0,13.0,13.0,14.0,13.0,13.0,11.0,13.0,17.0,12.0,11.0,10.0,12.0,14.0,14.0,14.0,14.0,12.0,8.0,8.0,17.0,14.0,20.0,15.0,12.0,14.0,12.0,13.0,5.0,12.0,17.0,15.0,15.0,14.0,16.0,15.0,15.0,7.0,23.0,0.0,0.0,1.0,0.0,182.0,71.0,3.0,1.0,2.0,3.0,4.0,2.0,3.0,1.0,2.0,1.0,3.0,9.0,13.0,14.0,8.0,14.0,13.0,12.0,10.0,13.0,14.0,14.0,13.0,15.0,13.0,14.0,14.0,13.0,11.0,12.0,12.0,13.0,16.0,12.0,12.0,15.0,13.0,14.0,15.0,15.0,13.0,14.0,12.0,9.0,16.0,15.0,20.0,15.0,15.0,15.0,10.0,14.0,6.0,12.0,8.0,15.0,14.0,16.0,15.0,15.0,16.0,6.0,32.0,13.0,0.0,19.0,1.0,172.0,72.0,3.0,1.0,3.0,2.0,1.0,2.0,2.0,2.0,3.0,1.0,1.0,7.0,12.0,12.0,5.0,13.0,7.0,6.0,9.0,9.0,12.0,14.0,9.0,14.0,12.0,13.0,14.0,14.0,15.0,15.0,10.0,13.0,17.0,7.0,18.0,8.0,15.0,18.0,15.0,12.0,14.0,12.0,6.0,10.0,16.0,13.0,20.0,15.0,12.0,15.0,9.0,15.0,5.0,10.0,12.0,16.0,14.0,13.0,15.0,18.0,18.0,5.0,36.0,0.0,0.0,3.0,0.0,168.0,72.0,3.0,2.0,1.0,3.0,1.0,3.0,3.0,1.0,3.0,3.0,1.0,11.0,8.0,12.0,5.0,13.0,11.0,8.0,13.0,6.0,12.0,13.0,8.0,14.0,13.0,17.0,14.0,17.0,14.0,15.0,13.0,14.0,17.0,12.0,16.0,10.0,15.0,16.0,14.0,10.0,13.0,14.0,4.0,8.0,16.0,8.0,20.0,12.0,13.0,17.0,14.0,14.0,7.0,10.0,19.0,15.0,14.0,16.0,15.0,9.0,9.0,7.0,33.0,14.0,0.0,0.0,0.0,172.0,68.0,3.0,3.0,1.0,1.0,1.0,1.0,1.0,3.0,1.0,2.0,1.0,14.0,11.0,13.0,8.0,14.0,13.0,7.0,13.0,4.0,10.0,13.0,10.0,12.0,14.0,11.0,13.0,14.0,13.0,13.0,12.0,14.0,15.0,10.0,13.0,12.0,13.0,16.0,17.0,13.0,13.0,12.0,7.0,10.0,14.0,12.0,20.0,14.0,9.0,14.0,11.0,15.0,10.0,12.0,20.0,13.0,13.0,15.0,14.0,13.0,12.0,8.0,28.0,0.0,0.0,0.0,0.0,168.0,65.0,3.0,4.0,1.0,1.0,2.0,3.0,1.0,2.0,2.0,1.0,2.0,14.0,14.0,15.0,8.0,14.0,14.0,9.0,8.0,7.0,8.0,13.0,10.0,7.0,14.0,12.0,12.0,12.0,13.0,13.0,13.0,12.0,15.0,13.0,6.0,11.0,7.0,14.0,14.0,16.0,14.0,10.0,6.0,20.0,13.0,15.0,5.0,13.0,9.0,12.0,12.0,14.0,9.0,6.0,18.0,14.0,14.0,14.0,14.0,13.0,13.0,6.0,22.0,2.0,0.0,0.0,0.0,169.0,59.0,3.0,1.0,3.0,1.0,1.0,1.0,1.0,1.0,3.0,3.0,2.0,13.0,13.0,15.0,13.0,15.0,13.0,7.0,13.0,8.0,6.0,13.0,13.0,5.0,16.0,10.0,10.0,8.0,13.0,11.0,14.0,12.0,12.0,14.0,10.0,12.0,6.0,10.0,8.0,16.0,15.0,17.0,6.0,12.0,12.0,15.0,20.0,13.0,9.0,12.0,8.0,12.0,8.0,12.0,13.0,13.0,13.0,14.0,12.0,10.0,13.0,9.0,21.0,0.0,0.0,9.0,6.0,178.0,72.0,1.0,1.0,1.0,1.0,2.0,3.0,2.0,3.0,3.0,4.0,3.0,5.0,8.0,15.0,13.0,15.0,6.0,11.0,10.0,5.0,3.0,10.0,13.0,3.0,14.0,10.0,12.0,11.0,12.0,10.0,12.0,9.0,12.0,16.0,5.0,14.0,7.0,7.0,11.0,13.0,14.0,13.0,9.0,12.0,13.0,12.0,20.0,13.0,11.0,10.0,10.0,8.0,7.0,8.0,8.0,11.0,11.0,9.0,7.0,13.0,10.0,5.0
2,1,30.0,0.0,0.0,0.0,0.0,182.0,78.0,13.0,14.0,10.0,5.0,12.0,13.0,12.0,13.0,11.0,11.0,9.0,3.0,3.0,3.0,2.0,8.0,7.0,3.0,3.0,2.0,2.0,8.0,1.0,1.0,8.0,9.0,13.0,13.0,13.0,13.0,9.0,13.0,14.0,5.0,9.0,1.0,11.0,12.0,6.0,12.0,13.0,14.0,11.0,20.0,15.0,10.0,5.0,13.0,14.0,13.0,9.0,14.0,6.0,1.0,20.0,13.0,13.0,13.0,15.0,15.0,15.0,5.0,24.0,0.0,0.0,8.0,1.0,185.0,75.0,3.0,3.0,1.0,4.0,3.0,1.0,2.0,1.0,3.0,1.0,4.0,9.0,12.0,10.0,6.0,13.0,10.0,12.0,11.0,5.0,10.0,14.0,8.0,12.0,13.0,8.0,13.0,11.0,13.0,13.0,13.0,12.0,15.0,9.0,10.0,8.0,12.0,15.0,14.0,11.0,12.0,14.0,12.0,10.0,16.0,12.0,20.0,15.0,13.0,13.0,8.0,14.0,9.0,16.0,5.0,14.0,14.0,13.0,16.0,15.0,15.0,6.0,36.0,3.0,0.0,0.0,0.0,186.0,77.0,2.0,1.0,2.0,1.0,3.0,1.0,1.0,2.0,2.0,4.0,1.0,5.0,11.0,8.0,6.0,12.0,6.0,14.0,7.0,9.0,12.0,12.0,6.0,14.0,12.0,10.0,14.0,14.0,14.0,14.0,9.0,12.0,14.0,5.0,16.0,8.0,14.0,15.0,13.0,9.0,10.0,15.0,12.0,20.0,10.0,8.0,10.0,9.0,12.0,15.0,10.0,16.0,14.0,10.0,13.0,10.0,17.0,14.0,18.0,15.0,15.0,8.0,33.0,24.0,1.0,3.0,0.0,193.0,90.0,1.0,2.0,2.0,2.0,3.0,2.0,3.0,1.0,3.0,2.0,3.0,3.0,6.0,8.0,8.0,11.0,10.0,17.0,8.0,5.0,13.0,10.0,7.0,14.0,11.0,14.0,14.0,16.0,11.0,10.0,9.0,10.0,14.0,7.0,13.0,7.0,13.0,14.0,11.0,9.0,10.0,15.0,15.0,7.0,13.0,10.0,20.0,10.0,13.0,10.0,13.0,15.0,9.0,8.0,12.0,15.0,13.0,11.0,15.0,12.0,13.0,7.0,38.0,0.0,0.0,0.0,0.0,177.0,68.0,2.0,3.0,2.0,3.0,1.0,2.0,2.0,1.0,3.0,4.0,4.0,9.0,13.0,10.0,7.0,11.0,7.0,10.0,12.0,11.0,11.0,13.0,7.0,12.0,12.0,11.0,13.0,14.0,14.0,14.0,11.0,12.0,14.0,9.0,15.0,10.0,13.0,17.0,15.0,10.0,12.0,12.0,8.0,10.0,13.0,11.0,20.0,10.0,9.0,14.0,11.0,13.0,5.0,17.0,11.0,12.0,16.0,14.0,18.0,16.0,15.0,5.0,22.0,25.0,0.0,0.0,0.0,180.0,75.0,2.0,3.0,1.0,1.0,4.0,3.0,1.0,1.0,4.0,2.0,2.0,11.0,13.0,14.0,10.0,12.0,9.0,12.0,9.0,13.0,13.0,12.0,9.0,13.0,12.0,13.0,12.0,14.0,13.0,12.0,10.0,11.0,5.0,8.0,6.0,10.0,12.0,13.0,15.0,15.0,14.0,13.0,10.0,20.0,14.0,14.0,5.0,15.0,13.0,12.0,13.0,6.0,7.0,11.0,14.0,11.0,12.0,12.0,14.0,9.0,11.0,5.0,23.0,3.0,0.0,0.0,0.0,186.0,83.0,4.0,3.0,1.0,1.0,1.0,3.0,3.0,2.0,2.0,3.0,2.0,4.0,7.0,10.0,6.0,11.0,6.0,14.0,8.0,5.0,11.0,10.0,6.0,13.0,10.0,13.0,12.0,14.0,10.0,11.0,9.0,11.0,14.0,8.0,8.0,10.0,12.0,13.0,15.0,11.0,10.0,16.0,13.0,8.0,15.0,12.0,20.0,16.0,17.0,13.0,13.0,10.0,7.0,10.0,20.0,12.0,11.0,14.0,12.0,11.0,14.0,7.0,33.0,0.0,0.0,0.0,0.0,188.0,77.0,1.0,2.0,3.0,1.0,2.0,1.0,1.0,3.0,3.0,3.0,3.0,7.0,12.0,10.0,10.0,13.0,14.0,14.0,13.0,5.0,11.0,14.0,12.0,12.0,12.0,14.0,14.0,14.0,13.0,13.0,13.0,12.0,14.0,9.0,15.0,8.0,14.0,15.0,14.0,10.0,11.0,14.0,14.0,8.0,14.0,11.0,20.0,14.0,14.0,16.0,12.0,14.0,7.0,10.0,13.0,13.0,14.0,13.0,16.0,14.0,13.0,6.0,28.0,2.0,0.0,0.0,0.0,188.0,70.0,3.0,1.0,2.0,2.0,2.0,3.0,3.0,2.0,1.0,3.0,2.0,11.0,9.0,13.0,13.0,9.0,8.0,14.0,12.0,6.0,10.0,13.0,8.0,9.0,13.0,12.0,13.0,12.0,13.0,13.0,13.0,12.0,11.0,14.0,13.0,13.0,10.0,12.0,12.0,14.0,13.0,12.0,14.0,10.0,13.0,13.0,20.0,15.0,14.0,13.0,12.0,7.0,12.0,13.0,9.0,11.0,9.0,11.0,7.0,9.0,10.0,13.0,24.0,14.0,0.0,7.0,3.0,186.0,84.0,2.0,1.0,3.0,2.0,3.0,3.0,4.0,2.0,3.0,2.0,2.0,7.0,9.0,13.0,10.0,13.0,7.0,12.0,9.0,6.0,5.0,10.0,11.0,6.0,12.0,13.0,9.0,15.0,8.0,11.0,10.0,12.0,14.0,13.0,7.0,10.0,8.0,15.0,13.0,12.0,12.0,16.0,14.0,14.0,15.0,16.0,20.0,13.0,15.0,11.0,7.0,10.0,10.0,10.0,13.0,15.0,12.0,9.0,12.0,10.0,10.0,7.0,27.0,0.0,0.0,0.0,0.0,176.0,70.0,1.0,2.0,3.0,3.0,2.0,4.0,3.0,3.0,4.0,3.0,1.0,10.0,9.0,12.0,11.0,13.0,8.0,12.0,11.0,8.0,5.0,12.0,12.0,5.0,12.0,12.0,11.0,10.0,10.0,9.0,8.0,11.0,12.0,11.0,8.0,12.0,9.0,12.0,11.0,15.0,14.0,15.0,9.0,8.0,12.0,14.0,20.0,14.0,12.0,11.0,6.0,7.0,10.0,11.0,17.0,12.0,11.0,8.0,8.0,13.0,15.0,6.0,25.0,4.0,0.0,11.0,0.0,184.0,81.0,14.0,14.0,13.0,9.0,15.0,12.0,16.0,16.0,13.0,7.0,11.0,8.0,1.0,2.0,1.0,11.0,12.0,6.0,1.0,3.0,3.0,11.0,5.0,3.0,11.0,8.0,15.0,15.0,13.0,14.0,10.0,11.0,14.0,8.0,13.0,5.0,13.0,10.0,10.0,14.0,16.0,14.0,13.0,20.0,14.0,12.0,5.0,14.0,14.0,15.0,9.0,16.0,6.0,1.0,17.0,11.0,15.0,13.0,14.0,12.0,12.0,4.0,27.0,0.0,0.0,0.0,0.0,169.0,60.0,3.0,2.0,1.0,3.0,3.0,2.0,1.0,3.0,3.0,2.0,2.0,11.0,11.0,13.0,9.0,13.0,12.0,8.0,10.0,4.0,5.0,14.0,8.0,5.0,13.0,12.0,9.0,9.0,10.0,10.0,10.0,9.0,16.0,13.0,4.0,14.0,8.0,11.0,8.0,16.0,16.0,9.0,9.0,5.0,13.0,15.0,20.0,11.0,11.0,10.0,8.0,7.0,5.0,11.0,14.0,10.0,12.0,11.0,12.0,10.0,13.0,8.0,27.0,4.0,0.0,5.0,1.0,184.0,83.0,2.0,4.0,3.0,1.0,1.0,2.0,1.0,2.0,4.0,2.0,3.0,4.0,8.0,11.0,4.0,10.0,4.0,14.0,4.0,4.0,15.0,12.0,5.0,16.0,11.0,14.0,14.0,16.0,14.0,10.0,11.0,12.0,17.0,7.0,10.0,9.0,13.0,14.0,15.0,14.0,13.0,16.0,13.0,10.0,15.0,13.0,20.0,15.0,16.0,12.0,12.0,14.0,6.0,12.0,11.0,13.0,12.0,12.0,16.0,15.0,14.0,6.0,32.0,52.0,1.0,0.0,0.0,180.0,80.0,2.0,3.0,2.0,2.0,1.0,4.0,1.0,2.0,3.0,4.0,3.0,7.0,12.0,12.0,6.0,12.0,7.0,12.0,11.0,13.0,13.0,11.0,9.0,13.0,12.0,13.0,13.0,15.0,12.0,10.0,11.0,12.0,16.0,12.0,10.0,13.0,11.0,13.0,14.0,15.0,13.0,14.0,10.0,20.0,12.0,14.0,5.0,15.0,14.0,10.0,13.0,12.0,7.0,8.0,12.0,15.0,13.0,12.0,13.0,14.0,14.0,9.0,37.0,0.0,0.0,0.0,0.0,185.0,83.0,1.0,1.0,2.0,1.0,3.0,2.0,3.0,1.0,1.0,3.0,1.0,6.0,8.0,9.0,12.0,10.0,8.0,13.0,9.0,4.0,5.0,10.0,14.0,4.0,11.0,11.0,10.0,11.0,13.0,12.0,12.0,13.0,15.0,14.0,12.0,11.0,7.0,12.0,8.0,7.0,7.0,12.0,12.0,11.0,11.0,7.0,20.0,8.0,14.0,12.0,8.0,13.0,9.0,12.0,12.0,12.0,19.0,14.0,15.0,14.0,8.0,8.0,19.0,0.0,0.0,3.0,1.0,181.0,69.0,3.0,2.0,3.0,3.0,2.0,1.0,1.0,1.0,3.0,3.0,4.0,10.0,10.0,12.0,12.0,12.0,7.0,8.0,11.0,5.0,7.0,10.0,10.0,7.0,11.0,8.0,10.0,10.0,12.0,8.0,11.0,8.0,14.0,13.0,6.0,14.0,8.0,13.0,13.0,16.0,14.0,13.0,9.0,20.0,15.0,16.0,10.0,15.0,13.0,12.0,8.0,11.0,7.0,12.0,11.0,11.0,15.0,10.0,12.0,14.0,14.0,1.0,27.0,8.0,0.0,6.0,0.0,187.0,76.0,3.0,2.0,3.0,2.0,2.0,1.0,1.0,3.0,3.0,1.0,2.0,5.0,7.0,11.0,5.0,14.0,5.0,14.0,9.0,5.0,15.0,15.0,8.0,14.0,13.0,15.0,16.0,15.0,14.0,12.0,14.0,14.0,18.0,8.0,17.0,9.0,12.0,18.0,15.0,13.0,14.0,15.0,14.0,10.0,17.0,12.0,20.0,17.0,15.0,14.0,13.0,16.0,4.0,12.0,10.0,14.0,17.0,12.0,15.0,13.0,13.0,6.0,21.0,0.0,0.0,15.0,3.0,181.0,78.0,3.0,3.0,4.0,2.0,1.0,2.0,2.0,4.0,2.0,1.0,1.0,5.0,7.0,11.0,10.0,14.0,5.0,14.0,10.0,6.0,13.0,14.0,8.0,14.0,14.0,12.0,14.0,12.0,11.0,10.0,12.0,11.0,16.0,11.0,12.0,14.0,14.0,14.0,14.0,14.0,13.0,14.0,13.0,10.0,16.0,14.0,20.0,16.0,14.0,12.0,10.0,11.0,5.0,19.0,8.0,11.0,14.0,11.0,16.0,13.0,13.0,10.0,36.0,0.0,0.0,7.0,2.0,171.0,74.0,1.0,1.0,2.0,3.0,2.0,3.0,2.0,4.0,1.0,1.0,2.0,12.0,12.0,10.0,5.0,15.0,12.0,4.0,10.0,4.0,8.0,16.0,11.0,12.0,14.0,10.0,15.0,13.0,13.0,14.0,16.0,12.0,11.0,11.0,12.0,10.0,13.0,17.0,13.0,9.0,9.0,9.0,6.0,14.0,13.0,9.0,20.0,9.0,9.0,13.0,10.0,13.0,14.0,12.0,14.0,13.0,14.0,12.0,15.0,16.0,16.0,6.0,25.0,5.0,0.0,5.0,0.0,186.0,72.0,1.0,2.0,1.0,2.0,2.0,3.0,3.0,3.0,3.0,3.0,2.0,13.0,12.0,14.0,9.0,16.0,15.0,11.0,12.0,5.0,8.0,16.0,11.0,10.0,15.0,8.0,13.0,11.0,14.0,13.0,15.0,14.0,15.0,14.0,11.0,13.0,10.0,12.0,12.0,13.0,14.0,14.0,10.0,10.0,13.0,11.0,20.0,11.0,11.0,13.0,9.0,15.0,13.0,7.0,15.0,17.0,14.0,13.0,15.0,15.0,15.0,7.0,28.0,2.0,1.0,0.0,0.0,174.0,66.0,2.0,2.0,2.0,1.0,1.0,3.0,2.0,3.0,3.0,1.0,4.0,6.0,11.0,13.0,15.0,13.0,11.0,14.0,11.0,6.0,5.0,10.0,12.0,5.0,13.0,8.0,14.0,10.0,13.0,14.0,8.0,12.0,12.0,12.0,5.0,14.0,8.0,12.0,11.0,17.0,15.0,11.0,12.0,7.0,14.0,15.0,20.0,13.0,10.0,12.0,8.0,14.0,8.0,8.0,19.0,15.0,12.0,10.0,11.0,13.0,13.0,12.0
0,1,17.0,0.0,0.0,0.0,0.0,193.0,82.0,13.0,11.0,12.0,2.0,12.0,10.0,14.0,15.0,14.0,12.0,10.0,3.0,1.0,1.0,3.0,5.0,6.0,2.0,2.0,1.0,3.0,9.0,3.0,1.0,8.0,7.0,12.0,13.0,13.0,13.0,11.0,11.0,15.0,3.0,8.0,3.0,12.0,12.0,11.0,10.0,12.0,14.0,17.0,5.0,15.0,11.0,20.0,13.0,12.0,13.0,8.0,11.0,5.0,11.0,13.0,15.0,15.0,17.0,14.0,15.0,15.0,5.0,23.0,5.0,0.0,13.0,0.0,186.0,82.0,3.0,3.0,1.0,4.0,3.0,1.0,2.0,1.0,2.0,1.0,2.0,4.0,8.0,8.0,5.0,11.0,6.0,13.0,8.0,6.0,14.0,10.0,7.0,13.0,11.0,14.0,13.0,14.0,11.0,11.0,9.0,11.0,14.0,8.0,11.0,9.0,15.0,12.0,12.0,14.0,12.0,14.0,13.0,8.0,15.0,14.0,20.0,14.0,14.0,15.0,14.0,13.0,6.0,10.0,15.0,13.0,12.0,12.0,14.0,11.0,13.0,9.0,19.0,0.0,0.0,0.0,0.0,194.0,92.0,2.0,1.0,3.0,3.0,3.0,3.0,1.0,3.0,3.0,2.0,1.0,3.0,3.0,5.0,6.0,10.0,5.0,16.0,10.0,8.0,12.0,9.0,4.0,15.0,11.0,14.0,11.0,12.0,10.0,11.0,10.0,12.0,15.0,3.0,13.0,13.0,12.0,14.0,14.0,11.0,8.0,15.0,17.0,5.0,16.0,12.0,20.0,12.0,16.0,12.0,13.0,12.0,5.0,7.0,10.0,14.0,13.0,8.0,10.0,11.0,18.0,6.0,26.0,0.0,0.0,0.0,0.0,187.0,78.0,2.0,1.0,2.0,3.0,2.0,1.0,1.0,1.0,3.0,3.0,1.0,10.0,12.0,14.0,9.0,11.0,11.0,13.0,8.0,14.0,13.0,11.0,9.0,12.0,14.0,13.0,13.0,13.0,13.0,12.0,12.0,11.0,15.0,12.0,8.0,13.0,13.0,13.0,14.0,15.0,12.0,8.0,14.0,20.0,12.0,14.0,6.0,14.0,12.0,12.0,13.0,11.0,12.0,15.0,8.0,15.0,9.0,15.0,14.0,12.0,15.0,10.0,23.0,1.0,0.0,4.0,0.0,190.0,80.0,1.0,4.0,1.0,3.0,3.0,1.0,1.0,1.0,2.0,4.0,2.0,6.0,11.0,13.0,7.0,13.0,6.0,11.0,8.0,10.0,15.0,12.0,5.0,15.0,12.0,14.0,14.0,16.0,9.0,11.0,10.0,10.0,16.0,12.0,12.0,9.0,12.0,10.0,14.0,14.0,12.0,15.0,17.0,8.0,15.0,16.0,20.0,13.0,14.0,13.0,8.0,13.0,6.0,14.0,11.0,14.0,12.0,13.0,16.0,14.0,12.0,6.0,26.0,17.0,0.0,19.0,1.0,191.0,79.0,3.0,2.0,1.0,1.0,1.0,1.0,2.0,2.0,3.0,3.0,4.0,4.0,8.0,11.0,9.0,12.0,7.0,14.0,10.0,6.0,12.0,13.0,7.0,11.0,12.0,14.0,13.0,14.0,12.0,10.0,11.0,12.0,15.0,9.0,7.0,11.0,12.0,12.0,15.0,14.0,13.0,16.0,15.0,8.0,15.0,13.0,20.0,19.0,15.0,11.0,14.0,14.0,7.0,12.0,12.0,14.0,12.0,10.0,9.0,14.0,14.0,14.0,23.0,11.0,0.0,0.0,0.0,180.0,71.0,2.0,1.0,2.0,3.0,3.0,1.0,1.0,2.0,2.0,1.0,1.0,6.0,11.0,10.0,8.0,10.0,7.0,11.0,9.0,12.0,13.0,11.0,6.0,13.0,11.0,12.0,11.0,13.0,12.0,9.0,11.0,11.0,14.0,12.0,11.0,12.0,11.0,13.0,15.0,15.0,13.0,13.0,11.0,7.0,14.0,15.0,20.0,12.0,11.0,12.0,12.0,13.0,10.0,15.0,10.0,13.0,16.0,12.0,15.0,14.0,14.0,7.0,28.0,0.0,0.0,0.0,0.0,180.0,79.0,3.0,2.0,3.0,3.0,2.0,2.0,2.0,1.0,3.0,2.0,3.0,8.0,11.0,15.0,12.0,15.0,12.0,7.0,10.0,7.0,8.0,13.0,13.0,6.0,16.0,11.0,11.0,10.0,13.0,10.0,15.0,12.0,3.0,15.0,6.0,13.0,13.0,12.0,12.0,15.0,16.0,14.0,8.0,12.0,12.0,14.0,20.0,12.0,12.0,13.0,6.0,13.0,6.0,6.0,8.0,9.0,13.0,10.0,12.0,12.0,2.0,2.0,25.0,14.0,1.0,2.0,0.0,177.0,77.0,3.0,3.0,1.0,2.0,3.0,3.0,1.0,3.0,3.0,4.0,1.0,8.0,11.0,13.0,12.0,12.0,10.0,11.0,10.0,2.0,3.0,11.0,10.0,5.0,13.0,12.0,12.0,13.0,11.0,10.0,11.0,10.0,14.0,16.0,14.0,15.0,5.0,13.0,14.0,15.0,14.0,12.0,12.0,12.0,14.0,16.0,20.0,13.0,14.0,13.0,7.0,14.0,11.0,13.0,14.0,11.0,12.0,8.0,12.0,13.0,15.0,6.0,25.0,0.0,0.0,3.0,0.0,170.0,68.0,2.0,1.0,3.0,1.0,3.0,1.0,3.0,2.0,2.0,4.0,1.0,12.0,11.0,15.0,16.0,16.0,13.0,11.0,12.0,4.0,5.0,12.0,14.0,4.0,17.0,7.0,14.0,7.0,15.0,13.0,13.0,14.0,14.0,15.0,7.0,16.0,8.0,10.0,13.0,15.0,15.0,12.0,6.0,11.0,14.0,14.0,20.0,13.0,11.0,12.0,7.0,15.0,7.0,8.0,12.0,14.0,13.0,14.0,13.0,16.0,16.0,8.0,32.0,0.0,0.0,0.0,0.0,183.0,67.0,1.0,2.0,3.0,2.0,3.0,2.0,3.0,1.0,2.0,2.0,2.0,4.0,12.0,11.0,6.0,5.0,5.0,4.0,8.0,11.0,13.0,11.0,5.0,13.0,11.0,11.0,11.0,12.0,11.0,11.0,9.0,12.0,11.0,12.0,10.0,12.0,11.0,12.0,12.0,14.0,13.0,13.0,8.0,8.0,13.0,13.0,20.0,14.0,14.0,10.0,12.0,11.0,8.0,11.0,11.0,10.0,10.0,12.0,11.0,9.0,10.0,12.0,25.0,0.0,0.0,11.0,0.0,189.0,83.0,12.0,12.0,11.0,7.0,13.0,12.0,17.0,17.0,16.0,12.0,13.0,6.0,2.0,1.0,1.0,10.0,10.0,7.0,1.0,1.0,1.0,9.0,5.0,1.0,10.0,8.0,15.0,14.0,14.0,12.0,7.0,13.0,12.0,6.0,9.0,3.0,16.0,17.0,10.0,13.0,16.0,14.0,12.0,8.0,15.0,10.0,20.0,13.0,14.0,14.0,5.0,14.0,4.0,12.0,15.0,15.0,13.0,13.0,17.0,15.0,17.0,4.0,29.0,0.0,0.0,0.0,0.0,170.0,65.0,2.0,1.0,3.0,3.0,1.0,3.0,2.0,1.0,2.0,3.0,2.0,5.0,11.0,4.0,6.0,7.0,4.0,7.0,5.0,6.0,6.0,6.0,2.0,6.0,7.0,9.0,10.0,13.0,8.0,12.0,8.0,13.0,15.0,2.0,7.0,5.0,9.0,8.0,8.0,12.0,12.0,14.0,4.0,9.0,12.0,11.0,20.0,12.0,5.0,9.0,9.0,9.0,9.0,9.0,10.0,12.0,12.0,12.0,12.0,7.0,5.0,8.0,29.0,56.0,3.0,0.0,0.0,189.0,84.0,3.0,2.0,2.0,1.0,2.0,2.0,2.0,2.0,2.0,1.0,3.0,8.0,9.0,13.0,12.0,13.0,14.0,14.0,12.0,18.0,17.0,12.0,15.0,16.0,13.0,17.0,16.0,16.0,12.0,10.0,10.0,11.0,17.0,12.0,15.0,12.0,11.0,13.0,16.0,17.0,15.0,16.0,16.0,10.0,16.0,15.0,20.0,14.0,13.0,10.0,12.0,13.0,10.0,13.0,15.0,16.0,18.0,13.0,16.0,11.0,10.0,7.0,28.0,0.0,0.0,0.0,0.0,169.0,0.0,3.0,3.0,2.0,3.0,3.0,1.0,1.0,3.0,2.0,1.0,3.0,5.0,8.0,11.0,9.0,8.0,8.0,7.0,8.0,4.0,2.0,9.0,5.0,3.0,11.0,11.0,11.0,13.0,9.0,11.0,8.0,15.0,14.0,11.0,7.0,10.0,8.0,8.0,10.0,11.0,11.0,6.0,5.0,14.0,11.0,12.0,20.0,14.0,5.0,9.0,12.0,9.0,5.0,6.0,9.0,12.0,11.0,9.0,9.0,10.0,12.0,11.0,23.0,25.0,0.0,0.0,0.0,174.0,74.0,2.0,1.0,1.0,1.0,3.0,3.0,3.0,3.0,3.0,1.0,2.0,8.0,13.0,12.0,8.0,12.0,8.0,14.0,9.0,13.0,14.0,12.0,6.0,16.0,13.0,13.0,14.0,15.0,13.0,11.0,10.0,12.0,15.0,9.0,10.0,14.0,11.0,14.0,17.0,16.0,13.0,14.0,10.0,8.0,17.0,15.0,20.0,18.0,15.0,14.0,13.0,14.0,8.0,12.0,12.0,14.0,13.0,13.0,12.0,12.0,15.0,13.0,25.0,0.0,0.0,14.0,0.0,180.0,82.0,1.0,3.0,3.0,1.0,3.0,2.0,3.0,1.0,1.0,3.0,1.0,5.0,10.0,10.0,7.0,13.0,7.0,12.0,8.0,10.0,14.0,12.0,8.0,17.0,13.0,13.0,16.0,16.0,14.0,15.0,10.0,12.0,15.0,8.0,13.0,10.0,14.0,18.0,15.0,10.0,12.0,16.0,11.0,10.0,15.0,12.0,20.0,16.0,15.0,17.0,10.0,16.0,6.0,10.0,12.0,16.0,12.0,13.0,17.0,14.0,14.0,5.0,33.0,30.0,1.0,0.0,0.0,187.0,83.0,1.0,3.0,4.0,2.0,1.0,1.0,2.0,3.0,1.0,1.0,3.0,13.0,13.0,12.0,8.0,16.0,10.0,16.0,13.0,10.0,14.0,16.0,13.0,16.0,15.0,13.0,15.0,14.0,16.0,15.0,14.0,14.0,13.0,11.0,13.0,10.0,17.0,18.0,10.0,10.0,12.0,17.0,14.0,20.0,12.0,12.0,10.0,13.0,16.0,16.0,16.0,15.0,13.0,11.0,16.0,16.0,13.0,15.0,12.0,8.0,8.0,11.0,29.0,51.0,8.0,24.0,0.0,175.0,70.0,3.0,4.0,2.0,3.0,2.0,3.0,2.0,2.0,2.0,1.0,3.0,6.0,12.0,12.0,10.0,13.0,7.0,12.0,12.0,8.0,14.0,13.0,9.0,16.0,13.0,14.0,16.0,16.0,15.0,16.0,11.0,14.0,16.0,8.0,14.0,14.0,15.0,18.0,18.0,15.0,14.0,16.0,8.0,20.0,16.0,14.0,8.0,18.0,14.0,16.0,13.0,14.0,7.0,14.0,15.0,14.0,14.0,14.0,16.0,16.0,16.0,5.0,27.0,10.0,0.0,0.0,0.0,187.0,75.0,2.0,2.0,4.0,3.0,3.0,3.0,2.0,3.0,4.0,2.0,1.0,13.0,13.0,15.0,11.0,18.0,13.0,8.0,13.0,4.0,3.0,17.0,14.0,4.0,17.0,10.0,13.0,9.0,14.0,12.0,17.0,13.0,12.0,18.0,8.0,14.0,6.0,14.0,9.0,15.0,16.0,12.0,12.0,14.0,12.0,14.0,20.0,12.0,11.0,13.0,8.0,13.0,13.0,10.0,11.0,17.0,13.0,12.0,14.0,15.0,15.0,8.0,16.0,0.0,0.0,0.0,0.0,173.0,0.0,3.0,1.0,1.0,1.0,2.0,1.0,4.0,1.0,2.0,3.0,1.0,1.0,1.0,4.0,4.0,5.0,4.0,4.0,4.0,1.0,5.0,6.0,5.0,8.0,9.0,10.0,6.0,6.0,3.0,5.0,4.0,10.0,7.0,8.0,8.0,3.0,11.0,13.0,9.0,7.0,5.0,14.0,4.0,20.0,6.0,5.0,8.0,6.0,9.0,5.0,7.0,8.0,5.0,7.0,6.0,11.0,7.0,10.0,18.0,19.0,15.0,9.0,34.0,116.0,62.0,7.0,6.0,195.0,95.0,1.0,1.0,3.0,1.0,1.0,3.0,4.0,1.0,2.0,3.0,2.0,5.0,12.0,15.0,16.0,18.0,14.0,14.0,16.0,8.0,6.0,15.0,18.0,6.0,18.0,16.0,16.0,15.0,13.0,13.0,16.0,14.0,14.0,19.0,16.0,15.0,4.0,13.0,8.0,12.0,15.0,20.0,18.0,16.0,16.0,14.0,20.0,15.0,18.0,16.0,13.0,11.0,11.0,8.0,15.0,20.0,11.0,15.0,14.0,7.0,7.0,13.0
1,0,34.0,1.0,0.0,0.0,0.0,187.0,87.0,13.0,14.0,15.0,7.0,13.0,11.0,14.0,15.0,11.0,17.0,12.0,2.0,1.0,1.0,3.0,8.0,7.0,2.0,1.0,2.0,1.0,9.0,8.0,2.0,6.0,12.0,15.0,17.0,14.0,15.0,8.0,13.0,17.0,7.0,14.0,6.0,14.0,12.0,6.0,7.0,13.0,14.0,13.0,8.0,13.0,8.0,20.0,11.0,16.0,14.0,10.0,14.0,6.0,1.0,12.0,12.0,15.0,16.0,16.0,14.0,15.0,6.0,25.0,0.0,0.0,0.0,0.0,191.0,81.0,1.0,1.0,3.0,2.0,3.0,2.0,3.0,4.0,2.0,1.0,2.0,4.0,3.0,10.0,8.0,6.0,6.0,11.0,6.0,10.0,11.0,10.0,5.0,12.0,7.0,16.0,13.0,16.0,11.0,13.0,7.0,10.0,14.0,5.0,12.0,10.0,13.0,13.0,12.0,13.0,13.0,16.0,16.0,7.0,16.0,14.0,20.0,14.0,14.0,13.0,13.0,15.0,6.0,12.0,13.0,6.0,14.0,8.0,8.0,13.0,7.0,4.0,26.0,0.0,0.0,0.0,0.0,176.0,70.0,2.0,1.0,4.0,3.0,3.0,3.0,1.0,3.0,3.0,2.0,1.0,10.0,11.0,11.0,6.0,13.0,9.0,5.0,12.0,11.0,13.0,13.0,7.0,14.0,13.0,15.0,11.0,14.0,12.0,11.0,9.0,12.0,13.0,9.0,9.0,13.0,12.0,15.0,14.0,12.0,16.0,12.0,7.0,20.0,13.0,13.0,10.0,15.0,11.0,13.0,14.0,13.0,11.0,9.0,8.0,9.0,17.0,12.0,14.0,14.0,15.0,3.0,21.0,0.0,0.0,1.0,0.0,177.0,68.0,4.0,1.0,2.0,1.0,1.0,1.0,1.0,1.0,2.0,1.0,2.0,5.0,12.0,9.0,7.0,12.0,8.0,13.0,10.0,16.0,13.0,12.0,8.0,14.0,12.0,12.0,13.0,12.0,12.0,12.0,10.0,13.0,15.0,11.0,13.0,11.0,13.0,13.0,14.0,13.0,14.0,13.0,11.0,10.0,14.0,12.0,20.0,12.0,14.0,12.0,11.0,12.0,8.0,14.0,13.0,10.0,14.0,12.0,14.0,12.0,11.0,5.0,28.0,1.0,0.0,7.0,0.0,181.0,71.0,2.0,2.0,1.0,3.0,1.0,3.0,3.0,2.0,3.0,3.0,3.0,12.0,11.0,10.0,5.0,13.0,11.0,8.0,10.0,8.0,9.0,14.0,11.0,12.0,13.0,14.0,14.0,12.0,12.0,13.0,12.0,13.0,12.0,8.0,9.0,9.0,12.0,17.0,15.0,11.0,13.0,14.0,10.0,12.0,13.0,12.0,20.0,16.0,12.0,13.0,14.0,16.0,12.0,9.0,10.0,14.0,16.0,14.0,13.0,12.0,12.0,14.0,34.0,103.0,7.0,16.0,1.0,182.0,72.0,2.0,1.0,1.0,1.0,3.0,1.0,4.0,3.0,3.0,2.0,1.0,11.0,13.0,12.0,8.0,15.0,13.0,9.0,13.0,6.0,8.0,15.0,12.0,8.0,15.0,11.0,14.0,13.0,15.0,15.0,14.0,16.0,17.0,15.0,14.0,11.0,13.0,17.0,13.0,8.0,11.0,10.0,11.0,16.0,13.0,8.0,20.0,12.0,10.0,15.0,11.0,12.0,12.0,15.0,14.0,12.0,15.0,15.0,18.0,14.0,14.0,7.0,23.0,39.0,1.0,5.0,2.0,174.0,73.0,3.0,4.0,2.0,1.0,1.0,2.0,4.0,1.0,3.0,2.0,4.0,7.0,6.0,10.0,5.0,11.0,7.0,6.0,8.0,5.0,11.0,12.0,6.0,13.0,11.0,15.0,9.0,16.0,8.0,12.0,10.0,10.0,14.0,10.0,6.0,12.0,11.0,16.0,20.0,15.0,16.0,15.0,9.0,6.0,13.0,14.0,20.0,16.0,14.0,9.0,13.0,13.0,7.0,14.0,14.0,12.0,13.0,12.0,14.0,12.0,14.0,3.0,25.0,19.0,6.0,0.0,0.0,182.0,78.0,1.0,4.0,3.0,1.0,2.0,1.0,2.0,2.0,4.0,1.0,4.0,16.0,13.0,12.0,11.0,12.0,13.0,8.0,12.0,5.0,5.0,13.0,13.0,5.0,15.0,11.0,12.0,12.0,13.0,12.0,15.0,12.0,15.0,14.0,6.0,15.0,9.0,11.0,14.0,15.0,14.0,14.0,10.0,11.0,11.0,14.0,20.0,12.0,13.0,10.0,11.0,15.0,5.0,12.0,10.0,15.0,16.0,11.0,13.0,16.0,16.0,7.0,23.0,21.0,3.0,9.0,4.0,176.0,69.0,1.0,2.0,1.0,3.0,3.0,1.0,2.0,1.0,1.0,2.0,3.0,9.0,9.0,14.0,13.0,14.0,10.0,10.0,9.0,3.0,5.0,12.0,14.0,6.0,15.0,9.0,13.0,9.0,11.0,10.0,12.0,12.0,13.0,14.0,10.0,13.0,8.0,8.0,10.0,16.0,15.0,10.0,8.0,10.0,12.0,15.0,20.0,13.0,10.0,9.0,8.0,13.0,11.0,13.0,7.0,14.0,12.0,13.0,8.0,14.0,13.0,8.0,31.0,0.0,0.0,0.0,0.0,182.0,76.0,3.0,2.0,3.0,4.0,2.0,1.0,2.0,3.0,1.0,2.0,2.0,10.0,13.0,15.0,6.0,14.0,9.0,11.0,8.0,7.0,4.0,12.0,10.0,3.0,14.0,7.0,13.0,10.0,12.0,12.0,12.0,10.0,11.0,12.0,6.0,15.0,6.0,13.0,13.0,14.0,14.0,12.0,10.0,20.0,13.0,13.0,8.0,12.0,11.0,8.0,7.0,14.0,13.0,8.0,8.0,13.0,14.0,12.0,12.0,14.0,14.0,6.0,28.0,37.0,15.0,1.0,0.0,194.0,88.0,2.0,1.0,2.0,1.0,1.0,2.0,3.0,1.0,3.0,2.0,2.0,4.0,6.0,12.0,15.0,12.0,7.0,16.0,11.0,3.0,6.0,10.0,14.0,4.0,11.0,10.0,14.0,15.0,13.0,10.0,8.0,9.0,13.0,12.0,6.0,14.0,8.0,11.0,16.0,13.0,12.0,18.0,17.0,9.0,12.0,12.0,20.0,14.0,18.0,13.0,10.0,15.0,15.0,6.0,20.0,17.0,12.0,15.0,14.0,11.0,14.0,7.0,33.0,101.0,0.0,0.0,0.0,182.0,87.0,12.0,11.0,15.0,12.0,14.0,13.0,14.0,15.0,15.0,13.0,12.0,9.0,2.0,3.0,8.0,9.0,11.0,10.0,11.0,1.0,3.0,12.0,15.0,8.0,10.0,8.0,14.0,14.0,14.0,12.0,9.0,12.0,16.0,9.0,15.0,2.0,13.0,12.0,6.0,12.0,13.0,14.0,13.0,8.0,13.0,10.0,20.0,12.0,15.0,13.0,8.0,15.0,5.0,1.0,13.0,15.0,13.0,15.0,18.0,18.0,15.0,5.0,20.0,0.0,0.0,7.0,0.0,186.0,76.0,3.0,1.0,2.0,4.0,3.0,1.0,1.0,2.0,3.0,3.0,1.0,5.0,9.0,12.0,6.0,12.0,5.0,11.0,9.0,10.0,13.0,14.0,10.0,12.0,14.0,14.0,16.0,14.0,16.0,11.0,12.0,13.0,13.0,9.0,10.0,8.0,13.0,15.0,10.0,10.0,11.0,13.0,13.0,10.0,14.0,12.0,20.0,12.0,11.0,13.0,8.0,11.0,6.0,15.0,7.0,14.0,13.0,10.0,14.0,15.0,17.0,6.0,32.0,0.0,0.0,0.0,0.0,195.0,89.0,3.0,2.0,3.0,1.0,4.0,2.0,4.0,2.0,3.0,1.0,2.0,3.0,5.0,5.0,11.0,8.0,8.0,14.0,9.0,11.0,15.0,12.0,9.0,13.0,8.0,16.0,13.0,19.0,10.0,14.0,8.0,13.0,16.0,5.0,15.0,10.0,15.0,15.0,14.0,8.0,8.0,16.0,17.0,5.0,11.0,10.0,20.0,13.0,17.0,13.0,12.0,15.0,7.0,5.0,12.0,14.0,14.0,12.0,15.0,8.0,8.0,7.0,24.0,0.0,0.0,0.0,0.0,187.0,93.0,4.0,3.0,2.0,1.0,2.0,2.0,2.0,2.0,1.0,2.0,1.0,4.0,5.0,6.0,6.0,12.0,6.0,15.0,8.0,6.0,15.0,10.0,6.0,13.0,9.0,14.0,13.0,16.0,12.0,14.0,7.0,12.0,15.0,5.0,8.0,6.0,12.0,14.0,15.0,9.0,10.0,18.0,13.0,6.0,14.0,12.0,20.0,15.0,17.0,13.0,14.0,14.0,11.0,10.0,19.0,14.0,15.0,11.0,13.0,14.0,14.0,5.0,25.0,0.0,0.0,26.0,3.0,176.0,64.0,3.0,2.0,2.0,1.0,3.0,3.0,3.0,2.0,1.0,1.0,1.0,12.0,13.0,12.0,7.0,13.0,13.0,11.0,11.0,11.0,14.0,13.0,11.0,14.0,13.0,13.0,13.0,14.0,13.0,13.0,11.0,13.0,17.0,12.0,11.0,10.0,12.0,14.0,14.0,14.0,14.0,12.0,8.0,8.0,17.0,14.0,20.0,15.0,12.0,14.0,12.0,13.0,5.0,12.0,17.0,15.0,15.0,14.0,16.0,15.0,15.0,7.0,23.0,0.0,0.0,1.0,0.0,182.0,71.0,3.0,1.0,2.0,3.0,4.0,2.0,3.0,1.0,2.0,1.0,3.0,9.0,13.0,14.0,8.0,14.0,13.0,12.0,10.0,13.0,14.0,14.0,13.0,15.0,13.0,14.0,14.0,13.0,11.0,12.0,12.0,13.0,16.0,12.0,12.0,15.0,13.0,14.0,15.0,15.0,13.0,14.0,12.0,9.0,16.0,15.0,20.0,15.0,15.0,15.0,10.0,14.0,6.0,12.0,8.0,15.0,14.0,16.0,15.0,15.0,16.0,6.0,32.0,13.0,0.0,19.0,1.0,172.0,72.0,3.0,1.0,3.0,2.0,1.0,2.0,2.0,2.0,3.0,1.0,1.0,7.0,12.0,12.0,5.0,13.0,7.0,6.0,9.0,9.0,12.0,14.0,9.0,14.0,12.0,13.0,14.0,14.0,15.0,15.0,10.0,13.0,17.0,7.0,18.0,8.0,15.0,18.0,15.0,12.0,14.0,12.0,6.0,10.0,16.0,13.0,20.0,15.0,12.0,15.0,9.0,15.0,5.0,10.0,12.0,16.0,14.0,13.0,15.0,18.0,18.0,5.0,33.0,14.0,0.0,0.0,0.0,172.0,68.0,3.0,3.0,1.0,1.0,1.0,1.0,1.0,3.0,1.0,2.0,1.0,14.0,11.0,13.0,8.0,14.0,13.0,7.0,13.0,4.0,10.0,13.0,10.0,12.0,14.0,11.0,13.0,14.0,13.0,13.0,12.0,14.0,15.0,10.0,13.0,12.0,13.0,16.0,17.0,13.0,13.0,12.0,7.0,10.0,14.0,12.0,20.0,14.0,9.0,14.0,11.0,15.0,10.0,12.0,20.0,13.0,13.0,15.0,14.0,13.0,12.0,8.0,22.0,2.0,0.0,0.0,0.0,169.0,59.0,3.0,1.0,3.0,1.0,1.0,1.0,1.0,1.0,3.0,3.0,2.0,13.0,13.0,15.0,13.0,15.0,13.0,7.0,13.0,8.0,6.0,13.0,13.0,5.0,16.0,10.0,10.0,8.0,13.0,11.0,14.0,12.0,12.0,14.0,10.0,12.0,6.0,10.0,8.0,16.0,15.0,17.0,6.0,12.0,12.0,15.0,20.0,13.0,9.0,12.0,8.0,12.0,8.0,12.0,13.0,13.0,13.0,14.0,12.0,10.0,13.0,9.0,28.0,0.0,0.0,0.0,0.0,168.0,65.0,3.0,4.0,1.0,1.0,2.0,3.0,1.0,2.0,2.0,1.0,2.0,14.0,14.0,15.0,8.0,14.0,14.0,9.0,8.0,7.0,8.0,13.0,10.0,7.0,14.0,12.0,12.0,12.0,13.0,13.0,13.0,12.0,15.0,13.0,6.0,11.0,7.0,14.0,14.0,16.0,14.0,10.0,6.0,20.0,13.0,15.0,5.0,13.0,9.0,12.0,12.0,14.0,9.0,6.0,18.0,14.0,14.0,14.0,14.0,13.0,13.0,6.0,23.0,0.0,0.0,1.0,0.0,187.0,77.0,3.0,1.0,3.0,1.0,2.0,2.0,3.0,1.0,3.0,1.0,3.0,6.0,8.0,12.0,12.0,13.0,10.0,12.0,9.0,5.0,6.0,11.0,12.0,6.0,12.0,8.0,11.0,10.0,12.0,8.0,9.0,10.0,5.0,9.0,7.0,14.0,7.0,13.0,9.0,15.0,13.0,14.0,10.0,8.0,12.0,14.0,20.0,12.0,13.0,12.0,8.0,10.0,9.0,11.0,13.0,13.0,12.0,11.0,13.0,11.0,11.0,13.0
0,2,25.0,0.0,0.0,0.0,0.0,187.0,83.0,11.0,14.0,12.0,8.0,13.0,11.0,14.0,15.0,13.0,13.0,9.0,8.0,1.0,1.0,1.0,11.0,11.0,1.0,2.0,2.0,1.0,10.0,3.0,2.0,11.0,8.0,12.0,14.0,12.0,12.0,10.0,12.0,14.0,6.0,14.0,2.0,12.0,12.0,8.0,13.0,15.0,14.0,13.0,20.0,15.0,11.0,5.0,14.0,13.0,13.0,8.0,8.0,10.0,1.0,9.0,13.0,14.0,12.0,15.0,15.0,15.0,5.0,27.0,1.0,0.0,3.0,0.0,186.0,83.0,2.0,2.0,2.0,2.0,1.0,4.0,2.0,3.0,3.0,3.0,2.0,5.0,9.0,9.0,8.0,10.0,6.0,16.0,8.0,7.0,14.0,11.0,6.0,15.0,12.0,14.0,15.0,16.0,13.0,12.0,8.0,13.0,14.0,8.0,11.0,8.0,14.0,15.0,15.0,15.0,9.0,15.0,12.0,8.0,13.0,14.0,20.0,14.0,17.0,15.0,13.0,13.0,10.0,8.0,9.0,14.0,9.0,13.0,15.0,15.0,15.0,6.0,26.0,11.0,0.0,4.0,0.0,183.0,79.0,3.0,2.0,1.0,2.0,2.0,2.0,3.0,2.0,2.0,2.0,1.0,5.0,7.0,9.0,6.0,10.0,11.0,15.0,11.0,7.0,14.0,10.0,7.0,13.0,10.0,14.0,13.0,15.0,13.0,12.0,10.0,12.0,17.0,8.0,11.0,10.0,13.0,15.0,16.0,13.0,13.0,16.0,13.0,5.0,15.0,13.0,20.0,16.0,15.0,13.0,14.0,15.0,7.0,14.0,16.0,12.0,14.0,14.0,15.0,14.0,14.0,5.0,26.0,14.0,0.0,0.0,0.0,181.0,74.0,2.0,1.0,1.0,1.0,3.0,2.0,3.0,1.0,3.0,3.0,2.0,6.0,13.0,8.0,5.0,12.0,7.0,12.0,8.0,11.0,13.0,12.0,6.0,14.0,10.0,14.0,12.0,14.0,10.0,12.0,8.0,8.0,14.0,6.0,6.0,12.0,11.0,14.0,15.0,16.0,14.0,14.0,11.0,5.0,14.0,14.0,20.0,16.0,14.0,12.0,13.0,14.0,8.0,10.0,8.0,14.0,12.0,13.0,15.0,15.0,15.0,6.0,22.0,12.0,2.0,13.0,0.0,170.0,71.0,2.0,2.0,1.0,3.0,2.0,2.0,1.0,1.0,1.0,3.0,2.0,15.0,15.0,12.0,10.0,14.0,15.0,8.0,13.0,12.0,9.0,13.0,10.0,10.0,14.0,14.0,16.0,10.0,17.0,14.0,12.0,16.0,14.0,12.0,8.0,14.0,10.0,17.0,16.0,16.0,17.0,10.0,6.0,20.0,17.0,13.0,8.0,15.0,7.0,15.0,6.0,15.0,8.0,17.0,13.0,13.0,12.0,12.0,14.0,16.0,16.0,8.0,29.0,0.0,0.0,0.0,0.0,188.0,74.0,1.0,2.0,3.0,3.0,2.0,3.0,1.0,3.0,2.0,1.0,1.0,4.0,8.0,10.0,6.0,13.0,7.0,14.0,9.0,6.0,13.0,12.0,8.0,13.0,13.0,12.0,14.0,13.0,14.0,11.0,13.0,12.0,14.0,6.0,13.0,8.0,14.0,15.0,15.0,9.0,12.0,14.0,14.0,10.0,13.0,10.0,20.0,16.0,12.0,13.0,12.0,15.0,9.0,11.0,11.0,14.0,14.0,12.0,15.0,13.0,13.0,6.0,30.0,7.0,0.0,0.0,0.0,181.0,72.0,1.0,3.0,3.0,1.0,2.0,3.0,2.0,1.0,3.0,2.0,2.0,12.0,11.0,14.0,8.0,14.0,12.0,8.0,12.0,6.0,5.0,13.0,13.0,5.0,14.0,8.0,12.0,10.0,11.0,12.0,15.0,11.0,13.0,14.0,9.0,13.0,10.0,12.0,13.0,12.0,14.0,12.0,10.0,12.0,15.0,13.0,20.0,15.0,9.0,10.0,8.0,13.0,5.0,8.0,12.0,14.0,14.0,12.0,11.0,14.0,14.0,8.0,22.0,18.0,0.0,0.0,0.0,179.0,75.0,1.0,4.0,2.0,1.0,1.0,1.0,3.0,1.0,1.0,3.0,2.0,7.0,8.0,12.0,8.0,13.0,10.0,11.0,12.0,11.0,11.0,11.0,10.0,14.0,13.0,15.0,12.0,15.0,8.0,12.0,10.0,12.0,14.0,12.0,10.0,13.0,12.0,13.0,17.0,14.0,14.0,13.0,10.0,9.0,15.0,15.0,20.0,15.0,14.0,13.0,13.0,12.0,11.0,12.0,13.0,15.0,9.0,10.0,12.0,10.0,10.0,4.0,31.0,0.0,0.0,0.0,0.0,175.0,65.0,3.0,4.0,1.0,1.0,3.0,3.0,3.0,2.0,4.0,3.0,3.0,14.0,13.0,13.0,7.0,14.0,12.0,7.0,12.0,7.0,6.0,14.0,15.0,8.0,15.0,11.0,12.0,13.0,13.0,11.0,14.0,12.0,15.0,13.0,9.0,11.0,10.0,12.0,13.0,14.0,15.0,12.0,7.0,20.0,10.0,13.0,10.0,12.0,9.0,12.0,11.0,15.0,16.0,13.0,8.0,14.0,14.0,14.0,13.0,13.0,13.0,7.0,28.0,0.0,0.0,0.0,0.0,170.0,67.0,2.0,3.0,3.0,4.0,3.0,2.0,1.0,1.0,2.0,2.0,3.0,8.0,12.0,12.0,10.0,14.0,7.0,5.0,10.0,6.0,5.0,12.0,5.0,4.0,13.0,7.0,16.0,12.0,9.0,11.0,12.0,10.0,3.0,12.0,6.0,13.0,6.0,8.0,13.0,16.0,13.0,10.0,5.0,5.0,13.0,16.0,20.0,15.0,7.0,12.0,4.0,9.0,7.0,10.0,20.0,13.0,12.0,10.0,13.0,11.0,10.0,2.0,24.0,0.0,0.0,5.0,0.0,183.0,79.0,4.0,4.0,3.0,3.0,1.0,3.0,2.0,1.0,3.0,2.0,3.0,4.0,7.0,12.0,13.0,12.0,8.0,13.0,12.0,5.0,6.0,11.0,12.0,4.0,13.0,11.0,12.0,14.0,9.0,12.0,10.0,10.0,13.0,12.0,6.0,14.0,12.0,13.0,14.0,15.0,14.0,14.0,11.0,10.0,13.0,14.0,20.0,14.0,14.0,12.0,12.0,14.0,9.0,5.0,7.0,13.0,15.0,11.0,14.0,14.0,14.0,6.0,31.0,25.0,0.0,6.0,0.0,191.0,84.0,11.0,14.0,13.0,12.0,15.0,14.0,15.0,16.0,13.0,14.0,14.0,8.0,2.0,10.0,5.0,11.0,11.0,7.0,10.0,2.0,5.0,10.0,11.0,11.0,9.0,12.0,13.0,15.0,13.0,13.0,8.0,13.0,16.0,12.0,14.0,1.0,16.0,13.0,11.0,12.0,13.0,16.0,16.0,8.0,16.0,13.0,20.0,15.0,15.0,17.0,8.0,15.0,7.0,2.0,15.0,15.0,17.0,15.0,17.0,16.0,15.0,6.0,26.0,0.0,0.0,0.0,0.0,167.0,0.0,3.0,2.0,1.0,2.0,2.0,3.0,3.0,3.0,2.0,3.0,2.0,11.0,12.0,12.0,11.0,12.0,13.0,8.0,10.0,7.0,5.0,12.0,11.0,6.0,12.0,11.0,10.0,11.0,10.0,10.0,13.0,11.0,9.0,10.0,9.0,11.0,6.0,10.0,11.0,11.0,11.0,10.0,6.0,5.0,13.0,11.0,20.0,12.0,9.0,12.0,5.0,10.0,9.0,8.0,12.0,11.0,9.0,9.0,11.0,4.0,1.0,5.0,32.0,0.0,0.0,3.0,0.0,187.0,82.0,1.0,2.0,2.0,3.0,2.0,1.0,1.0,2.0,2.0,3.0,1.0,5.0,11.0,8.0,7.0,10.0,6.0,15.0,9.0,13.0,15.0,10.0,8.0,16.0,9.0,16.0,14.0,17.0,12.0,15.0,8.0,12.0,17.0,9.0,14.0,11.0,13.0,15.0,13.0,12.0,11.0,16.0,14.0,6.0,13.0,14.0,20.0,13.0,16.0,15.0,14.0,14.0,8.0,14.0,14.0,14.0,15.0,16.0,15.0,12.0,10.0,7.0,28.0,52.0,5.0,8.0,6.0,179.0,70.0,3.0,3.0,2.0,3.0,2.0,3.0,1.0,1.0,2.0,3.0,1.0,13.0,15.0,15.0,11.0,14.0,12.0,12.0,12.0,14.0,13.0,14.0,12.0,16.0,14.0,14.0,15.0,15.0,12.0,14.0,13.0,14.0,12.0,13.0,11.0,16.0,13.0,13.0,15.0,14.0,13.0,14.0,10.0,20.0,9.0,14.0,8.0,13.0,11.0,13.0,14.0,17.0,15.0,15.0,12.0,14.0,14.0,13.0,8.0,11.0,12.0,14.0,31.0,0.0,0.0,6.0,0.0,174.0,80.0,1.0,1.0,1.0,1.0,1.0,5.0,1.0,1.0,1.0,1.0,1.0,14.0,12.0,11.0,7.0,12.0,13.0,9.0,7.0,10.0,11.0,11.0,10.0,10.0,12.0,11.0,11.0,11.0,10.0,6.0,10.0,9.0,12.0,12.0,12.0,10.0,12.0,12.0,14.0,12.0,15.0,10.0,9.0,20.0,12.0,12.0,7.0,12.0,9.0,9.0,10.0,12.0,7.0,9.0,11.0,14.0,9.0,7.0,14.0,8.0,9.0,9.0,32.0,36.0,0.0,12.0,2.0,183.0,77.0,1.0,3.0,2.0,1.0,3.0,1.0,1.0,2.0,1.0,1.0,3.0,6.0,11.0,8.0,6.0,13.0,11.0,13.0,10.0,6.0,15.0,14.0,10.0,17.0,12.0,15.0,16.0,18.0,14.0,17.0,12.0,15.0,17.0,11.0,17.0,7.0,17.0,20.0,16.0,9.0,11.0,15.0,11.0,8.0,15.0,10.0,20.0,14.0,14.0,17.0,10.0,16.0,10.0,13.0,15.0,15.0,15.0,14.0,18.0,15.0,13.0,6.0,21.0,0.0,0.0,9.0,0.0,184.0,72.0,1.0,3.0,1.0,2.0,3.0,2.0,1.0,1.0,2.0,1.0,2.0,6.0,10.0,12.0,7.0,12.0,7.0,14.0,11.0,7.0,14.0,13.0,10.0,13.0,12.0,14.0,13.0,14.0,12.0,12.0,12.0,12.0,16.0,11.0,10.0,12.0,13.0,14.0,15.0,14.0,13.0,16.0,12.0,12.0,14.0,15.0,20.0,15.0,17.0,14.0,12.0,15.0,9.0,9.0,10.0,16.0,14.0,15.0,14.0,14.0,14.0,8.0,29.0,90.0,4.0,16.0,2.0,170.0,61.0,2.0,3.0,3.0,1.0,3.0,1.0,2.0,2.0,2.0,2.0,1.0,15.0,14.0,15.0,9.0,17.0,16.0,7.0,12.0,4.0,11.0,18.0,15.0,12.0,17.0,15.0,15.0,16.0,13.0,16.0,17.0,14.0,16.0,15.0,14.0,12.0,14.0,18.0,16.0,13.0,14.0,12.0,8.0,10.0,14.0,11.0,20.0,14.0,10.0,14.0,9.0,17.0,10.0,14.0,13.0,17.0,15.0,16.0,17.0,15.0,16.0,7.0,20.0,0.0,0.0,7.0,1.0,170.0,58.0,1.0,2.0,2.0,2.0,2.0,2.0,2.0,4.0,1.0,3.0,2.0,16.0,14.0,16.0,13.0,16.0,17.0,5.0,14.0,2.0,6.0,15.0,13.0,4.0,17.0,9.0,12.0,14.0,12.0,12.0,14.0,13.0,15.0,16.0,7.0,13.0,9.0,13.0,15.0,15.0,16.0,11.0,7.0,20.0,14.0,15.0,8.0,14.0,8.0,15.0,5.0,15.0,7.0,16.0,15.0,15.0,15.0,14.0,16.0,18.0,16.0,3.0,30.0,18.0,2.0,0.0,0.0,184.0,79.0,2.0,2.0,2.0,1.0,2.0,2.0,3.0,1.0,3.0,1.0,1.0,13.0,16.0,15.0,10.0,13.0,12.0,9.0,11.0,11.0,10.0,14.0,12.0,8.0,14.0,14.0,10.0,15.0,10.0,12.0,12.0,11.0,15.0,12.0,14.0,14.0,11.0,13.0,14.0,15.0,14.0,15.0,11.0,7.0,15.0,15.0,20.0,15.0,14.0,13.0,13.0,13.0,11.0,14.0,12.0,14.0,14.0,10.0,13.0,14.0,11.0,9.0,25.0,0.0,0.0,0.0,0.0,191.0,87.0,2.0,1.0,2.0,2.0,3.0,1.0,1.0,3.0,2.0,3.0,1.0,5.0,8.0,10.0,14.0,13.0,8.0,17.0,12.0,4.0,6.0,13.0,14.0,6.0,13.0,12.0,13.0,16.0,13.0,14.0,11.0,13.0,15.0,9.0,12.0,15.0,9.0,15.0,14.0,11.0,12.0,15.0,17.0,10.0,14.0,13.0,20.0,14.0,15.0,12.0,6.0,13.0,7.0,6.0,11.0,13.0,14.0,12.0,16.0,15.0,14.0,7.0
4,0,31.0,25.0,0.0,6.0,0.0,191.0,84.0,11.0,14.0,13.0,12.0,15.0,14.0,15.0,16.0,13.0,14.0,14.0,8.0,2.0,10.0,5.0,11.0,11.0,7.0,10.0,2.0,5.0,10.0,11.0,11.0,9.0,12.0,13.0,15.0,13.0,13.0,8.0,13.0,16.0,12.0,14.0,1.0,16.0,13.0,11.0,12.0,13.0,16.0,16.0,8.0,16.0,13.0,20.0,15.0,15.0,17.0,8.0,15.0,7.0,2.0,15.0,15.0,17.0,15.0,17.0,16.0,15.0,6.0,32.0,0.0,0.0,3.0,0.0,187.0,82.0,1.0,2.0,2.0,3.0,2.0,1.0,1.0,2.0,2.0,3.0,1.0,5.0,11.0,8.0,7.0,10.0,6.0,15.0,9.0,13.0,15.0,10.0,8.0,16.0,9.0,16.0,14.0,17.0,12.0,15.0,8.0,12.0,17.0,9.0,14.0,11.0,13.0,15.0,13.0,12.0,11.0,16.0,14.0,6.0,13.0,14.0,20.0,13.0,16.0,15.0,14.0,14.0,8.0,14.0,14.0,14.0,15.0,16.0,15.0,12.0,10.0,7.0,38.0,89.0,6.0,14.0,1.0,183.0,79.0,3.0,3.0,2.0,3.0,2.0,3.0,2.0,4.0,3.0,2.0,3.0,4.0,8.0,8.0,7.0,12.0,6.0,14.0,8.0,11.0,17.0,12.0,11.0,16.0,12.0,15.0,16.0,17.0,15.0,17.0,10.0,16.0,18.0,6.0,15.0,8.0,16.0,17.0,13.0,8.0,8.0,12.0,11.0,10.0,13.0,8.0,20.0,10.0,11.0,16.0,12.0,16.0,11.0,7.0,15.0,16.0,16.0,15.0,18.0,16.0,14.0,4.0,26.0,0.0,0.0,0.0,0.0,167.0,0.0,3.0,2.0,1.0,2.0,2.0,3.0,3.0,3.0,2.0,3.0,2.0,11.0,12.0,12.0,11.0,12.0,13.0,8.0,10.0,7.0,5.0,12.0,11.0,6.0,12.0,11.0,10.0,11.0,10.0,10.0,13.0,11.0,9.0,10.0,9.0,11.0,6.0,10.0,11.0,11.0,11.0,10.0,6.0,5.0,13.0,11.0,20.0,12.0,9.0,12.0,5.0,10.0,9.0,8.0,12.0,11.0,9.0,9.0,11.0,4.0,1.0,5.0,28.0,52.0,5.0,8.0,6.0,179.0,70.0,3.0,3.0,2.0,3.0,2.0,3.0,1.0,1.0,2.0,3.0,1.0,13.0,15.0,15.0,11.0,14.0,12.0,12.0,12.0,14.0,13.0,14.0,12.0,16.0,14.0,14.0,15.0,15.0,12.0,14.0,13.0,14.0,12.0,13.0,11.0,16.0,13.0,13.0,15.0,14.0,13.0,14.0,10.0,20.0,9.0,14.0,8.0,13.0,11.0,13.0,14.0,17.0,15.0,15.0,12.0,14.0,14.0,13.0,8.0,11.0,12.0,14.0,31.0,0.0,0.0,6.0,0.0,174.0,80.0,1.0,1.0,1.0,1.0,1.0,5.0,1.0,1.0,1.0,1.0,1.0,14.0,12.0,11.0,7.0,12.0,13.0,9.0,7.0,10.0,11.0,11.0,10.0,10.0,12.0,11.0,11.0,11.0,10.0,6.0,10.0,9.0,12.0,12.0,12.0,10.0,12.0,12.0,14.0,12.0,15.0,10.0,9.0,20.0,12.0,12.0,7.0,12.0,9.0,9.0,10.0,12.0,7.0,9.0,11.0,14.0,9.0,7.0,14.0,8.0,9.0,9.0,21.0,0.0,0.0,9.0,0.0,184.0,72.0,1.0,3.0,1.0,2.0,3.0,2.0,1.0,1.0,2.0,1.0,2.0,6.0,10.0,12.0,7.0,12.0,7.0,14.0,11.0,7.0,14.0,13.0,10.0,13.0,12.0,14.0,13.0,14.0,12.0,12.0,12.0,12.0,16.0,11.0,10.0,12.0,13.0,14.0,15.0,14.0,13.0,16.0,12.0,12.0,14.0,15.0,20.0,15.0,17.0,14.0,12.0,15.0,9.0,9.0,10.0,16.0,14.0,15.0,14.0,14.0,14.0,8.0,29.0,90.0,4.0,16.0,2.0,170.0,61.0,2.0,3.0,3.0,1.0,3.0,1.0,2.0,2.0,2.0,2.0,1.0,15.0,14.0,15.0,9.0,17.0,16.0,7.0,12.0,4.0,11.0,18.0,15.0,12.0,17.0,15.0,15.0,16.0,13.0,16.0,17.0,14.0,16.0,15.0,14.0,12.0,14.0,18.0,16.0,13.0,14.0,12.0,8.0,10.0,14.0,11.0,20.0,14.0,10.0,14.0,9.0,17.0,10.0,14.0,13.0,17.0,15.0,16.0,17.0,15.0,16.0,7.0,21.0,7.0,0.0,14.0,6.0,173.0,64.0,3.0,2.0,3.0,2.0,3.0,3.0,3.0,2.0,3.0,3.0,3.0,14.0,14.0,18.0,14.0,17.0,14.0,7.0,11.0,2.0,6.0,15.0,14.0,6.0,18.0,12.0,14.0,14.0,15.0,13.0,16.0,14.0,17.0,17.0,12.0,13.0,9.0,13.0,17.0,15.0,17.0,13.0,7.0,20.0,14.0,14.0,9.0,14.0,9.0,15.0,7.0,16.0,7.0,14.0,15.0,17.0,15.0,16.0,17.0,16.0,15.0,4.0,20.0,0.0,0.0,7.0,1.0,170.0,58.0,1.0,2.0,2.0,2.0,2.0,2.0,2.0,4.0,1.0,3.0,2.0,16.0,14.0,16.0,13.0,16.0,17.0,5.0,14.0,2.0,6.0,15.0,13.0,4.0,17.0,9.0,12.0,14.0,12.0,12.0,14.0,13.0,15.0,16.0,7.0,13.0,9.0,13.0,15.0,15.0,16.0,11.0,7.0,20.0,14.0,15.0,8.0,14.0,8.0,15.0,5.0,15.0,7.0,16.0,15.0,15.0,15.0,14.0,16.0,18.0,16.0,3.0,26.0,13.0,4.0,5.0,3.0,203.0,87.0,3.0,4.0,4.0,1.0,1.0,2.0,3.0,1.0,3.0,4.0,2.0,5.0,8.0,10.0,13.0,13.0,10.0,9.0,12.0,11.0,6.0,9.0,13.0,5.0,14.0,13.0,10.0,13.0,13.0,10.0,9.0,11.0,12.0,12.0,9.0,12.0,7.0,11.0,13.0,13.0,11.0,15.0,18.0,20.0,13.0,14.0,12.0,12.0,16.0,6.0,15.0,13.0,14.0,7.0,11.0,13.0,11.0,10.0,10.0,11.0,13.0,12.0,17.0,0.0,0.0,0.0,0.0,193.0,82.0,13.0,11.0,12.0,2.0,12.0,10.0,14.0,15.0,14.0,12.0,10.0,3.0,1.0,1.0,3.0,5.0,6.0,2.0,2.0,1.0,3.0,9.0,3.0,1.0,8.0,7.0,12.0,13.0,13.0,13.0,11.0,11.0,15.0,3.0,8.0,3.0,12.0,12.0,11.0,10.0,12.0,14.0,17.0,5.0,15.0,11.0,20.0,13.0,12.0,13.0,8.0,11.0,5.0,11.0,13.0,15.0,15.0,17.0,14.0,15.0,15.0,5.0,23.0,5.0,0.0,13.0,0.0,186.0,82.0,3.0,3.0,1.0,4.0,3.0,1.0,2.0,1.0,2.0,1.0,2.0,4.0,8.0,8.0,5.0,11.0,6.0,13.0,8.0,6.0,14.0,10.0,7.0,13.0,11.0,14.0,13.0,14.0,11.0,11.0,9.0,11.0,14.0,8.0,11.0,9.0,15.0,12.0,12.0,14.0,12.0,14.0,13.0,8.0,15.0,14.0,20.0,14.0,14.0,15.0,14.0,13.0,6.0,10.0,15.0,13.0,12.0,12.0,14.0,11.0,13.0,9.0,19.0,0.0,0.0,0.0,0.0,194.0,92.0,2.0,1.0,3.0,3.0,3.0,3.0,1.0,3.0,3.0,2.0,1.0,3.0,3.0,5.0,6.0,10.0,5.0,16.0,10.0,8.0,12.0,9.0,4.0,15.0,11.0,14.0,11.0,12.0,10.0,11.0,10.0,12.0,15.0,3.0,13.0,13.0,12.0,14.0,14.0,11.0,8.0,15.0,17.0,5.0,16.0,12.0,20.0,12.0,16.0,12.0,13.0,12.0,5.0,7.0,10.0,14.0,13.0,8.0,10.0,11.0,18.0,6.0,23.0,1.0,0.0,4.0,0.0,190.0,80.0,1.0,4.0,1.0,3.0,3.0,1.0,1.0,1.0,2.0,4.0,2.0,6.0,11.0,13.0,7.0,13.0,6.0,11.0,8.0,10.0,15.0,12.0,5.0,15.0,12.0,14.0,14.0,16.0,9.0,11.0,10.0,10.0,16.0,12.0,12.0,9.0,12.0,10.0,14.0,14.0,12.0,15.0,17.0,8.0,15.0,16.0,20.0,13.0,14.0,13.0,8.0,13.0,6.0,14.0,11.0,14.0,12.0,13.0,16.0,14.0,12.0,6.0,26.0,4.0,0.0,2.0,0.0,180.0,74.0,3.0,3.0,1.0,2.0,2.0,1.0,3.0,4.0,1.0,2.0,1.0,8.0,13.0,13.0,6.0,13.0,9.0,12.0,7.0,11.0,13.0,13.0,11.0,12.0,12.0,16.0,14.0,14.0,9.0,12.0,11.0,13.0,4.0,4.0,6.0,11.0,12.0,8.0,12.0,14.0,14.0,13.0,9.0,20.0,16.0,13.0,5.0,15.0,13.0,12.0,6.0,9.0,10.0,12.0,8.0,14.0,8.0,11.0,12.0,11.0,13.0,2.0,26.0,17.0,0.0,19.0,1.0,191.0,79.0,3.0,2.0,1.0,1.0,1.0,1.0,2.0,2.0,3.0,3.0,4.0,4.0,8.0,11.0,9.0,12.0,7.0,14.0,10.0,6.0,12.0,13.0,7.0,11.0,12.0,14.0,13.0,14.0,12.0,10.0,11.0,12.0,15.0,9.0,7.0,11.0,12.0,12.0,15.0,14.0,13.0,16.0,15.0,8.0,15.0,13.0,20.0,19.0,15.0,11.0,14.0,14.0,7.0,12.0,12.0,14.0,12.0,10.0,9.0,14.0,14.0,14.0,23.0,11.0,0.0,0.0,0.0,180.0,71.0,2.0,1.0,2.0,3.0,3.0,1.0,1.0,2.0,2.0,1.0,1.0,6.0,11.0,10.0,8.0,10.0,7.0,11.0,9.0,12.0,13.0,11.0,6.0,13.0,11.0,12.0,11.0,13.0,12.0,9.0,11.0,11.0,14.0,12.0,11.0,12.0,11.0,13.0,15.0,15.0,13.0,13.0,11.0,7.0,14.0,15.0,20.0,12.0,11.0,12.0,12.0,13.0,10.0,15.0,10.0,13.0,16.0,12.0,15.0,14.0,14.0,7.0,28.0,0.0,0.0,0.0,0.0,180.0,79.0,3.0,2.0,3.0,3.0,2.0,2.0,2.0,1.0,3.0,2.0,3.0,8.0,11.0,15.0,12.0,15.0,12.0,7.0,10.0,7.0,8.0,13.0,13.0,6.0,16.0,11.0,11.0,10.0,13.0,10.0,15.0,12.0,3.0,15.0,6.0,13.0,13.0,12.0,12.0,15.0,16.0,14.0,8.0,12.0,12.0,14.0,20.0,12.0,12.0,13.0,6.0,13.0,6.0,6.0,8.0,9.0,13.0,10.0,12.0,12.0,2.0,2.0,25.0,0.0,0.0,3.0,0.0,170.0,68.0,2.0,1.0,3.0,1.0,3.0,1.0,3.0,2.0,2.0,4.0,1.0,12.0,11.0,15.0,16.0,16.0,13.0,11.0,12.0,4.0,5.0,12.0,14.0,4.0,17.0,7.0,14.0,7.0,15.0,13.0,13.0,14.0,14.0,15.0,7.0,16.0,8.0,10.0,13.0,15.0,15.0,12.0,6.0,11.0,14.0,14.0,20.0,13.0,11.0,12.0,7.0,15.0,7.0,8.0,12.0,14.0,13.0,14.0,13.0,16.0,16.0,8.0,25.0,14.0,1.0,2.0,0.0,177.0,77.0,3.0,3.0,1.0,2.0,3.0,3.0,1.0,3.0,3.0,4.0,1.0,8.0,11.0,13.0,12.0,12.0,10.0,11.0,10.0,2.0,3.0,11.0,10.0,5.0,13.0,12.0,12.0,13.0,11.0,10.0,11.0,10.0,14.0,16.0,14.0,15.0,5.0,13.0,14.0,15.0,14.0,12.0,12.0,12.0,14.0,16.0,20.0,13.0,14.0,13.0,7.0,14.0,11.0,13.0,14.0,11.0,12.0,8.0,12.0,13.0,15.0,6.0,32.0,0.0,0.0,0.0,0.0,183.0,67.0,1.0,2.0,3.0,2.0,3.0,2.0,3.0,1.0,2.0,2.0,2.0,4.0,12.0,11.0,6.0,5.0,5.0,4.0,8.0,11.0,13.0,11.0,5.0,13.0,11.0,11.0,11.0,12.0,11.0,11.0,9.0,12.0,11.0,12.0,10.0,12.0,11.0,12.0,12.0,14.0,13.0,13.0,8.0,8.0,13.0,13.0,20.0,14.0,14.0,10.0,12.0,11.0,8.0,11.0,11.0,10.0,10.0,12.0,11.0,9.0,10.0,12.0
1,0,30.0,0.0,0.0,0.0,0.0,180.0,75.0,11.0,13.0,13.0,9.0,13.0,11.0,12.0,15.0,15.0,14.0,13.0,6.0,1.0,2.0,3.0,7.0,8.0,1.0,1.0,1.0,2.0,7.0,2.0,1.0,7.0,8.0,12.0,14.0,13.0,14.0,7.0,12.0,14.0,5.0,12.0,3.0,13.0,15.0,9.0,13.0,14.0,13.0,10.0,5.0,14.0,11.0,20.0,12.0,13.0,12.0,8.0,14.0,6.0,1.0,9.0,13.0,14.0,13.0,16.0,15.0,15.0,5.0,25.0,0.0,0.0,3.0,0.0,184.0,80.0,2.0,2.0,4.0,2.0,1.0,3.0,2.0,1.0,1.0,2.0,1.0,5.0,8.0,7.0,6.0,9.0,6.0,14.0,6.0,6.0,14.0,7.0,6.0,13.0,9.0,12.0,14.0,13.0,11.0,13.0,7.0,12.0,14.0,8.0,10.0,7.0,14.0,13.0,14.0,15.0,12.0,14.0,12.0,8.0,15.0,15.0,20.0,14.0,14.0,13.0,12.0,14.0,5.0,10.0,16.0,13.0,15.0,15.0,12.0,14.0,14.0,8.0,35.0,21.0,0.0,0.0,0.0,185.0,80.0,2.0,2.0,3.0,4.0,2.0,2.0,3.0,1.0,1.0,1.0,1.0,5.0,10.0,7.0,8.0,11.0,5.0,15.0,9.0,9.0,14.0,11.0,12.0,15.0,10.0,16.0,14.0,15.0,15.0,11.0,8.0,13.0,15.0,7.0,14.0,8.0,14.0,14.0,14.0,10.0,10.0,15.0,13.0,9.0,13.0,11.0,20.0,13.0,14.0,13.0,11.0,12.0,8.0,7.0,10.0,14.0,10.0,15.0,12.0,13.0,14.0,13.0,32.0,0.0,0.0,0.0,0.0,165.0,65.0,1.0,2.0,3.0,1.0,3.0,1.0,3.0,2.0,1.0,4.0,4.0,7.0,12.0,10.0,5.0,13.0,8.0,9.0,8.0,11.0,13.0,12.0,10.0,14.0,11.0,14.0,13.0,15.0,12.0,12.0,8.0,11.0,14.0,5.0,8.0,7.0,10.0,15.0,17.0,14.0,13.0,14.0,4.0,10.0,13.0,13.0,20.0,15.0,12.0,14.0,5.0,13.0,7.0,8.0,7.0,12.0,17.0,13.0,15.0,13.0,13.0,7.0,29.0,0.0,0.0,0.0,0.0,170.0,66.0,1.0,1.0,1.0,1.0,4.0,3.0,1.0,2.0,3.0,1.0,1.0,11.0,13.0,12.0,7.0,12.0,10.0,7.0,12.0,9.0,13.0,12.0,8.0,12.0,13.0,14.0,11.0,15.0,12.0,14.0,10.0,12.0,14.0,12.0,10.0,13.0,8.0,13.0,15.0,14.0,13.0,10.0,7.0,20.0,15.0,13.0,10.0,15.0,7.0,14.0,14.0,14.0,6.0,16.0,9.0,13.0,14.0,14.0,16.0,11.0,9.0,9.0,22.0,0.0,0.0,4.0,0.0,179.0,71.0,1.0,3.0,1.0,3.0,2.0,1.0,3.0,2.0,1.0,2.0,4.0,11.0,13.0,12.0,8.0,15.0,11.0,6.0,11.0,6.0,4.0,14.0,12.0,6.0,16.0,7.0,12.0,10.0,12.0,11.0,13.0,13.0,13.0,9.0,6.0,12.0,9.0,15.0,12.0,13.0,14.0,12.0,9.0,20.0,14.0,12.0,10.0,13.0,10.0,13.0,7.0,14.0,7.0,8.0,18.0,13.0,14.0,14.0,16.0,15.0,15.0,5.0,32.0,25.0,0.0,0.0,0.0,181.0,82.0,2.0,3.0,3.0,1.0,1.0,1.0,1.0,3.0,1.0,2.0,3.0,5.0,10.0,6.0,7.0,10.0,7.0,14.0,9.0,8.0,11.0,12.0,7.0,13.0,10.0,15.0,14.0,16.0,11.0,13.0,10.0,12.0,16.0,9.0,15.0,8.0,11.0,16.0,18.0,11.0,12.0,14.0,11.0,8.0,13.0,11.0,20.0,17.0,15.0,13.0,15.0,11.0,6.0,14.0,18.0,12.0,13.0,13.0,14.0,11.0,11.0,8.0,20.0,0.0,0.0,0.0,0.0,175.0,77.0,2.0,1.0,2.0,3.0,3.0,3.0,3.0,1.0,4.0,3.0,1.0,8.0,8.0,12.0,12.0,11.0,8.0,13.0,10.0,9.0,10.0,11.0,10.0,9.0,12.0,12.0,6.0,9.0,9.0,11.0,15.0,11.0,4.0,10.0,8.0,12.0,11.0,10.0,13.0,14.0,15.0,15.0,8.0,8.0,9.0,15.0,20.0,11.0,12.0,12.0,8.0,4.0,10.0,10.0,15.0,11.0,12.0,11.0,9.0,10.0,10.0,7.0,34.0,0.0,0.0,0.0,0.0,176.0,65.0,2.0,3.0,3.0,3.0,2.0,2.0,1.0,2.0,1.0,1.0,2.0,14.0,15.0,13.0,10.0,15.0,13.0,6.0,15.0,10.0,3.0,14.0,13.0,6.0,14.0,8.0,12.0,9.0,13.0,12.0,14.0,13.0,11.0,12.0,7.0,13.0,8.0,14.0,15.0,14.0,13.0,12.0,8.0,20.0,14.0,13.0,10.0,12.0,7.0,13.0,8.0,15.0,7.0,6.0,13.0,14.0,14.0,9.0,14.0,14.0,11.0,10.0,20.0,7.0,1.0,0.0,0.0,182.0,75.0,2.0,1.0,3.0,2.0,2.0,1.0,3.0,1.0,3.0,2.0,1.0,11.0,11.0,13.0,12.0,13.0,11.0,12.0,10.0,5.0,4.0,12.0,8.0,5.0,13.0,11.0,12.0,11.0,11.0,8.0,10.0,10.0,3.0,10.0,1.0,13.0,8.0,12.0,12.0,15.0,14.0,13.0,11.0,6.0,14.0,13.0,20.0,12.0,13.0,12.0,9.0,11.0,9.0,11.0,9.0,9.0,9.0,12.0,11.0,9.0,17.0,7.0,25.0,0.0,0.0,0.0,0.0,183.0,77.0,3.0,1.0,1.0,4.0,1.0,2.0,1.0,2.0,2.0,3.0,1.0,6.0,10.0,12.0,12.0,11.0,6.0,11.0,7.0,1.0,5.0,2.0,4.0,4.0,12.0,7.0,11.0,4.0,11.0,7.0,3.0,12.0,10.0,16.0,13.0,11.0,7.0,7.0,8.0,13.0,9.0,7.0,10.0,10.0,11.0,12.0,20.0,12.0,12.0,9.0,10.0,4.0,10.0,9.0,13.0,9.0,11.0,11.0,14.0,7.0,7.0,3.0,25.0,4.0,0.0,11.0,0.0,184.0,81.0,14.0,14.0,13.0,9.0,15.0,12.0,16.0,16.0,13.0,7.0,11.0,8.0,1.0,2.0,1.0,11.0,12.0,6.0,1.0,3.0,3.0,11.0,5.0,3.0,11.0,8.0,15.0,15.0,13.0,14.0,10.0,11.0,14.0,8.0,13.0,5.0,13.0,10.0,10.0,14.0,16.0,14.0,13.0,20.0,14.0,12.0,5.0,14.0,14.0,15.0,9.0,16.0,6.0,1.0,17.0,11.0,15.0,13.0,14.0,12.0,12.0,4.0,27.0,4.0,0.0,5.0,1.0,184.0,83.0,2.0,4.0,3.0,1.0,1.0,2.0,1.0,2.0,4.0,2.0,3.0,4.0,8.0,11.0,4.0,10.0,4.0,14.0,4.0,4.0,15.0,12.0,5.0,16.0,11.0,14.0,14.0,16.0,14.0,10.0,11.0,12.0,17.0,7.0,10.0,9.0,13.0,14.0,15.0,14.0,13.0,16.0,13.0,10.0,15.0,13.0,20.0,15.0,16.0,12.0,12.0,14.0,6.0,12.0,11.0,13.0,12.0,12.0,16.0,15.0,14.0,6.0,22.0,3.0,0.0,7.0,1.0,182.0,75.0,3.0,3.0,1.0,3.0,2.0,3.0,1.0,1.0,2.0,2.0,1.0,4.0,11.0,10.0,6.0,14.0,7.0,13.0,10.0,9.0,16.0,14.0,8.0,15.0,14.0,13.0,17.0,15.0,16.0,14.0,11.0,14.0,15.0,8.0,11.0,10.0,15.0,16.0,14.0,14.0,14.0,14.0,11.0,20.0,15.0,14.0,10.0,15.0,15.0,15.0,12.0,15.0,8.0,11.0,12.0,14.0,16.0,15.0,14.0,14.0,14.0,5.0,32.0,0.0,0.0,0.0,0.0,172.0,71.0,2.0,1.0,3.0,1.0,2.0,3.0,2.0,3.0,2.0,2.0,2.0,8.0,9.0,7.0,6.0,10.0,6.0,10.0,9.0,10.0,14.0,11.0,6.0,14.0,11.0,10.0,16.0,15.0,12.0,12.0,7.0,12.0,15.0,9.0,13.0,8.0,14.0,15.0,15.0,14.0,14.0,14.0,10.0,20.0,14.0,14.0,8.0,15.0,13.0,13.0,11.0,13.0,7.0,13.0,17.0,14.0,17.0,8.0,13.0,15.0,15.0,6.0,32.0,11.0,1.0,0.0,0.0,176.0,68.0,2.0,1.0,3.0,2.0,2.0,2.0,2.0,3.0,3.0,2.0,2.0,8.0,10.0,10.0,7.0,11.0,8.0,10.0,11.0,12.0,11.0,13.0,12.0,14.0,12.0,9.0,14.0,15.0,13.0,12.0,11.0,12.0,17.0,8.0,14.0,14.0,11.0,18.0,18.0,14.0,14.0,12.0,10.0,10.0,14.0,13.0,20.0,17.0,13.0,15.0,9.0,13.0,8.0,13.0,17.0,13.0,15.0,16.0,16.0,16.0,18.0,5.0,27.0,8.0,0.0,6.0,0.0,187.0,76.0,3.0,2.0,3.0,2.0,2.0,1.0,1.0,3.0,3.0,1.0,2.0,5.0,7.0,11.0,5.0,14.0,5.0,14.0,9.0,5.0,15.0,15.0,8.0,14.0,13.0,15.0,16.0,15.0,14.0,12.0,14.0,14.0,18.0,8.0,17.0,9.0,12.0,18.0,15.0,13.0,14.0,15.0,14.0,10.0,17.0,12.0,20.0,17.0,15.0,14.0,13.0,16.0,4.0,12.0,10.0,14.0,17.0,12.0,15.0,13.0,13.0,6.0,24.0,0.0,0.0,6.0,1.0,172.0,70.0,3.0,1.0,1.0,3.0,1.0,2.0,3.0,1.0,1.0,3.0,3.0,11.0,12.0,11.0,8.0,12.0,10.0,6.0,14.0,7.0,11.0,15.0,8.0,12.0,13.0,14.0,14.0,18.0,13.0,12.0,13.0,13.0,15.0,12.0,12.0,12.0,11.0,18.0,18.0,13.0,14.0,13.0,7.0,10.0,16.0,12.0,20.0,14.0,12.0,14.0,14.0,15.0,4.0,8.0,7.0,14.0,14.0,13.0,14.0,12.0,10.0,6.0,21.0,0.0,0.0,15.0,3.0,181.0,78.0,3.0,3.0,4.0,2.0,1.0,2.0,2.0,4.0,2.0,1.0,1.0,5.0,7.0,11.0,10.0,14.0,5.0,14.0,10.0,6.0,13.0,14.0,8.0,14.0,14.0,12.0,14.0,12.0,11.0,10.0,12.0,11.0,16.0,11.0,12.0,14.0,14.0,14.0,14.0,14.0,13.0,14.0,13.0,10.0,16.0,14.0,20.0,16.0,14.0,12.0,10.0,11.0,5.0,19.0,8.0,11.0,14.0,11.0,16.0,13.0,13.0,10.0,24.0,6.0,1.0,0.0,0.0,183.0,66.0,1.0,1.0,2.0,2.0,1.0,2.0,1.0,2.0,3.0,2.0,1.0,14.0,14.0,14.0,10.0,14.0,14.0,9.0,10.0,8.0,8.0,14.0,10.0,8.0,15.0,9.0,11.0,13.0,11.0,11.0,13.0,10.0,14.0,13.0,5.0,12.0,9.0,14.0,13.0,14.0,16.0,12.0,9.0,20.0,13.0,14.0,5.0,15.0,9.0,12.0,10.0,12.0,8.0,9.0,16.0,9.0,16.0,13.0,11.0,12.0,13.0,9.0,31.0,52.0,8.0,0.0,0.0,167.0,58.0,1.0,2.0,2.0,1.0,3.0,2.0,4.0,2.0,1.0,2.0,3.0,15.0,15.0,14.0,7.0,15.0,15.0,6.0,11.0,3.0,4.0,15.0,14.0,7.0,15.0,13.0,12.0,15.0,13.0,14.0,16.0,11.0,17.0,14.0,11.0,12.0,10.0,12.0,14.0,15.0,18.0,10.0,5.0,10.0,16.0,14.0,20.0,13.0,7.0,14.0,13.0,16.0,8.0,12.0,13.0,16.0,14.0,15.0,13.0,9.0,11.0,14.0,25.0,10.0,1.0,11.0,4.0,175.0,73.0,1.0,3.0,3.0,3.0,3.0,3.0,3.0,1.0,2.0,3.0,1.0,5.0,10.0,15.0,17.0,15.0,10.0,11.0,12.0,5.0,5.0,14.0,15.0,5.0,16.0,8.0,15.0,12.0,15.0,14.0,13.0,15.0,15.0,15.0,14.0,14.0,10.0,10.0,12.0,16.0,16.0,15.0,9.0,10.0,15.0,16.0,20.0,13.0,15.0,14.0,8.0,14.0,7.0,10.0,8.0,16.0,17.0,13.0,15.0,15.0,14.0,5.0
3,1,28.0,0.0,0.0,6.0,0.0,191.0,81.0,11.0,10.0,14.0,8.0,13.0,12.0,14.0,15.0,11.0,8.0,13.0,4.0,3.0,2.0,1.0,9.0,9.0,3.0,10.0,1.0,1.0,8.0,3.0,3.0,9.0,8.0,12.0,14.0,12.0,13.0,8.0,11.0,12.0,6.0,14.0,2.0,12.0,10.0,7.0,13.0,14.0,16.0,15.0,6.0,14.0,11.0,20.0,15.0,14.0,12.0,9.0,14.0,7.0,1.0,9.0,15.0,13.0,11.0,15.0,15.0,14.0,8.0,32.0,67.0,9.0,7.0,0.0,191.0,85.0,1.0,1.0,1.0,3.0,2.0,2.0,4.0,3.0,3.0,2.0,3.0,7.0,7.0,6.0,9.0,12.0,3.0,16.0,7.0,3.0,15.0,11.0,7.0,13.0,12.0,14.0,11.0,14.0,10.0,11.0,10.0,14.0,11.0,8.0,13.0,13.0,13.0,13.0,15.0,9.0,7.0,14.0,16.0,8.0,7.0,10.0,20.0,12.0,15.0,13.0,14.0,5.0,6.0,11.0,8.0,11.0,9.0,12.0,11.0,6.0,9.0,11.0,23.0,0.0,0.0,0.0,0.0,174.0,64.0,4.0,3.0,1.0,1.0,3.0,3.0,2.0,3.0,3.0,2.0,3.0,8.0,12.0,10.0,8.0,11.0,7.0,10.0,9.0,12.0,14.0,9.0,10.0,13.0,12.0,12.0,12.0,12.0,11.0,12.0,10.0,12.0,13.0,8.0,9.0,12.0,11.0,13.0,14.0,15.0,14.0,11.0,10.0,10.0,14.0,14.0,20.0,15.0,10.0,14.0,12.0,12.0,8.0,13.0,10.0,12.0,15.0,12.0,13.0,10.0,17.0,6.0,26.0,10.0,1.0,0.0,0.0,175.0,65.0,4.0,1.0,2.0,2.0,2.0,3.0,3.0,1.0,3.0,2.0,3.0,11.0,13.0,13.0,7.0,13.0,7.0,6.0,11.0,13.0,10.0,12.0,8.0,11.0,14.0,12.0,11.0,12.0,10.0,10.0,12.0,10.0,10.0,13.0,10.0,13.0,10.0,13.0,12.0,14.0,15.0,13.0,10.0,20.0,12.0,13.0,8.0,14.0,7.0,12.0,6.0,10.0,5.0,13.0,10.0,13.0,8.0,11.0,14.0,11.0,13.0,7.0,32.0,18.0,0.0,0.0,0.0,180.0,72.0,1.0,2.0,3.0,2.0,3.0,2.0,2.0,3.0,3.0,1.0,3.0,5.0,9.0,8.0,7.0,12.0,8.0,13.0,10.0,10.0,12.0,13.0,9.0,13.0,12.0,13.0,13.0,14.0,14.0,13.0,12.0,12.0,15.0,7.0,11.0,8.0,12.0,13.0,14.0,14.0,11.0,14.0,11.0,7.0,15.0,13.0,20.0,14.0,14.0,14.0,14.0,15.0,8.0,10.0,5.0,14.0,13.0,11.0,15.0,15.0,15.0,6.0,29.0,52.0,2.0,0.0,0.0,178.0,75.0,1.0,1.0,1.0,1.0,3.0,3.0,2.0,3.0,1.0,2.0,2.0,10.0,12.0,12.0,11.0,12.0,11.0,8.0,11.0,7.0,11.0,13.0,12.0,9.0,13.0,12.0,9.0,13.0,9.0,12.0,13.0,10.0,16.0,7.0,9.0,14.0,13.0,15.0,16.0,13.0,13.0,12.0,10.0,8.0,15.0,13.0,20.0,15.0,11.0,10.0,13.0,14.0,3.0,13.0,13.0,15.0,8.0,13.0,16.0,12.0,14.0,3.0,32.0,22.0,1.0,6.0,1.0,186.0,79.0,1.0,2.0,1.0,1.0,2.0,3.0,1.0,2.0,1.0,2.0,1.0,11.0,12.0,13.0,11.0,13.0,11.0,14.0,11.0,8.0,12.0,13.0,13.0,13.0,13.0,14.0,13.0,14.0,14.0,13.0,14.0,13.0,12.0,13.0,14.0,15.0,13.0,12.0,15.0,12.0,13.0,12.0,12.0,10.0,12.0,13.0,20.0,15.0,13.0,14.0,5.0,12.0,9.0,17.0,8.0,12.0,8.0,13.0,10.0,10.0,10.0,5.0,24.0,8.0,0.0,0.0,0.0,182.0,76.0,2.0,3.0,2.0,1.0,2.0,3.0,3.0,3.0,2.0,1.0,2.0,8.0,11.0,10.0,8.0,12.0,9.0,13.0,11.0,5.0,13.0,13.0,10.0,12.0,12.0,10.0,14.0,12.0,13.0,12.0,13.0,12.0,14.0,6.0,10.0,12.0,14.0,15.0,14.0,13.0,12.0,11.0,12.0,7.0,15.0,13.0,20.0,14.0,14.0,14.0,10.0,14.0,7.0,8.0,2.0,12.0,16.0,13.0,14.0,14.0,14.0,6.0,22.0,0.0,0.0,0.0,0.0,177.0,72.0,2.0,1.0,2.0,4.0,2.0,2.0,1.0,3.0,4.0,2.0,3.0,10.0,12.0,13.0,11.0,12.0,10.0,12.0,12.0,4.0,10.0,13.0,11.0,11.0,13.0,11.0,12.0,11.0,13.0,9.0,13.0,12.0,3.0,12.0,8.0,14.0,12.0,12.0,13.0,16.0,13.0,12.0,9.0,8.0,15.0,14.0,20.0,14.0,13.0,10.0,4.0,11.0,11.0,12.0,19.0,9.0,12.0,13.0,12.0,11.0,14.0,7.0,21.0,0.0,0.0,3.0,0.0,175.0,71.0,3.0,3.0,2.0,1.0,3.0,1.0,2.0,2.0,3.0,3.0,2.0,9.0,13.0,14.0,12.0,14.0,14.0,8.0,13.0,5.0,6.0,14.0,11.0,6.0,15.0,8.0,13.0,8.0,12.0,11.0,13.0,14.0,12.0,15.0,9.0,14.0,7.0,11.0,12.0,13.0,13.0,8.0,7.0,10.0,14.0,13.0,20.0,13.0,8.0,10.0,9.0,12.0,8.0,10.0,10.0,10.0,9.0,10.0,12.0,5.0,10.0,9.0,25.0,0.0,0.0,0.0,0.0,187.0,83.0,2.0,1.0,3.0,3.0,1.0,3.0,3.0,3.0,1.0,1.0,3.0,4.0,8.0,10.0,14.0,12.0,8.0,14.0,9.0,5.0,7.0,11.0,13.0,5.0,12.0,11.0,13.0,13.0,13.0,11.0,10.0,12.0,16.0,9.0,8.0,13.0,11.0,13.0,16.0,14.0,13.0,15.0,13.0,20.0,14.0,12.0,8.0,14.0,16.0,13.0,11.0,13.0,7.0,5.0,13.0,14.0,13.0,14.0,14.0,13.0,13.0,6.0,30.0,0.0,0.0,0.0,0.0,182.0,78.0,13.0,14.0,10.0,5.0,12.0,13.0,12.0,13.0,11.0,11.0,9.0,3.0,3.0,3.0,2.0,8.0,7.0,3.0,3.0,2.0,2.0,8.0,1.0,1.0,8.0,9.0,13.0,13.0,13.0,13.0,9.0,13.0,14.0,5.0,9.0,1.0,11.0,12.0,6.0,12.0,13.0,14.0,11.0,20.0,15.0,10.0,5.0,13.0,14.0,13.0,9.0,14.0,6.0,1.0,20.0,13.0,13.0,13.0,15.0,15.0,15.0,5.0,36.0,3.0,0.0,0.0,0.0,186.0,77.0,2.0,1.0,2.0,1.0,3.0,1.0,1.0,2.0,2.0,4.0,1.0,5.0,11.0,8.0,6.0,12.0,6.0,14.0,7.0,9.0,12.0,12.0,6.0,14.0,12.0,10.0,14.0,14.0,14.0,14.0,9.0,12.0,14.0,5.0,16.0,8.0,14.0,15.0,13.0,9.0,10.0,15.0,12.0,20.0,10.0,8.0,10.0,9.0,12.0,15.0,10.0,16.0,14.0,10.0,13.0,10.0,17.0,14.0,18.0,15.0,15.0,8.0,33.0,24.0,1.0,3.0,0.0,193.0,90.0,1.0,2.0,2.0,2.0,3.0,2.0,3.0,1.0,3.0,2.0,3.0,3.0,6.0,8.0,8.0,11.0,10.0,17.0,8.0,5.0,13.0,10.0,7.0,14.0,11.0,14.0,14.0,16.0,11.0,10.0,9.0,10.0,14.0,7.0,13.0,7.0,13.0,14.0,11.0,9.0,10.0,15.0,15.0,7.0,13.0,10.0,20.0,10.0,13.0,10.0,13.0,15.0,9.0,8.0,12.0,15.0,13.0,11.0,15.0,12.0,13.0,7.0,24.0,0.0,0.0,8.0,1.0,185.0,75.0,3.0,3.0,1.0,4.0,3.0,1.0,2.0,1.0,3.0,1.0,4.0,9.0,12.0,10.0,6.0,13.0,10.0,12.0,11.0,5.0,10.0,14.0,8.0,12.0,13.0,8.0,13.0,11.0,13.0,13.0,13.0,12.0,15.0,9.0,10.0,8.0,12.0,15.0,14.0,11.0,12.0,14.0,12.0,10.0,16.0,12.0,20.0,15.0,13.0,13.0,8.0,14.0,9.0,16.0,5.0,14.0,14.0,13.0,16.0,15.0,15.0,6.0,16.0,0.0,0.0,0.0,0.0,177.0,0.0,3.0,2.0,1.0,1.0,3.0,3.0,2.0,2.0,2.0,1.0,3.0,1.0,3.0,2.0,2.0,4.0,1.0,3.0,1.0,6.0,9.0,2.0,1.0,9.0,6.0,14.0,4.0,5.0,5.0,3.0,2.0,5.0,4.0,5.0,7.0,4.0,8.0,4.0,3.0,10.0,7.0,13.0,7.0,15.0,13.0,9.0,20.0,5.0,8.0,7.0,11.0,5.0,8.0,8.0,11.0,11.0,5.0,14.0,20.0,7.0,12.0,5.0,38.0,0.0,0.0,0.0,0.0,177.0,68.0,2.0,3.0,2.0,3.0,1.0,2.0,2.0,1.0,3.0,4.0,4.0,9.0,13.0,10.0,7.0,11.0,7.0,10.0,12.0,11.0,11.0,13.0,7.0,12.0,12.0,11.0,13.0,14.0,14.0,14.0,11.0,12.0,14.0,9.0,15.0,10.0,13.0,17.0,15.0,10.0,12.0,12.0,8.0,10.0,13.0,11.0,20.0,10.0,9.0,14.0,11.0,13.0,5.0,17.0,11.0,12.0,16.0,14.0,18.0,16.0,15.0,5.0,33.0,0.0,0.0,0.0,0.0,188.0,77.0,1.0,2.0,3.0,1.0,2.0,1.0,1.0,3.0,3.0,3.0,3.0,7.0,12.0,10.0,10.0,13.0,14.0,14.0,13.0,5.0,11.0,14.0,12.0,12.0,12.0,14.0,14.0,14.0,13.0,13.0,13.0,12.0,14.0,9.0,15.0,8.0,14.0,15.0,14.0,10.0,11.0,14.0,14.0,8.0,14.0,11.0,20.0,14.0,14.0,16.0,12.0,14.0,7.0,10.0,13.0,13.0,14.0,13.0,16.0,14.0,13.0,6.0,23.0,3.0,0.0,0.0,0.0,186.0,83.0,4.0,3.0,1.0,1.0,1.0,3.0,3.0,2.0,2.0,3.0,2.0,4.0,7.0,10.0,6.0,11.0,6.0,14.0,8.0,5.0,11.0,10.0,6.0,13.0,10.0,13.0,12.0,14.0,10.0,11.0,9.0,11.0,14.0,8.0,8.0,10.0,12.0,13.0,15.0,11.0,10.0,16.0,13.0,8.0,15.0,12.0,20.0,16.0,17.0,13.0,13.0,10.0,7.0,10.0,20.0,12.0,11.0,14.0,12.0,11.0,14.0,7.0,28.0,2.0,0.0,0.0,0.0,188.0,70.0,3.0,1.0,2.0,2.0,2.0,3.0,3.0,2.0,1.0,3.0,2.0,11.0,9.0,13.0,13.0,9.0,8.0,14.0,12.0,6.0,10.0,13.0,8.0,9.0,13.0,12.0,13.0,12.0,13.0,13.0,13.0,12.0,11.0,14.0,13.0,13.0,10.0,12.0,12.0,14.0,13.0,12.0,14.0,10.0,13.0,13.0,20.0,15.0,14.0,13.0,12.0,7.0,12.0,13.0,9.0,11.0,9.0,11.0,7.0,9.0,10.0,13.0,24.0,14.0,0.0,7.0,3.0,186.0,84.0,2.0,1.0,3.0,2.0,3.0,3.0,4.0,2.0,3.0,2.0,2.0,7.0,9.0,13.0,10.0,13.0,7.0,12.0,9.0,6.0,5.0,10.0,11.0,6.0,12.0,13.0,9.0,15.0,8.0,11.0,10.0,12.0,14.0,13.0,7.0,10.0,8.0,15.0,13.0,12.0,12.0,16.0,14.0,14.0,15.0,16.0,20.0,13.0,15.0,11.0,7.0,10.0,10.0,10.0,13.0,15.0,12.0,9.0,12.0,10.0,10.0,7.0,23.0,0.0,0.0,5.0,0.0,182.0,76.0,2.0,4.0,2.0,2.0,3.0,4.0,3.0,2.0,3.0,1.0,2.0,3.0,8.0,11.0,11.0,11.0,6.0,12.0,9.0,5.0,5.0,8.0,11.0,3.0,12.0,9.0,12.0,11.0,10.0,12.0,10.0,10.0,16.0,11.0,10.0,14.0,8.0,8.0,12.0,16.0,13.0,14.0,13.0,8.0,13.0,14.0,20.0,13.0,14.0,13.0,9.0,11.0,10.0,8.0,15.0,12.0,14.0,11.0,13.0,15.0,15.0,8.0
3,0,25.0,4.0,0.0,11.0,0.0,184.0,81.0,14.0,14.0,13.0,9.0,15.0,12.0,16.0,16.0,13.0,7.0,11.0,8.0,1.0,2.0,1.0,11.0,12.0,6.0,1.0,3.0,3.0,11.0,5.0,3.0,11.0,8.0,15.0,15.0,13.0,14.0,10.0,11.0,14.0,8.0,13.0,5.0,13.0,10.0,10.0,14.0,16.0,14.0,13.0,20.0,14.0,12.0,5.0,14.0,14.0,15.0,9.0,16.0,6.0,1.0,17.0,11.0,15.0,13.0,14.0,12.0,12.0,4.0,22.0,3.0,0.0,7.0,1.0,182.0,75.0,3.0,3.0,1.0,3.0,2.0,3.0,1.0,1.0,2.0,2.0,1.0,4.0,11.0,10.0,6.0,14.0,7.0,13.0,10.0,9.0,16.0,14.0,8.0,15.0,14.0,13.0,17.0,15.0,16.0,14.0,11.0,14.0,15.0,8.0,11.0,10.0,15.0,16.0,14.0,14.0,14.0,14.0,11.0,20.0,15.0,14.0,10.0,15.0,15.0,15.0,12.0,15.0,8.0,11.0,12.0,14.0,16.0,15.0,14.0,14.0,14.0,5.0,27.0,4.0,0.0,5.0,1.0,184.0,83.0,2.0,4.0,3.0,1.0,1.0,2.0,1.0,2.0,4.0,2.0,3.0,4.0,8.0,11.0,4.0,10.0,4.0,14.0,4.0,4.0,15.0,12.0,5.0,16.0,11.0,14.0,14.0,16.0,14.0,10.0,11.0,12.0,17.0,7.0,10.0,9.0,13.0,14.0,15.0,14.0,13.0,16.0,13.0,10.0,15.0,13.0,20.0,15.0,16.0,12.0,12.0,14.0,6.0,12.0,11.0,13.0,12.0,12.0,16.0,15.0,14.0,6.0,19.0,0.0,0.0,3.0,1.0,181.0,69.0,3.0,2.0,3.0,3.0,2.0,1.0,1.0,1.0,3.0,3.0,4.0,10.0,10.0,12.0,12.0,12.0,7.0,8.0,11.0,5.0,7.0,10.0,10.0,7.0,11.0,8.0,10.0,10.0,12.0,8.0,11.0,8.0,14.0,13.0,6.0,14.0,8.0,13.0,13.0,16.0,14.0,13.0,9.0,20.0,15.0,16.0,10.0,15.0,13.0,12.0,8.0,11.0,7.0,12.0,11.0,11.0,15.0,10.0,12.0,14.0,14.0,1.0,32.0,0.0,0.0,0.0,0.0,172.0,71.0,2.0,1.0,3.0,1.0,2.0,3.0,2.0,3.0,2.0,2.0,2.0,8.0,9.0,7.0,6.0,10.0,6.0,10.0,9.0,10.0,14.0,11.0,6.0,14.0,11.0,10.0,16.0,15.0,12.0,12.0,7.0,12.0,15.0,9.0,13.0,8.0,14.0,15.0,15.0,14.0,14.0,14.0,10.0,20.0,14.0,14.0,8.0,15.0,13.0,13.0,11.0,13.0,7.0,13.0,17.0,14.0,17.0,8.0,13.0,15.0,15.0,6.0,32.0,11.0,1.0,0.0,0.0,176.0,68.0,2.0,1.0,3.0,2.0,2.0,2.0,2.0,3.0,3.0,2.0,2.0,8.0,10.0,10.0,7.0,11.0,8.0,10.0,11.0,12.0,11.0,13.0,12.0,14.0,12.0,9.0,14.0,15.0,13.0,12.0,11.0,12.0,17.0,8.0,14.0,14.0,11.0,18.0,18.0,14.0,14.0,12.0,10.0,10.0,14.0,13.0,20.0,17.0,13.0,15.0,9.0,13.0,8.0,13.0,17.0,13.0,15.0,16.0,16.0,16.0,18.0,5.0,27.0,8.0,0.0,6.0,0.0,187.0,76.0,3.0,2.0,3.0,2.0,2.0,1.0,1.0,3.0,3.0,1.0,2.0,5.0,7.0,11.0,5.0,14.0,5.0,14.0,9.0,5.0,15.0,15.0,8.0,14.0,13.0,15.0,16.0,15.0,14.0,12.0,14.0,14.0,18.0,8.0,17.0,9.0,12.0,18.0,15.0,13.0,14.0,15.0,14.0,10.0,17.0,12.0,20.0,17.0,15.0,14.0,13.0,16.0,4.0,12.0,10.0,14.0,17.0,12.0,15.0,13.0,13.0,6.0,21.0,0.0,0.0,15.0,3.0,181.0,78.0,3.0,3.0,4.0,2.0,1.0,2.0,2.0,4.0,2.0,1.0,1.0,5.0,7.0,11.0,10.0,14.0,5.0,14.0,10.0,6.0,13.0,14.0,8.0,14.0,14.0,12.0,14.0,12.0,11.0,10.0,12.0,11.0,16.0,11.0,12.0,14.0,14.0,14.0,14.0,14.0,13.0,14.0,13.0,10.0,16.0,14.0,20.0,16.0,14.0,12.0,10.0,11.0,5.0,19.0,8.0,11.0,14.0,11.0,16.0,13.0,13.0,10.0,31.0,52.0,8.0,0.0,0.0,167.0,58.0,1.0,2.0,2.0,1.0,3.0,2.0,4.0,2.0,1.0,2.0,3.0,15.0,15.0,14.0,7.0,15.0,15.0,6.0,11.0,3.0,4.0,15.0,14.0,7.0,15.0,13.0,12.0,15.0,13.0,14.0,16.0,11.0,17.0,14.0,11.0,12.0,10.0,12.0,14.0,15.0,18.0,10.0,5.0,10.0,16.0,14.0,20.0,13.0,7.0,14.0,13.0,16.0,8.0,12.0,13.0,16.0,14.0,15.0,13.0,9.0,11.0,14.0,25.0,5.0,0.0,5.0,0.0,186.0,72.0,1.0,2.0,1.0,2.0,2.0,3.0,3.0,3.0,3.0,3.0,2.0,13.0,12.0,14.0,9.0,16.0,15.0,11.0,12.0,5.0,8.0,16.0,11.0,10.0,15.0,8.0,13.0,11.0,14.0,13.0,15.0,14.0,15.0,14.0,11.0,13.0,10.0,12.0,12.0,13.0,14.0,14.0,10.0,10.0,13.0,11.0,20.0,11.0,11.0,13.0,9.0,15.0,13.0,7.0,15.0,17.0,14.0,13.0,15.0,15.0,15.0,7.0,25.0,10.0,1.0,11.0,4.0,175.0,73.0,1.0,3.0,3.0,3.0,3.0,3.0,3.0,1.0,2.0,3.0,1.0,5.0,10.0,15.0,17.0,15.0,10.0,11.0,12.0,5.0,5.0,14.0,15.0,5.0,16.0,8.0,15.0,12.0,15.0,14.0,13.0,15.0,15.0,15.0,14.0,14.0,10.0,10.0,12.0,16.0,16.0,15.0,9.0,10.0,15.0,16.0,20.0,13.0,15.0,14.0,8.0,14.0,7.0,10.0,8.0,16.0,17.0,13.0,15.0,15.0,14.0,5.0,19.0,0.0,0.0,0.0,0.0,190.0,78.0,13.0,12.0,11.0,14.0,13.0,6.0,11.0,13.0,13.0,12.0,7.0,3.0,3.0,1.0,3.0,8.0,8.0,3.0,1.0,2.0,3.0,7.0,3.0,1.0,7.0,8.0,13.0,13.0,12.0,13.0,7.0,11.0,11.0,3.0,14.0,2.0,11.0,11.0,10.0,12.0,13.0,11.0,15.0,20.0,10.0,13.0,5.0,13.0,13.0,9.0,10.0,6.0,10.0,10.0,10.0,12.0,11.0,14.0,14.0,12.0,13.0,3.0,25.0,0.0,0.0,0.0,0.0,191.0,81.0,1.0,1.0,3.0,2.0,3.0,2.0,3.0,4.0,2.0,1.0,2.0,4.0,3.0,10.0,8.0,6.0,6.0,11.0,6.0,10.0,11.0,10.0,5.0,12.0,7.0,16.0,13.0,16.0,11.0,13.0,7.0,10.0,14.0,5.0,12.0,10.0,13.0,13.0,12.0,13.0,13.0,16.0,16.0,7.0,16.0,14.0,20.0,14.0,14.0,13.0,13.0,15.0,6.0,12.0,13.0,6.0,14.0,8.0,8.0,13.0,7.0,4.0,30.0,27.0,2.0,2.0,0.0,178.0,78.0,2.0,2.0,1.0,1.0,1.0,1.0,3.0,2.0,1.0,1.0,1.0,8.0,13.0,13.0,8.0,12.0,7.0,14.0,9.0,12.0,14.0,11.0,8.0,16.0,11.0,14.0,14.0,17.0,12.0,14.0,12.0,13.0,17.0,11.0,12.0,13.0,15.0,14.0,15.0,13.0,13.0,13.0,12.0,9.0,12.0,13.0,20.0,13.0,11.0,14.0,14.0,14.0,13.0,18.0,14.0,13.0,13.0,15.0,16.0,13.0,12.0,8.0,26.0,0.0,0.0,0.0,0.0,176.0,70.0,2.0,1.0,4.0,3.0,3.0,3.0,1.0,3.0,3.0,2.0,1.0,10.0,11.0,11.0,6.0,13.0,9.0,5.0,12.0,11.0,13.0,13.0,7.0,14.0,13.0,15.0,11.0,14.0,12.0,11.0,9.0,12.0,13.0,9.0,9.0,13.0,12.0,15.0,14.0,12.0,16.0,12.0,7.0,20.0,13.0,13.0,10.0,15.0,11.0,13.0,14.0,13.0,11.0,9.0,8.0,9.0,17.0,12.0,14.0,14.0,15.0,3.0,21.0,0.0,0.0,1.0,0.0,177.0,68.0,4.0,1.0,2.0,1.0,1.0,1.0,1.0,1.0,2.0,1.0,2.0,5.0,12.0,9.0,7.0,12.0,8.0,13.0,10.0,16.0,13.0,12.0,8.0,14.0,12.0,12.0,13.0,12.0,12.0,12.0,10.0,13.0,15.0,11.0,13.0,11.0,13.0,13.0,14.0,13.0,14.0,13.0,11.0,10.0,14.0,12.0,20.0,12.0,14.0,12.0,11.0,12.0,8.0,14.0,13.0,10.0,14.0,12.0,14.0,12.0,11.0,5.0,34.0,103.0,7.0,16.0,1.0,182.0,72.0,2.0,1.0,1.0,1.0,3.0,1.0,4.0,3.0,3.0,2.0,1.0,11.0,13.0,12.0,8.0,15.0,13.0,9.0,13.0,6.0,8.0,15.0,12.0,8.0,15.0,11.0,14.0,13.0,15.0,15.0,14.0,16.0,17.0,15.0,14.0,11.0,13.0,17.0,13.0,8.0,11.0,10.0,11.0,16.0,13.0,8.0,20.0,12.0,10.0,15.0,11.0,12.0,12.0,15.0,14.0,12.0,15.0,15.0,18.0,14.0,14.0,7.0,28.0,1.0,0.0,7.0,0.0,181.0,71.0,2.0,2.0,1.0,3.0,1.0,3.0,3.0,2.0,3.0,3.0,3.0,12.0,11.0,10.0,5.0,13.0,11.0,8.0,10.0,8.0,9.0,14.0,11.0,12.0,13.0,14.0,14.0,12.0,12.0,13.0,12.0,13.0,12.0,8.0,9.0,9.0,12.0,17.0,15.0,11.0,13.0,14.0,10.0,12.0,13.0,12.0,20.0,16.0,12.0,13.0,14.0,16.0,12.0,9.0,10.0,14.0,16.0,14.0,13.0,12.0,12.0,14.0,20.0,0.0,0.0,0.0,0.0,173.0,66.0,1.0,1.0,1.0,1.0,1.0,2.0,3.0,1.0,3.0,3.0,4.0,15.0,13.0,13.0,10.0,15.0,12.0,5.0,13.0,5.0,7.0,15.0,12.0,7.0,15.0,10.0,10.0,13.0,12.0,10.0,16.0,13.0,18.0,14.0,7.0,14.0,12.0,14.0,14.0,8.0,14.0,13.0,7.0,14.0,12.0,9.0,20.0,12.0,13.0,12.0,8.0,15.0,6.0,12.0,12.0,14.0,14.0,14.0,15.0,14.0,11.0,6.0,23.0,21.0,3.0,9.0,4.0,176.0,69.0,1.0,2.0,1.0,3.0,3.0,1.0,2.0,1.0,1.0,2.0,3.0,9.0,9.0,14.0,13.0,14.0,10.0,10.0,9.0,3.0,5.0,12.0,14.0,6.0,15.0,9.0,13.0,9.0,11.0,10.0,12.0,12.0,13.0,14.0,10.0,13.0,8.0,8.0,10.0,16.0,15.0,10.0,8.0,10.0,12.0,15.0,20.0,13.0,10.0,9.0,8.0,13.0,11.0,13.0,7.0,14.0,12.0,13.0,8.0,14.0,13.0,8.0,19.0,0.0,0.0,0.0,0.0,172.0,64.0,1.0,3.0,2.0,2.0,4.0,2.0,1.0,2.0,3.0,3.0,1.0,13.0,13.0,15.0,12.0,15.0,12.0,6.0,12.0,3.0,2.0,13.0,11.0,3.0,16.0,8.0,10.0,9.0,12.0,9.0,13.0,10.0,12.0,15.0,8.0,13.0,4.0,5.0,7.0,17.0,16.0,14.0,5.0,20.0,11.0,15.0,12.0,10.0,8.0,8.0,10.0,14.0,8.0,10.0,17.0,14.0,9.0,10.0,9.0,4.0,10.0,10.0,28.0,37.0,15.0,1.0,0.0,194.0,88.0,2.0,1.0,2.0,1.0,1.0,2.0,3.0,1.0,3.0,2.0,2.0,4.0,6.0,12.0,15.0,12.0,7.0,16.0,11.0,3.0,6.0,10.0,14.0,4.0,11.0,10.0,14.0,15.0,13.0,10.0,8.0,9.0,13.0,12.0,6.0,14.0,8.0,11.0,16.0,13.0,12.0,18.0,17.0,9.0,12.0,12.0,20.0,14.0,18.0,13.0,10.0,15.0,15.0,6.0,20.0,17.0,12.0,15.0,14.0,11.0,14.0,7.0
3,1,25.0,0.0,0.0,11.0,0.0,189.0,83.0,12.0,12.0,11.0,7.0,13.0,12.0,17.0,17.0,16.0,12.0,13.0,6.0,2.0,1.0,1.0,10.0,10.0,7.0,1.0,1.0,1.0,9.0,5.0,1.0,10.0,8.0,15.0,14.0,14.0,12.0,7.0,13.0,12.0,6.0,9.0,3.0,16.0,17.0,10.0,13.0,16.0,14.0,12.0,8.0,15.0,10.0,20.0,13.0,14.0,14.0,5.0,14.0,4.0,12.0,15.0,15.0,13.0,13.0,17.0,15.0,17.0,4.0,31.0,0.0,0.0,0.0,0.0,171.0,65.0,1.0,3.0,1.0,3.0,2.0,2.0,3.0,1.0,2.0,2.0,3.0,8.0,9.0,11.0,7.0,5.0,6.0,5.0,6.0,7.0,14.0,14.0,6.0,14.0,13.0,14.0,12.0,13.0,12.0,11.0,11.0,12.0,12.0,11.0,7.0,12.0,12.0,12.0,10.0,15.0,15.0,7.0,9.0,9.0,12.0,14.0,20.0,12.0,13.0,11.0,13.0,11.0,9.0,10.0,15.0,14.0,12.0,11.0,14.0,13.0,12.0,7.0,29.0,0.0,0.0,0.0,0.0,170.0,65.0,2.0,1.0,3.0,3.0,1.0,3.0,2.0,1.0,2.0,3.0,2.0,5.0,11.0,4.0,6.0,7.0,4.0,7.0,5.0,6.0,6.0,6.0,2.0,6.0,7.0,9.0,10.0,13.0,8.0,12.0,8.0,13.0,15.0,2.0,7.0,5.0,9.0,8.0,8.0,12.0,12.0,14.0,4.0,9.0,12.0,11.0,20.0,12.0,5.0,9.0,9.0,9.0,9.0,9.0,10.0,12.0,12.0,12.0,12.0,7.0,5.0,8.0,23.0,25.0,0.0,0.0,0.0,174.0,74.0,2.0,1.0,1.0,1.0,3.0,3.0,3.0,3.0,3.0,1.0,2.0,8.0,13.0,12.0,8.0,12.0,8.0,14.0,9.0,13.0,14.0,12.0,6.0,16.0,13.0,13.0,14.0,15.0,13.0,11.0,10.0,12.0,15.0,9.0,10.0,14.0,11.0,14.0,17.0,16.0,13.0,14.0,10.0,8.0,17.0,15.0,20.0,18.0,15.0,14.0,13.0,14.0,8.0,12.0,12.0,14.0,13.0,13.0,12.0,12.0,15.0,13.0,23.0,2.0,0.0,5.0,3.0,182.0,73.0,3.0,1.0,1.0,1.0,2.0,1.0,2.0,1.0,3.0,4.0,2.0,12.0,14.0,14.0,10.0,13.0,12.0,16.0,11.0,13.0,12.0,13.0,13.0,14.0,14.0,12.0,11.0,14.0,13.0,11.0,13.0,11.0,15.0,15.0,9.0,15.0,10.0,14.0,15.0,16.0,15.0,13.0,13.0,20.0,14.0,15.0,6.0,15.0,12.0,13.0,9.0,13.0,14.0,15.0,17.0,15.0,13.0,12.0,12.0,15.0,13.0,9.0,33.0,30.0,1.0,0.0,0.0,187.0,83.0,1.0,3.0,4.0,2.0,1.0,1.0,2.0,3.0,1.0,1.0,3.0,13.0,13.0,12.0,8.0,16.0,10.0,16.0,13.0,10.0,14.0,16.0,13.0,16.0,15.0,13.0,15.0,14.0,16.0,15.0,14.0,14.0,13.0,11.0,13.0,10.0,17.0,18.0,10.0,10.0,12.0,17.0,14.0,20.0,12.0,12.0,10.0,13.0,16.0,16.0,16.0,15.0,13.0,11.0,16.0,16.0,13.0,15.0,12.0,8.0,8.0,11.0,25.0,0.0,0.0,14.0,0.0,180.0,82.0,1.0,3.0,3.0,1.0,3.0,2.0,3.0,1.0,1.0,3.0,1.0,5.0,10.0,10.0,7.0,13.0,7.0,12.0,8.0,10.0,14.0,12.0,8.0,17.0,13.0,13.0,16.0,16.0,14.0,15.0,10.0,12.0,15.0,8.0,13.0,10.0,14.0,18.0,15.0,10.0,12.0,16.0,11.0,10.0,15.0,12.0,20.0,16.0,15.0,17.0,10.0,16.0,6.0,10.0,12.0,16.0,12.0,13.0,17.0,14.0,14.0,5.0,19.0,0.0,0.0,0.0,0.0,177.0,69.0,1.0,2.0,4.0,4.0,2.0,2.0,1.0,2.0,2.0,3.0,2.0,4.0,9.0,11.0,12.0,13.0,7.0,10.0,13.0,5.0,3.0,10.0,10.0,5.0,13.0,14.0,10.0,14.0,10.0,10.0,10.0,11.0,11.0,14.0,5.0,13.0,5.0,11.0,12.0,16.0,13.0,14.0,9.0,8.0,13.0,14.0,20.0,12.0,10.0,10.0,9.0,10.0,10.0,10.0,16.0,12.0,14.0,12.0,12.0,8.0,18.0,5.0,34.0,116.0,62.0,7.0,6.0,195.0,95.0,1.0,1.0,3.0,1.0,1.0,3.0,4.0,1.0,2.0,3.0,2.0,5.0,12.0,15.0,16.0,18.0,14.0,14.0,16.0,8.0,6.0,15.0,18.0,6.0,18.0,16.0,16.0,15.0,13.0,13.0,16.0,14.0,14.0,19.0,16.0,15.0,4.0,13.0,8.0,12.0,15.0,20.0,18.0,16.0,16.0,14.0,20.0,15.0,18.0,16.0,13.0,11.0,11.0,8.0,15.0,20.0,11.0,15.0,14.0,7.0,7.0,13.0,21.0,0.0,0.0,1.0,0.0,170.0,65.0,1.0,3.0,2.0,3.0,3.0,3.0,3.0,3.0,2.0,3.0,3.0,11.0,11.0,14.0,12.0,14.0,8.0,11.0,8.0,5.0,8.0,12.0,11.0,6.0,13.0,9.0,12.0,9.0,10.0,9.0,10.0,11.0,13.0,15.0,10.0,13.0,7.0,6.0,11.0,16.0,16.0,14.0,5.0,8.0,14.0,15.0,20.0,13.0,9.0,10.0,6.0,14.0,7.0,10.0,19.0,13.0,8.0,14.0,12.0,12.0,14.0,5.0,29.0,76.0,27.0,13.0,9.0,188.0,72.0,2.0,3.0,1.0,2.0,3.0,3.0,1.0,3.0,3.0,3.0,3.0,5.0,10.0,13.0,16.0,13.0,11.0,17.0,13.0,5.0,10.0,13.0,14.0,10.0,13.0,15.0,16.0,18.0,14.0,15.0,10.0,13.0,14.0,13.0,10.0,18.0,12.0,14.0,19.0,15.0,14.0,16.0,14.0,10.0,18.0,16.0,20.0,18.0,14.0,14.0,8.0,15.0,5.0,16.0,10.0,16.0,12.0,14.0,16.0,14.0,10.0,10.0,25.0,0.0,0.0,0.0,0.0,187.0,83.0,11.0,14.0,12.0,8.0,13.0,11.0,14.0,15.0,13.0,13.0,9.0,8.0,1.0,1.0,1.0,11.0,11.0,1.0,2.0,2.0,1.0,10.0,3.0,2.0,11.0,8.0,12.0,14.0,12.0,12.0,10.0,12.0,14.0,6.0,14.0,2.0,12.0,12.0,8.0,13.0,15.0,14.0,13.0,20.0,15.0,11.0,5.0,14.0,13.0,13.0,8.0,8.0,10.0,1.0,9.0,13.0,14.0,12.0,15.0,15.0,15.0,5.0,26.0,11.0,0.0,4.0,0.0,183.0,79.0,3.0,2.0,1.0,2.0,2.0,2.0,3.0,2.0,2.0,2.0,1.0,5.0,7.0,9.0,6.0,10.0,11.0,15.0,11.0,7.0,14.0,10.0,7.0,13.0,10.0,14.0,13.0,15.0,13.0,12.0,10.0,12.0,17.0,8.0,11.0,10.0,13.0,15.0,16.0,13.0,13.0,16.0,13.0,5.0,15.0,13.0,20.0,16.0,15.0,13.0,14.0,15.0,7.0,14.0,16.0,12.0,14.0,14.0,15.0,14.0,14.0,5.0,24.0,0.0,0.0,4.0,0.0,186.0,88.0,1.0,2.0,1.0,3.0,2.0,1.0,1.0,2.0,1.0,2.0,1.0,4.0,8.0,8.0,6.0,12.0,6.0,14.0,9.0,11.0,14.0,12.0,6.0,12.0,12.0,14.0,13.0,14.0,12.0,13.0,8.0,12.0,13.0,8.0,8.0,9.0,12.0,12.0,13.0,13.0,11.0,15.0,13.0,8.0,15.0,14.0,20.0,14.0,15.0,13.0,14.0,15.0,8.0,12.0,14.0,14.0,12.0,9.0,12.0,13.0,13.0,8.0,26.0,14.0,0.0,0.0,0.0,181.0,74.0,2.0,1.0,1.0,1.0,3.0,2.0,3.0,1.0,3.0,3.0,2.0,6.0,13.0,8.0,5.0,12.0,7.0,12.0,8.0,11.0,13.0,12.0,6.0,14.0,10.0,14.0,12.0,14.0,10.0,12.0,8.0,8.0,14.0,6.0,6.0,12.0,11.0,14.0,15.0,16.0,14.0,14.0,11.0,5.0,14.0,14.0,20.0,16.0,14.0,12.0,13.0,14.0,8.0,10.0,8.0,14.0,12.0,13.0,15.0,15.0,15.0,6.0,22.0,12.0,2.0,13.0,0.0,170.0,71.0,2.0,2.0,1.0,3.0,2.0,2.0,1.0,1.0,1.0,3.0,2.0,15.0,15.0,12.0,10.0,14.0,15.0,8.0,13.0,12.0,9.0,13.0,10.0,10.0,14.0,14.0,16.0,10.0,17.0,14.0,12.0,16.0,14.0,12.0,8.0,14.0,10.0,17.0,16.0,16.0,17.0,10.0,6.0,20.0,17.0,13.0,8.0,15.0,7.0,15.0,6.0,15.0,8.0,17.0,13.0,13.0,12.0,12.0,14.0,16.0,16.0,8.0,22.0,0.0,0.0,0.0,0.0,179.0,75.0,1.0,3.0,1.0,3.0,3.0,2.0,1.0,4.0,3.0,2.0,2.0,9.0,12.0,11.0,7.0,13.0,12.0,8.0,11.0,5.0,11.0,13.0,11.0,9.0,12.0,12.0,14.0,13.0,12.0,11.0,11.0,12.0,14.0,9.0,8.0,10.0,13.0,15.0,14.0,13.0,13.0,13.0,9.0,8.0,14.0,12.0,20.0,14.0,12.0,12.0,12.0,15.0,10.0,10.0,9.0,14.0,14.0,13.0,16.0,13.0,14.0,6.0,30.0,7.0,0.0,0.0,0.0,181.0,72.0,1.0,3.0,3.0,1.0,2.0,3.0,2.0,1.0,3.0,2.0,2.0,12.0,11.0,14.0,8.0,14.0,12.0,8.0,12.0,6.0,5.0,13.0,13.0,5.0,14.0,8.0,12.0,10.0,11.0,12.0,15.0,11.0,13.0,14.0,9.0,13.0,10.0,12.0,13.0,12.0,14.0,12.0,10.0,12.0,15.0,13.0,20.0,15.0,9.0,10.0,8.0,13.0,5.0,8.0,12.0,14.0,14.0,12.0,11.0,14.0,14.0,8.0,22.0,18.0,0.0,0.0,0.0,179.0,75.0,1.0,4.0,2.0,1.0,1.0,1.0,3.0,1.0,1.0,3.0,2.0,7.0,8.0,12.0,8.0,13.0,10.0,11.0,12.0,11.0,11.0,11.0,10.0,14.0,13.0,15.0,12.0,15.0,8.0,12.0,10.0,12.0,14.0,12.0,10.0,13.0,12.0,13.0,17.0,14.0,14.0,13.0,10.0,9.0,15.0,15.0,20.0,15.0,14.0,13.0,13.0,12.0,11.0,12.0,13.0,15.0,9.0,10.0,12.0,10.0,10.0,4.0,27.0,0.0,0.0,0.0,0.0,173.0,68.0,2.0,2.0,1.0,1.0,3.0,3.0,1.0,2.0,3.0,4.0,2.0,12.0,12.0,13.0,8.0,13.0,10.0,7.0,8.0,9.0,7.0,12.0,10.0,9.0,14.0,7.0,10.0,8.0,11.0,12.0,12.0,11.0,12.0,13.0,5.0,13.0,10.0,10.0,12.0,14.0,14.0,11.0,7.0,20.0,12.0,15.0,10.0,13.0,8.0,12.0,7.0,13.0,9.0,12.0,18.0,12.0,14.0,11.0,14.0,15.0,15.0,6.0,28.0,0.0,0.0,0.0,0.0,170.0,67.0,2.0,3.0,3.0,4.0,3.0,2.0,1.0,1.0,2.0,2.0,3.0,8.0,12.0,12.0,10.0,14.0,7.0,5.0,10.0,6.0,5.0,12.0,5.0,4.0,13.0,7.0,16.0,12.0,9.0,11.0,12.0,10.0,3.0,12.0,6.0,13.0,6.0,8.0,13.0,16.0,13.0,10.0,5.0,5.0,13.0,16.0,20.0,15.0,7.0,12.0,4.0,9.0,7.0,10.0,20.0,13.0,12.0,10.0,13.0,11.0,10.0,2.0,24.0,24.0,4.0,0.0,0.0,172.0,74.0,2.0,4.0,3.0,2.0,2.0,1.0,2.0,2.0,3.0,2.0,4.0,8.0,9.0,14.0,13.0,14.0,9.0,11.0,10.0,7.0,5.0,12.0,12.0,3.0,13.0,10.0,12.0,12.0,13.0,12.0,11.0,10.0,14.0,13.0,7.0,14.0,9.0,9.0,13.0,16.0,15.0,13.0,6.0,8.0,13.0,16.0,20.0,14.0,12.0,11.0,11.0,13.0,9.0,8.0,9.0,13.0,9.0,11.0,12.0,13.0,10.0,9.0
0,0,17.0,0.0,0.0,0.0,0.0,193.0,82.0,13.0,11.0,12.0,2.0,12.0,10.0,14.0,15.0,14.0,12.0,10.0,3.0,1.0,1.0,3.0,5.0,6.0,2.0,2.0,1.0,3.0,9.0,3.0,1.0,8.0,7.0,12.0,13.0,13.0,13.0,11.0,11.0,15.0,3.0,8.0,3.0,12.0,12.0,11.0,10.0,12.0,14.0,17.0,5.0,15.0,11.0,20.0,13.0,12.0,13.0,8.0,11.0,5.0,11.0,13.0,15.0,15.0,17.0,14.0,15.0,15.0,5.0,23.0,5.0,0.0,13.0,0.0,186.0,82.0,3.0,3.0,1.0,4.0,3.0,1.0,2.0,1.0,2.0,1.0,2.0,4.0,8.0,8.0,5.0,11.0,6.0,13.0,8.0,6.0,14.0,10.0,7.0,13.0,11.0,14.0,13.0,14.0,11.0,11.0,9.0,11.0,14.0,8.0,11.0,9.0,15.0,12.0,12.0,14.0,12.0,14.0,13.0,8.0,15.0,14.0,20.0,14.0,14.0,15.0,14.0,13.0,6.0,10.0,15.0,13.0,12.0,12.0,14.0,11.0,13.0,9.0,19.0,0.0,0.0,0.0,0.0,194.0,92.0,2.0,1.0,3.0,3.0,3.0,3.0,1.0,3.0,3.0,2.0,1.0,3.0,3.0,5.0,6.0,10.0,5.0,16.0,10.0,8.0,12.0,9.0,4.0,15.0,11.0,14.0,11.0,12.0,10.0,11.0,10.0,12.0,15.0,3.0,13.0,13.0,12.0,14.0,14.0,11.0,8.0,15.0,17.0,5.0,16.0,12.0,20.0,12.0,16.0,12.0,13.0,12.0,5.0,7.0,10.0,14.0,13.0,8.0,10.0,11.0,18.0,6.0,23.0,1.0,0.0,4.0,0.0,190.0,80.0,1.0,4.0,1.0,3.0,3.0,1.0,1.0,1.0,2.0,4.0,2.0,6.0,11.0,13.0,7.0,13.0,6.0,11.0,8.0,10.0,15.0,12.0,5.0,15.0,12.0,14.0,14.0,16.0,9.0,11.0,10.0,10.0,16.0,12.0,12.0,9.0,12.0,10.0,14.0,14.0,12.0,15.0,17.0,8.0,15.0,16.0,20.0,13.0,14.0,13.0,8.0,13.0,6.0,14.0,11.0,14.0,12.0,13.0,16.0,14.0,12.0,6.0,26.0,4.0,0.0,2.0,0.0,180.0,74.0,3.0,3.0,1.0,2.0,2.0,1.0,3.0,4.0,1.0,2.0,1.0,8.0,13.0,13.0,6.0,13.0,9.0,12.0,7.0,11.0,13.0,13.0,11.0,12.0,12.0,16.0,14.0,14.0,9.0,12.0,11.0,13.0,4.0,4.0,6.0,11.0,12.0,8.0,12.0,14.0,14.0,13.0,9.0,20.0,16.0,13.0,5.0,15.0,13.0,12.0,6.0,9.0,10.0,12.0,8.0,14.0,8.0,11.0,12.0,11.0,13.0,2.0,19.0,0.0,0.0,0.0,0.0,184.0,78.0,3.0,1.0,2.0,1.0,2.0,2.0,2.0,3.0,3.0,4.0,2.0,6.0,8.0,9.0,5.0,13.0,6.0,11.0,8.0,5.0,13.0,13.0,8.0,12.0,13.0,13.0,13.0,15.0,12.0,12.0,13.0,12.0,14.0,7.0,11.0,8.0,15.0,14.0,15.0,13.0,12.0,14.0,11.0,5.0,15.0,12.0,20.0,16.0,14.0,13.0,12.0,11.0,7.0,10.0,19.0,13.0,15.0,12.0,14.0,13.0,12.0,6.0,23.0,11.0,0.0,0.0,0.0,180.0,71.0,2.0,1.0,2.0,3.0,3.0,1.0,1.0,2.0,2.0,1.0,1.0,6.0,11.0,10.0,8.0,10.0,7.0,11.0,9.0,12.0,13.0,11.0,6.0,13.0,11.0,12.0,11.0,13.0,12.0,9.0,11.0,11.0,14.0,12.0,11.0,12.0,11.0,13.0,15.0,15.0,13.0,13.0,11.0,7.0,14.0,15.0,20.0,12.0,11.0,12.0,12.0,13.0,10.0,15.0,10.0,13.0,16.0,12.0,15.0,14.0,14.0,7.0,28.0,0.0,0.0,0.0,0.0,180.0,79.0,3.0,2.0,3.0,3.0,2.0,2.0,2.0,1.0,3.0,2.0,3.0,8.0,11.0,15.0,12.0,15.0,12.0,7.0,10.0,7.0,8.0,13.0,13.0,6.0,16.0,11.0,11.0,10.0,13.0,10.0,15.0,12.0,3.0,15.0,6.0,13.0,13.0,12.0,12.0,15.0,16.0,14.0,8.0,12.0,12.0,14.0,20.0,12.0,12.0,13.0,6.0,13.0,6.0,6.0,8.0,9.0,13.0,10.0,12.0,12.0,2.0,2.0,24.0,0.0,0.0,15.0,3.0,190.0,87.0,1.0,3.0,2.0,2.0,3.0,3.0,2.0,2.0,1.0,1.0,2.0,8.0,9.0,13.0,12.0,12.0,8.0,12.0,14.0,8.0,7.0,11.0,12.0,10.0,11.0,8.0,12.0,11.0,12.0,11.0,11.0,11.0,12.0,12.0,7.0,12.0,9.0,8.0,10.0,12.0,13.0,12.0,13.0,12.0,14.0,12.0,20.0,12.0,12.0,12.0,6.0,12.0,9.0,8.0,10.0,17.0,7.0,8.0,6.0,7.0,10.0,14.0,25.0,0.0,0.0,3.0,0.0,170.0,68.0,2.0,1.0,3.0,1.0,3.0,1.0,3.0,2.0,2.0,4.0,1.0,12.0,11.0,15.0,16.0,16.0,13.0,11.0,12.0,4.0,5.0,12.0,14.0,4.0,17.0,7.0,14.0,7.0,15.0,13.0,13.0,14.0,14.0,15.0,7.0,16.0,8.0,10.0,13.0,15.0,15.0,12.0,6.0,11.0,14.0,14.0,20.0,13.0,11.0,12.0,7.0,15.0,7.0,8.0,12.0,14.0,13.0,14.0,13.0,16.0,16.0,8.0,32.0,0.0,0.0,0.0,0.0,183.0,67.0,1.0,2.0,3.0,2.0,3.0,2.0,3.0,1.0,2.0,2.0,2.0,4.0,12.0,11.0,6.0,5.0,5.0,4.0,8.0,11.0,13.0,11.0,5.0,13.0,11.0,11.0,11.0,12.0,11.0,11.0,9.0,12.0,11.0,12.0,10.0,12.0,11.0,12.0,12.0,14.0,13.0,13.0,8.0,8.0,13.0,13.0,20.0,14.0,14.0,10.0,12.0,11.0,8.0,11.0,11.0,10.0,10.0,12.0,11.0,9.0,10.0,12.0,28.0,0.0,0.0,6.0,0.0,191.0,81.0,11.0,10.0,14.0,8.0,13.0,12.0,14.0,15.0,11.0,8.0,13.0,4.0,3.0,2.0,1.0,9.0,9.0,3.0,10.0,1.0,1.0,8.0,3.0,3.0,9.0,8.0,12.0,14.0,12.0,13.0,8.0,11.0,12.0,6.0,14.0,2.0,12.0,10.0,7.0,13.0,14.0,16.0,15.0,6.0,14.0,11.0,20.0,15.0,14.0,12.0,9.0,14.0,7.0,1.0,9.0,15.0,13.0,11.0,15.0,15.0,14.0,8.0,32.0,93.0,1.0,0.0,0.0,186.0,85.0,3.0,2.0,3.0,2.0,1.0,2.0,2.0,1.0,2.0,1.0,2.0,5.0,8.0,8.0,9.0,10.0,10.0,15.0,13.0,14.0,11.0,13.0,11.0,14.0,11.0,17.0,14.0,19.0,15.0,14.0,10.0,11.0,20.0,8.0,18.0,11.0,15.0,17.0,15.0,10.0,9.0,13.0,13.0,8.0,15.0,11.0,20.0,12.0,13.0,11.0,18.0,15.0,4.0,14.0,18.0,15.0,14.0,15.0,17.0,12.0,12.0,7.0,32.0,67.0,9.0,7.0,0.0,191.0,85.0,1.0,1.0,1.0,3.0,2.0,2.0,4.0,3.0,3.0,2.0,3.0,7.0,7.0,6.0,9.0,12.0,3.0,16.0,7.0,3.0,15.0,11.0,7.0,13.0,12.0,14.0,11.0,14.0,10.0,11.0,10.0,14.0,11.0,8.0,13.0,13.0,13.0,13.0,15.0,9.0,7.0,14.0,16.0,8.0,7.0,10.0,20.0,12.0,15.0,13.0,14.0,5.0,6.0,11.0,8.0,11.0,9.0,12.0,11.0,6.0,9.0,11.0,23.0,0.0,0.0,0.0,0.0,174.0,64.0,4.0,3.0,1.0,1.0,3.0,3.0,2.0,3.0,3.0,2.0,3.0,8.0,12.0,10.0,8.0,11.0,7.0,10.0,9.0,12.0,14.0,9.0,10.0,13.0,12.0,12.0,12.0,12.0,11.0,12.0,10.0,12.0,13.0,8.0,9.0,12.0,11.0,13.0,14.0,15.0,14.0,11.0,10.0,10.0,14.0,14.0,20.0,15.0,10.0,14.0,12.0,12.0,8.0,13.0,10.0,12.0,15.0,12.0,13.0,10.0,17.0,6.0,27.0,0.0,0.0,0.0,0.0,172.0,67.0,3.0,3.0,2.0,3.0,3.0,4.0,1.0,3.0,3.0,3.0,2.0,8.0,12.0,11.0,5.0,11.0,7.0,8.0,10.0,11.0,7.0,11.0,8.0,12.0,12.0,13.0,11.0,13.0,9.0,8.0,11.0,11.0,13.0,8.0,6.0,12.0,10.0,12.0,14.0,16.0,13.0,11.0,7.0,20.0,14.0,15.0,8.0,14.0,8.0,13.0,13.0,15.0,11.0,12.0,11.0,12.0,12.0,12.0,16.0,16.0,16.0,7.0,32.0,18.0,0.0,0.0,0.0,180.0,72.0,1.0,2.0,3.0,2.0,3.0,2.0,2.0,3.0,3.0,1.0,3.0,5.0,9.0,8.0,7.0,12.0,8.0,13.0,10.0,10.0,12.0,13.0,9.0,13.0,12.0,13.0,13.0,14.0,14.0,13.0,12.0,12.0,15.0,7.0,11.0,8.0,12.0,13.0,14.0,14.0,11.0,14.0,11.0,7.0,15.0,13.0,20.0,14.0,14.0,14.0,14.0,15.0,8.0,10.0,5.0,14.0,13.0,11.0,15.0,15.0,15.0,6.0,29.0,52.0,2.0,0.0,0.0,178.0,75.0,1.0,1.0,1.0,1.0,3.0,3.0,2.0,3.0,1.0,2.0,2.0,10.0,12.0,12.0,11.0,12.0,11.0,8.0,11.0,7.0,11.0,13.0,12.0,9.0,13.0,12.0,9.0,13.0,9.0,12.0,13.0,10.0,16.0,7.0,9.0,14.0,13.0,15.0,16.0,13.0,13.0,12.0,10.0,8.0,15.0,13.0,20.0,15.0,11.0,10.0,13.0,14.0,3.0,13.0,13.0,15.0,8.0,13.0,16.0,12.0,14.0,3.0,32.0,22.0,1.0,6.0,1.0,186.0,79.0,1.0,2.0,1.0,1.0,2.0,3.0,1.0,2.0,1.0,2.0,1.0,11.0,12.0,13.0,11.0,13.0,11.0,14.0,11.0,8.0,12.0,13.0,13.0,13.0,13.0,14.0,13.0,14.0,14.0,13.0,14.0,13.0,12.0,13.0,14.0,15.0,13.0,12.0,15.0,12.0,13.0,12.0,12.0,10.0,12.0,13.0,20.0,15.0,13.0,14.0,5.0,12.0,9.0,17.0,8.0,12.0,8.0,13.0,10.0,10.0,10.0,5.0,21.0,0.0,0.0,3.0,0.0,175.0,71.0,3.0,3.0,2.0,1.0,3.0,1.0,2.0,2.0,3.0,3.0,2.0,9.0,13.0,14.0,12.0,14.0,14.0,8.0,13.0,5.0,6.0,14.0,11.0,6.0,15.0,8.0,13.0,8.0,12.0,11.0,13.0,14.0,12.0,15.0,9.0,14.0,7.0,11.0,12.0,13.0,13.0,8.0,7.0,10.0,14.0,13.0,20.0,13.0,8.0,10.0,9.0,12.0,8.0,10.0,10.0,10.0,9.0,10.0,12.0,5.0,10.0,9.0,22.0,0.0,0.0,0.0,0.0,177.0,72.0,2.0,1.0,2.0,4.0,2.0,2.0,1.0,3.0,4.0,2.0,3.0,10.0,12.0,13.0,11.0,12.0,10.0,12.0,12.0,4.0,10.0,13.0,11.0,11.0,13.0,11.0,12.0,11.0,13.0,9.0,13.0,12.0,3.0,12.0,8.0,14.0,12.0,12.0,13.0,16.0,13.0,12.0,9.0,8.0,15.0,14.0,20.0,14.0,13.0,10.0,4.0,11.0,11.0,12.0,19.0,9.0,12.0,13.0,12.0,11.0,14.0,7.0,25.0,0.0,0.0,0.0,0.0,187.0,83.0,2.0,1.0,3.0,3.0,1.0,3.0,3.0,3.0,1.0,1.0,3.0,4.0,8.0,10.0,14.0,12.0,8.0,14.0,9.0,5.0,7.0,11.0,13.0,5.0,12.0,11.0,13.0,13.0,13.0,11.0,10.0,12.0,16.0,9.0,8.0,13.0,11.0,13.0,16.0,14.0,13.0,15.0,13.0,20.0,14.0,12.0,8.0,14.0,16.0,13.0,11.0,13.0,7.0,5.0,13.0,14.0,13.0,14.0,14.0,13.0,13.0,6.0
0,0,25.0,0.0,0.0,11.0,0.0,189.0,83.0,12.0,12.0,11.0,7.0,13.0,12.0,17.0,17.0,16.0,12.0,13.0,6.0,2.0,1.0,1.0,10.0,10.0,7.0,1.0,1.0,1.0,9.0,5.0,1.0,10.0,8.0,15.0,14.0,14.0,12.0,7.0,13.0,12.0,6.0,9.0,3.0,16.0,17.0,10.0,13.0,16.0,14.0,12.0,8.0,15.0,10.0,20.0,13.0,14.0,14.0,5.0,14.0,4.0,12.0,15.0,15.0,13.0,13.0,17.0,15.0,17.0,4.0,29.0,0.0,0.0,0.0,0.0,170.0,65.0,2.0,1.0,3.0,3.0,1.0,3.0,2.0,1.0,2.0,3.0,2.0,5.0,11.0,4.0,6.0,7.0,4.0,7.0,5.0,6.0,6.0,6.0,2.0,6.0,7.0,9.0,10.0,13.0,8.0,12.0,8.0,13.0,15.0,2.0,7.0,5.0,9.0,8.0,8.0,12.0,12.0,14.0,4.0,9.0,12.0,11.0,20.0,12.0,5.0,9.0,9.0,9.0,9.0,9.0,10.0,12.0,12.0,12.0,12.0,7.0,5.0,8.0,29.0,56.0,3.0,0.0,0.0,189.0,84.0,3.0,2.0,2.0,1.0,2.0,2.0,2.0,2.0,2.0,1.0,3.0,8.0,9.0,13.0,12.0,13.0,14.0,14.0,12.0,18.0,17.0,12.0,15.0,16.0,13.0,17.0,16.0,16.0,12.0,10.0,10.0,11.0,17.0,12.0,15.0,12.0,11.0,13.0,16.0,17.0,15.0,16.0,16.0,10.0,16.0,15.0,20.0,14.0,13.0,10.0,12.0,13.0,10.0,13.0,15.0,16.0,18.0,13.0,16.0,11.0,10.0,7.0,23.0,2.0,0.0,5.0,3.0,182.0,73.0,3.0,1.0,1.0,1.0,2.0,1.0,2.0,1.0,3.0,4.0,2.0,12.0,14.0,14.0,10.0,13.0,12.0,16.0,11.0,13.0,12.0,13.0,13.0,14.0,14.0,12.0,11.0,14.0,13.0,11.0,13.0,11.0,15.0,15.0,9.0,15.0,10.0,14.0,15.0,16.0,15.0,13.0,13.0,20.0,14.0,15.0,6.0,15.0,12.0,13.0,9.0,13.0,14.0,15.0,17.0,15.0,13.0,12.0,12.0,15.0,13.0,9.0,28.0,46.0,0.0,5.0,0.0,183.0,69.0,1.0,1.0,1.0,1.0,1.0,1.0,3.0,3.0,2.0,1.0,3.0,10.0,14.0,14.0,7.0,14.0,5.0,11.0,11.0,12.0,13.0,14.0,6.0,14.0,15.0,15.0,12.0,13.0,12.0,13.0,14.0,12.0,5.0,11.0,8.0,14.0,10.0,13.0,13.0,15.0,14.0,13.0,11.0,9.0,15.0,14.0,20.0,15.0,12.0,13.0,10.0,15.0,9.0,12.0,9.0,4.0,13.0,15.0,5.0,13.0,12.0,7.0,25.0,0.0,0.0,14.0,0.0,180.0,82.0,1.0,3.0,3.0,1.0,3.0,2.0,3.0,1.0,1.0,3.0,1.0,5.0,10.0,10.0,7.0,13.0,7.0,12.0,8.0,10.0,14.0,12.0,8.0,17.0,13.0,13.0,16.0,16.0,14.0,15.0,10.0,12.0,15.0,8.0,13.0,10.0,14.0,18.0,15.0,10.0,12.0,16.0,11.0,10.0,15.0,12.0,20.0,16.0,15.0,17.0,10.0,16.0,6.0,10.0,12.0,16.0,12.0,13.0,17.0,14.0,14.0,5.0,29.0,51.0,8.0,24.0,0.0,175.0,70.0,3.0,4.0,2.0,3.0,2.0,3.0,2.0,2.0,2.0,1.0,3.0,6.0,12.0,12.0,10.0,13.0,7.0,12.0,12.0,8.0,14.0,13.0,9.0,16.0,13.0,14.0,16.0,16.0,15.0,16.0,11.0,14.0,16.0,8.0,14.0,14.0,15.0,18.0,18.0,15.0,14.0,16.0,8.0,20.0,16.0,14.0,8.0,18.0,14.0,16.0,13.0,14.0,7.0,14.0,15.0,14.0,14.0,14.0,16.0,16.0,16.0,5.0,28.0,66.0,15.0,13.0,3.0,180.0,70.0,2.0,2.0,1.0,2.0,1.0,1.0,3.0,2.0,3.0,3.0,1.0,14.0,15.0,16.0,13.0,17.0,15.0,6.0,15.0,4.0,5.0,16.0,14.0,8.0,17.0,13.0,16.0,11.0,15.0,13.0,16.0,14.0,13.0,17.0,10.0,14.0,9.0,13.0,13.0,16.0,18.0,12.0,10.0,20.0,14.0,15.0,8.0,16.0,9.0,13.0,14.0,12.0,10.0,15.0,14.0,15.0,10.0,16.0,14.0,6.0,12.0,10.0,27.0,10.0,0.0,0.0,0.0,187.0,75.0,2.0,2.0,4.0,3.0,3.0,3.0,2.0,3.0,4.0,2.0,1.0,13.0,13.0,15.0,11.0,18.0,13.0,8.0,13.0,4.0,3.0,17.0,14.0,4.0,17.0,10.0,13.0,9.0,14.0,12.0,17.0,13.0,12.0,18.0,8.0,14.0,6.0,14.0,9.0,15.0,16.0,12.0,12.0,14.0,12.0,14.0,20.0,12.0,11.0,13.0,8.0,13.0,13.0,10.0,11.0,17.0,13.0,12.0,14.0,15.0,15.0,8.0,29.0,76.0,27.0,13.0,9.0,188.0,72.0,2.0,3.0,1.0,2.0,3.0,3.0,1.0,3.0,3.0,3.0,3.0,5.0,10.0,13.0,16.0,13.0,11.0,17.0,13.0,5.0,10.0,13.0,14.0,10.0,13.0,15.0,16.0,18.0,14.0,15.0,10.0,13.0,14.0,13.0,10.0,18.0,12.0,14.0,19.0,15.0,14.0,16.0,14.0,10.0,18.0,16.0,20.0,18.0,14.0,14.0,8.0,15.0,5.0,16.0,10.0,16.0,12.0,14.0,16.0,14.0,10.0,10.0,19.0,0.0,0.0,0.0,0.0,177.0,69.0,1.0,2.0,4.0,4.0,2.0,2.0,1.0,2.0,2.0,3.0,2.0,4.0,9.0,11.0,12.0,13.0,7.0,10.0,13.0,5.0,3.0,10.0,10.0,5.0,13.0,14.0,10.0,14.0,10.0,10.0,10.0,11.0,11.0,14.0,5.0,13.0,5.0,11.0,12.0,16.0,13.0,14.0,9.0,8.0,13.0,14.0,20.0,12.0,10.0,10.0,9.0,10.0,10.0,10.0,16.0,12.0,14.0,12.0,12.0,8.0,18.0,5.0,33.0,101.0,0.0,0.0,0.0,182.0,87.0,12.0,11.0,15.0,12.0,14.0,13.0,14.0,15.0,15.0,13.0,12.0,9.0,2.0,3.0,8.0,9.0,11.0,10.0,11.0,1.0,3.0,12.0,15.0,8.0,10.0,8.0,14.0,14.0,14.0,12.0,9.0,12.0,16.0,9.0,15.0,2.0,13.0,12.0,6.0,12.0,13.0,14.0,13.0,8.0,13.0,10.0,20.0,12.0,15.0,13.0,8.0,15.0,5.0,1.0,13.0,15.0,13.0,15.0,18.0,18.0,15.0,5.0,32.0,0.0,0.0,0.0,0.0,195.0,89.0,3.0,2.0,3.0,1.0,4.0,2.0,4.0,2.0,3.0,1.0,2.0,3.0,5.0,5.0,11.0,8.0,8.0,14.0,9.0,11.0,15.0,12.0,9.0,13.0,8.0,16.0,13.0,19.0,10.0,14.0,8.0,13.0,16.0,5.0,15.0,10.0,15.0,15.0,14.0,8.0,8.0,16.0,17.0,5.0,11.0,10.0,20.0,13.0,17.0,13.0,12.0,15.0,7.0,5.0,12.0,14.0,14.0,12.0,15.0,8.0,8.0,7.0,24.0,0.0,0.0,0.0,0.0,187.0,93.0,4.0,3.0,2.0,1.0,2.0,2.0,2.0,2.0,1.0,2.0,1.0,4.0,5.0,6.0,6.0,12.0,6.0,15.0,8.0,6.0,15.0,10.0,6.0,13.0,9.0,14.0,13.0,16.0,12.0,14.0,7.0,12.0,15.0,5.0,8.0,6.0,12.0,14.0,15.0,9.0,10.0,18.0,13.0,6.0,14.0,12.0,20.0,15.0,17.0,13.0,14.0,14.0,11.0,10.0,19.0,14.0,15.0,11.0,13.0,14.0,14.0,5.0,23.0,0.0,0.0,0.0,0.0,184.0,81.0,1.0,1.0,3.0,2.0,1.0,2.0,3.0,1.0,2.0,3.0,3.0,4.0,11.0,9.0,6.0,12.0,6.0,13.0,11.0,7.0,14.0,13.0,8.0,14.0,12.0,14.0,12.0,15.0,14.0,13.0,12.0,12.0,14.0,8.0,10.0,11.0,12.0,14.0,16.0,13.0,13.0,15.0,12.0,8.0,14.0,12.0,20.0,14.0,14.0,12.0,13.0,15.0,10.0,12.0,17.0,13.0,13.0,11.0,13.0,13.0,13.0,7.0,25.0,0.0,0.0,26.0,3.0,176.0,64.0,3.0,2.0,2.0,1.0,3.0,3.0,3.0,2.0,1.0,1.0,1.0,12.0,13.0,12.0,7.0,13.0,13.0,11.0,11.0,11.0,14.0,13.0,11.0,14.0,13.0,13.0,13.0,14.0,13.0,13.0,11.0,13.0,17.0,12.0,11.0,10.0,12.0,14.0,14.0,14.0,14.0,12.0,8.0,8.0,17.0,14.0,20.0,15.0,12.0,14.0,12.0,13.0,5.0,12.0,17.0,15.0,15.0,14.0,16.0,15.0,15.0,7.0,23.0,0.0,0.0,1.0,0.0,182.0,71.0,3.0,1.0,2.0,3.0,4.0,2.0,3.0,1.0,2.0,1.0,3.0,9.0,13.0,14.0,8.0,14.0,13.0,12.0,10.0,13.0,14.0,14.0,13.0,15.0,13.0,14.0,14.0,13.0,11.0,12.0,12.0,13.0,16.0,12.0,12.0,15.0,13.0,14.0,15.0,15.0,13.0,14.0,12.0,9.0,16.0,15.0,20.0,15.0,15.0,15.0,10.0,14.0,6.0,12.0,8.0,15.0,14.0,16.0,15.0,15.0,16.0,6.0,32.0,13.0,0.0,19.0,1.0,172.0,72.0,3.0,1.0,3.0,2.0,1.0,2.0,2.0,2.0,3.0,1.0,1.0,7.0,12.0,12.0,5.0,13.0,7.0,6.0,9.0,9.0,12.0,14.0,9.0,14.0,12.0,13.0,14.0,14.0,15.0,15.0,10.0,13.0,17.0,7.0,18.0,8.0,15.0,18.0,15.0,12.0,14.0,12.0,6.0,10.0,16.0,13.0,20.0,15.0,12.0,15.0,9.0,15.0,5.0,10.0,12.0,16.0,14.0,13.0,15.0,18.0,18.0,5.0,36.0,0.0,0.0,3.0,0.0,168.0,72.0,3.0,2.0,1.0,3.0,1.0,3.0,3.0,1.0,3.0,3.0,1.0,11.0,8.0,12.0,5.0,13.0,11.0,8.0,13.0,6.0,12.0,13.0,8.0,14.0,13.0,17.0,14.0,17.0,14.0,15.0,13.0,14.0,17.0,12.0,16.0,10.0,15.0,16.0,14.0,10.0,13.0,14.0,4.0,8.0,16.0,8.0,20.0,12.0,13.0,17.0,14.0,14.0,7.0,10.0,19.0,15.0,14.0,16.0,15.0,9.0,9.0,7.0,28.0,0.0,0.0,0.0,0.0,168.0,65.0,3.0,4.0,1.0,1.0,2.0,3.0,1.0,2.0,2.0,1.0,2.0,14.0,14.0,15.0,8.0,14.0,14.0,9.0,8.0,7.0,8.0,13.0,10.0,7.0,14.0,12.0,12.0,12.0,13.0,13.0,13.0,12.0,15.0,13.0,6.0,11.0,7.0,14.0,14.0,16.0,14.0,10.0,6.0,20.0,13.0,15.0,5.0,13.0,9.0,12.0,12.0,14.0,9.0,6.0,18.0,14.0,14.0,14.0,14.0,13.0,13.0,6.0,21.0,0.0,0.0,9.0,6.0,178.0,72.0,1.0,1.0,1.0,1.0,2.0,3.0,2.0,3.0,3.0,4.0,3.0,5.0,8.0,15.0,13.0,15.0,6.0,11.0,10.0,5.0,3.0,10.0,13.0,3.0,14.0,10.0,12.0,11.0,12.0,10.0,12.0,9.0,12.0,16.0,5.0,14.0,7.0,7.0,11.0,13.0,14.0,13.0,9.0,12.0,13.0,12.0,20.0,13.0,11.0,10.0,10.0,8.0,7.0,8.0,8.0,11.0,11.0,9.0,7.0,13.0,10.0,5.0,23.0,0.0,0.0,1.0,0.0,187.0,77.0,3.0,1.0,3.0,1.0,2.0,2.0,3.0,1.0,3.0,1.0,3.0,6.0,8.0,12.0,12.0,13.0,10.0,12.0,9.0,5.0,6.0,11.0,12.0,6.0,12.0,8.0,11.0,10.0,12.0,8.0,9.0,10.0,5.0,9.0,7.0,14.0,7.0,13.0,9.0,15.0,13.0,14.0,10.0,8.0,12.0,14.0,20.0,12.0,13.0,12.0,8.0,10.0,9.0,11.0,13.0,13.0,12.0,11.0,13.0,11.0,11.0,13.0
2,1,28.0,0.0,0.0,6.0,0.0,191.0,81.0,11.0,10.0,14.0,8.0,13.0,12.0,14.0,15.0,11.0,8.0,13.0,4.0,3.0,2.0,1.0,9.0,9.0,3.0,10.0,1.0,1.0,8.0,3.0,3.0,9.0,8.0,12.0,14.0,12.0,13.0,8.0,11.0,12.0,6.0,14.0,2.0,12.0,10.0,7.0,13.0,14.0,16.0,15.0,6.0,14.0,11.0,20.0,15.0,14.0,12.0,9.0,14.0,7.0,1.0,9.0,15.0,13.0,11.0,15.0,15.0,14.0,8.0,32.0,67.0,9.0,7.0,0.0,191.0,85.0,1.0,1.0,1.0,3.0,2.0,2.0,4.0,3.0,3.0,2.0,3.0,7.0,7.0,6.0,9.0,12.0,3.0,16.0,7.0,3.0,15.0,11.0,7.0,13.0,12.0,14.0,11.0,14.0,10.0,11.0,10.0,14.0,11.0,8.0,13.0,13.0,13.0,13.0,15.0,9.0,7.0,14.0,16.0,8.0,7.0,10.0,20.0,12.0,15.0,13.0,14.0,5.0,6.0,11.0,8.0,11.0,9.0,12.0,11.0,6.0,9.0,11.0,32.0,93.0,1.0,0.0,0.0,186.0,85.0,3.0,2.0,3.0,2.0,1.0,2.0,2.0,1.0,2.0,1.0,2.0,5.0,8.0,8.0,9.0,10.0,10.0,15.0,13.0,14.0,11.0,13.0,11.0,14.0,11.0,17.0,14.0,19.0,15.0,14.0,10.0,11.0,20.0,8.0,18.0,11.0,15.0,17.0,15.0,10.0,9.0,13.0,13.0,8.0,15.0,11.0,20.0,12.0,13.0,11.0,18.0,15.0,4.0,14.0,18.0,15.0,14.0,15.0,17.0,12.0,12.0,7.0,23.0,0.0,0.0,0.0,0.0,174.0,64.0,4.0,3.0,1.0,1.0,3.0,3.0,2.0,3.0,3.0,2.0,3.0,8.0,12.0,10.0,8.0,11.0,7.0,10.0,9.0,12.0,14.0,9.0,10.0,13.0,12.0,12.0,12.0,12.0,11.0,12.0,10.0,12.0,13.0,8.0,9.0,12.0,11.0,13.0,14.0,15.0,14.0,11.0,10.0,10.0,14.0,14.0,20.0,15.0,10.0,14.0,12.0,12.0,8.0,13.0,10.0,12.0,15.0,12.0,13.0,10.0,17.0,6.0,26.0,10.0,1.0,0.0,0.0,175.0,65.0,4.0,1.0,2.0,2.0,2.0,3.0,3.0,1.0,3.0,2.0,3.0,11.0,13.0,13.0,7.0,13.0,7.0,6.0,11.0,13.0,10.0,12.0,8.0,11.0,14.0,12.0,11.0,12.0,10.0,10.0,12.0,10.0,10.0,13.0,10.0,13.0,10.0,13.0,12.0,14.0,15.0,13.0,10.0,20.0,12.0,13.0,8.0,14.0,7.0,12.0,6.0,10.0,5.0,13.0,10.0,13.0,8.0,11.0,14.0,11.0,13.0,7.0,32.0,18.0,0.0,0.0,0.0,180.0,72.0,1.0,2.0,3.0,2.0,3.0,2.0,2.0,3.0,3.0,1.0,3.0,5.0,9.0,8.0,7.0,12.0,8.0,13.0,10.0,10.0,12.0,13.0,9.0,13.0,12.0,13.0,13.0,14.0,14.0,13.0,12.0,12.0,15.0,7.0,11.0,8.0,12.0,13.0,14.0,14.0,11.0,14.0,11.0,7.0,15.0,13.0,20.0,14.0,14.0,14.0,14.0,15.0,8.0,10.0,5.0,14.0,13.0,11.0,15.0,15.0,15.0,6.0,32.0,22.0,1.0,6.0,1.0,186.0,79.0,1.0,2.0,1.0,1.0,2.0,3.0,1.0,2.0,1.0,2.0,1.0,11.0,12.0,13.0,11.0,13.0,11.0,14.0,11.0,8.0,12.0,13.0,13.0,13.0,13.0,14.0,13.0,14.0,14.0,13.0,14.0,13.0,12.0,13.0,14.0,15.0,13.0,12.0,15.0,12.0,13.0,12.0,12.0,10.0,12.0,13.0,20.0,15.0,13.0,14.0,5.0,12.0,9.0,17.0,8.0,12.0,8.0,13.0,10.0,10.0,10.0,5.0,29.0,52.0,2.0,0.0,0.0,178.0,75.0,1.0,1.0,1.0,1.0,3.0,3.0,2.0,3.0,1.0,2.0,2.0,10.0,12.0,12.0,11.0,12.0,11.0,8.0,11.0,7.0,11.0,13.0,12.0,9.0,13.0,12.0,9.0,13.0,9.0,12.0,13.0,10.0,16.0,7.0,9.0,14.0,13.0,15.0,16.0,13.0,13.0,12.0,10.0,8.0,15.0,13.0,20.0,15.0,11.0,10.0,13.0,14.0,3.0,13.0,13.0,15.0,8.0,13.0,16.0,12.0,14.0,3.0,21.0,0.0,0.0,3.0,0.0,175.0,71.0,3.0,3.0,2.0,1.0,3.0,1.0,2.0,2.0,3.0,3.0,2.0,9.0,13.0,14.0,12.0,14.0,14.0,8.0,13.0,5.0,6.0,14.0,11.0,6.0,15.0,8.0,13.0,8.0,12.0,11.0,13.0,14.0,12.0,15.0,9.0,14.0,7.0,11.0,12.0,13.0,13.0,8.0,7.0,10.0,14.0,13.0,20.0,13.0,8.0,10.0,9.0,12.0,8.0,10.0,10.0,10.0,9.0,10.0,12.0,5.0,10.0,9.0,22.0,0.0,0.0,0.0,0.0,177.0,72.0,2.0,1.0,2.0,4.0,2.0,2.0,1.0,3.0,4.0,2.0,3.0,10.0,12.0,13.0,11.0,12.0,10.0,12.0,12.0,4.0,10.0,13.0,11.0,11.0,13.0,11.0,12.0,11.0,13.0,9.0,13.0,12.0,3.0,12.0,8.0,14.0,12.0,12.0,13.0,16.0,13.0,12.0,9.0,8.0,15.0,14.0,20.0,14.0,13.0,10.0,4.0,11.0,11.0,12.0,19.0,9.0,12.0,13.0,12.0,11.0,14.0,7.0,25.0,0.0,0.0,0.0,0.0,187.0,83.0,2.0,1.0,3.0,3.0,1.0,3.0,3.0,3.0,1.0,1.0,3.0,4.0,8.0,10.0,14.0,12.0,8.0,14.0,9.0,5.0,7.0,11.0,13.0,5.0,12.0,11.0,13.0,13.0,13.0,11.0,10.0,12.0,16.0,9.0,8.0,13.0,11.0,13.0,16.0,14.0,13.0,15.0,13.0,20.0,14.0,12.0,8.0,14.0,16.0,13.0,11.0,13.0,7.0,5.0,13.0,14.0,13.0,14.0,14.0,13.0,13.0,6.0,25.0,0.0,0.0,0.0,0.0,187.0,83.0,11.0,14.0,12.0,8.0,13.0,11.0,14.0,15.0,13.0,13.0,9.0,8.0,1.0,1.0,1.0,11.0,11.0,1.0,2.0,2.0,1.0,10.0,3.0,2.0,11.0,8.0,12.0,14.0,12.0,12.0,10.0,12.0,14.0,6.0,14.0,2.0,12.0,12.0,8.0,13.0,15.0,14.0,13.0,20.0,15.0,11.0,5.0,14.0,13.0,13.0,8.0,8.0,10.0,1.0,9.0,13.0,14.0,12.0,15.0,15.0,15.0,5.0,24.0,0.0,0.0,4.0,0.0,186.0,88.0,1.0,2.0,1.0,3.0,2.0,1.0,1.0,2.0,1.0,2.0,1.0,4.0,8.0,8.0,6.0,12.0,6.0,14.0,9.0,11.0,14.0,12.0,6.0,12.0,12.0,14.0,13.0,14.0,12.0,13.0,8.0,12.0,13.0,8.0,8.0,9.0,12.0,12.0,13.0,13.0,11.0,15.0,13.0,8.0,15.0,14.0,20.0,14.0,15.0,13.0,14.0,15.0,8.0,12.0,14.0,14.0,12.0,9.0,12.0,13.0,13.0,8.0,26.0,11.0,0.0,4.0,0.0,183.0,79.0,3.0,2.0,1.0,2.0,2.0,2.0,3.0,2.0,2.0,2.0,1.0,5.0,7.0,9.0,6.0,10.0,11.0,15.0,11.0,7.0,14.0,10.0,7.0,13.0,10.0,14.0,13.0,15.0,13.0,12.0,10.0,12.0,17.0,8.0,11.0,10.0,13.0,15.0,16.0,13.0,13.0,16.0,13.0,5.0,15.0,13.0,20.0,16.0,15.0,13.0,14.0,15.0,7.0,14.0,16.0,12.0,14.0,14.0,15.0,14.0,14.0,5.0,26.0,0.0,0.0,0.0,0.0,177.0,68.0,4.0,2.0,1.0,2.0,3.0,1.0,1.0,2.0,3.0,3.0,3.0,12.0,13.0,11.0,8.0,13.0,11.0,8.0,10.0,8.0,10.0,13.0,10.0,12.0,13.0,7.0,12.0,10.0,13.0,11.0,15.0,13.0,14.0,11.0,7.0,14.0,10.0,14.0,14.0,13.0,15.0,12.0,9.0,20.0,15.0,14.0,5.0,15.0,8.0,13.0,7.0,14.0,6.0,12.0,11.0,12.0,14.0,13.0,16.0,16.0,16.0,5.0,22.0,12.0,2.0,13.0,0.0,170.0,71.0,2.0,2.0,1.0,3.0,2.0,2.0,1.0,1.0,1.0,3.0,2.0,15.0,15.0,12.0,10.0,14.0,15.0,8.0,13.0,12.0,9.0,13.0,10.0,10.0,14.0,14.0,16.0,10.0,17.0,14.0,12.0,16.0,14.0,12.0,8.0,14.0,10.0,17.0,16.0,16.0,17.0,10.0,6.0,20.0,17.0,13.0,8.0,15.0,7.0,15.0,6.0,15.0,8.0,17.0,13.0,13.0,12.0,12.0,14.0,16.0,16.0,8.0,26.0,14.0,0.0,0.0,0.0,181.0,74.0,2.0,1.0,1.0,1.0,3.0,2.0,3.0,1.0,3.0,3.0,2.0,6.0,13.0,8.0,5.0,12.0,7.0,12.0,8.0,11.0,13.0,12.0,6.0,14.0,10.0,14.0,12.0,14.0,10.0,12.0,8.0,8.0,14.0,6.0,6.0,12.0,11.0,14.0,15.0,16.0,14.0,14.0,11.0,5.0,14.0,14.0,20.0,16.0,14.0,12.0,13.0,14.0,8.0,10.0,8.0,14.0,12.0,13.0,15.0,15.0,15.0,6.0,30.0,7.0,0.0,0.0,0.0,181.0,72.0,1.0,3.0,3.0,1.0,2.0,3.0,2.0,1.0,3.0,2.0,2.0,12.0,11.0,14.0,8.0,14.0,12.0,8.0,12.0,6.0,5.0,13.0,13.0,5.0,14.0,8.0,12.0,10.0,11.0,12.0,15.0,11.0,13.0,14.0,9.0,13.0,10.0,12.0,13.0,12.0,14.0,12.0,10.0,12.0,15.0,13.0,20.0,15.0,9.0,10.0,8.0,13.0,5.0,8.0,12.0,14.0,14.0,12.0,11.0,14.0,14.0,8.0,22.0,18.0,0.0,0.0,0.0,179.0,75.0,1.0,4.0,2.0,1.0,1.0,1.0,3.0,1.0,1.0,3.0,2.0,7.0,8.0,12.0,8.0,13.0,10.0,11.0,12.0,11.0,11.0,11.0,10.0,14.0,13.0,15.0,12.0,15.0,8.0,12.0,10.0,12.0,14.0,12.0,10.0,13.0,12.0,13.0,17.0,14.0,14.0,13.0,10.0,9.0,15.0,15.0,20.0,15.0,14.0,13.0,13.0,12.0,11.0,12.0,13.0,15.0,9.0,10.0,12.0,10.0,10.0,4.0,22.0,0.0,0.0,0.0,0.0,164.0,65.0,1.0,2.0,3.0,1.0,2.0,2.0,3.0,2.0,2.0,1.0,2.0,10.0,12.0,13.0,11.0,13.0,10.0,5.0,10.0,7.0,5.0,12.0,10.0,3.0,13.0,7.0,11.0,11.0,11.0,13.0,13.0,11.0,13.0,13.0,6.0,14.0,7.0,12.0,12.0,15.0,15.0,8.0,2.0,9.0,13.0,14.0,20.0,13.0,8.0,13.0,7.0,10.0,8.0,12.0,10.0,12.0,11.0,12.0,11.0,10.0,10.0,8.0,24.0,0.0,0.0,5.0,0.0,183.0,79.0,4.0,4.0,3.0,3.0,1.0,3.0,2.0,1.0,3.0,2.0,3.0,4.0,7.0,12.0,13.0,12.0,8.0,13.0,12.0,5.0,6.0,11.0,12.0,4.0,13.0,11.0,12.0,14.0,9.0,12.0,10.0,10.0,13.0,12.0,6.0,14.0,12.0,13.0,14.0,15.0,14.0,14.0,11.0,10.0,13.0,14.0,20.0,14.0,14.0,12.0,12.0,14.0,9.0,5.0,7.0,13.0,15.0,11.0,14.0,14.0,14.0,6.0,27.0,33.0,4.0,3.0,0.0,180.0,75.0,2.0,1.0,2.0,1.0,4.0,2.0,1.0,3.0,1.0,1.0,2.0,12.0,11.0,13.0,13.0,11.0,11.0,11.0,10.0,7.0,5.0,10.0,14.0,5.0,14.0,9.0,11.0,12.0,10.0,11.0,12.0,12.0,14.0,13.0,8.0,14.0,8.0,11.0,14.0,16.0,14.0,13.0,10.0,7.0,12.0,15.0,20.0,14.0,12.0,12.0,9.0,13.0,10.0,10.0,9.0,15.0,8.0,9.0,13.0,14.0,14.0,7.0
4,1,25.0,4.0,0.0,11.0,0.0,184.0,81.0,14.0,14.0,13.0,9.0,15.0,12.0,16.0,16.0,13.0,7.0,11.0,8.0,1.0,2.0,1.0,11.0,12.0,6.0,1.0,3.0,3.0,11.0,5.0,3.0,11.0,8.0,15.0,15.0,13.0,14.0,10.0,11.0,14.0,8.0,13.0,5.0,13.0,10.0,10.0,14.0,16.0,14.0,13.0,20.0,14.0,12.0,5.0,14.0,14.0,15.0,9.0,16.0,6.0,1.0,17.0,11.0,15.0,13.0,14.0,12.0,12.0,4.0,27.0,4.0,0.0,5.0,1.0,184.0,83.0,2.0,4.0,3.0,1.0,1.0,2.0,1.0,2.0,4.0,2.0,3.0,4.0,8.0,11.0,4.0,10.0,4.0,14.0,4.0,4.0,15.0,12.0,5.0,16.0,11.0,14.0,14.0,16.0,14.0,10.0,11.0,12.0,17.0,7.0,10.0,9.0,13.0,14.0,15.0,14.0,13.0,16.0,13.0,10.0,15.0,13.0,20.0,15.0,16.0,12.0,12.0,14.0,6.0,12.0,11.0,13.0,12.0,12.0,16.0,15.0,14.0,6.0,22.0,3.0,0.0,7.0,1.0,182.0,75.0,3.0,3.0,1.0,3.0,2.0,3.0,1.0,1.0,2.0,2.0,1.0,4.0,11.0,10.0,6.0,14.0,7.0,13.0,10.0,9.0,16.0,14.0,8.0,15.0,14.0,13.0,17.0,15.0,16.0,14.0,11.0,14.0,15.0,8.0,11.0,10.0,15.0,16.0,14.0,14.0,14.0,14.0,11.0,20.0,15.0,14.0,10.0,15.0,15.0,15.0,12.0,15.0,8.0,11.0,12.0,14.0,16.0,15.0,14.0,14.0,14.0,5.0,19.0,0.0,0.0,3.0,1.0,181.0,69.0,3.0,2.0,3.0,3.0,2.0,1.0,1.0,1.0,3.0,3.0,4.0,10.0,10.0,12.0,12.0,12.0,7.0,8.0,11.0,5.0,7.0,10.0,10.0,7.0,11.0,8.0,10.0,10.0,12.0,8.0,11.0,8.0,14.0,13.0,6.0,14.0,8.0,13.0,13.0,16.0,14.0,13.0,9.0,20.0,15.0,16.0,10.0,15.0,13.0,12.0,8.0,11.0,7.0,12.0,11.0,11.0,15.0,10.0,12.0,14.0,14.0,1.0,32.0,52.0,1.0,0.0,0.0,180.0,80.0,2.0,3.0,2.0,2.0,1.0,4.0,1.0,2.0,3.0,4.0,3.0,7.0,12.0,12.0,6.0,12.0,7.0,12.0,11.0,13.0,13.0,11.0,9.0,13.0,12.0,13.0,13.0,15.0,12.0,10.0,11.0,12.0,16.0,12.0,10.0,13.0,11.0,13.0,14.0,15.0,13.0,14.0,10.0,20.0,12.0,14.0,5.0,15.0,14.0,10.0,13.0,12.0,7.0,8.0,12.0,15.0,13.0,12.0,13.0,14.0,14.0,9.0,32.0,11.0,1.0,0.0,0.0,176.0,68.0,2.0,1.0,3.0,2.0,2.0,2.0,2.0,3.0,3.0,2.0,2.0,8.0,10.0,10.0,7.0,11.0,8.0,10.0,11.0,12.0,11.0,13.0,12.0,14.0,12.0,9.0,14.0,15.0,13.0,12.0,11.0,12.0,17.0,8.0,14.0,14.0,11.0,18.0,18.0,14.0,14.0,12.0,10.0,10.0,14.0,13.0,20.0,17.0,13.0,15.0,9.0,13.0,8.0,13.0,17.0,13.0,15.0,16.0,16.0,16.0,18.0,5.0,27.0,8.0,0.0,6.0,0.0,187.0,76.0,3.0,2.0,3.0,2.0,2.0,1.0,1.0,3.0,3.0,1.0,2.0,5.0,7.0,11.0,5.0,14.0,5.0,14.0,9.0,5.0,15.0,15.0,8.0,14.0,13.0,15.0,16.0,15.0,14.0,12.0,14.0,14.0,18.0,8.0,17.0,9.0,12.0,18.0,15.0,13.0,14.0,15.0,14.0,10.0,17.0,12.0,20.0,17.0,15.0,14.0,13.0,16.0,4.0,12.0,10.0,14.0,17.0,12.0,15.0,13.0,13.0,6.0,24.0,0.0,0.0,6.0,1.0,172.0,70.0,3.0,1.0,1.0,3.0,1.0,2.0,3.0,1.0,1.0,3.0,3.0,11.0,12.0,11.0,8.0,12.0,10.0,6.0,14.0,7.0,11.0,15.0,8.0,12.0,13.0,14.0,14.0,18.0,13.0,12.0,13.0,13.0,15.0,12.0,12.0,12.0,11.0,18.0,18.0,13.0,14.0,13.0,7.0,10.0,16.0,12.0,20.0,14.0,12.0,14.0,14.0,15.0,4.0,8.0,7.0,14.0,14.0,13.0,14.0,12.0,10.0,6.0,21.0,0.0,0.0,15.0,3.0,181.0,78.0,3.0,3.0,4.0,2.0,1.0,2.0,2.0,4.0,2.0,1.0,1.0,5.0,7.0,11.0,10.0,14.0,5.0,14.0,10.0,6.0,13.0,14.0,8.0,14.0,14.0,12.0,14.0,12.0,11.0,10.0,12.0,11.0,16.0,11.0,12.0,14.0,14.0,14.0,14.0,14.0,13.0,14.0,13.0,10.0,16.0,14.0,20.0,16.0,14.0,12.0,10.0,11.0,5.0,19.0,8.0,11.0,14.0,11.0,16.0,13.0,13.0,10.0,31.0,52.0,8.0,0.0,0.0,167.0,58.0,1.0,2.0,2.0,1.0,3.0,2.0,4.0,2.0,1.0,2.0,3.0,15.0,15.0,14.0,7.0,15.0,15.0,6.0,11.0,3.0,4.0,15.0,14.0,7.0,15.0,13.0,12.0,15.0,13.0,14.0,16.0,11.0,17.0,14.0,11.0,12.0,10.0,12.0,14.0,15.0,18.0,10.0,5.0,10.0,16.0,14.0,20.0,13.0,7.0,14.0,13.0,16.0,8.0,12.0,13.0,16.0,14.0,15.0,13.0,9.0,11.0,14.0,25.0,10.0,1.0,11.0,4.0,175.0,73.0,1.0,3.0,3.0,3.0,3.0,3.0,3.0,1.0,2.0,3.0,1.0,5.0,10.0,15.0,17.0,15.0,10.0,11.0,12.0,5.0,5.0,14.0,15.0,5.0,16.0,8.0,15.0,12.0,15.0,14.0,13.0,15.0,15.0,15.0,14.0,14.0,10.0,10.0,12.0,16.0,16.0,15.0,9.0,10.0,15.0,16.0,20.0,13.0,15.0,14.0,8.0,14.0,7.0,10.0,8.0,16.0,17.0,13.0,15.0,15.0,14.0,5.0,36.0,0.0,0.0,0.0,0.0,185.0,78.0,11.0,14.0,12.0,7.0,13.0,12.0,14.0,15.0,13.0,14.0,10.0,4.0,1.0,3.0,1.0,8.0,8.0,11.0,8.0,3.0,3.0,7.0,2.0,1.0,8.0,11.0,13.0,15.0,11.0,12.0,7.0,13.0,9.0,5.0,14.0,3.0,13.0,15.0,8.0,11.0,14.0,13.0,12.0,5.0,15.0,11.0,20.0,12.0,14.0,13.0,11.0,13.0,8.0,1.0,19.0,14.0,16.0,10.0,17.0,9.0,9.0,11.0,34.0,23.0,1.0,0.0,0.0,186.0,81.0,3.0,3.0,1.0,2.0,1.0,3.0,2.0,3.0,1.0,3.0,3.0,4.0,8.0,6.0,10.0,7.0,8.0,17.0,12.0,10.0,14.0,7.0,9.0,15.0,7.0,15.0,13.0,17.0,8.0,12.0,7.0,12.0,15.0,6.0,17.0,7.0,14.0,15.0,14.0,8.0,10.0,16.0,13.0,12.0,13.0,9.0,20.0,13.0,15.0,11.0,15.0,14.0,9.0,10.0,10.0,14.0,11.0,13.0,15.0,11.0,11.0,12.0,28.0,0.0,0.0,0.0,0.0,183.0,81.0,1.0,2.0,4.0,1.0,1.0,3.0,2.0,3.0,3.0,3.0,1.0,5.0,5.0,6.0,10.0,12.0,6.0,14.0,8.0,6.0,15.0,11.0,6.0,13.0,12.0,13.0,14.0,16.0,14.0,14.0,10.0,12.0,14.0,5.0,14.0,8.0,14.0,15.0,15.0,9.0,12.0,15.0,13.0,7.0,11.0,12.0,20.0,15.0,15.0,14.0,14.0,14.0,9.0,8.0,14.0,14.0,11.0,13.0,15.0,13.0,15.0,6.0,24.0,0.0,0.0,0.0,0.0,179.0,68.0,3.0,2.0,3.0,2.0,1.0,3.0,3.0,1.0,3.0,3.0,1.0,4.0,13.0,9.0,6.0,12.0,9.0,12.0,7.0,8.0,12.0,14.0,8.0,14.0,12.0,15.0,14.0,13.0,14.0,13.0,10.0,12.0,14.0,10.0,9.0,9.0,10.0,13.0,14.0,14.0,12.0,13.0,9.0,9.0,8.0,14.0,20.0,15.0,14.0,11.0,11.0,13.0,10.0,14.0,13.0,14.0,14.0,11.0,16.0,15.0,15.0,6.0,36.0,0.0,0.0,0.0,0.0,180.0,72.0,1.0,2.0,4.0,1.0,1.0,2.0,2.0,1.0,1.0,1.0,2.0,6.0,10.0,8.0,6.0,11.0,8.0,13.0,10.0,7.0,11.0,11.0,8.0,13.0,11.0,13.0,13.0,14.0,14.0,13.0,11.0,12.0,13.0,7.0,10.0,10.0,13.0,13.0,15.0,11.0,12.0,14.0,10.0,10.0,14.0,10.0,20.0,12.0,11.0,12.0,14.0,14.0,5.0,15.0,20.0,12.0,20.0,14.0,16.0,15.0,15.0,5.0,18.0,0.0,0.0,0.0,0.0,178.0,70.0,1.0,2.0,3.0,1.0,1.0,3.0,2.0,2.0,3.0,3.0,2.0,6.0,9.0,11.0,6.0,13.0,8.0,6.0,10.0,5.0,10.0,14.0,6.0,8.0,13.0,10.0,10.0,10.0,13.0,12.0,12.0,10.0,16.0,12.0,5.0,12.0,6.0,10.0,11.0,12.0,13.0,12.0,9.0,20.0,14.0,14.0,5.0,8.0,11.0,10.0,6.0,2.0,8.0,10.0,20.0,9.0,11.0,11.0,10.0,12.0,12.0,1.0,29.0,13.0,5.0,0.0,0.0,170.0,64.0,4.0,2.0,2.0,2.0,1.0,1.0,1.0,2.0,1.0,3.0,2.0,9.0,8.0,12.0,8.0,12.0,5.0,6.0,10.0,6.0,3.0,10.0,9.0,7.0,12.0,12.0,11.0,10.0,5.0,5.0,11.0,8.0,10.0,15.0,3.0,13.0,4.0,9.0,7.0,17.0,17.0,11.0,4.0,10.0,9.0,15.0,20.0,12.0,8.0,9.0,11.0,9.0,11.0,15.0,10.0,5.0,5.0,10.0,7.0,10.0,5.0,10.0,33.0,0.0,0.0,0.0,0.0,187.0,76.0,2.0,2.0,3.0,1.0,1.0,3.0,2.0,1.0,2.0,3.0,2.0,15.0,14.0,14.0,10.0,15.0,13.0,10.0,12.0,7.0,4.0,15.0,13.0,7.0,15.0,6.0,12.0,9.0,14.0,11.0,15.0,12.0,12.0,14.0,12.0,13.0,7.0,13.0,12.0,11.0,12.0,14.0,12.0,14.0,15.0,12.0,20.0,11.0,12.0,12.0,6.0,14.0,6.0,11.0,14.0,13.0,12.0,12.0,15.0,15.0,13.0,9.0,30.0,0.0,0.0,0.0,0.0,178.0,73.0,3.0,4.0,1.0,1.0,2.0,4.0,3.0,2.0,2.0,2.0,3.0,13.0,14.0,12.0,7.0,13.0,12.0,7.0,13.0,5.0,10.0,13.0,9.0,10.0,13.0,11.0,11.0,12.0,12.0,13.0,11.0,14.0,14.0,11.0,7.0,11.0,10.0,13.0,15.0,13.0,15.0,15.0,8.0,20.0,14.0,14.0,8.0,14.0,11.0,13.0,11.0,14.0,8.0,10.0,19.0,12.0,12.0,9.0,12.0,12.0,10.0,10.0,26.0,0.0,0.0,0.0,0.0,193.0,81.0,1.0,3.0,3.0,3.0,3.0,1.0,2.0,2.0,2.0,3.0,3.0,4.0,9.0,14.0,10.0,13.0,12.0,14.0,14.0,5.0,5.0,10.0,12.0,3.0,14.0,8.0,13.0,12.0,9.0,10.0,11.0,11.0,12.0,16.0,5.0,14.0,6.0,9.0,12.0,14.0,13.0,14.0,16.0,14.0,13.0,13.0,20.0,13.0,14.0,10.0,8.0,14.0,9.0,8.0,16.0,16.0,11.0,13.0,11.0,13.0,13.0,10.0,24.0,0.0,0.0,0.0,0.0,182.0,82.0,3.0,3.0,2.0,1.0,1.0,3.0,2.0,2.0,3.0,2.0,2.0,4.0,7.0,13.0,14.0,13.0,12.0,14.0,12.0,5.0,7.0,10.0,14.0,6.0,15.0,13.0,13.0,16.0,8.0,12.0,11.0,11.0,12.0,14.0,7.0,13.0,8.0,12.0,13.0,14.0,14.0,15.0,12.0,10.0,10.0,12.0,20.0,16.0,15.0,12.0,13.0,14.0,10.0,8.0,8.0,13.0,5.0,10.0,11.0,9.0,9.0,13.0
1,0,33.0,101.0,0.0,0.0,0.0,182.0,87.0,12.0,11.0,15.0,12.0,14.0,13.0,14.0,15.0,15.0,13.0,12.0,9.0,2.0,3.0,8.0,9.0,11.0,10.0,11.0,1.0,3.0,12.0,15.0,8.0,10.0,8.0,14.0,14.0,14.0,12.0,9.0,12.0,16.0,9.0,15.0,2.0,13.0,12.0,6.0,12.0,13.0,14.0,13.0,8.0,13.0,10.0,20.0,12.0,15.0,13.0,8.0,15.0,5.0,1.0,13.0,15.0,13.0,15.0,18.0,18.0,15.0,5.0,23.0,0.0,0.0,0.0,0.0,184.0,81.0,1.0,1.0,3.0,2.0,1.0,2.0,3.0,1.0,2.0,3.0,3.0,4.0,11.0,9.0,6.0,12.0,6.0,13.0,11.0,7.0,14.0,13.0,8.0,14.0,12.0,14.0,12.0,15.0,14.0,13.0,12.0,12.0,14.0,8.0,10.0,11.0,12.0,14.0,16.0,13.0,13.0,15.0,12.0,8.0,14.0,12.0,20.0,14.0,14.0,12.0,13.0,15.0,10.0,12.0,17.0,13.0,13.0,11.0,13.0,13.0,13.0,7.0,32.0,0.0,0.0,0.0,0.0,195.0,89.0,3.0,2.0,3.0,1.0,4.0,2.0,4.0,2.0,3.0,1.0,2.0,3.0,5.0,5.0,11.0,8.0,8.0,14.0,9.0,11.0,15.0,12.0,9.0,13.0,8.0,16.0,13.0,19.0,10.0,14.0,8.0,13.0,16.0,5.0,15.0,10.0,15.0,15.0,14.0,8.0,8.0,16.0,17.0,5.0,11.0,10.0,20.0,13.0,17.0,13.0,12.0,15.0,7.0,5.0,12.0,14.0,14.0,12.0,15.0,8.0,8.0,7.0,24.0,0.0,0.0,0.0,0.0,187.0,93.0,4.0,3.0,2.0,1.0,2.0,2.0,2.0,2.0,1.0,2.0,1.0,4.0,5.0,6.0,6.0,12.0,6.0,15.0,8.0,6.0,15.0,10.0,6.0,13.0,9.0,14.0,13.0,16.0,12.0,14.0,7.0,12.0,15.0,5.0,8.0,6.0,12.0,14.0,15.0,9.0,10.0,18.0,13.0,6.0,14.0,12.0,20.0,15.0,17.0,13.0,14.0,14.0,11.0,10.0,19.0,14.0,15.0,11.0,13.0,14.0,14.0,5.0,25.0,0.0,0.0,26.0,3.0,176.0,64.0,3.0,2.0,2.0,1.0,3.0,3.0,3.0,2.0,1.0,1.0,1.0,12.0,13.0,12.0,7.0,13.0,13.0,11.0,11.0,11.0,14.0,13.0,11.0,14.0,13.0,13.0,13.0,14.0,13.0,13.0,11.0,13.0,17.0,12.0,11.0,10.0,12.0,14.0,14.0,14.0,14.0,12.0,8.0,8.0,17.0,14.0,20.0,15.0,12.0,14.0,12.0,13.0,5.0,12.0,17.0,15.0,15.0,14.0,16.0,15.0,15.0,7.0,23.0,0.0,0.0,1.0,0.0,182.0,71.0,3.0,1.0,2.0,3.0,4.0,2.0,3.0,1.0,2.0,1.0,3.0,9.0,13.0,14.0,8.0,14.0,13.0,12.0,10.0,13.0,14.0,14.0,13.0,15.0,13.0,14.0,14.0,13.0,11.0,12.0,12.0,13.0,16.0,12.0,12.0,15.0,13.0,14.0,15.0,15.0,13.0,14.0,12.0,9.0,16.0,15.0,20.0,15.0,15.0,15.0,10.0,14.0,6.0,12.0,8.0,15.0,14.0,16.0,15.0,15.0,16.0,6.0,32.0,13.0,0.0,19.0,1.0,172.0,72.0,3.0,1.0,3.0,2.0,1.0,2.0,2.0,2.0,3.0,1.0,1.0,7.0,12.0,12.0,5.0,13.0,7.0,6.0,9.0,9.0,12.0,14.0,9.0,14.0,12.0,13.0,14.0,14.0,15.0,15.0,10.0,13.0,17.0,7.0,18.0,8.0,15.0,18.0,15.0,12.0,14.0,12.0,6.0,10.0,16.0,13.0,20.0,15.0,12.0,15.0,9.0,15.0,5.0,10.0,12.0,16.0,14.0,13.0,15.0,18.0,18.0,5.0,22.0,2.0,0.0,0.0,0.0,169.0,59.0,3.0,1.0,3.0,1.0,1.0,1.0,1.0,1.0,3.0,3.0,2.0,13.0,13.0,15.0,13.0,15.0,13.0,7.0,13.0,8.0,6.0,13.0,13.0,5.0,16.0,10.0,10.0,8.0,13.0,11.0,14.0,12.0,12.0,14.0,10.0,12.0,6.0,10.0,8.0,16.0,15.0,17.0,6.0,12.0,12.0,15.0,20.0,13.0,9.0,12.0,8.0,12.0,8.0,12.0,13.0,13.0,13.0,14.0,12.0,10.0,13.0,9.0,31.0,1.0,0.0,0.0,0.0,178.0,74.0,1.0,3.0,2.0,2.0,2.0,1.0,2.0,2.0,3.0,1.0,3.0,12.0,13.0,13.0,7.0,15.0,13.0,10.0,12.0,7.0,6.0,14.0,11.0,8.0,15.0,14.0,14.0,13.0,13.0,12.0,13.0,13.0,15.0,14.0,10.0,12.0,10.0,10.0,12.0,12.0,13.0,14.0,10.0,10.0,15.0,12.0,20.0,14.0,12.0,11.0,14.0,14.0,6.0,14.0,12.0,14.0,10.0,12.0,13.0,10.0,6.0,14.0,28.0,0.0,0.0,0.0,0.0,168.0,65.0,3.0,4.0,1.0,1.0,2.0,3.0,1.0,2.0,2.0,1.0,2.0,14.0,14.0,15.0,8.0,14.0,14.0,9.0,8.0,7.0,8.0,13.0,10.0,7.0,14.0,12.0,12.0,12.0,13.0,13.0,13.0,12.0,15.0,13.0,6.0,11.0,7.0,14.0,14.0,16.0,14.0,10.0,6.0,20.0,13.0,15.0,5.0,13.0,9.0,12.0,12.0,14.0,9.0,6.0,18.0,14.0,14.0,14.0,14.0,13.0,13.0,6.0,21.0,0.0,0.0,9.0,6.0,178.0,72.0,1.0,1.0,1.0,1.0,2.0,3.0,2.0,3.0,3.0,4.0,3.0,5.0,8.0,15.0,13.0,15.0,6.0,11.0,10.0,5.0,3.0,10.0,13.0,3.0,14.0,10.0,12.0,11.0,12.0,10.0,12.0,9.0,12.0,16.0,5.0,14.0,7.0,7.0,11.0,13.0,14.0,13.0,9.0,12.0,13.0,12.0,20.0,13.0,11.0,10.0,10.0,8.0,7.0,8.0,8.0,11.0,11.0,9.0,7.0,13.0,10.0,5.0,25.0,4.0,0.0,11.0,0.0,184.0,81.0,14.0,14.0,13.0,9.0,15.0,12.0,16.0,16.0,13.0,7.0,11.0,8.0,1.0,2.0,1.0,11.0,12.0,6.0,1.0,3.0,3.0,11.0,5.0,3.0,11.0,8.0,15.0,15.0,13.0,14.0,10.0,11.0,14.0,8.0,13.0,5.0,13.0,10.0,10.0,14.0,16.0,14.0,13.0,20.0,14.0,12.0,5.0,14.0,14.0,15.0,9.0,16.0,6.0,1.0,17.0,11.0,15.0,13.0,14.0,12.0,12.0,4.0,22.0,3.0,0.0,7.0,1.0,182.0,75.0,3.0,3.0,1.0,3.0,2.0,3.0,1.0,1.0,2.0,2.0,1.0,4.0,11.0,10.0,6.0,14.0,7.0,13.0,10.0,9.0,16.0,14.0,8.0,15.0,14.0,13.0,17.0,15.0,16.0,14.0,11.0,14.0,15.0,8.0,11.0,10.0,15.0,16.0,14.0,14.0,14.0,14.0,11.0,20.0,15.0,14.0,10.0,15.0,15.0,15.0,12.0,15.0,8.0,11.0,12.0,14.0,16.0,15.0,14.0,14.0,14.0,5.0,27.0,4.0,0.0,5.0,1.0,184.0,83.0,2.0,4.0,3.0,1.0,1.0,2.0,1.0,2.0,4.0,2.0,3.0,4.0,8.0,11.0,4.0,10.0,4.0,14.0,4.0,4.0,15.0,12.0,5.0,16.0,11.0,14.0,14.0,16.0,14.0,10.0,11.0,12.0,17.0,7.0,10.0,9.0,13.0,14.0,15.0,14.0,13.0,16.0,13.0,10.0,15.0,13.0,20.0,15.0,16.0,12.0,12.0,14.0,6.0,12.0,11.0,13.0,12.0,12.0,16.0,15.0,14.0,6.0,19.0,0.0,0.0,3.0,1.0,181.0,69.0,3.0,2.0,3.0,3.0,2.0,1.0,1.0,1.0,3.0,3.0,4.0,10.0,10.0,12.0,12.0,12.0,7.0,8.0,11.0,5.0,7.0,10.0,10.0,7.0,11.0,8.0,10.0,10.0,12.0,8.0,11.0,8.0,14.0,13.0,6.0,14.0,8.0,13.0,13.0,16.0,14.0,13.0,9.0,20.0,15.0,16.0,10.0,15.0,13.0,12.0,8.0,11.0,7.0,12.0,11.0,11.0,15.0,10.0,12.0,14.0,14.0,1.0,32.0,0.0,0.0,0.0,0.0,172.0,71.0,2.0,1.0,3.0,1.0,2.0,3.0,2.0,3.0,2.0,2.0,2.0,8.0,9.0,7.0,6.0,10.0,6.0,10.0,9.0,10.0,14.0,11.0,6.0,14.0,11.0,10.0,16.0,15.0,12.0,12.0,7.0,12.0,15.0,9.0,13.0,8.0,14.0,15.0,15.0,14.0,14.0,14.0,10.0,20.0,14.0,14.0,8.0,15.0,13.0,13.0,11.0,13.0,7.0,13.0,17.0,14.0,17.0,8.0,13.0,15.0,15.0,6.0,32.0,11.0,1.0,0.0,0.0,176.0,68.0,2.0,1.0,3.0,2.0,2.0,2.0,2.0,3.0,3.0,2.0,2.0,8.0,10.0,10.0,7.0,11.0,8.0,10.0,11.0,12.0,11.0,13.0,12.0,14.0,12.0,9.0,14.0,15.0,13.0,12.0,11.0,12.0,17.0,8.0,14.0,14.0,11.0,18.0,18.0,14.0,14.0,12.0,10.0,10.0,14.0,13.0,20.0,17.0,13.0,15.0,9.0,13.0,8.0,13.0,17.0,13.0,15.0,16.0,16.0,16.0,18.0,5.0,24.0,0.0,0.0,6.0,1.0,172.0,70.0,3.0,1.0,1.0,3.0,1.0,2.0,3.0,1.0,1.0,3.0,3.0,11.0,12.0,11.0,8.0,12.0,10.0,6.0,14.0,7.0,11.0,15.0,8.0,12.0,13.0,14.0,14.0,18.0,13.0,12.0,13.0,13.0,15.0,12.0,12.0,12.0,11.0,18.0,18.0,13.0,14.0,13.0,7.0,10.0,16.0,12.0,20.0,14.0,12.0,14.0,14.0,15.0,4.0,8.0,7.0,14.0,14.0,13.0,14.0,12.0,10.0,6.0,24.0,6.0,1.0,0.0,0.0,183.0,66.0,1.0,1.0,2.0,2.0,1.0,2.0,1.0,2.0,3.0,2.0,1.0,14.0,14.0,14.0,10.0,14.0,14.0,9.0,10.0,8.0,8.0,14.0,10.0,8.0,15.0,9.0,11.0,13.0,11.0,11.0,13.0,10.0,14.0,13.0,5.0,12.0,9.0,14.0,13.0,14.0,16.0,12.0,9.0,20.0,13.0,14.0,5.0,15.0,9.0,12.0,10.0,12.0,8.0,9.0,16.0,9.0,16.0,13.0,11.0,12.0,13.0,9.0,31.0,52.0,8.0,0.0,0.0,167.0,58.0,1.0,2.0,2.0,1.0,3.0,2.0,4.0,2.0,1.0,2.0,3.0,15.0,15.0,14.0,7.0,15.0,15.0,6.0,11.0,3.0,4.0,15.0,14.0,7.0,15.0,13.0,12.0,15.0,13.0,14.0,16.0,11.0,17.0,14.0,11.0,12.0,10.0,12.0,14.0,15.0,18.0,10.0,5.0,10.0,16.0,14.0,20.0,13.0,7.0,14.0,13.0,16.0,8.0,12.0,13.0,16.0,14.0,15.0,13.0,9.0,11.0,14.0,25.0,5.0,0.0,5.0,0.0,186.0,72.0,1.0,2.0,1.0,2.0,2.0,3.0,3.0,3.0,3.0,3.0,2.0,13.0,12.0,14.0,9.0,16.0,15.0,11.0,12.0,5.0,8.0,16.0,11.0,10.0,15.0,8.0,13.0,11.0,14.0,13.0,15.0,14.0,15.0,14.0,11.0,13.0,10.0,12.0,12.0,13.0,14.0,14.0,10.0,10.0,13.0,11.0,20.0,11.0,11.0,13.0,9.0,15.0,13.0,7.0,15.0,17.0,14.0,13.0,15.0,15.0,15.0,7.0,25.0,10.0,1.0,11.0,4.0,175.0,73.0,1.0,3.0,3.0,3.0,3.0,3.0,3.0,1.0,2.0,3.0,1.0,5.0,10.0,15.0,17.0,15.0,10.0,11.0,12.0,5.0,5.0,14.0,15.0,5.0,16.0,8.0,15.0,12.0,15.0,14.0,13.0,15.0,15.0,15.0,14.0,14.0,10.0,10.0,12.0,16.0,16.0,15.0,9.0,10.0,15.0,16.0,20.0,13.0,15.0,14.0,8.0,14.0,7.0,10.0,8.0,16.0,17.0,13.0,15.0,15.0,14.0,5.0
2,1,25.0,4.0,0.0,11.0,0.0,184.0,81.0,14.0,14.0,13.0,9.0,15.0,12.0,16.0,16.0,13.0,7.0,11.0,8.0,1.0,2.0,1.0,11.0,12.0,6.0,1.0,3.0,3.0,11.0,5.0,3.0,11.0,8.0,15.0,15.0,13.0,14.0,10.0,11.0,14.0,8.0,13.0,5.0,13.0,10.0,10.0,14.0,16.0,14.0,13.0,20.0,14.0,12.0,5.0,14.0,14.0,15.0,9.0,16.0,6.0,1.0,17.0,11.0,15.0,13.0,14.0,12.0,12.0,4.0,27.0,4.0,0.0,5.0,1.0,184.0,83.0,2.0,4.0,3.0,1.0,1.0,2.0,1.0,2.0,4.0,2.0,3.0,4.0,8.0,11.0,4.0,10.0,4.0,14.0,4.0,4.0,15.0,12.0,5.0,16.0,11.0,14.0,14.0,16.0,14.0,10.0,11.0,12.0,17.0,7.0,10.0,9.0,13.0,14.0,15.0,14.0,13.0,16.0,13.0,10.0,15.0,13.0,20.0,15.0,16.0,12.0,12.0,14.0,6.0,12.0,11.0,13.0,12.0,12.0,16.0,15.0,14.0,6.0,19.0,0.0,0.0,3.0,1.0,181.0,69.0,3.0,2.0,3.0,3.0,2.0,1.0,1.0,1.0,3.0,3.0,4.0,10.0,10.0,12.0,12.0,12.0,7.0,8.0,11.0,5.0,7.0,10.0,10.0,7.0,11.0,8.0,10.0,10.0,12.0,8.0,11.0,8.0,14.0,13.0,6.0,14.0,8.0,13.0,13.0,16.0,14.0,13.0,9.0,20.0,15.0,16.0,10.0,15.0,13.0,12.0,8.0,11.0,7.0,12.0,11.0,11.0,15.0,10.0,12.0,14.0,14.0,1.0,37.0,0.0,0.0,0.0,0.0,185.0,83.0,1.0,1.0,2.0,1.0,3.0,2.0,3.0,1.0,1.0,3.0,1.0,6.0,8.0,9.0,12.0,10.0,8.0,13.0,9.0,4.0,5.0,10.0,14.0,4.0,11.0,11.0,10.0,11.0,13.0,12.0,12.0,13.0,15.0,14.0,12.0,11.0,7.0,12.0,8.0,7.0,7.0,12.0,12.0,11.0,11.0,7.0,20.0,8.0,14.0,12.0,8.0,13.0,9.0,12.0,12.0,12.0,19.0,14.0,15.0,14.0,8.0,8.0,32.0,0.0,0.0,0.0,0.0,172.0,71.0,2.0,1.0,3.0,1.0,2.0,3.0,2.0,3.0,2.0,2.0,2.0,8.0,9.0,7.0,6.0,10.0,6.0,10.0,9.0,10.0,14.0,11.0,6.0,14.0,11.0,10.0,16.0,15.0,12.0,12.0,7.0,12.0,15.0,9.0,13.0,8.0,14.0,15.0,15.0,14.0,14.0,14.0,10.0,20.0,14.0,14.0,8.0,15.0,13.0,13.0,11.0,13.0,7.0,13.0,17.0,14.0,17.0,8.0,13.0,15.0,15.0,6.0,32.0,52.0,1.0,0.0,0.0,180.0,80.0,2.0,3.0,2.0,2.0,1.0,4.0,1.0,2.0,3.0,4.0,3.0,7.0,12.0,12.0,6.0,12.0,7.0,12.0,11.0,13.0,13.0,11.0,9.0,13.0,12.0,13.0,13.0,15.0,12.0,10.0,11.0,12.0,16.0,12.0,10.0,13.0,11.0,13.0,14.0,15.0,13.0,14.0,10.0,20.0,12.0,14.0,5.0,15.0,14.0,10.0,13.0,12.0,7.0,8.0,12.0,15.0,13.0,12.0,13.0,14.0,14.0,9.0,27.0,8.0,0.0,6.0,0.0,187.0,76.0,3.0,2.0,3.0,2.0,2.0,1.0,1.0,3.0,3.0,1.0,2.0,5.0,7.0,11.0,5.0,14.0,5.0,14.0,9.0,5.0,15.0,15.0,8.0,14.0,13.0,15.0,16.0,15.0,14.0,12.0,14.0,14.0,18.0,8.0,17.0,9.0,12.0,18.0,15.0,13.0,14.0,15.0,14.0,10.0,17.0,12.0,20.0,17.0,15.0,14.0,13.0,16.0,4.0,12.0,10.0,14.0,17.0,12.0,15.0,13.0,13.0,6.0,22.0,0.0,0.0,4.0,0.0,180.0,80.0,4.0,1.0,1.0,3.0,2.0,3.0,1.0,3.0,3.0,3.0,4.0,7.0,10.0,11.0,8.0,15.0,11.0,10.0,14.0,5.0,14.0,15.0,10.0,15.0,15.0,13.0,14.0,13.0,12.0,14.0,15.0,13.0,16.0,12.0,8.0,15.0,13.0,13.0,13.0,13.0,13.0,12.0,10.0,12.0,12.0,12.0,20.0,13.0,12.0,13.0,10.0,12.0,7.0,11.0,12.0,15.0,12.0,16.0,15.0,10.0,10.0,7.0,24.0,0.0,0.0,6.0,1.0,172.0,70.0,3.0,1.0,1.0,3.0,1.0,2.0,3.0,1.0,1.0,3.0,3.0,11.0,12.0,11.0,8.0,12.0,10.0,6.0,14.0,7.0,11.0,15.0,8.0,12.0,13.0,14.0,14.0,18.0,13.0,12.0,13.0,13.0,15.0,12.0,12.0,12.0,11.0,18.0,18.0,13.0,14.0,13.0,7.0,10.0,16.0,12.0,20.0,14.0,12.0,14.0,14.0,15.0,4.0,8.0,7.0,14.0,14.0,13.0,14.0,12.0,10.0,6.0,24.0,6.0,1.0,0.0,0.0,183.0,66.0,1.0,1.0,2.0,2.0,1.0,2.0,1.0,2.0,3.0,2.0,1.0,14.0,14.0,14.0,10.0,14.0,14.0,9.0,10.0,8.0,8.0,14.0,10.0,8.0,15.0,9.0,11.0,13.0,11.0,11.0,13.0,10.0,14.0,13.0,5.0,12.0,9.0,14.0,13.0,14.0,16.0,12.0,9.0,20.0,13.0,14.0,5.0,15.0,9.0,12.0,10.0,12.0,8.0,9.0,16.0,9.0,16.0,13.0,11.0,12.0,13.0,9.0,25.0,10.0,1.0,11.0,4.0,175.0,73.0,1.0,3.0,3.0,3.0,3.0,3.0,3.0,1.0,2.0,3.0,1.0,5.0,10.0,15.0,17.0,15.0,10.0,11.0,12.0,5.0,5.0,14.0,15.0,5.0,16.0,8.0,15.0,12.0,15.0,14.0,13.0,15.0,15.0,15.0,14.0,14.0,10.0,10.0,12.0,16.0,16.0,15.0,9.0,10.0,15.0,16.0,20.0,13.0,15.0,14.0,8.0,14.0,7.0,10.0,8.0,16.0,17.0,13.0,15.0,15.0,14.0,5.0,25.0,0.0,0.0,11.0,0.0,189.0,83.0,12.0,12.0,11.0,7.0,13.0,12.0,17.0,17.0,16.0,12.0,13.0,6.0,2.0,1.0,1.0,10.0,10.0,7.0,1.0,1.0,1.0,9.0,5.0,1.0,10.0,8.0,15.0,14.0,14.0,12.0,7.0,13.0,12.0,6.0,9.0,3.0,16.0,17.0,10.0,13.0,16.0,14.0,12.0,8.0,15.0,10.0,20.0,13.0,14.0,14.0,5.0,14.0,4.0,12.0,15.0,15.0,13.0,13.0,17.0,15.0,17.0,4.0,31.0,0.0,0.0,0.0,0.0,171.0,65.0,1.0,3.0,1.0,3.0,2.0,2.0,3.0,1.0,2.0,2.0,3.0,8.0,9.0,11.0,7.0,5.0,6.0,5.0,6.0,7.0,14.0,14.0,6.0,14.0,13.0,14.0,12.0,13.0,12.0,11.0,11.0,12.0,12.0,11.0,7.0,12.0,12.0,12.0,10.0,15.0,15.0,7.0,9.0,9.0,12.0,14.0,20.0,12.0,13.0,11.0,13.0,11.0,9.0,10.0,15.0,14.0,12.0,11.0,14.0,13.0,12.0,7.0,29.0,56.0,3.0,0.0,0.0,189.0,84.0,3.0,2.0,2.0,1.0,2.0,2.0,2.0,2.0,2.0,1.0,3.0,8.0,9.0,13.0,12.0,13.0,14.0,14.0,12.0,18.0,17.0,12.0,15.0,16.0,13.0,17.0,16.0,16.0,12.0,10.0,10.0,11.0,17.0,12.0,15.0,12.0,11.0,13.0,16.0,17.0,15.0,16.0,16.0,10.0,16.0,15.0,20.0,14.0,13.0,10.0,12.0,13.0,10.0,13.0,15.0,16.0,18.0,13.0,16.0,11.0,10.0,7.0,28.0,0.0,0.0,0.0,0.0,169.0,0.0,3.0,3.0,2.0,3.0,3.0,1.0,1.0,3.0,2.0,1.0,3.0,5.0,8.0,11.0,9.0,8.0,8.0,7.0,8.0,4.0,2.0,9.0,5.0,3.0,11.0,11.0,11.0,13.0,9.0,11.0,8.0,15.0,14.0,11.0,7.0,10.0,8.0,8.0,10.0,11.0,11.0,6.0,5.0,14.0,11.0,12.0,20.0,14.0,5.0,9.0,12.0,9.0,5.0,6.0,9.0,12.0,11.0,9.0,9.0,10.0,12.0,11.0,28.0,46.0,0.0,5.0,0.0,183.0,69.0,1.0,1.0,1.0,1.0,1.0,1.0,3.0,3.0,2.0,1.0,3.0,10.0,14.0,14.0,7.0,14.0,5.0,11.0,11.0,12.0,13.0,14.0,6.0,14.0,15.0,15.0,12.0,13.0,12.0,13.0,14.0,12.0,5.0,11.0,8.0,14.0,10.0,13.0,13.0,15.0,14.0,13.0,11.0,9.0,15.0,14.0,20.0,15.0,12.0,13.0,10.0,15.0,9.0,12.0,9.0,4.0,13.0,15.0,5.0,13.0,12.0,7.0,25.0,0.0,0.0,14.0,0.0,180.0,82.0,1.0,3.0,3.0,1.0,3.0,2.0,3.0,1.0,1.0,3.0,1.0,5.0,10.0,10.0,7.0,13.0,7.0,12.0,8.0,10.0,14.0,12.0,8.0,17.0,13.0,13.0,16.0,16.0,14.0,15.0,10.0,12.0,15.0,8.0,13.0,10.0,14.0,18.0,15.0,10.0,12.0,16.0,11.0,10.0,15.0,12.0,20.0,16.0,15.0,17.0,10.0,16.0,6.0,10.0,12.0,16.0,12.0,13.0,17.0,14.0,14.0,5.0,33.0,30.0,1.0,0.0,0.0,187.0,83.0,1.0,3.0,4.0,2.0,1.0,1.0,2.0,3.0,1.0,1.0,3.0,13.0,13.0,12.0,8.0,16.0,10.0,16.0,13.0,10.0,14.0,16.0,13.0,16.0,15.0,13.0,15.0,14.0,16.0,15.0,14.0,14.0,13.0,11.0,13.0,10.0,17.0,18.0,10.0,10.0,12.0,17.0,14.0,20.0,12.0,12.0,10.0,13.0,16.0,16.0,16.0,15.0,13.0,11.0,16.0,16.0,13.0,15.0,12.0,8.0,8.0,11.0,21.0,0.0,0.0,15.0,1.0,189.0,75.0,3.0,3.0,3.0,3.0,1.0,1.0,3.0,3.0,3.0,2.0,3.0,10.0,12.0,13.0,7.0,14.0,8.0,14.0,12.0,5.0,13.0,15.0,8.0,15.0,14.0,14.0,14.0,15.0,14.0,14.0,13.0,14.0,15.0,12.0,10.0,12.0,14.0,15.0,16.0,12.0,13.0,15.0,14.0,20.0,14.0,13.0,10.0,16.0,13.0,14.0,11.0,14.0,7.0,10.0,8.0,16.0,10.0,12.0,13.0,13.0,11.0,14.0,16.0,0.0,0.0,0.0,0.0,173.0,0.0,3.0,1.0,1.0,1.0,2.0,1.0,4.0,1.0,2.0,3.0,1.0,1.0,1.0,4.0,4.0,5.0,4.0,4.0,4.0,1.0,5.0,6.0,5.0,8.0,9.0,10.0,6.0,6.0,3.0,5.0,4.0,10.0,7.0,8.0,8.0,3.0,11.0,13.0,9.0,7.0,5.0,14.0,4.0,20.0,6.0,5.0,8.0,6.0,9.0,5.0,7.0,8.0,5.0,7.0,6.0,11.0,7.0,10.0,18.0,19.0,15.0,9.0,29.0,76.0,27.0,13.0,9.0,188.0,72.0,2.0,3.0,1.0,2.0,3.0,3.0,1.0,3.0,3.0,3.0,3.0,5.0,10.0,13.0,16.0,13.0,11.0,17.0,13.0,5.0,10.0,13.0,14.0,10.0,13.0,15.0,16.0,18.0,14.0,15.0,10.0,13.0,14.0,13.0,10.0,18.0,12.0,14.0,19.0,15.0,14.0,16.0,14.0,10.0,18.0,16.0,20.0,18.0,14.0,14.0,8.0,15.0,5.0,16.0,10.0,16.0,12.0,14.0,16.0,14.0,10.0,10.0,34.0,116.0,62.0,7.0,6.0,195.0,95.0,1.0,1.0,3.0,1.0,1.0,3.0,4.0,1.0,2.0,3.0,2.0,5.0,12.0,15.0,16.0,18.0,14.0,14.0,16.0,8.0,6.0,15.0,18.0,6.0,18.0,16.0,16.0,15.0,13.0,13.0,16.0,14.0,14.0,19.0,16.0,15.0,4.0,13.0,8.0,12.0,15.0,20.0,18.0,16.0,16.0,14.0,20.0,15.0,18.0,16.0,13.0,11.0,11.0,8.0,15.0,20.0,11.0,15.0,14.0,7.0,7.0,13.0
0,0,30.0,0.0,0.0,0.0,0.0,180.0,75.0,11.0,13.0,13.0,9.0,13.0,11.0,12.0,15.0,15.0,14.0,13.0,6.0,1.0,2.0,3.0,7.0,8.0,1.0,1.0,1.0,2.0,7.0,2.0,1.0,7.0,8.0,12.0,14.0,13.0,14.0,7.0,12.0,14.0,5.0,12.0,3.0,13.0,15.0,9.0,13.0,14.0,13.0,10.0,5.0,14.0,11.0,20.0,12.0,13.0,12.0,8.0,14.0,6.0,1.0,9.0,13.0,14.0,13.0,16.0,15.0,15.0,5.0,35.0,21.0,0.0,0.0,0.0,185.0,80.0,2.0,2.0,3.0,4.0,2.0,2.0,3.0,1.0,1.0,1.0,1.0,5.0,10.0,7.0,8.0,11.0,5.0,15.0,9.0,9.0,14.0,11.0,12.0,15.0,10.0,16.0,14.0,15.0,15.0,11.0,8.0,13.0,15.0,7.0,14.0,8.0,14.0,14.0,14.0,10.0,10.0,15.0,13.0,9.0,13.0,11.0,20.0,13.0,14.0,13.0,11.0,12.0,8.0,7.0,10.0,14.0,10.0,15.0,12.0,13.0,14.0,13.0,25.0,0.0,0.0,3.0,0.0,184.0,80.0,2.0,2.0,4.0,2.0,1.0,3.0,2.0,1.0,1.0,2.0,1.0,5.0,8.0,7.0,6.0,9.0,6.0,14.0,6.0,6.0,14.0,7.0,6.0,13.0,9.0,12.0,14.0,13.0,11.0,13.0,7.0,12.0,14.0,8.0,10.0,7.0,14.0,13.0,14.0,15.0,12.0,14.0,12.0,8.0,15.0,15.0,20.0,14.0,14.0,13.0,12.0,14.0,5.0,10.0,16.0,13.0,15.0,15.0,12.0,14.0,14.0,8.0,21.0,0.0,0.0,0.0,0.0,182.0,74.0,2.0,2.0,2.0,2.0,2.0,1.0,1.0,1.0,3.0,2.0,2.0,9.0,11.0,12.0,7.0,9.0,8.0,12.0,7.0,11.0,12.0,7.0,8.0,13.0,11.0,12.0,12.0,14.0,12.0,13.0,7.0,12.0,11.0,1.0,9.0,11.0,9.0,10.0,12.0,14.0,10.0,13.0,11.0,9.0,8.0,12.0,20.0,13.0,11.0,10.0,13.0,8.0,10.0,10.0,15.0,11.0,13.0,10.0,10.0,8.0,13.0,7.0,29.0,0.0,0.0,0.0,0.0,170.0,66.0,1.0,1.0,1.0,1.0,4.0,3.0,1.0,2.0,3.0,1.0,1.0,11.0,13.0,12.0,7.0,12.0,10.0,7.0,12.0,9.0,13.0,12.0,8.0,12.0,13.0,14.0,11.0,15.0,12.0,14.0,10.0,12.0,14.0,12.0,10.0,13.0,8.0,13.0,15.0,14.0,13.0,10.0,7.0,20.0,15.0,13.0,10.0,15.0,7.0,14.0,14.0,14.0,6.0,16.0,9.0,13.0,14.0,14.0,16.0,11.0,9.0,9.0,31.0,0.0,0.0,0.0,0.0,178.0,70.0,3.0,1.0,3.0,3.0,2.0,2.0,2.0,1.0,2.0,1.0,2.0,5.0,8.0,7.0,7.0,12.0,5.0,8.0,8.0,7.0,14.0,13.0,8.0,13.0,12.0,15.0,14.0,17.0,12.0,13.0,9.0,13.0,16.0,10.0,15.0,8.0,13.0,18.0,15.0,13.0,14.0,12.0,9.0,10.0,15.0,13.0,20.0,16.0,13.0,14.0,12.0,14.0,5.0,16.0,13.0,12.0,16.0,13.0,13.0,13.0,13.0,6.0,32.0,25.0,0.0,0.0,0.0,181.0,82.0,2.0,3.0,3.0,1.0,1.0,1.0,1.0,3.0,1.0,2.0,3.0,5.0,10.0,6.0,7.0,10.0,7.0,14.0,9.0,8.0,11.0,12.0,7.0,13.0,10.0,15.0,14.0,16.0,11.0,13.0,10.0,12.0,16.0,9.0,15.0,8.0,11.0,16.0,18.0,11.0,12.0,14.0,11.0,8.0,13.0,11.0,20.0,17.0,15.0,13.0,15.0,11.0,6.0,14.0,18.0,12.0,13.0,13.0,14.0,11.0,11.0,8.0,34.0,0.0,0.0,0.0,0.0,176.0,65.0,2.0,3.0,3.0,3.0,2.0,2.0,1.0,2.0,1.0,1.0,2.0,14.0,15.0,13.0,10.0,15.0,13.0,6.0,15.0,10.0,3.0,14.0,13.0,6.0,14.0,8.0,12.0,9.0,13.0,12.0,14.0,13.0,11.0,12.0,7.0,13.0,8.0,14.0,15.0,14.0,13.0,12.0,8.0,20.0,14.0,13.0,10.0,12.0,7.0,13.0,8.0,15.0,7.0,6.0,13.0,14.0,14.0,9.0,14.0,14.0,11.0,10.0,20.0,7.0,1.0,0.0,0.0,182.0,75.0,2.0,1.0,3.0,2.0,2.0,1.0,3.0,1.0,3.0,2.0,1.0,11.0,11.0,13.0,12.0,13.0,11.0,12.0,10.0,5.0,4.0,12.0,8.0,5.0,13.0,11.0,12.0,11.0,11.0,8.0,10.0,10.0,3.0,10.0,1.0,13.0,8.0,12.0,12.0,15.0,14.0,13.0,11.0,6.0,14.0,13.0,20.0,12.0,13.0,12.0,9.0,11.0,9.0,11.0,9.0,9.0,9.0,12.0,11.0,9.0,17.0,7.0,25.0,0.0,0.0,0.0,0.0,183.0,77.0,3.0,1.0,1.0,4.0,1.0,2.0,1.0,2.0,2.0,3.0,1.0,6.0,10.0,12.0,12.0,11.0,6.0,11.0,7.0,1.0,5.0,2.0,4.0,4.0,12.0,7.0,11.0,4.0,11.0,7.0,3.0,12.0,10.0,16.0,13.0,11.0,7.0,7.0,8.0,13.0,9.0,7.0,10.0,10.0,11.0,12.0,20.0,12.0,12.0,9.0,10.0,4.0,10.0,9.0,13.0,9.0,11.0,11.0,14.0,7.0,7.0,3.0,27.0,27.0,5.0,0.0,0.0,174.0,68.0,1.0,3.0,3.0,2.0,3.0,2.0,1.0,3.0,3.0,1.0,2.0,11.0,10.0,15.0,12.0,14.0,13.0,7.0,13.0,6.0,4.0,12.0,11.0,7.0,15.0,9.0,13.0,12.0,11.0,12.0,12.0,10.0,14.0,13.0,6.0,14.0,7.0,8.0,10.0,16.0,14.0,12.0,9.0,10.0,13.0,15.0,20.0,14.0,11.0,13.0,9.0,14.0,10.0,15.0,14.0,14.0,13.0,11.0,12.0,14.0,14.0,8.0,25.0,0.0,0.0,0.0,0.0,187.0,83.0,11.0,14.0,12.0,8.0,13.0,11.0,14.0,15.0,13.0,13.0,9.0,8.0,1.0,1.0,1.0,11.0,11.0,1.0,2.0,2.0,1.0,10.0,3.0,2.0,11.0,8.0,12.0,14.0,12.0,12.0,10.0,12.0,14.0,6.0,14.0,2.0,12.0,12.0,8.0,13.0,15.0,14.0,13.0,20.0,15.0,11.0,5.0,14.0,13.0,13.0,8.0,8.0,10.0,1.0,9.0,13.0,14.0,12.0,15.0,15.0,15.0,5.0,24.0,8.0,0.0,0.0,0.0,186.0,81.0,1.0,1.0,1.0,3.0,3.0,1.0,1.0,1.0,2.0,1.0,2.0,4.0,8.0,7.0,5.0,9.0,5.0,14.0,8.0,7.0,12.0,8.0,6.0,12.0,9.0,13.0,12.0,14.0,12.0,11.0,9.0,12.0,14.0,1.0,11.0,7.0,13.0,14.0,14.0,12.0,8.0,15.0,14.0,5.0,13.0,14.0,20.0,13.0,15.0,13.0,13.0,8.0,13.0,8.0,7.0,11.0,14.0,10.0,14.0,14.0,14.0,6.0,26.0,11.0,0.0,4.0,0.0,183.0,79.0,3.0,2.0,1.0,2.0,2.0,2.0,3.0,2.0,2.0,2.0,1.0,5.0,7.0,9.0,6.0,10.0,11.0,15.0,11.0,7.0,14.0,10.0,7.0,13.0,10.0,14.0,13.0,15.0,13.0,12.0,10.0,12.0,17.0,8.0,11.0,10.0,13.0,15.0,16.0,13.0,13.0,16.0,13.0,5.0,15.0,13.0,20.0,16.0,15.0,13.0,14.0,15.0,7.0,14.0,16.0,12.0,14.0,14.0,15.0,14.0,14.0,5.0,26.0,0.0,0.0,0.0,0.0,177.0,68.0,4.0,2.0,1.0,2.0,3.0,1.0,1.0,2.0,3.0,3.0,3.0,12.0,13.0,11.0,8.0,13.0,11.0,8.0,10.0,8.0,10.0,13.0,10.0,12.0,13.0,7.0,12.0,10.0,13.0,11.0,15.0,13.0,14.0,11.0,7.0,14.0,10.0,14.0,14.0,13.0,15.0,12.0,9.0,20.0,15.0,14.0,5.0,15.0,8.0,13.0,7.0,14.0,6.0,12.0,11.0,12.0,14.0,13.0,16.0,16.0,16.0,5.0,26.0,14.0,0.0,0.0,0.0,181.0,74.0,2.0,1.0,1.0,1.0,3.0,2.0,3.0,1.0,3.0,3.0,2.0,6.0,13.0,8.0,5.0,12.0,7.0,12.0,8.0,11.0,13.0,12.0,6.0,14.0,10.0,14.0,12.0,14.0,10.0,12.0,8.0,8.0,14.0,6.0,6.0,12.0,11.0,14.0,15.0,16.0,14.0,14.0,11.0,5.0,14.0,14.0,20.0,16.0,14.0,12.0,13.0,14.0,8.0,10.0,8.0,14.0,12.0,13.0,15.0,15.0,15.0,6.0,22.0,0.0,0.0,0.0,0.0,179.0,75.0,1.0,3.0,1.0,3.0,3.0,2.0,1.0,4.0,3.0,2.0,2.0,9.0,12.0,11.0,7.0,13.0,12.0,8.0,11.0,5.0,11.0,13.0,11.0,9.0,12.0,12.0,14.0,13.0,12.0,11.0,11.0,12.0,14.0,9.0,8.0,10.0,13.0,15.0,14.0,13.0,13.0,13.0,9.0,8.0,14.0,12.0,20.0,14.0,12.0,12.0,12.0,15.0,10.0,10.0,9.0,14.0,14.0,13.0,16.0,13.0,14.0,6.0,29.0,0.0,0.0,0.0,0.0,188.0,74.0,1.0,2.0,3.0,3.0,2.0,3.0,1.0,3.0,2.0,1.0,1.0,4.0,8.0,10.0,6.0,13.0,7.0,14.0,9.0,6.0,13.0,12.0,8.0,13.0,13.0,12.0,14.0,13.0,14.0,11.0,13.0,12.0,14.0,6.0,13.0,8.0,14.0,15.0,15.0,9.0,12.0,14.0,14.0,10.0,13.0,10.0,20.0,16.0,12.0,13.0,12.0,15.0,9.0,11.0,11.0,14.0,14.0,12.0,15.0,13.0,13.0,6.0,22.0,18.0,0.0,0.0,0.0,179.0,75.0,1.0,4.0,2.0,1.0,1.0,1.0,3.0,1.0,1.0,3.0,2.0,7.0,8.0,12.0,8.0,13.0,10.0,11.0,12.0,11.0,11.0,11.0,10.0,14.0,13.0,15.0,12.0,15.0,8.0,12.0,10.0,12.0,14.0,12.0,10.0,13.0,12.0,13.0,17.0,14.0,14.0,13.0,10.0,9.0,15.0,15.0,20.0,15.0,14.0,13.0,13.0,12.0,11.0,12.0,13.0,15.0,9.0,10.0,12.0,10.0,10.0,4.0,22.0,0.0,0.0,0.0,0.0,164.0,65.0,1.0,2.0,3.0,1.0,2.0,2.0,3.0,2.0,2.0,1.0,2.0,10.0,12.0,13.0,11.0,13.0,10.0,5.0,10.0,7.0,5.0,12.0,10.0,3.0,13.0,7.0,11.0,11.0,11.0,13.0,13.0,11.0,13.0,13.0,6.0,14.0,7.0,12.0,12.0,15.0,15.0,8.0,2.0,9.0,13.0,14.0,20.0,13.0,8.0,13.0,7.0,10.0,8.0,12.0,10.0,12.0,11.0,12.0,11.0,10.0,10.0,8.0,28.0,0.0,0.0,0.0,0.0,170.0,67.0,2.0,3.0,3.0,4.0,3.0,2.0,1.0,1.0,2.0,2.0,3.0,8.0,12.0,12.0,10.0,14.0,7.0,5.0,10.0,6.0,5.0,12.0,5.0,4.0,13.0,7.0,16.0,12.0,9.0,11.0,12.0,10.0,3.0,12.0,6.0,13.0,6.0,8.0,13.0,16.0,13.0,10.0,5.0,5.0,13.0,16.0,20.0,15.0,7.0,12.0,4.0,9.0,7.0,10.0,20.0,13.0,12.0,10.0,13.0,11.0,10.0,2.0,24.0,24.0,4.0,0.0,0.0,172.0,74.0,2.0,4.0,3.0,2.0,2.0,1.0,2.0,2.0,3.0,2.0,4.0,8.0,9.0,14.0,13.0,14.0,9.0,11.0,10.0,7.0,5.0,12.0,12.0,3.0,13.0,10.0,12.0,12.0,13.0,12.0,11.0,10.0,14.0,13.0,7.0,14.0,9.0,9.0,13.0,16.0,15.0,13.0,6.0,8.0,13.0,16.0,20.0,14.0,12.0,11.0,11.0,13.0,9.0,8.0,9.0,13.0,9.0,11.0,12.0,13.0,10.0,9.0
4,0,17.0,0.0,0.0,0.0,0.0,193.0,82.0,13.0,11.0,12.0,2.0,12.0,10.0,14.0,15.0,14.0,12.0,10.0,3.0,1.0,1.0,3.0,5.0,6.0,2.0,2.0,1.0,3.0,9.0,3.0,1.0,8.0,7.0,12.0,13.0,13.0,13.0,11.0,11.0,15.0,3.0,8.0,3.0,12.0,12.0,11.0,10.0,12.0,14.0,17.0,5.0,15.0,11.0,20.0,13.0,12.0,13.0,8.0,11.0,5.0,11.0,13.0,15.0,15.0,17.0,14.0,15.0,15.0,5.0,19.0,0.0,0.0,0.0,0.0,194.0,92.0,2.0,1.0,3.0,3.0,3.0,3.0,1.0,3.0,3.0,2.0,1.0,3.0,3.0,5.0,6.0,10.0,5.0,16.0,10.0,8.0,12.0,9.0,4.0,15.0,11.0,14.0,11.0,12.0,10.0,11.0,10.0,12.0,15.0,3.0,13.0,13.0,12.0,14.0,14.0,11.0,8.0,15.0,17.0,5.0,16.0,12.0,20.0,12.0,16.0,12.0,13.0,12.0,5.0,7.0,10.0,14.0,13.0,8.0,10.0,11.0,18.0,6.0,26.0,4.0,0.0,2.0,0.0,180.0,74.0,3.0,3.0,1.0,2.0,2.0,1.0,3.0,4.0,1.0,2.0,1.0,8.0,13.0,13.0,6.0,13.0,9.0,12.0,7.0,11.0,13.0,13.0,11.0,12.0,12.0,16.0,14.0,14.0,9.0,12.0,11.0,13.0,4.0,4.0,6.0,11.0,12.0,8.0,12.0,14.0,14.0,13.0,9.0,20.0,16.0,13.0,5.0,15.0,13.0,12.0,6.0,9.0,10.0,12.0,8.0,14.0,8.0,11.0,12.0,11.0,13.0,2.0,23.0,1.0,0.0,4.0,0.0,190.0,80.0,1.0,4.0,1.0,3.0,3.0,1.0,1.0,1.0,2.0,4.0,2.0,6.0,11.0,13.0,7.0,13.0,6.0,11.0,8.0,10.0,15.0,12.0,5.0,15.0,12.0,14.0,14.0,16.0,9.0,11.0,10.0,10.0,16.0,12.0,12.0,9.0,12.0,10.0,14.0,14.0,12.0,15.0,17.0,8.0,15.0,16.0,20.0,13.0,14.0,13.0,8.0,13.0,6.0,14.0,11.0,14.0,12.0,13.0,16.0,14.0,12.0,6.0,19.0,0.0,0.0,0.0,0.0,184.0,78.0,3.0,1.0,2.0,1.0,2.0,2.0,2.0,3.0,3.0,4.0,2.0,6.0,8.0,9.0,5.0,13.0,6.0,11.0,8.0,5.0,13.0,13.0,8.0,12.0,13.0,13.0,13.0,15.0,12.0,12.0,13.0,12.0,14.0,7.0,11.0,8.0,15.0,14.0,15.0,13.0,12.0,14.0,11.0,5.0,15.0,12.0,20.0,16.0,14.0,13.0,12.0,11.0,7.0,10.0,19.0,13.0,15.0,12.0,14.0,13.0,12.0,6.0,26.0,17.0,0.0,19.0,1.0,191.0,79.0,3.0,2.0,1.0,1.0,1.0,1.0,2.0,2.0,3.0,3.0,4.0,4.0,8.0,11.0,9.0,12.0,7.0,14.0,10.0,6.0,12.0,13.0,7.0,11.0,12.0,14.0,13.0,14.0,12.0,10.0,11.0,12.0,15.0,9.0,7.0,11.0,12.0,12.0,15.0,14.0,13.0,16.0,15.0,8.0,15.0,13.0,20.0,19.0,15.0,11.0,14.0,14.0,7.0,12.0,12.0,14.0,12.0,10.0,9.0,14.0,14.0,14.0,32.0,0.0,0.0,13.0,0.0,175.0,65.0,2.0,1.0,1.0,2.0,3.0,3.0,1.0,2.0,3.0,2.0,3.0,15.0,13.0,11.0,6.0,14.0,13.0,10.0,12.0,8.0,8.0,16.0,8.0,12.0,13.0,11.0,14.0,15.0,14.0,15.0,14.0,14.0,14.0,6.0,13.0,9.0,15.0,18.0,13.0,12.0,13.0,13.0,8.0,8.0,13.0,10.0,20.0,13.0,13.0,12.0,11.0,15.0,12.0,10.0,17.0,14.0,15.0,14.0,16.0,14.0,14.0,6.0,23.0,11.0,0.0,0.0,0.0,180.0,71.0,2.0,1.0,2.0,3.0,3.0,1.0,1.0,2.0,2.0,1.0,1.0,6.0,11.0,10.0,8.0,10.0,7.0,11.0,9.0,12.0,13.0,11.0,6.0,13.0,11.0,12.0,11.0,13.0,12.0,9.0,11.0,11.0,14.0,12.0,11.0,12.0,11.0,13.0,15.0,15.0,13.0,13.0,11.0,7.0,14.0,15.0,20.0,12.0,11.0,12.0,12.0,13.0,10.0,15.0,10.0,13.0,16.0,12.0,15.0,14.0,14.0,7.0,24.0,1.0,0.0,0.0,0.0,168.0,66.0,2.0,3.0,1.0,1.0,2.0,1.0,3.0,1.0,1.0,1.0,2.0,10.0,15.0,15.0,6.0,14.0,12.0,5.0,12.0,5.0,5.0,14.0,8.0,3.0,15.0,7.0,9.0,8.0,12.0,12.0,13.0,12.0,15.0,16.0,5.0,15.0,5.0,9.0,13.0,16.0,17.0,9.0,5.0,8.0,14.0,12.0,20.0,11.0,5.0,12.0,7.0,14.0,7.0,11.0,17.0,14.0,14.0,11.0,11.0,14.0,14.0,7.0,25.0,0.0,0.0,3.0,0.0,170.0,68.0,2.0,1.0,3.0,1.0,3.0,1.0,3.0,2.0,2.0,4.0,1.0,12.0,11.0,15.0,16.0,16.0,13.0,11.0,12.0,4.0,5.0,12.0,14.0,4.0,17.0,7.0,14.0,7.0,15.0,13.0,13.0,14.0,14.0,15.0,7.0,16.0,8.0,10.0,13.0,15.0,15.0,12.0,6.0,11.0,14.0,14.0,20.0,13.0,11.0,12.0,7.0,15.0,7.0,8.0,12.0,14.0,13.0,14.0,13.0,16.0,16.0,8.0,25.0,14.0,1.0,2.0,0.0,177.0,77.0,3.0,3.0,1.0,2.0,3.0,3.0,1.0,3.0,3.0,4.0,1.0,8.0,11.0,13.0,12.0,12.0,10.0,11.0,10.0,2.0,3.0,11.0,10.0,5.0,13.0,12.0,12.0,13.0,11.0,10.0,11.0,10.0,14.0,16.0,14.0,15.0,5.0,13.0,14.0,15.0,14.0,12.0,12.0,12.0,14.0,16.0,20.0,13.0,14.0,13.0,7.0,14.0,11.0,13.0,14.0,11.0,12.0,8.0,12.0,13.0,15.0,6.0,19.0,0.0,0.0,0.0,0.0,190.0,78.0,13.0,12.0,11.0,14.0,13.0,6.0,11.0,13.0,13.0,12.0,7.0,3.0,3.0,1.0,3.0,8.0,8.0,3.0,1.0,2.0,3.0,7.0,3.0,1.0,7.0,8.0,13.0,13.0,12.0,13.0,7.0,11.0,11.0,3.0,14.0,2.0,11.0,11.0,10.0,12.0,13.0,11.0,15.0,20.0,10.0,13.0,5.0,13.0,13.0,9.0,10.0,6.0,10.0,10.0,10.0,12.0,11.0,14.0,14.0,12.0,13.0,3.0,29.0,35.0,0.0,0.0,0.0,192.0,77.0,1.0,3.0,2.0,2.0,2.0,2.0,2.0,3.0,1.0,3.0,3.0,5.0,8.0,8.0,7.0,9.0,6.0,11.0,9.0,12.0,14.0,10.0,7.0,15.0,10.0,14.0,13.0,17.0,9.0,13.0,10.0,11.0,13.0,7.0,14.0,8.0,12.0,10.0,13.0,13.0,11.0,17.0,18.0,6.0,12.0,15.0,20.0,13.0,16.0,13.0,14.0,16.0,14.0,12.0,9.0,12.0,15.0,10.0,10.0,11.0,8.0,15.0,34.0,0.0,0.0,0.0,0.0,191.0,81.0,14.0,10.0,8.0,3.0,9.0,14.0,13.0,10.0,9.0,3.0,12.0,4.0,3.0,3.0,1.0,1.0,6.0,1.0,1.0,2.0,1.0,2.0,3.0,3.0,3.0,8.0,6.0,10.0,8.0,9.0,5.0,10.0,2.0,1.0,10.0,2.0,10.0,8.0,7.0,10.0,8.0,8.0,16.0,9.0,14.0,9.0,20.0,3.0,9.0,9.0,9.0,1.0,9.0,9.0,20.0,9.0,13.0,12.0,10.0,10.0,12.0,7.0,23.0,0.0,0.0,0.0,0.0,179.0,71.0,2.0,1.0,3.0,3.0,2.0,3.0,2.0,2.0,1.0,3.0,1.0,8.0,10.0,12.0,6.0,12.0,10.0,5.0,10.0,13.0,11.0,11.0,6.0,12.0,11.0,9.0,11.0,12.0,12.0,7.0,10.0,9.0,15.0,12.0,5.0,13.0,8.0,12.0,14.0,16.0,13.0,13.0,10.0,20.0,16.0,15.0,8.0,14.0,14.0,13.0,9.0,14.0,7.0,10.0,7.0,14.0,14.0,13.0,15.0,13.0,13.0,5.0,21.0,0.0,0.0,1.0,0.0,177.0,68.0,4.0,1.0,2.0,1.0,1.0,1.0,1.0,1.0,2.0,1.0,2.0,5.0,12.0,9.0,7.0,12.0,8.0,13.0,10.0,16.0,13.0,12.0,8.0,14.0,12.0,12.0,13.0,12.0,12.0,12.0,10.0,13.0,15.0,11.0,13.0,11.0,13.0,13.0,14.0,13.0,14.0,13.0,11.0,10.0,14.0,12.0,20.0,12.0,14.0,12.0,11.0,12.0,8.0,14.0,13.0,10.0,14.0,12.0,14.0,12.0,11.0,5.0,20.0,0.0,0.0,18.0,3.0,174.0,71.0,1.0,2.0,3.0,1.0,3.0,2.0,2.0,1.0,4.0,2.0,3.0,8.0,10.0,12.0,10.0,13.0,11.0,8.0,11.0,4.0,11.0,13.0,6.0,8.0,13.0,13.0,11.0,13.0,12.0,13.0,12.0,12.0,13.0,11.0,8.0,11.0,11.0,15.0,13.0,11.0,11.0,12.0,6.0,10.0,12.0,11.0,20.0,13.0,11.0,11.0,11.0,12.0,10.0,12.0,8.0,10.0,10.0,9.0,14.0,13.0,8.0,8.0,28.0,1.0,0.0,7.0,0.0,181.0,71.0,2.0,2.0,1.0,3.0,1.0,3.0,3.0,2.0,3.0,3.0,3.0,12.0,11.0,10.0,5.0,13.0,11.0,8.0,10.0,8.0,9.0,14.0,11.0,12.0,13.0,14.0,14.0,12.0,12.0,13.0,12.0,13.0,12.0,8.0,9.0,9.0,12.0,17.0,15.0,11.0,13.0,14.0,10.0,12.0,13.0,12.0,20.0,16.0,12.0,13.0,14.0,16.0,12.0,9.0,10.0,14.0,16.0,14.0,13.0,12.0,12.0,14.0,23.0,39.0,1.0,5.0,2.0,174.0,73.0,3.0,4.0,2.0,1.0,1.0,2.0,4.0,1.0,3.0,2.0,4.0,7.0,6.0,10.0,5.0,11.0,7.0,6.0,8.0,5.0,11.0,12.0,6.0,13.0,11.0,15.0,9.0,16.0,8.0,12.0,10.0,10.0,14.0,10.0,6.0,12.0,11.0,16.0,20.0,15.0,16.0,15.0,9.0,6.0,13.0,14.0,20.0,16.0,14.0,9.0,13.0,13.0,7.0,14.0,14.0,12.0,13.0,12.0,14.0,12.0,14.0,3.0,19.0,0.0,0.0,11.0,1.0,171.0,65.0,2.0,2.0,2.0,2.0,2.0,3.0,3.0,3.0,1.0,1.0,3.0,14.0,13.0,13.0,11.0,14.0,15.0,8.0,12.0,6.0,4.0,13.0,12.0,4.0,15.0,8.0,12.0,10.0,12.0,8.0,13.0,13.0,14.0,15.0,8.0,14.0,6.0,13.0,12.0,15.0,16.0,10.0,7.0,20.0,13.0,15.0,10.0,12.0,7.0,11.0,6.0,11.0,8.0,11.0,12.0,13.0,11.0,12.0,12.0,6.0,12.0,5.0,28.0,37.0,15.0,1.0,0.0,194.0,88.0,2.0,1.0,2.0,1.0,1.0,2.0,3.0,1.0,3.0,2.0,2.0,4.0,6.0,12.0,15.0,12.0,7.0,16.0,11.0,3.0,6.0,10.0,14.0,4.0,11.0,10.0,14.0,15.0,13.0,10.0,8.0,9.0,13.0,12.0,6.0,14.0,8.0,11.0,16.0,13.0,12.0,18.0,17.0,9.0,12.0,12.0,20.0,14.0,18.0,13.0,10.0,15.0,15.0,6.0,20.0,17.0,12.0,15.0,14.0,11.0,14.0,7.0,19.0,0.0,0.0,0.0,0.0,172.0,64.0,1.0,3.0,2.0,2.0,4.0,2.0,1.0,2.0,3.0,3.0,1.0,13.0,13.0,15.0,12.0,15.0,12.0,6.0,12.0,3.0,2.0,13.0,11.0,3.0,16.0,8.0,10.0,9.0,12.0,9.0,13.0,10.0,12.0,15.0,8.0,13.0,4.0,5.0,7.0,17.0,16.0,14.0,5.0,20.0,11.0,15.0,12.0,10.0,8.0,8.0,10.0,14.0,8.0,10.0,17.0,14.0,9.0,10.0,9.0,4.0,10.0,10.0
2,2,28.0,0.0,0.0,0.0,0.0,188.0,86.0,14.0,13.0,15.0,8.0,14.0,11.0,14.0,16.0,13.0,12.0,8.0,6.0,2.0,1.0,3.0,8.0,8.0,1.0,1.0,3.0,1.0,8.0,4.0,1.0,8.0,8.0,13.0,13.0,14.0,14.0,11.0,12.0,15.0,7.0,10.0,2.0,14.0,12.0,11.0,13.0,14.0,16.0,13.0,5.0,16.0,12.0,20.0,14.0,15.0,14.0,8.0,15.0,5.0,1.0,11.0,15.0,14.0,14.0,16.0,14.0,11.0,6.0,26.0,0.0,0.0,0.0,0.0,183.0,79.0,1.0,1.0,3.0,4.0,3.0,2.0,2.0,1.0,2.0,1.0,1.0,9.0,8.0,12.0,11.0,10.0,11.0,10.0,9.0,7.0,6.0,8.0,9.0,5.0,12.0,10.0,9.0,8.0,11.0,11.0,9.0,8.0,11.0,14.0,6.0,12.0,8.0,10.0,11.0,11.0,12.0,11.0,10.0,10.0,10.0,12.0,20.0,11.0,11.0,9.0,9.0,9.0,6.0,13.0,17.0,11.0,10.0,11.0,12.0,10.0,10.0,4.0,35.0,0.0,0.0,9.0,0.0,182.0,82.0,1.0,1.0,1.0,3.0,1.0,1.0,3.0,3.0,1.0,2.0,3.0,9.0,12.0,9.0,7.0,11.0,13.0,15.0,13.0,12.0,13.0,11.0,12.0,15.0,11.0,12.0,15.0,16.0,13.0,13.0,9.0,13.0,14.0,6.0,14.0,7.0,15.0,17.0,10.0,7.0,11.0,15.0,12.0,20.0,14.0,8.0,8.0,12.0,14.0,14.0,12.0,14.0,6.0,12.0,13.0,14.0,16.0,12.0,16.0,14.0,13.0,7.0,24.0,9.0,0.0,0.0,0.0,176.0,71.0,3.0,1.0,1.0,2.0,3.0,1.0,1.0,1.0,3.0,1.0,4.0,5.0,12.0,10.0,6.0,11.0,5.0,6.0,9.0,11.0,8.0,9.0,6.0,11.0,12.0,12.0,11.0,11.0,9.0,10.0,8.0,10.0,14.0,9.0,8.0,12.0,10.0,12.0,13.0,16.0,13.0,12.0,8.0,10.0,16.0,14.0,20.0,15.0,10.0,13.0,12.0,10.0,5.0,15.0,9.0,13.0,13.0,10.0,12.0,14.0,14.0,7.0,29.0,0.0,0.0,4.0,0.0,184.0,72.0,3.0,2.0,4.0,2.0,3.0,1.0,1.0,3.0,1.0,1.0,1.0,8.0,13.0,10.0,6.0,11.0,7.0,12.0,8.0,10.0,12.0,11.0,9.0,13.0,11.0,9.0,14.0,14.0,11.0,14.0,10.0,12.0,16.0,9.0,14.0,12.0,13.0,15.0,16.0,15.0,12.0,14.0,12.0,8.0,13.0,14.0,20.0,16.0,12.0,13.0,9.0,16.0,8.0,15.0,13.0,13.0,17.0,14.0,16.0,16.0,16.0,5.0,29.0,59.0,2.0,9.0,0.0,179.0,70.0,2.0,3.0,2.0,1.0,1.0,1.0,1.0,1.0,4.0,3.0,3.0,6.0,8.0,8.0,7.0,12.0,6.0,10.0,8.0,12.0,14.0,12.0,7.0,14.0,11.0,18.0,14.0,16.0,10.0,16.0,8.0,12.0,17.0,6.0,14.0,8.0,14.0,18.0,19.0,13.0,12.0,14.0,11.0,10.0,18.0,15.0,20.0,18.0,13.0,15.0,13.0,15.0,7.0,15.0,18.0,14.0,8.0,13.0,18.0,12.0,14.0,5.0,25.0,0.0,0.0,7.0,0.0,180.0,76.0,2.0,1.0,3.0,3.0,3.0,3.0,4.0,2.0,1.0,1.0,3.0,10.0,12.0,11.0,8.0,14.0,9.0,12.0,13.0,8.0,10.0,14.0,8.0,12.0,14.0,13.0,13.0,15.0,13.0,14.0,13.0,13.0,15.0,10.0,7.0,11.0,12.0,15.0,16.0,14.0,15.0,14.0,10.0,8.0,14.0,13.0,20.0,15.0,13.0,14.0,13.0,14.0,9.0,16.0,12.0,13.0,15.0,13.0,14.0,12.0,11.0,8.0,26.0,0.0,0.0,0.0,0.0,176.0,72.0,4.0,3.0,1.0,2.0,3.0,1.0,2.0,1.0,2.0,1.0,1.0,9.0,13.0,9.0,9.0,10.0,11.0,7.0,10.0,4.0,12.0,9.0,9.0,10.0,9.0,10.0,11.0,9.0,9.0,9.0,8.0,9.0,9.0,14.0,9.0,8.0,9.0,8.0,9.0,13.0,13.0,7.0,8.0,20.0,8.0,12.0,10.0,10.0,6.0,10.0,5.0,10.0,4.0,10.0,14.0,10.0,14.0,12.0,11.0,5.0,7.0,1.0,29.0,31.0,4.0,19.0,4.0,185.0,82.0,3.0,1.0,2.0,2.0,1.0,2.0,1.0,2.0,3.0,1.0,1.0,13.0,13.0,13.0,9.0,16.0,14.0,12.0,14.0,5.0,6.0,16.0,14.0,6.0,16.0,10.0,14.0,10.0,14.0,12.0,15.0,13.0,14.0,12.0,11.0,13.0,8.0,15.0,12.0,12.0,13.0,14.0,12.0,12.0,12.0,12.0,20.0,14.0,14.0,14.0,12.0,15.0,15.0,10.0,12.0,16.0,14.0,8.0,17.0,14.0,15.0,5.0,19.0,0.0,0.0,2.0,0.0,178.0,67.0,3.0,3.0,1.0,3.0,2.0,1.0,3.0,1.0,2.0,2.0,1.0,14.0,14.0,17.0,14.0,15.0,12.0,7.0,13.0,6.0,4.0,13.0,11.0,5.0,16.0,10.0,11.0,7.0,10.0,9.0,12.0,8.0,11.0,17.0,5.0,12.0,6.0,8.0,10.0,17.0,15.0,10.0,9.0,20.0,14.0,18.0,19.0,12.0,8.0,11.0,5.0,11.0,5.0,13.0,13.0,16.0,10.0,13.0,12.0,9.0,15.0,14.0,28.0,44.0,8.0,12.0,2.0,180.0,78.0,3.0,1.0,1.0,2.0,2.0,2.0,3.0,4.0,2.0,3.0,2.0,11.0,13.0,15.0,12.0,14.0,10.0,6.0,13.0,5.0,7.0,13.0,13.0,7.0,13.0,8.0,12.0,11.0,13.0,12.0,12.0,13.0,14.0,15.0,8.0,14.0,10.0,11.0,14.0,15.0,13.0,14.0,9.0,8.0,12.0,16.0,20.0,12.0,13.0,12.0,8.0,12.0,8.0,12.0,12.0,13.0,8.0,13.0,10.0,10.0,11.0,11.0,25.0,4.0,0.0,11.0,0.0,184.0,81.0,14.0,14.0,13.0,9.0,15.0,12.0,16.0,16.0,13.0,7.0,11.0,8.0,1.0,2.0,1.0,11.0,12.0,6.0,1.0,3.0,3.0,11.0,5.0,3.0,11.0,8.0,15.0,15.0,13.0,14.0,10.0,11.0,14.0,8.0,13.0,5.0,13.0,10.0,10.0,14.0,16.0,14.0,13.0,20.0,14.0,12.0,5.0,14.0,14.0,15.0,9.0,16.0,6.0,1.0,17.0,11.0,15.0,13.0,14.0,12.0,12.0,4.0,27.0,0.0,0.0,0.0,0.0,169.0,60.0,3.0,2.0,1.0,3.0,3.0,2.0,1.0,3.0,3.0,2.0,2.0,11.0,11.0,13.0,9.0,13.0,12.0,8.0,10.0,4.0,5.0,14.0,8.0,5.0,13.0,12.0,9.0,9.0,10.0,10.0,10.0,9.0,16.0,13.0,4.0,14.0,8.0,11.0,8.0,16.0,16.0,9.0,9.0,5.0,13.0,15.0,20.0,11.0,11.0,10.0,8.0,7.0,5.0,11.0,14.0,10.0,12.0,11.0,12.0,10.0,13.0,8.0,22.0,3.0,0.0,7.0,1.0,182.0,75.0,3.0,3.0,1.0,3.0,2.0,3.0,1.0,1.0,2.0,2.0,1.0,4.0,11.0,10.0,6.0,14.0,7.0,13.0,10.0,9.0,16.0,14.0,8.0,15.0,14.0,13.0,17.0,15.0,16.0,14.0,11.0,14.0,15.0,8.0,11.0,10.0,15.0,16.0,14.0,14.0,14.0,14.0,11.0,20.0,15.0,14.0,10.0,15.0,15.0,15.0,12.0,15.0,8.0,11.0,12.0,14.0,16.0,15.0,14.0,14.0,14.0,5.0,37.0,0.0,0.0,0.0,0.0,185.0,83.0,1.0,1.0,2.0,1.0,3.0,2.0,3.0,1.0,1.0,3.0,1.0,6.0,8.0,9.0,12.0,10.0,8.0,13.0,9.0,4.0,5.0,10.0,14.0,4.0,11.0,11.0,10.0,11.0,13.0,12.0,12.0,13.0,15.0,14.0,12.0,11.0,7.0,12.0,8.0,7.0,7.0,12.0,12.0,11.0,11.0,7.0,20.0,8.0,14.0,12.0,8.0,13.0,9.0,12.0,12.0,12.0,19.0,14.0,15.0,14.0,8.0,8.0,32.0,0.0,0.0,0.0,0.0,172.0,71.0,2.0,1.0,3.0,1.0,2.0,3.0,2.0,3.0,2.0,2.0,2.0,8.0,9.0,7.0,6.0,10.0,6.0,10.0,9.0,10.0,14.0,11.0,6.0,14.0,11.0,10.0,16.0,15.0,12.0,12.0,7.0,12.0,15.0,9.0,13.0,8.0,14.0,15.0,15.0,14.0,14.0,14.0,10.0,20.0,14.0,14.0,8.0,15.0,13.0,13.0,11.0,13.0,7.0,13.0,17.0,14.0,17.0,8.0,13.0,15.0,15.0,6.0,19.0,0.0,0.0,3.0,1.0,181.0,69.0,3.0,2.0,3.0,3.0,2.0,1.0,1.0,1.0,3.0,3.0,4.0,10.0,10.0,12.0,12.0,12.0,7.0,8.0,11.0,5.0,7.0,10.0,10.0,7.0,11.0,8.0,10.0,10.0,12.0,8.0,11.0,8.0,14.0,13.0,6.0,14.0,8.0,13.0,13.0,16.0,14.0,13.0,9.0,20.0,15.0,16.0,10.0,15.0,13.0,12.0,8.0,11.0,7.0,12.0,11.0,11.0,15.0,10.0,12.0,14.0,14.0,1.0,27.0,8.0,0.0,6.0,0.0,187.0,76.0,3.0,2.0,3.0,2.0,2.0,1.0,1.0,3.0,3.0,1.0,2.0,5.0,7.0,11.0,5.0,14.0,5.0,14.0,9.0,5.0,15.0,15.0,8.0,14.0,13.0,15.0,16.0,15.0,14.0,12.0,14.0,14.0,18.0,8.0,17.0,9.0,12.0,18.0,15.0,13.0,14.0,15.0,14.0,10.0,17.0,12.0,20.0,17.0,15.0,14.0,13.0,16.0,4.0,12.0,10.0,14.0,17.0,12.0,15.0,13.0,13.0,6.0,24.0,0.0,0.0,6.0,1.0,172.0,70.0,3.0,1.0,1.0,3.0,1.0,2.0,3.0,1.0,1.0,3.0,3.0,11.0,12.0,11.0,8.0,12.0,10.0,6.0,14.0,7.0,11.0,15.0,8.0,12.0,13.0,14.0,14.0,18.0,13.0,12.0,13.0,13.0,15.0,12.0,12.0,12.0,11.0,18.0,18.0,13.0,14.0,13.0,7.0,10.0,16.0,12.0,20.0,14.0,12.0,14.0,14.0,15.0,4.0,8.0,7.0,14.0,14.0,13.0,14.0,12.0,10.0,6.0,22.0,0.0,0.0,4.0,0.0,180.0,80.0,4.0,1.0,1.0,3.0,2.0,3.0,1.0,3.0,3.0,3.0,4.0,7.0,10.0,11.0,8.0,15.0,11.0,10.0,14.0,5.0,14.0,15.0,10.0,15.0,15.0,13.0,14.0,13.0,12.0,14.0,15.0,13.0,16.0,12.0,8.0,15.0,13.0,13.0,13.0,13.0,13.0,12.0,10.0,12.0,12.0,12.0,20.0,13.0,12.0,13.0,10.0,12.0,7.0,11.0,12.0,15.0,12.0,16.0,15.0,10.0,10.0,7.0,24.0,6.0,1.0,0.0,0.0,183.0,66.0,1.0,1.0,2.0,2.0,1.0,2.0,1.0,2.0,3.0,2.0,1.0,14.0,14.0,14.0,10.0,14.0,14.0,9.0,10.0,8.0,8.0,14.0,10.0,8.0,15.0,9.0,11.0,13.0,11.0,11.0,13.0,10.0,14.0,13.0,5.0,12.0,9.0,14.0,13.0,14.0,16.0,12.0,9.0,20.0,13.0,14.0,5.0,15.0,9.0,12.0,10.0,12.0,8.0,9.0,16.0,9.0,16.0,13.0,11.0,12.0,13.0,9.0,25.0,10.0,1.0,11.0,4.0,175.0,73.0,1.0,3.0,3.0,3.0,3.0,3.0,3.0,1.0,2.0,3.0,1.0,5.0,10.0,15.0,17.0,15.0,10.0,11.0,12.0,5.0,5.0,14.0,15.0,5.0,16.0,8.0,15.0,12.0,15.0,14.0,13.0,15.0,15.0,15.0,14.0,14.0,10.0,10.0,12.0,16.0,16.0,15.0,9.0,10.0,15.0,16.0,20.0,13.0,15.0,14.0,8.0,14.0,7.0,10.0,8.0,16.0,17.0,13.0,15.0,15.0,14.0,5.0
1,2,31.0,25.0,0.0,6.0,0.0,191.0,84.0,11.0,14.0,13.0,12.0,15.0,14.0,15.0,16.0,13.0,14.0,14.0,8.0,2.0,10.0,5.0,11.0,11.0,7.0,10.0,2.0,5.0,10.0,11.0,11.0,9.0,12.0,13.0,15.0,13.0,13.0,8.0,13.0,16.0,12.0,14.0,1.0,16.0,13.0,11.0,12.0,13.0,16.0,16.0,8.0,16.0,13.0,20.0,15.0,15.0,17.0,8.0,15.0,7.0,2.0,15.0,15.0,17.0,15.0,17.0,16.0,15.0,6.0,38.0,89.0,6.0,14.0,1.0,183.0,79.0,3.0,3.0,2.0,3.0,2.0,3.0,2.0,4.0,3.0,2.0,3.0,4.0,8.0,8.0,7.0,12.0,6.0,14.0,8.0,11.0,17.0,12.0,11.0,16.0,12.0,15.0,16.0,17.0,15.0,17.0,10.0,16.0,18.0,6.0,15.0,8.0,16.0,17.0,13.0,8.0,8.0,12.0,11.0,10.0,13.0,8.0,20.0,10.0,11.0,16.0,12.0,16.0,11.0,7.0,15.0,16.0,16.0,15.0,18.0,16.0,14.0,4.0,32.0,0.0,0.0,3.0,0.0,187.0,82.0,1.0,2.0,2.0,3.0,2.0,1.0,1.0,2.0,2.0,3.0,1.0,5.0,11.0,8.0,7.0,10.0,6.0,15.0,9.0,13.0,15.0,10.0,8.0,16.0,9.0,16.0,14.0,17.0,12.0,15.0,8.0,12.0,17.0,9.0,14.0,11.0,13.0,15.0,13.0,12.0,11.0,16.0,14.0,6.0,13.0,14.0,20.0,13.0,16.0,15.0,14.0,14.0,8.0,14.0,14.0,14.0,15.0,16.0,15.0,12.0,10.0,7.0,28.0,54.0,3.0,5.0,1.0,184.0,76.0,1.0,3.0,3.0,3.0,2.0,2.0,2.0,1.0,2.0,2.0,1.0,8.0,13.0,11.0,7.0,10.0,7.0,13.0,9.0,14.0,12.0,11.0,8.0,14.0,11.0,13.0,12.0,14.0,11.0,12.0,9.0,11.0,12.0,8.0,7.0,13.0,11.0,14.0,14.0,14.0,13.0,15.0,12.0,20.0,14.0,15.0,5.0,12.0,16.0,10.0,11.0,11.0,8.0,10.0,4.0,13.0,13.0,11.0,12.0,12.0,11.0,9.0,31.0,0.0,0.0,6.0,0.0,174.0,80.0,1.0,1.0,1.0,1.0,1.0,5.0,1.0,1.0,1.0,1.0,1.0,14.0,12.0,11.0,7.0,12.0,13.0,9.0,7.0,10.0,11.0,11.0,10.0,10.0,12.0,11.0,11.0,11.0,10.0,6.0,10.0,9.0,12.0,12.0,12.0,10.0,12.0,12.0,14.0,12.0,15.0,10.0,9.0,20.0,12.0,12.0,7.0,12.0,9.0,9.0,10.0,12.0,7.0,9.0,11.0,14.0,9.0,7.0,14.0,8.0,9.0,9.0,21.0,0.0,0.0,9.0,0.0,184.0,72.0,1.0,3.0,1.0,2.0,3.0,2.0,1.0,1.0,2.0,1.0,2.0,6.0,10.0,12.0,7.0,12.0,7.0,14.0,11.0,7.0,14.0,13.0,10.0,13.0,12.0,14.0,13.0,14.0,12.0,12.0,12.0,12.0,16.0,11.0,10.0,12.0,13.0,14.0,15.0,14.0,13.0,16.0,12.0,12.0,14.0,15.0,20.0,15.0,17.0,14.0,12.0,15.0,9.0,9.0,10.0,16.0,14.0,15.0,14.0,14.0,14.0,8.0,32.0,36.0,0.0,12.0,2.0,183.0,77.0,1.0,3.0,2.0,1.0,3.0,1.0,1.0,2.0,1.0,1.0,3.0,6.0,11.0,8.0,6.0,13.0,11.0,13.0,10.0,6.0,15.0,14.0,10.0,17.0,12.0,15.0,16.0,18.0,14.0,17.0,12.0,15.0,17.0,11.0,17.0,7.0,17.0,20.0,16.0,9.0,11.0,15.0,11.0,8.0,15.0,10.0,20.0,14.0,14.0,17.0,10.0,16.0,10.0,13.0,15.0,15.0,15.0,14.0,18.0,15.0,13.0,6.0,21.0,0.0,0.0,6.0,1.0,181.0,78.0,1.0,3.0,3.0,2.0,1.0,3.0,2.0,2.0,3.0,2.0,1.0,13.0,12.0,16.0,8.0,15.0,13.0,9.0,12.0,5.0,4.0,13.0,12.0,3.0,16.0,12.0,8.0,10.0,8.0,8.0,14.0,10.0,11.0,15.0,6.0,11.0,5.0,9.0,12.0,13.0,14.0,14.0,9.0,10.0,12.0,14.0,20.0,12.0,15.0,9.0,12.0,10.0,10.0,13.0,5.0,16.0,12.0,12.0,7.0,12.0,11.0,11.0,21.0,7.0,0.0,14.0,6.0,173.0,64.0,3.0,2.0,3.0,2.0,3.0,3.0,3.0,2.0,3.0,3.0,3.0,14.0,14.0,18.0,14.0,17.0,14.0,7.0,11.0,2.0,6.0,15.0,14.0,6.0,18.0,12.0,14.0,14.0,15.0,13.0,16.0,14.0,17.0,17.0,12.0,13.0,9.0,13.0,17.0,15.0,17.0,13.0,7.0,20.0,14.0,14.0,9.0,14.0,9.0,15.0,7.0,16.0,7.0,14.0,15.0,17.0,15.0,16.0,17.0,16.0,15.0,4.0,20.0,0.0,0.0,7.0,1.0,170.0,58.0,1.0,2.0,2.0,2.0,2.0,2.0,2.0,4.0,1.0,3.0,2.0,16.0,14.0,16.0,13.0,16.0,17.0,5.0,14.0,2.0,6.0,15.0,13.0,4.0,17.0,9.0,12.0,14.0,12.0,12.0,14.0,13.0,15.0,16.0,7.0,13.0,9.0,13.0,15.0,15.0,16.0,11.0,7.0,20.0,14.0,15.0,8.0,14.0,8.0,15.0,5.0,15.0,7.0,16.0,15.0,15.0,15.0,14.0,16.0,18.0,16.0,3.0,32.0,22.0,4.0,5.0,4.0,171.0,72.0,3.0,3.0,3.0,1.0,3.0,1.0,1.0,2.0,2.0,2.0,3.0,10.0,10.0,13.0,14.0,14.0,11.0,13.0,12.0,5.0,7.0,12.0,16.0,8.0,14.0,11.0,14.0,12.0,12.0,11.0,13.0,13.0,13.0,15.0,8.0,16.0,7.0,12.0,11.0,14.0,14.0,15.0,7.0,12.0,12.0,13.0,20.0,13.0,14.0,12.0,8.0,15.0,7.0,11.0,15.0,17.0,11.0,14.0,12.0,11.0,15.0,11.0,20.0,0.0,0.0,0.0,0.0,184.0,88.0,12.0,10.0,12.0,13.0,11.0,13.0,12.0,14.0,8.0,13.0,13.0,9.0,3.0,3.0,1.0,9.0,11.0,2.0,1.0,3.0,3.0,11.0,4.0,1.0,10.0,10.0,13.0,16.0,11.0,11.0,12.0,11.0,14.0,9.0,12.0,1.0,12.0,12.0,12.0,15.0,13.0,14.0,11.0,20.0,13.0,12.0,8.0,13.0,15.0,12.0,11.0,15.0,6.0,1.0,19.0,14.0,16.0,14.0,8.0,7.0,6.0,15.0,34.0,0.0,0.0,0.0,0.0,191.0,81.0,14.0,10.0,8.0,3.0,9.0,14.0,13.0,10.0,9.0,3.0,12.0,4.0,3.0,3.0,1.0,1.0,6.0,1.0,1.0,2.0,1.0,2.0,3.0,3.0,3.0,8.0,6.0,10.0,8.0,9.0,5.0,10.0,2.0,1.0,10.0,2.0,10.0,8.0,7.0,10.0,8.0,8.0,16.0,9.0,14.0,9.0,20.0,3.0,9.0,9.0,9.0,1.0,9.0,9.0,20.0,9.0,13.0,12.0,10.0,10.0,12.0,7.0,25.0,0.0,0.0,0.0,0.0,191.0,81.0,1.0,1.0,3.0,2.0,3.0,2.0,3.0,4.0,2.0,1.0,2.0,4.0,3.0,10.0,8.0,6.0,6.0,11.0,6.0,10.0,11.0,10.0,5.0,12.0,7.0,16.0,13.0,16.0,11.0,13.0,7.0,10.0,14.0,5.0,12.0,10.0,13.0,13.0,12.0,13.0,13.0,16.0,16.0,7.0,16.0,14.0,20.0,14.0,14.0,13.0,13.0,15.0,6.0,12.0,13.0,6.0,14.0,8.0,8.0,13.0,7.0,4.0,21.0,0.0,0.0,1.0,0.0,177.0,68.0,4.0,1.0,2.0,1.0,1.0,1.0,1.0,1.0,2.0,1.0,2.0,5.0,12.0,9.0,7.0,12.0,8.0,13.0,10.0,16.0,13.0,12.0,8.0,14.0,12.0,12.0,13.0,12.0,12.0,12.0,10.0,13.0,15.0,11.0,13.0,11.0,13.0,13.0,14.0,13.0,14.0,13.0,11.0,10.0,14.0,12.0,20.0,12.0,14.0,12.0,11.0,12.0,8.0,14.0,13.0,10.0,14.0,12.0,14.0,12.0,11.0,5.0,23.0,0.0,0.0,0.0,0.0,179.0,71.0,2.0,1.0,3.0,3.0,2.0,3.0,2.0,2.0,1.0,3.0,1.0,8.0,10.0,12.0,6.0,12.0,10.0,5.0,10.0,13.0,11.0,11.0,6.0,12.0,11.0,9.0,11.0,12.0,12.0,7.0,10.0,9.0,15.0,12.0,5.0,13.0,8.0,12.0,14.0,16.0,13.0,13.0,10.0,20.0,16.0,15.0,8.0,14.0,14.0,13.0,9.0,14.0,7.0,10.0,7.0,14.0,14.0,13.0,15.0,13.0,13.0,5.0,26.0,0.0,0.0,0.0,0.0,176.0,70.0,2.0,1.0,4.0,3.0,3.0,3.0,1.0,3.0,3.0,2.0,1.0,10.0,11.0,11.0,6.0,13.0,9.0,5.0,12.0,11.0,13.0,13.0,7.0,14.0,13.0,15.0,11.0,14.0,12.0,11.0,9.0,12.0,13.0,9.0,9.0,13.0,12.0,15.0,14.0,12.0,16.0,12.0,7.0,20.0,13.0,13.0,10.0,15.0,11.0,13.0,14.0,13.0,11.0,9.0,8.0,9.0,17.0,12.0,14.0,14.0,15.0,3.0,34.0,103.0,7.0,16.0,1.0,182.0,72.0,2.0,1.0,1.0,1.0,3.0,1.0,4.0,3.0,3.0,2.0,1.0,11.0,13.0,12.0,8.0,15.0,13.0,9.0,13.0,6.0,8.0,15.0,12.0,8.0,15.0,11.0,14.0,13.0,15.0,15.0,14.0,16.0,17.0,15.0,14.0,11.0,13.0,17.0,13.0,8.0,11.0,10.0,11.0,16.0,13.0,8.0,20.0,12.0,10.0,15.0,11.0,12.0,12.0,15.0,14.0,12.0,15.0,15.0,18.0,14.0,14.0,7.0,23.0,39.0,1.0,5.0,2.0,174.0,73.0,3.0,4.0,2.0,1.0,1.0,2.0,4.0,1.0,3.0,2.0,4.0,7.0,6.0,10.0,5.0,11.0,7.0,6.0,8.0,5.0,11.0,12.0,6.0,13.0,11.0,15.0,9.0,16.0,8.0,12.0,10.0,10.0,14.0,10.0,6.0,12.0,11.0,16.0,20.0,15.0,16.0,15.0,9.0,6.0,13.0,14.0,20.0,16.0,14.0,9.0,13.0,13.0,7.0,14.0,14.0,12.0,13.0,12.0,14.0,12.0,14.0,3.0,22.0,1.0,0.0,0.0,0.0,177.0,73.0,3.0,2.0,1.0,3.0,3.0,3.0,1.0,3.0,2.0,2.0,1.0,12.0,13.0,14.0,10.0,14.0,12.0,10.0,14.0,2.0,5.0,13.0,14.0,7.0,15.0,12.0,10.0,6.0,10.0,7.0,8.0,8.0,7.0,15.0,8.0,13.0,8.0,5.0,8.0,16.0,15.0,14.0,8.0,8.0,10.0,15.0,20.0,12.0,11.0,8.0,9.0,11.0,12.0,12.0,13.0,13.0,13.0,12.0,6.0,9.0,6.0,14.0,21.0,0.0,0.0,4.0,1.0,184.0,79.0,1.0,2.0,3.0,1.0,2.0,1.0,3.0,2.0,2.0,1.0,3.0,3.0,6.0,10.0,12.0,12.0,7.0,15.0,8.0,4.0,5.0,13.0,10.0,8.0,12.0,18.0,12.0,19.0,13.0,10.0,13.0,12.0,14.0,13.0,10.0,12.0,9.0,16.0,15.0,12.0,14.0,14.0,14.0,12.0,13.0,10.0,20.0,14.0,14.0,11.0,14.0,14.0,11.0,5.0,10.0,13.0,14.0,15.0,10.0,8.0,4.0,15.0,19.0,0.0,0.0,0.0,0.0,172.0,64.0,1.0,3.0,2.0,2.0,4.0,2.0,1.0,2.0,3.0,3.0,1.0,13.0,13.0,15.0,12.0,15.0,12.0,6.0,12.0,3.0,2.0,13.0,11.0,3.0,16.0,8.0,10.0,9.0,12.0,9.0,13.0,10.0,12.0,15.0,8.0,13.0,4.0,5.0,7.0,17.0,16.0,14.0,5.0,20.0,11.0,15.0,12.0,10.0,8.0,8.0,10.0,14.0,8.0,10.0,17.0,14.0,9.0,10.0,9.0,4.0,10.0,10.0
2,0,17.0,0.0,0.0,0.0,0.0,193.0,82.0,13.0,11.0,12.0,2.0,12.0,10.0,14.0,15.0,14.0,12.0,10.0,3.0,1.0,1.0,3.0,5.0,6.0,2.0,2.0,1.0,3.0,9.0,3.0,1.0,8.0,7.0,12.0,13.0,13.0,13.0,11.0,11.0,15.0,3.0,8.0,3.0,12.0,12.0,11.0,10.0,12.0,14.0,17.0,5.0,15.0,11.0,20.0,13.0,12.0,13.0,8.0,11.0,5.0,11.0,13.0,15.0,15.0,17.0,14.0,15.0,15.0,5.0,23.0,0.0,0.0,0.0,0.0,180.0,77.0,2.0,1.0,3.0,2.0,3.0,2.0,2.0,2.0,3.0,1.0,2.0,6.0,11.0,11.0,6.0,13.0,7.0,11.0,5.0,8.0,14.0,12.0,9.0,12.0,9.0,15.0,14.0,17.0,10.0,14.0,8.0,13.0,14.0,7.0,8.0,7.0,10.0,13.0,15.0,15.0,13.0,13.0,10.0,5.0,14.0,14.0,20.0,15.0,14.0,14.0,15.0,6.0,7.0,11.0,18.0,13.0,14.0,15.0,13.0,12.0,14.0,2.0,19.0,0.0,0.0,0.0,0.0,194.0,92.0,2.0,1.0,3.0,3.0,3.0,3.0,1.0,3.0,3.0,2.0,1.0,3.0,3.0,5.0,6.0,10.0,5.0,16.0,10.0,8.0,12.0,9.0,4.0,15.0,11.0,14.0,11.0,12.0,10.0,11.0,10.0,12.0,15.0,3.0,13.0,13.0,12.0,14.0,14.0,11.0,8.0,15.0,17.0,5.0,16.0,12.0,20.0,12.0,16.0,12.0,13.0,12.0,5.0,7.0,10.0,14.0,13.0,8.0,10.0,11.0,18.0,6.0,23.0,1.0,0.0,4.0,0.0,190.0,80.0,1.0,4.0,1.0,3.0,3.0,1.0,1.0,1.0,2.0,4.0,2.0,6.0,11.0,13.0,7.0,13.0,6.0,11.0,8.0,10.0,15.0,12.0,5.0,15.0,12.0,14.0,14.0,16.0,9.0,11.0,10.0,10.0,16.0,12.0,12.0,9.0,12.0,10.0,14.0,14.0,12.0,15.0,17.0,8.0,15.0,16.0,20.0,13.0,14.0,13.0,8.0,13.0,6.0,14.0,11.0,14.0,12.0,13.0,16.0,14.0,12.0,6.0,26.0,4.0,0.0,2.0,0.0,180.0,74.0,3.0,3.0,1.0,2.0,2.0,1.0,3.0,4.0,1.0,2.0,1.0,8.0,13.0,13.0,6.0,13.0,9.0,12.0,7.0,11.0,13.0,13.0,11.0,12.0,12.0,16.0,14.0,14.0,9.0,12.0,11.0,13.0,4.0,4.0,6.0,11.0,12.0,8.0,12.0,14.0,14.0,13.0,9.0,20.0,16.0,13.0,5.0,15.0,13.0,12.0,6.0,9.0,10.0,12.0,8.0,14.0,8.0,11.0,12.0,11.0,13.0,2.0,26.0,17.0,0.0,19.0,1.0,191.0,79.0,3.0,2.0,1.0,1.0,1.0,1.0,2.0,2.0,3.0,3.0,4.0,4.0,8.0,11.0,9.0,12.0,7.0,14.0,10.0,6.0,12.0,13.0,7.0,11.0,12.0,14.0,13.0,14.0,12.0,10.0,11.0,12.0,15.0,9.0,7.0,11.0,12.0,12.0,15.0,14.0,13.0,16.0,15.0,8.0,15.0,13.0,20.0,19.0,15.0,11.0,14.0,14.0,7.0,12.0,12.0,14.0,12.0,10.0,9.0,14.0,14.0,14.0,19.0,0.0,0.0,0.0,0.0,184.0,78.0,3.0,1.0,2.0,1.0,2.0,2.0,2.0,3.0,3.0,4.0,2.0,6.0,8.0,9.0,5.0,13.0,6.0,11.0,8.0,5.0,13.0,13.0,8.0,12.0,13.0,13.0,13.0,15.0,12.0,12.0,13.0,12.0,14.0,7.0,11.0,8.0,15.0,14.0,15.0,13.0,12.0,14.0,11.0,5.0,15.0,12.0,20.0,16.0,14.0,13.0,12.0,11.0,7.0,10.0,19.0,13.0,15.0,12.0,14.0,13.0,12.0,6.0,32.0,0.0,0.0,13.0,0.0,175.0,65.0,2.0,1.0,1.0,2.0,3.0,3.0,1.0,2.0,3.0,2.0,3.0,15.0,13.0,11.0,6.0,14.0,13.0,10.0,12.0,8.0,8.0,16.0,8.0,12.0,13.0,11.0,14.0,15.0,14.0,15.0,14.0,14.0,14.0,6.0,13.0,9.0,15.0,18.0,13.0,12.0,13.0,13.0,8.0,8.0,13.0,10.0,20.0,13.0,13.0,12.0,11.0,15.0,12.0,10.0,17.0,14.0,15.0,14.0,16.0,14.0,14.0,6.0,24.0,1.0,0.0,0.0,0.0,168.0,66.0,2.0,3.0,1.0,1.0,2.0,1.0,3.0,1.0,1.0,1.0,2.0,10.0,15.0,15.0,6.0,14.0,12.0,5.0,12.0,5.0,5.0,14.0,8.0,3.0,15.0,7.0,9.0,8.0,12.0,12.0,13.0,12.0,15.0,16.0,5.0,15.0,5.0,9.0,13.0,16.0,17.0,9.0,5.0,8.0,14.0,12.0,20.0,11.0,5.0,12.0,7.0,14.0,7.0,11.0,17.0,14.0,14.0,11.0,11.0,14.0,14.0,7.0,25.0,14.0,1.0,2.0,0.0,177.0,77.0,3.0,3.0,1.0,2.0,3.0,3.0,1.0,3.0,3.0,4.0,1.0,8.0,11.0,13.0,12.0,12.0,10.0,11.0,10.0,2.0,3.0,11.0,10.0,5.0,13.0,12.0,12.0,13.0,11.0,10.0,11.0,10.0,14.0,16.0,14.0,15.0,5.0,13.0,14.0,15.0,14.0,12.0,12.0,12.0,14.0,16.0,20.0,13.0,14.0,13.0,7.0,14.0,11.0,13.0,14.0,11.0,12.0,8.0,12.0,13.0,15.0,6.0,25.0,0.0,0.0,3.0,0.0,170.0,68.0,2.0,1.0,3.0,1.0,3.0,1.0,3.0,2.0,2.0,4.0,1.0,12.0,11.0,15.0,16.0,16.0,13.0,11.0,12.0,4.0,5.0,12.0,14.0,4.0,17.0,7.0,14.0,7.0,15.0,13.0,13.0,14.0,14.0,15.0,7.0,16.0,8.0,10.0,13.0,15.0,15.0,12.0,6.0,11.0,14.0,14.0,20.0,13.0,11.0,12.0,7.0,15.0,7.0,8.0,12.0,14.0,13.0,14.0,13.0,16.0,16.0,8.0,36.0,0.0,0.0,0.0,0.0,185.0,78.0,11.0,14.0,12.0,7.0,13.0,12.0,14.0,15.0,13.0,14.0,10.0,4.0,1.0,3.0,1.0,8.0,8.0,11.0,8.0,3.0,3.0,7.0,2.0,1.0,8.0,11.0,13.0,15.0,11.0,12.0,7.0,13.0,9.0,5.0,14.0,3.0,13.0,15.0,8.0,11.0,14.0,13.0,12.0,5.0,15.0,11.0,20.0,12.0,14.0,13.0,11.0,13.0,8.0,1.0,19.0,14.0,16.0,10.0,17.0,9.0,9.0,11.0,34.0,23.0,1.0,0.0,0.0,186.0,81.0,3.0,3.0,1.0,2.0,1.0,3.0,2.0,3.0,1.0,3.0,3.0,4.0,8.0,6.0,10.0,7.0,8.0,17.0,12.0,10.0,14.0,7.0,9.0,15.0,7.0,15.0,13.0,17.0,8.0,12.0,7.0,12.0,15.0,6.0,17.0,7.0,14.0,15.0,14.0,8.0,10.0,16.0,13.0,12.0,13.0,9.0,20.0,13.0,15.0,11.0,15.0,14.0,9.0,10.0,10.0,14.0,11.0,13.0,15.0,11.0,11.0,12.0,28.0,0.0,0.0,0.0,0.0,183.0,81.0,1.0,2.0,4.0,1.0,1.0,3.0,2.0,3.0,3.0,3.0,1.0,5.0,5.0,6.0,10.0,12.0,6.0,14.0,8.0,6.0,15.0,11.0,6.0,13.0,12.0,13.0,14.0,16.0,14.0,14.0,10.0,12.0,14.0,5.0,14.0,8.0,14.0,15.0,15.0,9.0,12.0,15.0,13.0,7.0,11.0,12.0,20.0,15.0,15.0,14.0,14.0,14.0,9.0,8.0,14.0,14.0,11.0,13.0,15.0,13.0,15.0,6.0,30.0,0.0,0.0,2.0,0.0,178.0,71.0,2.0,3.0,1.0,2.0,3.0,2.0,2.0,1.0,4.0,2.0,2.0,6.0,10.0,9.0,5.0,11.0,7.0,12.0,11.0,8.0,10.0,11.0,7.0,12.0,10.0,10.0,12.0,13.0,13.0,12.0,10.0,12.0,16.0,11.0,8.0,10.0,11.0,14.0,14.0,11.0,11.0,13.0,10.0,20.0,16.0,13.0,5.0,13.0,12.0,13.0,10.0,14.0,5.0,14.0,19.0,13.0,14.0,14.0,14.0,14.0,14.0,7.0,24.0,0.0,0.0,0.0,0.0,179.0,68.0,3.0,2.0,3.0,2.0,1.0,3.0,3.0,1.0,3.0,3.0,1.0,4.0,13.0,9.0,6.0,12.0,9.0,12.0,7.0,8.0,12.0,14.0,8.0,14.0,12.0,15.0,14.0,13.0,14.0,13.0,10.0,12.0,14.0,10.0,9.0,9.0,10.0,13.0,14.0,14.0,12.0,13.0,9.0,9.0,8.0,14.0,20.0,15.0,14.0,11.0,11.0,13.0,10.0,14.0,13.0,14.0,14.0,11.0,16.0,15.0,15.0,6.0,23.0,14.0,1.0,0.0,0.0,180.0,75.0,1.0,3.0,2.0,4.0,1.0,3.0,2.0,2.0,4.0,1.0,2.0,5.0,12.0,12.0,6.0,11.0,7.0,13.0,12.0,6.0,12.0,12.0,6.0,12.0,11.0,13.0,13.0,15.0,11.0,11.0,12.0,9.0,16.0,7.0,12.0,8.0,12.0,14.0,16.0,14.0,13.0,15.0,10.0,8.0,15.0,13.0,20.0,15.0,14.0,14.0,13.0,12.0,7.0,11.0,12.0,13.0,14.0,14.0,14.0,13.0,13.0,6.0,30.0,0.0,0.0,0.0,0.0,167.0,60.0,3.0,1.0,1.0,2.0,3.0,1.0,1.0,3.0,1.0,1.0,3.0,10.0,11.0,12.0,8.0,13.0,10.0,6.0,9.0,10.0,12.0,14.0,9.0,10.0,14.0,11.0,14.0,14.0,14.0,14.0,13.0,14.0,12.0,14.0,11.0,13.0,12.0,15.0,15.0,15.0,14.0,11.0,5.0,11.0,11.0,15.0,20.0,11.0,8.0,14.0,10.0,12.0,13.0,11.0,11.0,12.0,11.0,10.0,12.0,11.0,11.0,2.0,33.0,0.0,0.0,0.0,0.0,187.0,76.0,2.0,2.0,3.0,1.0,1.0,3.0,2.0,1.0,2.0,3.0,2.0,15.0,14.0,14.0,10.0,15.0,13.0,10.0,12.0,7.0,4.0,15.0,13.0,7.0,15.0,6.0,12.0,9.0,14.0,11.0,15.0,12.0,12.0,14.0,12.0,13.0,7.0,13.0,12.0,11.0,12.0,14.0,12.0,14.0,15.0,12.0,20.0,11.0,12.0,12.0,6.0,14.0,6.0,11.0,14.0,13.0,12.0,12.0,15.0,15.0,13.0,9.0,26.0,1.0,0.0,0.0,0.0,180.0,73.0,2.0,3.0,2.0,1.0,3.0,1.0,1.0,1.0,2.0,3.0,3.0,6.0,12.0,13.0,12.0,13.0,12.0,7.0,11.0,6.0,4.0,11.0,12.0,5.0,14.0,7.0,12.0,9.0,12.0,12.0,8.0,10.0,16.0,13.0,5.0,13.0,7.0,9.0,14.0,16.0,14.0,13.0,10.0,20.0,13.0,15.0,6.0,13.0,13.0,10.0,7.0,13.0,7.0,8.0,12.0,14.0,15.0,13.0,12.0,14.0,14.0,9.0,26.0,0.0,0.0,0.0,0.0,193.0,81.0,1.0,3.0,3.0,3.0,3.0,1.0,2.0,2.0,2.0,3.0,3.0,4.0,9.0,14.0,10.0,13.0,12.0,14.0,14.0,5.0,5.0,10.0,12.0,3.0,14.0,8.0,13.0,12.0,9.0,10.0,11.0,11.0,12.0,16.0,5.0,14.0,6.0,9.0,12.0,14.0,13.0,14.0,16.0,14.0,13.0,13.0,20.0,13.0,14.0,10.0,8.0,14.0,9.0,8.0,16.0,16.0,11.0,13.0,11.0,13.0,13.0,10.0,24.0,0.0,0.0,0.0,0.0,182.0,82.0,3.0,3.0,2.0,1.0,1.0,3.0,2.0,2.0,3.0,2.0,2.0,4.0,7.0,13.0,14.0,13.0,12.0,14.0,12.0,5.0,7.0,10.0,14.0,6.0,15.0,13.0,13.0,16.0,8.0,12.0,11.0,11.0,12.0,14.0,7.0,13.0,8.0,12.0,13.0,14.0,14.0,15.0,12.0,10.0,10.0,12.0,20.0,16.0,15.0,12.0,13.0,14.0,10.0,8.0,8.0,13.0,5.0,10.0,11.0,9.0,9.0,13.0
1,3,25.0,0.0,0.0,0.0,0.0,187.0,83.0,11.0,14.0,12.0,8.0,13.0,11.0,14.0,15.0,13.0,13.0,9.0,8.0,1.0,1.0,1.0,11.0,11.0,1.0,2.0,2.0,1.0,10.0,3.0,2.0,11.0,8.0,12.0,14.0,12.0,12.0,10.0,12.0,14.0,6.0,14.0,2.0,12.0,12.0,8.0,13.0,15.0,14.0,13.0,20.0,15.0,11.0,5.0,14.0,13.0,13.0,8.0,8.0,10.0,1.0,9.0,13.0,14.0,12.0,15.0,15.0,15.0,5.0,26.0,11.0,0.0,4.0,0.0,183.0,79.0,3.0,2.0,1.0,2.0,2.0,2.0,3.0,2.0,2.0,2.0,1.0,5.0,7.0,9.0,6.0,10.0,11.0,15.0,11.0,7.0,14.0,10.0,7.0,13.0,10.0,14.0,13.0,15.0,13.0,12.0,10.0,12.0,17.0,8.0,11.0,10.0,13.0,15.0,16.0,13.0,13.0,16.0,13.0,5.0,15.0,13.0,20.0,16.0,15.0,13.0,14.0,15.0,7.0,14.0,16.0,12.0,14.0,14.0,15.0,14.0,14.0,5.0,24.0,8.0,0.0,0.0,0.0,186.0,81.0,1.0,1.0,1.0,3.0,3.0,1.0,1.0,1.0,2.0,1.0,2.0,4.0,8.0,7.0,5.0,9.0,5.0,14.0,8.0,7.0,12.0,8.0,6.0,12.0,9.0,13.0,12.0,14.0,12.0,11.0,9.0,12.0,14.0,1.0,11.0,7.0,13.0,14.0,14.0,12.0,8.0,15.0,14.0,5.0,13.0,14.0,20.0,13.0,15.0,13.0,13.0,8.0,13.0,8.0,7.0,11.0,14.0,10.0,14.0,14.0,14.0,6.0,26.0,14.0,0.0,0.0,0.0,181.0,74.0,2.0,1.0,1.0,1.0,3.0,2.0,3.0,1.0,3.0,3.0,2.0,6.0,13.0,8.0,5.0,12.0,7.0,12.0,8.0,11.0,13.0,12.0,6.0,14.0,10.0,14.0,12.0,14.0,10.0,12.0,8.0,8.0,14.0,6.0,6.0,12.0,11.0,14.0,15.0,16.0,14.0,14.0,11.0,5.0,14.0,14.0,20.0,16.0,14.0,12.0,13.0,14.0,8.0,10.0,8.0,14.0,12.0,13.0,15.0,15.0,15.0,6.0,22.0,12.0,2.0,13.0,0.0,170.0,71.0,2.0,2.0,1.0,3.0,2.0,2.0,1.0,1.0,1.0,3.0,2.0,15.0,15.0,12.0,10.0,14.0,15.0,8.0,13.0,12.0,9.0,13.0,10.0,10.0,14.0,14.0,16.0,10.0,17.0,14.0,12.0,16.0,14.0,12.0,8.0,14.0,10.0,17.0,16.0,16.0,17.0,10.0,6.0,20.0,17.0,13.0,8.0,15.0,7.0,15.0,6.0,15.0,8.0,17.0,13.0,13.0,12.0,12.0,14.0,16.0,16.0,8.0,29.0,0.0,0.0,0.0,0.0,188.0,74.0,1.0,2.0,3.0,3.0,2.0,3.0,1.0,3.0,2.0,1.0,1.0,4.0,8.0,10.0,6.0,13.0,7.0,14.0,9.0,6.0,13.0,12.0,8.0,13.0,13.0,12.0,14.0,13.0,14.0,11.0,13.0,12.0,14.0,6.0,13.0,8.0,14.0,15.0,15.0,9.0,12.0,14.0,14.0,10.0,13.0,10.0,20.0,16.0,12.0,13.0,12.0,15.0,9.0,11.0,11.0,14.0,14.0,12.0,15.0,13.0,13.0,6.0,30.0,7.0,0.0,0.0,0.0,181.0,72.0,1.0,3.0,3.0,1.0,2.0,3.0,2.0,1.0,3.0,2.0,2.0,12.0,11.0,14.0,8.0,14.0,12.0,8.0,12.0,6.0,5.0,13.0,13.0,5.0,14.0,8.0,12.0,10.0,11.0,12.0,15.0,11.0,13.0,14.0,9.0,13.0,10.0,12.0,13.0,12.0,14.0,12.0,10.0,12.0,15.0,13.0,20.0,15.0,9.0,10.0,8.0,13.0,5.0,8.0,12.0,14.0,14.0,12.0,11.0,14.0,14.0,8.0,31.0,0.0,0.0,0.0,0.0,175.0,65.0,3.0,4.0,1.0,1.0,3.0,3.0,3.0,2.0,4.0,3.0,3.0,14.0,13.0,13.0,7.0,14.0,12.0,7.0,12.0,7.0,6.0,14.0,15.0,8.0,15.0,11.0,12.0,13.0,13.0,11.0,14.0,12.0,15.0,13.0,9.0,11.0,10.0,12.0,13.0,14.0,15.0,12.0,7.0,20.0,10.0,13.0,10.0,12.0,9.0,12.0,11.0,15.0,16.0,13.0,8.0,14.0,14.0,14.0,13.0,13.0,13.0,7.0,27.0,0.0,0.0,0.0,0.0,173.0,68.0,2.0,2.0,1.0,1.0,3.0,3.0,1.0,2.0,3.0,4.0,2.0,12.0,12.0,13.0,8.0,13.0,10.0,7.0,8.0,9.0,7.0,12.0,10.0,9.0,14.0,7.0,10.0,8.0,11.0,12.0,12.0,11.0,12.0,13.0,5.0,13.0,10.0,10.0,12.0,14.0,14.0,11.0,7.0,20.0,12.0,15.0,10.0,13.0,8.0,12.0,7.0,13.0,9.0,12.0,18.0,12.0,14.0,11.0,14.0,15.0,15.0,6.0,24.0,0.0,0.0,5.0,0.0,183.0,79.0,4.0,4.0,3.0,3.0,1.0,3.0,2.0,1.0,3.0,2.0,3.0,4.0,7.0,12.0,13.0,12.0,8.0,13.0,12.0,5.0,6.0,11.0,12.0,4.0,13.0,11.0,12.0,14.0,9.0,12.0,10.0,10.0,13.0,12.0,6.0,14.0,12.0,13.0,14.0,15.0,14.0,14.0,11.0,10.0,13.0,14.0,20.0,14.0,14.0,12.0,12.0,14.0,9.0,5.0,7.0,13.0,15.0,11.0,14.0,14.0,14.0,6.0,24.0,24.0,4.0,0.0,0.0,172.0,74.0,2.0,4.0,3.0,2.0,2.0,1.0,2.0,2.0,3.0,2.0,4.0,8.0,9.0,14.0,13.0,14.0,9.0,11.0,10.0,7.0,5.0,12.0,12.0,3.0,13.0,10.0,12.0,12.0,13.0,12.0,11.0,10.0,14.0,13.0,7.0,14.0,9.0,9.0,13.0,16.0,15.0,13.0,6.0,8.0,13.0,16.0,20.0,14.0,12.0,11.0,11.0,13.0,9.0,8.0,9.0,13.0,9.0,11.0,12.0,13.0,10.0,9.0,25.0,4.0,0.0,11.0,0.0,184.0,81.0,14.0,14.0,13.0,9.0,15.0,12.0,16.0,16.0,13.0,7.0,11.0,8.0,1.0,2.0,1.0,11.0,12.0,6.0,1.0,3.0,3.0,11.0,5.0,3.0,11.0,8.0,15.0,15.0,13.0,14.0,10.0,11.0,14.0,8.0,13.0,5.0,13.0,10.0,10.0,14.0,16.0,14.0,13.0,20.0,14.0,12.0,5.0,14.0,14.0,15.0,9.0,16.0,6.0,1.0,17.0,11.0,15.0,13.0,14.0,12.0,12.0,4.0,22.0,3.0,0.0,7.0,1.0,182.0,75.0,3.0,3.0,1.0,3.0,2.0,3.0,1.0,1.0,2.0,2.0,1.0,4.0,11.0,10.0,6.0,14.0,7.0,13.0,10.0,9.0,16.0,14.0,8.0,15.0,14.0,13.0,17.0,15.0,16.0,14.0,11.0,14.0,15.0,8.0,11.0,10.0,15.0,16.0,14.0,14.0,14.0,14.0,11.0,20.0,15.0,14.0,10.0,15.0,15.0,15.0,12.0,15.0,8.0,11.0,12.0,14.0,16.0,15.0,14.0,14.0,14.0,5.0,27.0,4.0,0.0,5.0,1.0,184.0,83.0,2.0,4.0,3.0,1.0,1.0,2.0,1.0,2.0,4.0,2.0,3.0,4.0,8.0,11.0,4.0,10.0,4.0,14.0,4.0,4.0,15.0,12.0,5.0,16.0,11.0,14.0,14.0,16.0,14.0,10.0,11.0,12.0,17.0,7.0,10.0,9.0,13.0,14.0,15.0,14.0,13.0,16.0,13.0,10.0,15.0,13.0,20.0,15.0,16.0,12.0,12.0,14.0,6.0,12.0,11.0,13.0,12.0,12.0,16.0,15.0,14.0,6.0,32.0,0.0,0.0,0.0,0.0,172.0,71.0,2.0,1.0,3.0,1.0,2.0,3.0,2.0,3.0,2.0,2.0,2.0,8.0,9.0,7.0,6.0,10.0,6.0,10.0,9.0,10.0,14.0,11.0,6.0,14.0,11.0,10.0,16.0,15.0,12.0,12.0,7.0,12.0,15.0,9.0,13.0,8.0,14.0,15.0,15.0,14.0,14.0,14.0,10.0,20.0,14.0,14.0,8.0,15.0,13.0,13.0,11.0,13.0,7.0,13.0,17.0,14.0,17.0,8.0,13.0,15.0,15.0,6.0,19.0,0.0,0.0,3.0,1.0,181.0,69.0,3.0,2.0,3.0,3.0,2.0,1.0,1.0,1.0,3.0,3.0,4.0,10.0,10.0,12.0,12.0,12.0,7.0,8.0,11.0,5.0,7.0,10.0,10.0,7.0,11.0,8.0,10.0,10.0,12.0,8.0,11.0,8.0,14.0,13.0,6.0,14.0,8.0,13.0,13.0,16.0,14.0,13.0,9.0,20.0,15.0,16.0,10.0,15.0,13.0,12.0,8.0,11.0,7.0,12.0,11.0,11.0,15.0,10.0,12.0,14.0,14.0,1.0,32.0,11.0,1.0,0.0,0.0,176.0,68.0,2.0,1.0,3.0,2.0,2.0,2.0,2.0,3.0,3.0,2.0,2.0,8.0,10.0,10.0,7.0,11.0,8.0,10.0,11.0,12.0,11.0,13.0,12.0,14.0,12.0,9.0,14.0,15.0,13.0,12.0,11.0,12.0,17.0,8.0,14.0,14.0,11.0,18.0,18.0,14.0,14.0,12.0,10.0,10.0,14.0,13.0,20.0,17.0,13.0,15.0,9.0,13.0,8.0,13.0,17.0,13.0,15.0,16.0,16.0,16.0,18.0,5.0,22.0,0.0,0.0,4.0,0.0,180.0,80.0,4.0,1.0,1.0,3.0,2.0,3.0,1.0,3.0,3.0,3.0,4.0,7.0,10.0,11.0,8.0,15.0,11.0,10.0,14.0,5.0,14.0,15.0,10.0,15.0,15.0,13.0,14.0,13.0,12.0,14.0,15.0,13.0,16.0,12.0,8.0,15.0,13.0,13.0,13.0,13.0,13.0,12.0,10.0,12.0,12.0,12.0,20.0,13.0,12.0,13.0,10.0,12.0,7.0,11.0,12.0,15.0,12.0,16.0,15.0,10.0,10.0,7.0,21.0,0.0,0.0,15.0,3.0,181.0,78.0,3.0,3.0,4.0,2.0,1.0,2.0,2.0,4.0,2.0,1.0,1.0,5.0,7.0,11.0,10.0,14.0,5.0,14.0,10.0,6.0,13.0,14.0,8.0,14.0,14.0,12.0,14.0,12.0,11.0,10.0,12.0,11.0,16.0,11.0,12.0,14.0,14.0,14.0,14.0,14.0,13.0,14.0,13.0,10.0,16.0,14.0,20.0,16.0,14.0,12.0,10.0,11.0,5.0,19.0,8.0,11.0,14.0,11.0,16.0,13.0,13.0,10.0,24.0,0.0,0.0,6.0,1.0,172.0,70.0,3.0,1.0,1.0,3.0,1.0,2.0,3.0,1.0,1.0,3.0,3.0,11.0,12.0,11.0,8.0,12.0,10.0,6.0,14.0,7.0,11.0,15.0,8.0,12.0,13.0,14.0,14.0,18.0,13.0,12.0,13.0,13.0,15.0,12.0,12.0,12.0,11.0,18.0,18.0,13.0,14.0,13.0,7.0,10.0,16.0,12.0,20.0,14.0,12.0,14.0,14.0,15.0,4.0,8.0,7.0,14.0,14.0,13.0,14.0,12.0,10.0,6.0,24.0,6.0,1.0,0.0,0.0,183.0,66.0,1.0,1.0,2.0,2.0,1.0,2.0,1.0,2.0,3.0,2.0,1.0,14.0,14.0,14.0,10.0,14.0,14.0,9.0,10.0,8.0,8.0,14.0,10.0,8.0,15.0,9.0,11.0,13.0,11.0,11.0,13.0,10.0,14.0,13.0,5.0,12.0,9.0,14.0,13.0,14.0,16.0,12.0,9.0,20.0,13.0,14.0,5.0,15.0,9.0,12.0,10.0,12.0,8.0,9.0,16.0,9.0,16.0,13.0,11.0,12.0,13.0,9.0,25.0,10.0,1.0,11.0,4.0,175.0,73.0,1.0,3.0,3.0,3.0,3.0,3.0,3.0,1.0,2.0,3.0,1.0,5.0,10.0,15.0,17.0,15.0,10.0,11.0,12.0,5.0,5.0,14.0,15.0,5.0,16.0,8.0,15.0,12.0,15.0,14.0,13.0,15.0,15.0,15.0,14.0,14.0,10.0,10.0,12.0,16.0,16.0,15.0,9.0,10.0,15.0,16.0,20.0,13.0,15.0,14.0,8.0,14.0,7.0,10.0,8.0,16.0,17.0,13.0,15.0,15.0,14.0,5.0
1,2,36.0,0.0,0.0,0.0,0.0,185.0,78.0,11.0,14.0,12.0,7.0,13.0,12.0,14.0,15.0,13.0,14.0,10.0,4.0,1.0,3.0,1.0,8.0,8.0,11.0,8.0,3.0,3.0,7.0,2.0,1.0,8.0,11.0,13.0,15.0,11.0,12.0,7.0,13.0,9.0,5.0,14.0,3.0,13.0,15.0,8.0,11.0,14.0,13.0,12.0,5.0,15.0,11.0,20.0,12.0,14.0,13.0,11.0,13.0,8.0,1.0,19.0,14.0,16.0,10.0,17.0,9.0,9.0,11.0,34.0,23.0,1.0,0.0,0.0,186.0,81.0,3.0,3.0,1.0,2.0,1.0,3.0,2.0,3.0,1.0,3.0,3.0,4.0,8.0,6.0,10.0,7.0,8.0,17.0,12.0,10.0,14.0,7.0,9.0,15.0,7.0,15.0,13.0,17.0,8.0,12.0,7.0,12.0,15.0,6.0,17.0,7.0,14.0,15.0,14.0,8.0,10.0,16.0,13.0,12.0,13.0,9.0,20.0,13.0,15.0,11.0,15.0,14.0,9.0,10.0,10.0,14.0,11.0,13.0,15.0,11.0,11.0,12.0,28.0,0.0,0.0,0.0,0.0,183.0,81.0,1.0,2.0,4.0,1.0,1.0,3.0,2.0,3.0,3.0,3.0,1.0,5.0,5.0,6.0,10.0,12.0,6.0,14.0,8.0,6.0,15.0,11.0,6.0,13.0,12.0,13.0,14.0,16.0,14.0,14.0,10.0,12.0,14.0,5.0,14.0,8.0,14.0,15.0,15.0,9.0,12.0,15.0,13.0,7.0,11.0,12.0,20.0,15.0,15.0,14.0,14.0,14.0,9.0,8.0,14.0,14.0,11.0,13.0,15.0,13.0,15.0,6.0,27.0,10.0,0.0,0.0,0.0,181.0,69.0,1.0,1.0,3.0,3.0,3.0,3.0,2.0,3.0,3.0,3.0,1.0,5.0,13.0,10.0,7.0,13.0,9.0,10.0,10.0,12.0,12.0,11.0,7.0,12.0,11.0,11.0,13.0,12.0,11.0,13.0,9.0,9.0,12.0,8.0,7.0,12.0,11.0,11.0,13.0,15.0,13.0,13.0,10.0,20.0,12.0,15.0,8.0,15.0,12.0,13.0,11.0,14.0,13.0,12.0,10.0,14.0,12.0,10.0,11.0,15.0,15.0,7.0,24.0,0.0,0.0,0.0,0.0,179.0,68.0,3.0,2.0,3.0,2.0,1.0,3.0,3.0,1.0,3.0,3.0,1.0,4.0,13.0,9.0,6.0,12.0,9.0,12.0,7.0,8.0,12.0,14.0,8.0,14.0,12.0,15.0,14.0,13.0,14.0,13.0,10.0,12.0,14.0,10.0,9.0,9.0,10.0,13.0,14.0,14.0,12.0,13.0,9.0,9.0,8.0,14.0,20.0,15.0,14.0,11.0,11.0,13.0,10.0,14.0,13.0,14.0,14.0,11.0,16.0,15.0,15.0,6.0,23.0,14.0,1.0,0.0,0.0,180.0,75.0,1.0,3.0,2.0,4.0,1.0,3.0,2.0,2.0,4.0,1.0,2.0,5.0,12.0,12.0,6.0,11.0,7.0,13.0,12.0,6.0,12.0,12.0,6.0,12.0,11.0,13.0,13.0,15.0,11.0,11.0,12.0,9.0,16.0,7.0,12.0,8.0,12.0,14.0,16.0,14.0,13.0,15.0,10.0,8.0,15.0,13.0,20.0,15.0,14.0,14.0,13.0,12.0,7.0,11.0,12.0,13.0,14.0,14.0,14.0,13.0,13.0,6.0,30.0,0.0,0.0,0.0,0.0,167.0,60.0,3.0,1.0,1.0,2.0,3.0,1.0,1.0,3.0,1.0,1.0,3.0,10.0,11.0,12.0,8.0,13.0,10.0,6.0,9.0,10.0,12.0,14.0,9.0,10.0,14.0,11.0,14.0,14.0,14.0,14.0,13.0,14.0,12.0,14.0,11.0,13.0,12.0,15.0,15.0,15.0,14.0,11.0,5.0,11.0,11.0,15.0,20.0,11.0,8.0,14.0,10.0,12.0,13.0,11.0,11.0,12.0,11.0,10.0,12.0,11.0,11.0,2.0,33.0,0.0,0.0,0.0,0.0,187.0,76.0,2.0,2.0,3.0,1.0,1.0,3.0,2.0,1.0,2.0,3.0,2.0,15.0,14.0,14.0,10.0,15.0,13.0,10.0,12.0,7.0,4.0,15.0,13.0,7.0,15.0,6.0,12.0,9.0,14.0,11.0,15.0,12.0,12.0,14.0,12.0,13.0,7.0,13.0,12.0,11.0,12.0,14.0,12.0,14.0,15.0,12.0,20.0,11.0,12.0,12.0,6.0,14.0,6.0,11.0,14.0,13.0,12.0,12.0,15.0,15.0,13.0,9.0,26.0,0.0,0.0,0.0,0.0,193.0,81.0,1.0,3.0,3.0,3.0,3.0,1.0,2.0,2.0,2.0,3.0,3.0,4.0,9.0,14.0,10.0,13.0,12.0,14.0,14.0,5.0,5.0,10.0,12.0,3.0,14.0,8.0,13.0,12.0,9.0,10.0,11.0,11.0,12.0,16.0,5.0,14.0,6.0,9.0,12.0,14.0,13.0,14.0,16.0,14.0,13.0,13.0,20.0,13.0,14.0,10.0,8.0,14.0,9.0,8.0,16.0,16.0,11.0,13.0,11.0,13.0,13.0,10.0,26.0,1.0,0.0,0.0,0.0,180.0,73.0,2.0,3.0,2.0,1.0,3.0,1.0,1.0,1.0,2.0,3.0,3.0,6.0,12.0,13.0,12.0,13.0,12.0,7.0,11.0,6.0,4.0,11.0,12.0,5.0,14.0,7.0,12.0,9.0,12.0,12.0,8.0,10.0,16.0,13.0,5.0,13.0,7.0,9.0,14.0,16.0,14.0,13.0,10.0,20.0,13.0,15.0,6.0,13.0,13.0,10.0,7.0,13.0,7.0,8.0,12.0,14.0,15.0,13.0,12.0,14.0,14.0,9.0,24.0,0.0,0.0,0.0,0.0,182.0,82.0,3.0,3.0,2.0,1.0,1.0,3.0,2.0,2.0,3.0,2.0,2.0,4.0,7.0,13.0,14.0,13.0,12.0,14.0,12.0,5.0,7.0,10.0,14.0,6.0,15.0,13.0,13.0,16.0,8.0,12.0,11.0,11.0,12.0,14.0,7.0,13.0,8.0,12.0,13.0,14.0,14.0,15.0,12.0,10.0,10.0,12.0,20.0,16.0,15.0,12.0,13.0,14.0,10.0,8.0,8.0,13.0,5.0,10.0,11.0,9.0,9.0,13.0,25.0,0.0,0.0,0.0,0.0,187.0,83.0,11.0,14.0,12.0,8.0,13.0,11.0,14.0,15.0,13.0,13.0,9.0,8.0,1.0,1.0,1.0,11.0,11.0,1.0,2.0,2.0,1.0,10.0,3.0,2.0,11.0,8.0,12.0,14.0,12.0,12.0,10.0,12.0,14.0,6.0,14.0,2.0,12.0,12.0,8.0,13.0,15.0,14.0,13.0,20.0,15.0,11.0,5.0,14.0,13.0,13.0,8.0,8.0,10.0,1.0,9.0,13.0,14.0,12.0,15.0,15.0,15.0,5.0,26.0,11.0,0.0,4.0,0.0,183.0,79.0,3.0,2.0,1.0,2.0,2.0,2.0,3.0,2.0,2.0,2.0,1.0,5.0,7.0,9.0,6.0,10.0,11.0,15.0,11.0,7.0,14.0,10.0,7.0,13.0,10.0,14.0,13.0,15.0,13.0,12.0,10.0,12.0,17.0,8.0,11.0,10.0,13.0,15.0,16.0,13.0,13.0,16.0,13.0,5.0,15.0,13.0,20.0,16.0,15.0,13.0,14.0,15.0,7.0,14.0,16.0,12.0,14.0,14.0,15.0,14.0,14.0,5.0,24.0,0.0,0.0,4.0,0.0,186.0,88.0,1.0,2.0,1.0,3.0,2.0,1.0,1.0,2.0,1.0,2.0,1.0,4.0,8.0,8.0,6.0,12.0,6.0,14.0,9.0,11.0,14.0,12.0,6.0,12.0,12.0,14.0,13.0,14.0,12.0,13.0,8.0,12.0,13.0,8.0,8.0,9.0,12.0,12.0,13.0,13.0,11.0,15.0,13.0,8.0,15.0,14.0,20.0,14.0,15.0,13.0,14.0,15.0,8.0,12.0,14.0,14.0,12.0,9.0,12.0,13.0,13.0,8.0,26.0,14.0,0.0,0.0,0.0,181.0,74.0,2.0,1.0,1.0,1.0,3.0,2.0,3.0,1.0,3.0,3.0,2.0,6.0,13.0,8.0,5.0,12.0,7.0,12.0,8.0,11.0,13.0,12.0,6.0,14.0,10.0,14.0,12.0,14.0,10.0,12.0,8.0,8.0,14.0,6.0,6.0,12.0,11.0,14.0,15.0,16.0,14.0,14.0,11.0,5.0,14.0,14.0,20.0,16.0,14.0,12.0,13.0,14.0,8.0,10.0,8.0,14.0,12.0,13.0,15.0,15.0,15.0,6.0,22.0,12.0,2.0,13.0,0.0,170.0,71.0,2.0,2.0,1.0,3.0,2.0,2.0,1.0,1.0,1.0,3.0,2.0,15.0,15.0,12.0,10.0,14.0,15.0,8.0,13.0,12.0,9.0,13.0,10.0,10.0,14.0,14.0,16.0,10.0,17.0,14.0,12.0,16.0,14.0,12.0,8.0,14.0,10.0,17.0,16.0,16.0,17.0,10.0,6.0,20.0,17.0,13.0,8.0,15.0,7.0,15.0,6.0,15.0,8.0,17.0,13.0,13.0,12.0,12.0,14.0,16.0,16.0,8.0,22.0,18.0,0.0,0.0,0.0,179.0,75.0,1.0,4.0,2.0,1.0,1.0,1.0,3.0,1.0,1.0,3.0,2.0,7.0,8.0,12.0,8.0,13.0,10.0,11.0,12.0,11.0,11.0,11.0,10.0,14.0,13.0,15.0,12.0,15.0,8.0,12.0,10.0,12.0,14.0,12.0,10.0,13.0,12.0,13.0,17.0,14.0,14.0,13.0,10.0,9.0,15.0,15.0,20.0,15.0,14.0,13.0,13.0,12.0,11.0,12.0,13.0,15.0,9.0,10.0,12.0,10.0,10.0,4.0,30.0,7.0,0.0,0.0,0.0,181.0,72.0,1.0,3.0,3.0,1.0,2.0,3.0,2.0,1.0,3.0,2.0,2.0,12.0,11.0,14.0,8.0,14.0,12.0,8.0,12.0,6.0,5.0,13.0,13.0,5.0,14.0,8.0,12.0,10.0,11.0,12.0,15.0,11.0,13.0,14.0,9.0,13.0,10.0,12.0,13.0,12.0,14.0,12.0,10.0,12.0,15.0,13.0,20.0,15.0,9.0,10.0,8.0,13.0,5.0,8.0,12.0,14.0,14.0,12.0,11.0,14.0,14.0,8.0,27.0,0.0,0.0,0.0,0.0,173.0,68.0,2.0,2.0,1.0,1.0,3.0,3.0,1.0,2.0,3.0,4.0,2.0,12.0,12.0,13.0,8.0,13.0,10.0,7.0,8.0,9.0,7.0,12.0,10.0,9.0,14.0,7.0,10.0,8.0,11.0,12.0,12.0,11.0,12.0,13.0,5.0,13.0,10.0,10.0,12.0,14.0,14.0,11.0,7.0,20.0,12.0,15.0,10.0,13.0,8.0,12.0,7.0,13.0,9.0,12.0,18.0,12.0,14.0,11.0,14.0,15.0,15.0,6.0,28.0,0.0,0.0,0.0,0.0,170.0,67.0,2.0,3.0,3.0,4.0,3.0,2.0,1.0,1.0,2.0,2.0,3.0,8.0,12.0,12.0,10.0,14.0,7.0,5.0,10.0,6.0,5.0,12.0,5.0,4.0,13.0,7.0,16.0,12.0,9.0,11.0,12.0,10.0,3.0,12.0,6.0,13.0,6.0,8.0,13.0,16.0,13.0,10.0,5.0,5.0,13.0,16.0,20.0,15.0,7.0,12.0,4.0,9.0,7.0,10.0,20.0,13.0,12.0,10.0,13.0,11.0,10.0,2.0,24.0,24.0,4.0,0.0,0.0,172.0,74.0,2.0,4.0,3.0,2.0,2.0,1.0,2.0,2.0,3.0,2.0,4.0,8.0,9.0,14.0,13.0,14.0,9.0,11.0,10.0,7.0,5.0,12.0,12.0,3.0,13.0,10.0,12.0,12.0,13.0,12.0,11.0,10.0,14.0,13.0,7.0,14.0,9.0,9.0,13.0,16.0,15.0,13.0,6.0,8.0,13.0,16.0,20.0,14.0,12.0,11.0,11.0,13.0,9.0,8.0,9.0,13.0,9.0,11.0,12.0,13.0,10.0,9.0,24.0,0.0,0.0,5.0,0.0,183.0,79.0,4.0,4.0,3.0,3.0,1.0,3.0,2.0,1.0,3.0,2.0,3.0,4.0,7.0,12.0,13.0,12.0,8.0,13.0,12.0,5.0,6.0,11.0,12.0,4.0,13.0,11.0,12.0,14.0,9.0,12.0,10.0,10.0,13.0,12.0,6.0,14.0,12.0,13.0,14.0,15.0,14.0,14.0,11.0,10.0,13.0,14.0,20.0,14.0,14.0,12.0,12.0,14.0,9.0,5.0,7.0,13.0,15.0,11.0,14.0,14.0,14.0,6.0
4,1,33.0,101.0,0.0,0.0,0.0,182.0,87.0,12.0,11.0,15.0,12.0,14.0,13.0,14.0,15.0,15.0,13.0,12.0,9.0,2.0,3.0,8.0,9.0,11.0,10.0,11.0,1.0,3.0,12.0,15.0,8.0,10.0,8.0,14.0,14.0,14.0,12.0,9.0,12.0,16.0,9.0,15.0,2.0,13.0,12.0,6.0,12.0,13.0,14.0,13.0,8.0,13.0,10.0,20.0,12.0,15.0,13.0,8.0,15.0,5.0,1.0,13.0,15.0,13.0,15.0,18.0,18.0,15.0,5.0,33.0,37.0,2.0,0.0,0.0,190.0,86.0,3.0,3.0,1.0,2.0,1.0,1.0,1.0,3.0,1.0,3.0,3.0,4.0,9.0,9.0,8.0,12.0,5.0,16.0,9.0,7.0,15.0,12.0,8.0,15.0,12.0,12.0,15.0,16.0,14.0,14.0,11.0,12.0,14.0,8.0,12.0,8.0,15.0,13.0,12.0,11.0,9.0,15.0,15.0,10.0,12.0,10.0,20.0,12.0,15.0,14.0,12.0,14.0,15.0,8.0,13.0,12.0,13.0,14.0,14.0,14.0,13.0,11.0,23.0,0.0,0.0,0.0,0.0,184.0,81.0,1.0,1.0,3.0,2.0,1.0,2.0,3.0,1.0,2.0,3.0,3.0,4.0,11.0,9.0,6.0,12.0,6.0,13.0,11.0,7.0,14.0,13.0,8.0,14.0,12.0,14.0,12.0,15.0,14.0,13.0,12.0,12.0,14.0,8.0,10.0,11.0,12.0,14.0,16.0,13.0,13.0,15.0,12.0,8.0,14.0,12.0,20.0,14.0,14.0,12.0,13.0,15.0,10.0,12.0,17.0,13.0,13.0,11.0,13.0,13.0,13.0,7.0,32.0,0.0,0.0,0.0,0.0,195.0,89.0,3.0,2.0,3.0,1.0,4.0,2.0,4.0,2.0,3.0,1.0,2.0,3.0,5.0,5.0,11.0,8.0,8.0,14.0,9.0,11.0,15.0,12.0,9.0,13.0,8.0,16.0,13.0,19.0,10.0,14.0,8.0,13.0,16.0,5.0,15.0,10.0,15.0,15.0,14.0,8.0,8.0,16.0,17.0,5.0,11.0,10.0,20.0,13.0,17.0,13.0,12.0,15.0,7.0,5.0,12.0,14.0,14.0,12.0,15.0,8.0,8.0,7.0,25.0,0.0,0.0,26.0,3.0,176.0,64.0,3.0,2.0,2.0,1.0,3.0,3.0,3.0,2.0,1.0,1.0,1.0,12.0,13.0,12.0,7.0,13.0,13.0,11.0,11.0,11.0,14.0,13.0,11.0,14.0,13.0,13.0,13.0,14.0,13.0,13.0,11.0,13.0,17.0,12.0,11.0,10.0,12.0,14.0,14.0,14.0,14.0,12.0,8.0,8.0,17.0,14.0,20.0,15.0,12.0,14.0,12.0,13.0,5.0,12.0,17.0,15.0,15.0,14.0,16.0,15.0,15.0,7.0,23.0,0.0,0.0,1.0,0.0,182.0,71.0,3.0,1.0,2.0,3.0,4.0,2.0,3.0,1.0,2.0,1.0,3.0,9.0,13.0,14.0,8.0,14.0,13.0,12.0,10.0,13.0,14.0,14.0,13.0,15.0,13.0,14.0,14.0,13.0,11.0,12.0,12.0,13.0,16.0,12.0,12.0,15.0,13.0,14.0,15.0,15.0,13.0,14.0,12.0,9.0,16.0,15.0,20.0,15.0,15.0,15.0,10.0,14.0,6.0,12.0,8.0,15.0,14.0,16.0,15.0,15.0,16.0,6.0,36.0,0.0,0.0,3.0,0.0,168.0,72.0,3.0,2.0,1.0,3.0,1.0,3.0,3.0,1.0,3.0,3.0,1.0,11.0,8.0,12.0,5.0,13.0,11.0,8.0,13.0,6.0,12.0,13.0,8.0,14.0,13.0,17.0,14.0,17.0,14.0,15.0,13.0,14.0,17.0,12.0,16.0,10.0,15.0,16.0,14.0,10.0,13.0,14.0,4.0,8.0,16.0,8.0,20.0,12.0,13.0,17.0,14.0,14.0,7.0,10.0,19.0,15.0,14.0,16.0,15.0,9.0,9.0,7.0,33.0,14.0,0.0,0.0,0.0,172.0,68.0,3.0,3.0,1.0,1.0,1.0,1.0,1.0,3.0,1.0,2.0,1.0,14.0,11.0,13.0,8.0,14.0,13.0,7.0,13.0,4.0,10.0,13.0,10.0,12.0,14.0,11.0,13.0,14.0,13.0,13.0,12.0,14.0,15.0,10.0,13.0,12.0,13.0,16.0,17.0,13.0,13.0,12.0,7.0,10.0,14.0,12.0,20.0,14.0,9.0,14.0,11.0,15.0,10.0,12.0,20.0,13.0,13.0,15.0,14.0,13.0,12.0,8.0,22.0,2.0,0.0,0.0,0.0,169.0,59.0,3.0,1.0,3.0,1.0,1.0,1.0,1.0,1.0,3.0,3.0,2.0,13.0,13.0,15.0,13.0,15.0,13.0,7.0,13.0,8.0,6.0,13.0,13.0,5.0,16.0,10.0,10.0,8.0,13.0,11.0,14.0,12.0,12.0,14.0,10.0,12.0,6.0,10.0,8.0,16.0,15.0,17.0,6.0,12.0,12.0,15.0,20.0,13.0,9.0,12.0,8.0,12.0,8.0,12.0,13.0,13.0,13.0,14.0,12.0,10.0,13.0,9.0,31.0,1.0,0.0,0.0,0.0,178.0,74.0,1.0,3.0,2.0,2.0,2.0,1.0,2.0,2.0,3.0,1.0,3.0,12.0,13.0,13.0,7.0,15.0,13.0,10.0,12.0,7.0,6.0,14.0,11.0,8.0,15.0,14.0,14.0,13.0,13.0,12.0,13.0,13.0,15.0,14.0,10.0,12.0,10.0,10.0,12.0,12.0,13.0,14.0,10.0,10.0,15.0,12.0,20.0,14.0,12.0,11.0,14.0,14.0,6.0,14.0,12.0,14.0,10.0,12.0,13.0,10.0,6.0,14.0,26.0,0.0,0.0,0.0,0.0,171.0,69.0,2.0,3.0,4.0,3.0,1.0,1.0,1.0,2.0,1.0,2.0,1.0,7.0,7.0,12.0,14.0,14.0,7.0,7.0,9.0,6.0,8.0,8.0,5.0,6.0,11.0,9.0,11.0,8.0,10.0,8.0,9.0,12.0,11.0,15.0,7.0,13.0,8.0,7.0,9.0,12.0,12.0,12.0,10.0,10.0,10.0,14.0,20.0,8.0,8.0,14.0,9.0,11.0,4.0,9.0,13.0,12.0,10.0,12.0,10.0,3.0,7.0,8.0,31.0,25.0,0.0,6.0,0.0,191.0,84.0,11.0,14.0,13.0,12.0,15.0,14.0,15.0,16.0,13.0,14.0,14.0,8.0,2.0,10.0,5.0,11.0,11.0,7.0,10.0,2.0,5.0,10.0,11.0,11.0,9.0,12.0,13.0,15.0,13.0,13.0,8.0,13.0,16.0,12.0,14.0,1.0,16.0,13.0,11.0,12.0,13.0,16.0,16.0,8.0,16.0,13.0,20.0,15.0,15.0,17.0,8.0,15.0,7.0,2.0,15.0,15.0,17.0,15.0,17.0,16.0,15.0,6.0,38.0,89.0,6.0,14.0,1.0,183.0,79.0,3.0,3.0,2.0,3.0,2.0,3.0,2.0,4.0,3.0,2.0,3.0,4.0,8.0,8.0,7.0,12.0,6.0,14.0,8.0,11.0,17.0,12.0,11.0,16.0,12.0,15.0,16.0,17.0,15.0,17.0,10.0,16.0,18.0,6.0,15.0,8.0,16.0,17.0,13.0,8.0,8.0,12.0,11.0,10.0,13.0,8.0,20.0,10.0,11.0,16.0,12.0,16.0,11.0,7.0,15.0,16.0,16.0,15.0,18.0,16.0,14.0,4.0,32.0,0.0,0.0,3.0,0.0,187.0,82.0,1.0,2.0,2.0,3.0,2.0,1.0,1.0,2.0,2.0,3.0,1.0,5.0,11.0,8.0,7.0,10.0,6.0,15.0,9.0,13.0,15.0,10.0,8.0,16.0,9.0,16.0,14.0,17.0,12.0,15.0,8.0,12.0,17.0,9.0,14.0,11.0,13.0,15.0,13.0,12.0,11.0,16.0,14.0,6.0,13.0,14.0,20.0,13.0,16.0,15.0,14.0,14.0,8.0,14.0,14.0,14.0,15.0,16.0,15.0,12.0,10.0,7.0,23.0,0.0,0.0,0.0,0.0,184.0,77.0,1.0,1.0,1.0,1.0,3.0,2.0,3.0,2.0,2.0,2.0,3.0,6.0,9.0,11.0,7.0,12.0,7.0,15.0,9.0,11.0,14.0,13.0,10.0,15.0,12.0,14.0,15.0,15.0,13.0,12.0,11.0,13.0,15.0,11.0,9.0,9.0,14.0,14.0,14.0,14.0,13.0,15.0,13.0,9.0,16.0,15.0,20.0,14.0,14.0,14.0,11.0,14.0,4.0,11.0,14.0,13.0,15.0,14.0,16.0,14.0,15.0,6.0,31.0,0.0,0.0,6.0,0.0,174.0,80.0,1.0,1.0,1.0,1.0,1.0,5.0,1.0,1.0,1.0,1.0,1.0,14.0,12.0,11.0,7.0,12.0,13.0,9.0,7.0,10.0,11.0,11.0,10.0,10.0,12.0,11.0,11.0,11.0,10.0,6.0,10.0,9.0,12.0,12.0,12.0,10.0,12.0,12.0,14.0,12.0,15.0,10.0,9.0,20.0,12.0,12.0,7.0,12.0,9.0,9.0,10.0,12.0,7.0,9.0,11.0,14.0,9.0,7.0,14.0,8.0,9.0,9.0,28.0,54.0,3.0,5.0,1.0,184.0,76.0,1.0,3.0,3.0,3.0,2.0,2.0,2.0,1.0,2.0,2.0,1.0,8.0,13.0,11.0,7.0,10.0,7.0,13.0,9.0,14.0,12.0,11.0,8.0,14.0,11.0,13.0,12.0,14.0,11.0,12.0,9.0,11.0,12.0,8.0,7.0,13.0,11.0,14.0,14.0,14.0,13.0,15.0,12.0,20.0,14.0,15.0,5.0,12.0,16.0,10.0,11.0,11.0,8.0,10.0,4.0,13.0,13.0,11.0,12.0,12.0,11.0,9.0,32.0,36.0,0.0,12.0,2.0,183.0,77.0,1.0,3.0,2.0,1.0,3.0,1.0,1.0,2.0,1.0,1.0,3.0,6.0,11.0,8.0,6.0,13.0,11.0,13.0,10.0,6.0,15.0,14.0,10.0,17.0,12.0,15.0,16.0,18.0,14.0,17.0,12.0,15.0,17.0,11.0,17.0,7.0,17.0,20.0,16.0,9.0,11.0,15.0,11.0,8.0,15.0,10.0,20.0,14.0,14.0,17.0,10.0,16.0,10.0,13.0,15.0,15.0,15.0,14.0,18.0,15.0,13.0,6.0,20.0,0.0,0.0,7.0,1.0,170.0,58.0,1.0,2.0,2.0,2.0,2.0,2.0,2.0,4.0,1.0,3.0,2.0,16.0,14.0,16.0,13.0,16.0,17.0,5.0,14.0,2.0,6.0,15.0,13.0,4.0,17.0,9.0,12.0,14.0,12.0,12.0,14.0,13.0,15.0,16.0,7.0,13.0,9.0,13.0,15.0,15.0,16.0,11.0,7.0,20.0,14.0,15.0,8.0,14.0,8.0,15.0,5.0,15.0,7.0,16.0,15.0,15.0,15.0,14.0,16.0,18.0,16.0,3.0,30.0,18.0,2.0,0.0,0.0,184.0,79.0,2.0,2.0,2.0,1.0,2.0,2.0,3.0,1.0,3.0,1.0,1.0,13.0,16.0,15.0,10.0,13.0,12.0,9.0,11.0,11.0,10.0,14.0,12.0,8.0,14.0,14.0,10.0,15.0,10.0,12.0,12.0,11.0,15.0,12.0,14.0,14.0,11.0,13.0,14.0,15.0,14.0,15.0,11.0,7.0,15.0,15.0,20.0,15.0,14.0,13.0,13.0,13.0,11.0,14.0,12.0,14.0,14.0,10.0,13.0,14.0,11.0,9.0,21.0,7.0,0.0,14.0,6.0,173.0,64.0,3.0,2.0,3.0,2.0,3.0,3.0,3.0,2.0,3.0,3.0,3.0,14.0,14.0,18.0,14.0,17.0,14.0,7.0,11.0,2.0,6.0,15.0,14.0,6.0,18.0,12.0,14.0,14.0,15.0,13.0,16.0,14.0,17.0,17.0,12.0,13.0,9.0,13.0,17.0,15.0,17.0,13.0,7.0,20.0,14.0,14.0,9.0,14.0,9.0,15.0,7.0,16.0,7.0,14.0,15.0,17.0,15.0,16.0,17.0,16.0,15.0,4.0,32.0,22.0,4.0,5.0,4.0,171.0,72.0,3.0,3.0,3.0,1.0,3.0,1.0,1.0,2.0,2.0,2.0,3.0,10.0,10.0,13.0,14.0,14.0,11.0,13.0,12.0,5.0,7.0,12.0,16.0,8.0,14.0,11.0,14.0,12.0,12.0,11.0,13.0,13.0,13.0,15.0,8.0,16.0,7.0,12.0,11.0,14.0,14.0,15.0,7.0,12.0,12.0,13.0,20.0,13.0,14.0,12.0,8.0,15.0,7.0,11.0,15.0,17.0,11.0,14.0,12.0,11.0,15.0,11.0
1,1,25.0,0.0,0.0,0.0,0.0,187.0,83.0,11.0,14.0,12.0,8.0,13.0,11.0,14.0,15.0,13.0,13.0,9.0,8.0,1.0,1.0,1.0,11.0,11.0,1.0,2.0,2.0,1.0,10.0,3.0,2.0,11.0,8.0,12.0,14.0,12.0,12.0,10.0,12.0,14.0,6.0,14.0,2.0,12.0,12.0,8.0,13.0,15.0,14.0,13.0,20.0,15.0,11.0,5.0,14.0,13.0,13.0,8.0,8.0,10.0,1.0,9.0,13.0,14.0,12.0,15.0,15.0,15.0,5.0,24.0,0.0,0.0,4.0,0.0,186.0,88.0,1.0,2.0,1.0,3.0,2.0,1.0,1.0,2.0,1.0,2.0,1.0,4.0,8.0,8.0,6.0,12.0,6.0,14.0,9.0,11.0,14.0,12.0,6.0,12.0,12.0,14.0,13.0,14.0,12.0,13.0,8.0,12.0,13.0,8.0,8.0,9.0,12.0,12.0,13.0,13.0,11.0,15.0,13.0,8.0,15.0,14.0,20.0,14.0,15.0,13.0,14.0,15.0,8.0,12.0,14.0,14.0,12.0,9.0,12.0,13.0,13.0,8.0,26.0,11.0,0.0,4.0,0.0,183.0,79.0,3.0,2.0,1.0,2.0,2.0,2.0,3.0,2.0,2.0,2.0,1.0,5.0,7.0,9.0,6.0,10.0,11.0,15.0,11.0,7.0,14.0,10.0,7.0,13.0,10.0,14.0,13.0,15.0,13.0,12.0,10.0,12.0,17.0,8.0,11.0,10.0,13.0,15.0,16.0,13.0,13.0,16.0,13.0,5.0,15.0,13.0,20.0,16.0,15.0,13.0,14.0,15.0,7.0,14.0,16.0,12.0,14.0,14.0,15.0,14.0,14.0,5.0,22.0,12.0,2.0,13.0,0.0,170.0,71.0,2.0,2.0,1.0,3.0,2.0,2.0,1.0,1.0,1.0,3.0,2.0,15.0,15.0,12.0,10.0,14.0,15.0,8.0,13.0,12.0,9.0,13.0,10.0,10.0,14.0,14.0,16.0,10.0,17.0,14.0,12.0,16.0,14.0,12.0,8.0,14.0,10.0,17.0,16.0,16.0,17.0,10.0,6.0,20.0,17.0,13.0,8.0,15.0,7.0,15.0,6.0,15.0,8.0,17.0,13.0,13.0,12.0,12.0,14.0,16.0,16.0,8.0,26.0,14.0,0.0,0.0,0.0,181.0,74.0,2.0,1.0,1.0,1.0,3.0,2.0,3.0,1.0,3.0,3.0,2.0,6.0,13.0,8.0,5.0,12.0,7.0,12.0,8.0,11.0,13.0,12.0,6.0,14.0,10.0,14.0,12.0,14.0,10.0,12.0,8.0,8.0,14.0,6.0,6.0,12.0,11.0,14.0,15.0,16.0,14.0,14.0,11.0,5.0,14.0,14.0,20.0,16.0,14.0,12.0,13.0,14.0,8.0,10.0,8.0,14.0,12.0,13.0,15.0,15.0,15.0,6.0,22.0,0.0,0.0,0.0,0.0,179.0,75.0,1.0,3.0,1.0,3.0,3.0,2.0,1.0,4.0,3.0,2.0,2.0,9.0,12.0,11.0,7.0,13.0,12.0,8.0,11.0,5.0,11.0,13.0,11.0,9.0,12.0,12.0,14.0,13.0,12.0,11.0,11.0,12.0,14.0,9.0,8.0,10.0,13.0,15.0,14.0,13.0,13.0,13.0,9.0,8.0,14.0,12.0,20.0,14.0,12.0,12.0,12.0,15.0,10.0,10.0,9.0,14.0,14.0,13.0,16.0,13.0,14.0,6.0,22.0,18.0,0.0,0.0,0.0,179.0,75.0,1.0,4.0,2.0,1.0,1.0,1.0,3.0,1.0,1.0,3.0,2.0,7.0,8.0,12.0,8.0,13.0,10.0,11.0,12.0,11.0,11.0,11.0,10.0,14.0,13.0,15.0,12.0,15.0,8.0,12.0,10.0,12.0,14.0,12.0,10.0,13.0,12.0,13.0,17.0,14.0,14.0,13.0,10.0,9.0,15.0,15.0,20.0,15.0,14.0,13.0,13.0,12.0,11.0,12.0,13.0,15.0,9.0,10.0,12.0,10.0,10.0,4.0,27.0,0.0,0.0,0.0,0.0,173.0,68.0,2.0,2.0,1.0,1.0,3.0,3.0,1.0,2.0,3.0,4.0,2.0,12.0,12.0,13.0,8.0,13.0,10.0,7.0,8.0,9.0,7.0,12.0,10.0,9.0,14.0,7.0,10.0,8.0,11.0,12.0,12.0,11.0,12.0,13.0,5.0,13.0,10.0,10.0,12.0,14.0,14.0,11.0,7.0,20.0,12.0,15.0,10.0,13.0,8.0,12.0,7.0,13.0,9.0,12.0,18.0,12.0,14.0,11.0,14.0,15.0,15.0,6.0,28.0,0.0,0.0,0.0,0.0,170.0,67.0,2.0,3.0,3.0,4.0,3.0,2.0,1.0,1.0,2.0,2.0,3.0,8.0,12.0,12.0,10.0,14.0,7.0,5.0,10.0,6.0,5.0,12.0,5.0,4.0,13.0,7.0,16.0,12.0,9.0,11.0,12.0,10.0,3.0,12.0,6.0,13.0,6.0,8.0,13.0,16.0,13.0,10.0,5.0,5.0,13.0,16.0,20.0,15.0,7.0,12.0,4.0,9.0,7.0,10.0,20.0,13.0,12.0,10.0,13.0,11.0,10.0,2.0,27.0,33.0,4.0,3.0,0.0,180.0,75.0,2.0,1.0,2.0,1.0,4.0,2.0,1.0,3.0,1.0,1.0,2.0,12.0,11.0,13.0,13.0,11.0,11.0,11.0,10.0,7.0,5.0,10.0,14.0,5.0,14.0,9.0,11.0,12.0,10.0,11.0,12.0,12.0,14.0,13.0,8.0,14.0,8.0,11.0,14.0,16.0,14.0,13.0,10.0,7.0,12.0,15.0,20.0,14.0,12.0,12.0,9.0,13.0,10.0,10.0,9.0,15.0,8.0,9.0,13.0,14.0,14.0,7.0,24.0,0.0,0.0,5.0,0.0,183.0,79.0,4.0,4.0,3.0,3.0,1.0,3.0,2.0,1.0,3.0,2.0,3.0,4.0,7.0,12.0,13.0,12.0,8.0,13.0,12.0,5.0,6.0,11.0,12.0,4.0,13.0,11.0,12.0,14.0,9.0,12.0,10.0,10.0,13.0,12.0,6.0,14.0,12.0,13.0,14.0,15.0,14.0,14.0,11.0,10.0,13.0,14.0,20.0,14.0,14.0,12.0,12.0,14.0,9.0,5.0,7.0,13.0,15.0,11.0,14.0,14.0,14.0,6.0,17.0,0.0,0.0,0.0,0.0,193.0,82.0,13.0,11.0,12.0,2.0,12.0,10.0,14.0,15.0,14.0,12.0,10.0,3.0,1.0,1.0,3.0,5.0,6.0,2.0,2.0,1.0,3.0,9.0,3.0,1.0,8.0,7.0,12.0,13.0,13.0,13.0,11.0,11.0,15.0,3.0,8.0,3.0,12.0,12.0,11.0,10.0,12.0,14.0,17.0,5.0,15.0,11.0,20.0,13.0,12.0,13.0,8.0,11.0,5.0,11.0,13.0,15.0,15.0,17.0,14.0,15.0,15.0,5.0,26.0,5.0,0.0,0.0,0.0,184.0,86.0,3.0,3.0,2.0,1.0,2.0,2.0,4.0,1.0,3.0,1.0,3.0,4.0,10.0,9.0,6.0,10.0,7.0,14.0,8.0,8.0,14.0,9.0,6.0,14.0,9.0,14.0,14.0,16.0,9.0,15.0,7.0,11.0,13.0,8.0,10.0,9.0,13.0,12.0,12.0,12.0,12.0,17.0,12.0,5.0,15.0,15.0,20.0,14.0,17.0,11.0,14.0,13.0,7.0,10.0,13.0,16.0,14.0,11.0,11.0,12.0,9.0,14.0,23.0,0.0,0.0,0.0,0.0,180.0,77.0,2.0,1.0,3.0,2.0,3.0,2.0,2.0,2.0,3.0,1.0,2.0,6.0,11.0,11.0,6.0,13.0,7.0,11.0,5.0,8.0,14.0,12.0,9.0,12.0,9.0,15.0,14.0,17.0,10.0,14.0,8.0,13.0,14.0,7.0,8.0,7.0,10.0,13.0,15.0,15.0,13.0,13.0,10.0,5.0,14.0,14.0,20.0,15.0,14.0,14.0,15.0,6.0,7.0,11.0,18.0,13.0,14.0,15.0,13.0,12.0,14.0,2.0,23.0,1.0,0.0,4.0,0.0,190.0,80.0,1.0,4.0,1.0,3.0,3.0,1.0,1.0,1.0,2.0,4.0,2.0,6.0,11.0,13.0,7.0,13.0,6.0,11.0,8.0,10.0,15.0,12.0,5.0,15.0,12.0,14.0,14.0,16.0,9.0,11.0,10.0,10.0,16.0,12.0,12.0,9.0,12.0,10.0,14.0,14.0,12.0,15.0,17.0,8.0,15.0,16.0,20.0,13.0,14.0,13.0,8.0,13.0,6.0,14.0,11.0,14.0,12.0,13.0,16.0,14.0,12.0,6.0,26.0,4.0,0.0,2.0,0.0,180.0,74.0,3.0,3.0,1.0,2.0,2.0,1.0,3.0,4.0,1.0,2.0,1.0,8.0,13.0,13.0,6.0,13.0,9.0,12.0,7.0,11.0,13.0,13.0,11.0,12.0,12.0,16.0,14.0,14.0,9.0,12.0,11.0,13.0,4.0,4.0,6.0,11.0,12.0,8.0,12.0,14.0,14.0,13.0,9.0,20.0,16.0,13.0,5.0,15.0,13.0,12.0,6.0,9.0,10.0,12.0,8.0,14.0,8.0,11.0,12.0,11.0,13.0,2.0,26.0,17.0,0.0,19.0,1.0,191.0,79.0,3.0,2.0,1.0,1.0,1.0,1.0,2.0,2.0,3.0,3.0,4.0,4.0,8.0,11.0,9.0,12.0,7.0,14.0,10.0,6.0,12.0,13.0,7.0,11.0,12.0,14.0,13.0,14.0,12.0,10.0,11.0,12.0,15.0,9.0,7.0,11.0,12.0,12.0,15.0,14.0,13.0,16.0,15.0,8.0,15.0,13.0,20.0,19.0,15.0,11.0,14.0,14.0,7.0,12.0,12.0,14.0,12.0,10.0,9.0,14.0,14.0,14.0,19.0,0.0,0.0,0.0,0.0,184.0,78.0,3.0,1.0,2.0,1.0,2.0,2.0,2.0,3.0,3.0,4.0,2.0,6.0,8.0,9.0,5.0,13.0,6.0,11.0,8.0,5.0,13.0,13.0,8.0,12.0,13.0,13.0,13.0,15.0,12.0,12.0,13.0,12.0,14.0,7.0,11.0,8.0,15.0,14.0,15.0,13.0,12.0,14.0,11.0,5.0,15.0,12.0,20.0,16.0,14.0,13.0,12.0,11.0,7.0,10.0,19.0,13.0,15.0,12.0,14.0,13.0,12.0,6.0,32.0,0.0,0.0,13.0,0.0,175.0,65.0,2.0,1.0,1.0,2.0,3.0,3.0,1.0,2.0,3.0,2.0,3.0,15.0,13.0,11.0,6.0,14.0,13.0,10.0,12.0,8.0,8.0,16.0,8.0,12.0,13.0,11.0,14.0,15.0,14.0,15.0,14.0,14.0,14.0,6.0,13.0,9.0,15.0,18.0,13.0,12.0,13.0,13.0,8.0,8.0,13.0,10.0,20.0,13.0,13.0,12.0,11.0,15.0,12.0,10.0,17.0,14.0,15.0,14.0,16.0,14.0,14.0,6.0,24.0,1.0,0.0,0.0,0.0,168.0,66.0,2.0,3.0,1.0,1.0,2.0,1.0,3.0,1.0,1.0,1.0,2.0,10.0,15.0,15.0,6.0,14.0,12.0,5.0,12.0,5.0,5.0,14.0,8.0,3.0,15.0,7.0,9.0,8.0,12.0,12.0,13.0,12.0,15.0,16.0,5.0,15.0,5.0,9.0,13.0,16.0,17.0,9.0,5.0,8.0,14.0,12.0,20.0,11.0,5.0,12.0,7.0,14.0,7.0,11.0,17.0,14.0,14.0,11.0,11.0,14.0,14.0,7.0,25.0,0.0,0.0,3.0,0.0,170.0,68.0,2.0,1.0,3.0,1.0,3.0,1.0,3.0,2.0,2.0,4.0,1.0,12.0,11.0,15.0,16.0,16.0,13.0,11.0,12.0,4.0,5.0,12.0,14.0,4.0,17.0,7.0,14.0,7.0,15.0,13.0,13.0,14.0,14.0,15.0,7.0,16.0,8.0,10.0,13.0,15.0,15.0,12.0,6.0,11.0,14.0,14.0,20.0,13.0,11.0,12.0,7.0,15.0,7.0,8.0,12.0,14.0,13.0,14.0,13.0,16.0,16.0,8.0,25.0,14.0,1.0,2.0,0.0,177.0,77.0,3.0,3.0,1.0,2.0,3.0,3.0,1.0,3.0,3.0,4.0,1.0,8.0,11.0,13.0,12.0,12.0,10.0,11.0,10.0,2.0,3.0,11.0,10.0,5.0,13.0,12.0,12.0,13.0,11.0,10.0,11.0,10.0,14.0,16.0,14.0,15.0,5.0,13.0,14.0,15.0,14.0,12.0,12.0,12.0,14.0,16.0,20.0,13.0,14.0,13.0,7.0,14.0,11.0,13.0,14.0,11.0,12.0,8.0,12.0,13.0,15.0,6.0
2,4,27.0,0.0,0.0,2.0,0.0,188.0,81.0,9.0,10.0,8.0,6.0,13.0,8.0,14.0,15.0,12.0,12.0,10.0,4.0,3.0,2.0,2.0,8.0,8.0,2.0,2.0,1.0,3.0,8.0,3.0,1.0,8.0,8.0,12.0,13.0,12.0,12.0,8.0,11.0,15.0,6.0,9.0,1.0,12.0,11.0,9.0,13.0,14.0,15.0,14.0,5.0,15.0,11.0,20.0,13.0,15.0,12.0,8.0,15.0,5.0,1.0,19.0,13.0,10.0,15.0,14.0,14.0,14.0,6.0,29.0,0.0,0.0,0.0,0.0,188.0,80.0,2.0,1.0,3.0,4.0,1.0,3.0,1.0,3.0,1.0,1.0,3.0,5.0,6.0,9.0,6.0,12.0,8.0,13.0,9.0,7.0,13.0,11.0,8.0,12.0,12.0,12.0,12.0,13.0,11.0,10.0,9.0,11.0,14.0,8.0,10.0,9.0,11.0,12.0,13.0,12.0,11.0,15.0,14.0,10.0,15.0,13.0,20.0,13.0,15.0,13.0,13.0,11.0,12.0,14.0,15.0,14.0,12.0,10.0,14.0,14.0,14.0,5.0,26.0,0.0,0.0,0.0,0.0,181.0,77.0,1.0,3.0,1.0,1.0,3.0,3.0,3.0,1.0,1.0,2.0,3.0,5.0,8.0,8.0,6.0,12.0,6.0,13.0,7.0,7.0,13.0,14.0,7.0,12.0,13.0,12.0,13.0,11.0,14.0,14.0,13.0,13.0,13.0,6.0,10.0,7.0,14.0,13.0,13.0,12.0,11.0,14.0,11.0,7.0,8.0,11.0,20.0,13.0,14.0,12.0,9.0,14.0,14.0,10.0,15.0,13.0,14.0,15.0,15.0,15.0,15.0,6.0,25.0,0.0,0.0,9.0,0.0,183.0,78.0,1.0,3.0,1.0,1.0,1.0,2.0,3.0,2.0,1.0,3.0,2.0,5.0,12.0,10.0,5.0,11.0,6.0,13.0,8.0,10.0,13.0,10.0,6.0,12.0,12.0,13.0,11.0,13.0,10.0,10.0,10.0,9.0,12.0,8.0,7.0,12.0,11.0,12.0,12.0,16.0,13.0,13.0,11.0,20.0,14.0,15.0,7.0,14.0,11.0,11.0,13.0,12.0,6.0,8.0,13.0,15.0,12.0,10.0,8.0,14.0,14.0,10.0,19.0,0.0,0.0,0.0,0.0,174.0,61.0,2.0,3.0,1.0,1.0,1.0,3.0,3.0,4.0,2.0,1.0,3.0,10.0,11.0,12.0,9.0,12.0,8.0,8.0,10.0,8.0,11.0,13.0,9.0,7.0,12.0,9.0,12.0,12.0,12.0,13.0,13.0,11.0,12.0,11.0,9.0,12.0,12.0,13.0,11.0,11.0,12.0,10.0,6.0,11.0,13.0,12.0,20.0,12.0,11.0,12.0,8.0,12.0,8.0,13.0,10.0,11.0,10.0,11.0,11.0,11.0,12.0,4.0,22.0,0.0,0.0,0.0,0.0,180.0,74.0,2.0,4.0,2.0,1.0,3.0,1.0,2.0,1.0,1.0,2.0,3.0,7.0,8.0,10.0,7.0,13.0,10.0,8.0,11.0,5.0,13.0,13.0,12.0,10.0,13.0,12.0,13.0,12.0,12.0,14.0,12.0,12.0,14.0,11.0,7.0,8.0,12.0,14.0,14.0,12.0,12.0,13.0,9.0,14.0,14.0,12.0,20.0,14.0,11.0,14.0,10.0,14.0,8.0,10.0,14.0,14.0,12.0,9.0,12.0,10.0,7.0,7.0,32.0,0.0,0.0,0.0,0.0,183.0,77.0,2.0,2.0,3.0,2.0,1.0,2.0,2.0,1.0,2.0,2.0,3.0,13.0,14.0,12.0,11.0,14.0,14.0,10.0,13.0,8.0,6.0,13.0,14.0,5.0,14.0,7.0,12.0,11.0,13.0,13.0,13.0,13.0,12.0,12.0,9.0,12.0,8.0,14.0,13.0,11.0,12.0,13.0,11.0,20.0,11.0,11.0,8.0,14.0,13.0,13.0,7.0,12.0,8.0,8.0,6.0,14.0,12.0,12.0,14.0,13.0,13.0,7.0,31.0,3.0,1.0,0.0,0.0,180.0,68.0,2.0,1.0,2.0,2.0,1.0,1.0,3.0,2.0,1.0,3.0,2.0,14.0,12.0,13.0,10.0,15.0,13.0,8.0,14.0,7.0,6.0,14.0,6.0,6.0,16.0,9.0,10.0,11.0,12.0,9.0,14.0,11.0,14.0,13.0,7.0,13.0,6.0,10.0,10.0,12.0,12.0,10.0,9.0,12.0,14.0,12.0,20.0,9.0,10.0,12.0,9.0,15.0,8.0,14.0,14.0,8.0,12.0,11.0,10.0,14.0,15.0,5.0,28.0,0.0,0.0,0.0,0.0,170.0,72.0,1.0,2.0,2.0,1.0,2.0,3.0,2.0,2.0,3.0,3.0,1.0,10.0,12.0,13.0,6.0,14.0,8.0,7.0,11.0,8.0,4.0,13.0,11.0,4.0,14.0,8.0,11.0,12.0,11.0,11.0,12.0,12.0,15.0,13.0,6.0,12.0,8.0,12.0,14.0,15.0,15.0,10.0,6.0,5.0,13.0,14.0,20.0,12.0,10.0,14.0,8.0,14.0,9.0,10.0,9.0,12.0,14.0,14.0,14.0,15.0,15.0,6.0,39.0,0.0,0.0,0.0,0.0,178.0,75.0,4.0,3.0,1.0,2.0,2.0,2.0,3.0,3.0,2.0,2.0,1.0,12.0,12.0,13.0,12.0,15.0,12.0,12.0,11.0,6.0,6.0,15.0,15.0,8.0,16.0,7.0,12.0,12.0,13.0,14.0,14.0,12.0,14.0,11.0,12.0,9.0,12.0,12.0,14.0,11.0,12.0,14.0,8.0,10.0,15.0,10.0,20.0,10.0,12.0,15.0,7.0,16.0,6.0,10.0,14.0,14.0,14.0,14.0,14.0,14.0,14.0,6.0,20.0,0.0,0.0,8.0,0.0,170.0,65.0,3.0,1.0,1.0,3.0,2.0,3.0,2.0,2.0,2.0,1.0,3.0,10.0,10.0,13.0,13.0,13.0,10.0,9.0,10.0,3.0,4.0,11.0,12.0,4.0,13.0,12.0,12.0,14.0,11.0,11.0,11.0,11.0,15.0,12.0,7.0,14.0,7.0,12.0,15.0,16.0,16.0,12.0,7.0,7.0,14.0,15.0,20.0,14.0,11.0,13.0,9.0,13.0,8.0,12.0,9.0,13.0,14.0,14.0,15.0,15.0,14.0,6.0,20.0,0.0,0.0,0.0,0.0,184.0,88.0,12.0,10.0,12.0,13.0,11.0,13.0,12.0,14.0,8.0,13.0,13.0,9.0,3.0,3.0,1.0,9.0,11.0,2.0,1.0,3.0,3.0,11.0,4.0,1.0,10.0,10.0,13.0,16.0,11.0,11.0,12.0,11.0,14.0,9.0,12.0,1.0,12.0,12.0,12.0,15.0,13.0,14.0,11.0,20.0,13.0,12.0,8.0,13.0,15.0,12.0,11.0,15.0,6.0,1.0,19.0,14.0,16.0,14.0,8.0,7.0,6.0,15.0,28.0,0.0,0.0,0.0,0.0,190.0,85.0,3.0,2.0,3.0,3.0,2.0,2.0,2.0,4.0,3.0,1.0,2.0,5.0,9.0,8.0,9.0,8.0,7.0,14.0,10.0,9.0,15.0,9.0,6.0,14.0,9.0,16.0,13.0,16.0,10.0,13.0,10.0,12.0,15.0,6.0,13.0,7.0,13.0,14.0,16.0,12.0,11.0,17.0,13.0,20.0,15.0,13.0,8.0,15.0,15.0,12.0,14.0,14.0,9.0,8.0,14.0,13.0,14.0,11.0,12.0,13.0,16.0,14.0,30.0,27.0,2.0,2.0,0.0,178.0,78.0,2.0,2.0,1.0,1.0,1.0,1.0,3.0,2.0,1.0,1.0,1.0,8.0,13.0,13.0,8.0,12.0,7.0,14.0,9.0,12.0,14.0,11.0,8.0,16.0,11.0,14.0,14.0,17.0,12.0,14.0,12.0,13.0,17.0,11.0,12.0,13.0,15.0,14.0,15.0,13.0,13.0,13.0,12.0,9.0,12.0,13.0,20.0,13.0,11.0,14.0,14.0,14.0,13.0,18.0,14.0,13.0,13.0,15.0,16.0,13.0,12.0,8.0,23.0,0.0,0.0,0.0,0.0,179.0,71.0,2.0,1.0,3.0,3.0,2.0,3.0,2.0,2.0,1.0,3.0,1.0,8.0,10.0,12.0,6.0,12.0,10.0,5.0,10.0,13.0,11.0,11.0,6.0,12.0,11.0,9.0,11.0,12.0,12.0,7.0,10.0,9.0,15.0,12.0,5.0,13.0,8.0,12.0,14.0,16.0,13.0,13.0,10.0,20.0,16.0,15.0,8.0,14.0,14.0,13.0,9.0,14.0,7.0,10.0,7.0,14.0,14.0,13.0,15.0,13.0,13.0,5.0,21.0,0.0,0.0,1.0,0.0,177.0,68.0,4.0,1.0,2.0,1.0,1.0,1.0,1.0,1.0,2.0,1.0,2.0,5.0,12.0,9.0,7.0,12.0,8.0,13.0,10.0,16.0,13.0,12.0,8.0,14.0,12.0,12.0,13.0,12.0,12.0,12.0,10.0,13.0,15.0,11.0,13.0,11.0,13.0,13.0,14.0,13.0,14.0,13.0,11.0,10.0,14.0,12.0,20.0,12.0,14.0,12.0,11.0,12.0,8.0,14.0,13.0,10.0,14.0,12.0,14.0,12.0,11.0,5.0,34.0,103.0,7.0,16.0,1.0,182.0,72.0,2.0,1.0,1.0,1.0,3.0,1.0,4.0,3.0,3.0,2.0,1.0,11.0,13.0,12.0,8.0,15.0,13.0,9.0,13.0,6.0,8.0,15.0,12.0,8.0,15.0,11.0,14.0,13.0,15.0,15.0,14.0,16.0,17.0,15.0,14.0,11.0,13.0,17.0,13.0,8.0,11.0,10.0,11.0,16.0,13.0,8.0,20.0,12.0,10.0,15.0,11.0,12.0,12.0,15.0,14.0,12.0,15.0,15.0,18.0,14.0,14.0,7.0,20.0,0.0,0.0,0.0,0.0,173.0,66.0,1.0,1.0,1.0,1.0,1.0,2.0,3.0,1.0,3.0,3.0,4.0,15.0,13.0,13.0,10.0,15.0,12.0,5.0,13.0,5.0,7.0,15.0,12.0,7.0,15.0,10.0,10.0,13.0,12.0,10.0,16.0,13.0,18.0,14.0,7.0,14.0,12.0,14.0,14.0,8.0,14.0,13.0,7.0,14.0,12.0,9.0,20.0,12.0,13.0,12.0,8.0,15.0,6.0,12.0,12.0,14.0,14.0,14.0,15.0,14.0,11.0,6.0,19.0,0.0,0.0,11.0,1.0,171.0,65.0,2.0,2.0,2.0,2.0,2.0,3.0,3.0,3.0,1.0,1.0,3.0,14.0,13.0,13.0,11.0,14.0,15.0,8.0,12.0,6.0,4.0,13.0,12.0,4.0,15.0,8.0,12.0,10.0,12.0,8.0,13.0,13.0,14.0,15.0,8.0,14.0,6.0,13.0,12.0,15.0,16.0,10.0,7.0,20.0,13.0,15.0,10.0,12.0,7.0,11.0,6.0,11.0,8.0,11.0,12.0,13.0,11.0,12.0,12.0,6.0,12.0,5.0,28.0,37.0,15.0,1.0,0.0,194.0,88.0,2.0,1.0,2.0,1.0,1.0,2.0,3.0,1.0,3.0,2.0,2.0,4.0,6.0,12.0,15.0,12.0,7.0,16.0,11.0,3.0,6.0,10.0,14.0,4.0,11.0,10.0,14.0,15.0,13.0,10.0,8.0,9.0,13.0,12.0,6.0,14.0,8.0,11.0,16.0,13.0,12.0,18.0,17.0,9.0,12.0,12.0,20.0,14.0,18.0,13.0,10.0,15.0,15.0,6.0,20.0,17.0,12.0,15.0,14.0,11.0,14.0,7.0,23.0,21.0,3.0,9.0,4.0,176.0,69.0,1.0,2.0,1.0,3.0,3.0,1.0,2.0,1.0,1.0,2.0,3.0,9.0,9.0,14.0,13.0,14.0,10.0,10.0,9.0,3.0,5.0,12.0,14.0,6.0,15.0,9.0,13.0,9.0,11.0,10.0,12.0,12.0,13.0,14.0,10.0,13.0,8.0,8.0,10.0,16.0,15.0,10.0,8.0,10.0,12.0,15.0,20.0,13.0,10.0,9.0,8.0,13.0,11.0,13.0,7.0,14.0,12.0,13.0,8.0,14.0,13.0,8.0,19.0,0.0,0.0,0.0,0.0,172.0,64.0,1.0,3.0,2.0,2.0,4.0,2.0,1.0,2.0,3.0,3.0,1.0,13.0,13.0,15.0,12.0,15.0,12.0,6.0,12.0,3.0,2.0,13.0,11.0,3.0,16.0,8.0,10.0,9.0,12.0,9.0,13.0,10.0,12.0,15.0,8.0,13.0,4.0,5.0,7.0,17.0,16.0,14.0,5.0,20.0,11.0,15.0,12.0,10.0,8.0,8.0,10.0,14.0,8.0,10.0,17.0,14.0,9.0,10.0,9.0,4.0,10.0,10.0
0,1,25.0,0.0,0.0,0.0,0.0,187.0,83.0,11.0,14.0,12.0,8.0,13.0,11.0,14.0,15.0,13.0,13.0,9.0,8.0,1.0,1.0,1.0,11.0,11.0,1.0,2.0,2.0,1.0,10.0,3.0,2.0,11.0,8.0,12.0,14.0,12.0,12.0,10.0,12.0,14.0,6.0,14.0,2.0,12.0,12.0,8.0,13.0,15.0,14.0,13.0,20.0,15.0,11.0,5.0,14.0,13.0,13.0,8.0,8.0,10.0,1.0,9.0,13.0,14.0,12.0,15.0,15.0,15.0,5.0,28.0,0.0,0.0,0.0,0.0,184.0,85.0,2.0,3.0,2.0,1.0,1.0,3.0,2.0,2.0,3.0,1.0,3.0,4.0,8.0,8.0,6.0,12.0,6.0,14.0,8.0,5.0,13.0,12.0,6.0,14.0,12.0,11.0,13.0,14.0,13.0,12.0,11.0,11.0,13.0,7.0,14.0,10.0,15.0,16.0,12.0,12.0,11.0,15.0,12.0,20.0,13.0,11.0,7.0,14.0,16.0,13.0,11.0,13.0,13.0,12.0,15.0,13.0,13.0,14.0,15.0,14.0,14.0,6.0,26.0,0.0,0.0,0.0,0.0,169.0,70.0,3.0,3.0,2.0,2.0,3.0,3.0,2.0,2.0,1.0,3.0,3.0,6.0,10.0,10.0,7.0,11.0,7.0,13.0,11.0,16.0,10.0,11.0,8.0,12.0,12.0,12.0,14.0,13.0,12.0,11.0,10.0,10.0,13.0,9.0,6.0,11.0,9.0,14.0,15.0,15.0,15.0,11.0,5.0,5.0,13.0,14.0,20.0,14.0,11.0,14.0,12.0,13.0,7.0,12.0,18.0,12.0,13.0,12.0,13.0,14.0,15.0,6.0,26.0,14.0,0.0,0.0,0.0,181.0,74.0,2.0,1.0,1.0,1.0,3.0,2.0,3.0,1.0,3.0,3.0,2.0,6.0,13.0,8.0,5.0,12.0,7.0,12.0,8.0,11.0,13.0,12.0,6.0,14.0,10.0,14.0,12.0,14.0,10.0,12.0,8.0,8.0,14.0,6.0,6.0,12.0,11.0,14.0,15.0,16.0,14.0,14.0,11.0,5.0,14.0,14.0,20.0,16.0,14.0,12.0,13.0,14.0,8.0,10.0,8.0,14.0,12.0,13.0,15.0,15.0,15.0,6.0,29.0,0.0,0.0,0.0,0.0,188.0,74.0,1.0,2.0,3.0,3.0,2.0,3.0,1.0,3.0,2.0,1.0,1.0,4.0,8.0,10.0,6.0,13.0,7.0,14.0,9.0,6.0,13.0,12.0,8.0,13.0,13.0,12.0,14.0,13.0,14.0,11.0,13.0,12.0,14.0,6.0,13.0,8.0,14.0,15.0,15.0,9.0,12.0,14.0,14.0,10.0,13.0,10.0,20.0,16.0,12.0,13.0,12.0,15.0,9.0,11.0,11.0,14.0,14.0,12.0,15.0,13.0,13.0,6.0,22.0,18.0,0.0,0.0,0.0,179.0,75.0,1.0,4.0,2.0,1.0,1.0,1.0,3.0,1.0,1.0,3.0,2.0,7.0,8.0,12.0,8.0,13.0,10.0,11.0,12.0,11.0,11.0,11.0,10.0,14.0,13.0,15.0,12.0,15.0,8.0,12.0,10.0,12.0,14.0,12.0,10.0,13.0,12.0,13.0,17.0,14.0,14.0,13.0,10.0,9.0,15.0,15.0,20.0,15.0,14.0,13.0,13.0,12.0,11.0,12.0,13.0,15.0,9.0,10.0,12.0,10.0,10.0,4.0,30.0,7.0,0.0,0.0,0.0,181.0,72.0,1.0,3.0,3.0,1.0,2.0,3.0,2.0,1.0,3.0,2.0,2.0,12.0,11.0,14.0,8.0,14.0,12.0,8.0,12.0,6.0,5.0,13.0,13.0,5.0,14.0,8.0,12.0,10.0,11.0,12.0,15.0,11.0,13.0,14.0,9.0,13.0,10.0,12.0,13.0,12.0,14.0,12.0,10.0,12.0,15.0,13.0,20.0,15.0,9.0,10.0,8.0,13.0,5.0,8.0,12.0,14.0,14.0,12.0,11.0,14.0,14.0,8.0,28.0,0.0,0.0,0.0,0.0,170.0,67.0,2.0,3.0,3.0,4.0,3.0,2.0,1.0,1.0,2.0,2.0,3.0,8.0,12.0,12.0,10.0,14.0,7.0,5.0,10.0,6.0,5.0,12.0,5.0,4.0,13.0,7.0,16.0,12.0,9.0,11.0,12.0,10.0,3.0,12.0,6.0,13.0,6.0,8.0,13.0,16.0,13.0,10.0,5.0,5.0,13.0,16.0,20.0,15.0,7.0,12.0,4.0,9.0,7.0,10.0,20.0,13.0,12.0,10.0,13.0,11.0,10.0,2.0,31.0,0.0,0.0,0.0,0.0,175.0,65.0,3.0,4.0,1.0,1.0,3.0,3.0,3.0,2.0,4.0,3.0,3.0,14.0,13.0,13.0,7.0,14.0,12.0,7.0,12.0,7.0,6.0,14.0,15.0,8.0,15.0,11.0,12.0,13.0,13.0,11.0,14.0,12.0,15.0,13.0,9.0,11.0,10.0,12.0,13.0,14.0,15.0,12.0,7.0,20.0,10.0,13.0,10.0,12.0,9.0,12.0,11.0,15.0,16.0,13.0,8.0,14.0,14.0,14.0,13.0,13.0,13.0,7.0,24.0,0.0,0.0,5.0,0.0,183.0,79.0,4.0,4.0,3.0,3.0,1.0,3.0,2.0,1.0,3.0,2.0,3.0,4.0,7.0,12.0,13.0,12.0,8.0,13.0,12.0,5.0,6.0,11.0,12.0,4.0,13.0,11.0,12.0,14.0,9.0,12.0,10.0,10.0,13.0,12.0,6.0,14.0,12.0,13.0,14.0,15.0,14.0,14.0,11.0,10.0,13.0,14.0,20.0,14.0,14.0,12.0,12.0,14.0,9.0,5.0,7.0,13.0,15.0,11.0,14.0,14.0,14.0,6.0,27.0,33.0,4.0,3.0,0.0,180.0,75.0,2.0,1.0,2.0,1.0,4.0,2.0,1.0,3.0,1.0,1.0,2.0,12.0,11.0,13.0,13.0,11.0,11.0,11.0,10.0,7.0,5.0,10.0,14.0,5.0,14.0,9.0,11.0,12.0,10.0,11.0,12.0,12.0,14.0,13.0,8.0,14.0,8.0,11.0,14.0,16.0,14.0,13.0,10.0,7.0,12.0,15.0,20.0,14.0,12.0,12.0,9.0,13.0,10.0,10.0,9.0,15.0,8.0,9.0,13.0,14.0,14.0,7.0,33.0,101.0,0.0,0.0,0.0,182.0,87.0,12.0,11.0,15.0,12.0,14.0,13.0,14.0,15.0,15.0,13.0,12.0,9.0,2.0,3.0,8.0,9.0,11.0,10.0,11.0,1.0,3.0,12.0,15.0,8.0,10.0,8.0,14.0,14.0,14.0,12.0,9.0,12.0,16.0,9.0,15.0,2.0,13.0,12.0,6.0,12.0,13.0,14.0,13.0,8.0,13.0,10.0,20.0,12.0,15.0,13.0,8.0,15.0,5.0,1.0,13.0,15.0,13.0,15.0,18.0,18.0,15.0,5.0,27.0,59.0,3.0,3.0,0.0,189.0,80.0,3.0,3.0,1.0,3.0,2.0,3.0,2.0,2.0,2.0,1.0,2.0,4.0,8.0,8.0,7.0,11.0,6.0,15.0,8.0,8.0,15.0,9.0,5.0,14.0,11.0,15.0,13.0,16.0,10.0,11.0,8.0,10.0,14.0,8.0,13.0,8.0,12.0,13.0,14.0,13.0,12.0,15.0,15.0,5.0,15.0,13.0,20.0,15.0,15.0,13.0,15.0,15.0,7.0,11.0,14.0,14.0,11.0,12.0,13.0,11.0,13.0,7.0,24.0,0.0,0.0,0.0,0.0,187.0,93.0,4.0,3.0,2.0,1.0,2.0,2.0,2.0,2.0,1.0,2.0,1.0,4.0,5.0,6.0,6.0,12.0,6.0,15.0,8.0,6.0,15.0,10.0,6.0,13.0,9.0,14.0,13.0,16.0,12.0,14.0,7.0,12.0,15.0,5.0,8.0,6.0,12.0,14.0,15.0,9.0,10.0,18.0,13.0,6.0,14.0,12.0,20.0,15.0,17.0,13.0,14.0,14.0,11.0,10.0,19.0,14.0,15.0,11.0,13.0,14.0,14.0,5.0,23.0,0.0,0.0,0.0,0.0,184.0,81.0,1.0,1.0,3.0,2.0,1.0,2.0,3.0,1.0,2.0,3.0,3.0,4.0,11.0,9.0,6.0,12.0,6.0,13.0,11.0,7.0,14.0,13.0,8.0,14.0,12.0,14.0,12.0,15.0,14.0,13.0,12.0,12.0,14.0,8.0,10.0,11.0,12.0,14.0,16.0,13.0,13.0,15.0,12.0,8.0,14.0,12.0,20.0,14.0,14.0,12.0,13.0,15.0,10.0,12.0,17.0,13.0,13.0,11.0,13.0,13.0,13.0,7.0,25.0,0.0,0.0,26.0,3.0,176.0,64.0,3.0,2.0,2.0,1.0,3.0,3.0,3.0,2.0,1.0,1.0,1.0,12.0,13.0,12.0,7.0,13.0,13.0,11.0,11.0,11.0,14.0,13.0,11.0,14.0,13.0,13.0,13.0,14.0,13.0,13.0,11.0,13.0,17.0,12.0,11.0,10.0,12.0,14.0,14.0,14.0,14.0,12.0,8.0,8.0,17.0,14.0,20.0,15.0,12.0,14.0,12.0,13.0,5.0,12.0,17.0,15.0,15.0,14.0,16.0,15.0,15.0,7.0,23.0,0.0,0.0,1.0,0.0,182.0,71.0,3.0,1.0,2.0,3.0,4.0,2.0,3.0,1.0,2.0,1.0,3.0,9.0,13.0,14.0,8.0,14.0,13.0,12.0,10.0,13.0,14.0,14.0,13.0,15.0,13.0,14.0,14.0,13.0,11.0,12.0,12.0,13.0,16.0,12.0,12.0,15.0,13.0,14.0,15.0,15.0,13.0,14.0,12.0,9.0,16.0,15.0,20.0,15.0,15.0,15.0,10.0,14.0,6.0,12.0,8.0,15.0,14.0,16.0,15.0,15.0,16.0,6.0,32.0,13.0,0.0,19.0,1.0,172.0,72.0,3.0,1.0,3.0,2.0,1.0,2.0,2.0,2.0,3.0,1.0,1.0,7.0,12.0,12.0,5.0,13.0,7.0,6.0,9.0,9.0,12.0,14.0,9.0,14.0,12.0,13.0,14.0,14.0,15.0,15.0,10.0,13.0,17.0,7.0,18.0,8.0,15.0,18.0,15.0,12.0,14.0,12.0,6.0,10.0,16.0,13.0,20.0,15.0,12.0,15.0,9.0,15.0,5.0,10.0,12.0,16.0,14.0,13.0,15.0,18.0,18.0,5.0,33.0,14.0,0.0,0.0,0.0,172.0,68.0,3.0,3.0,1.0,1.0,1.0,1.0,1.0,3.0,1.0,2.0,1.0,14.0,11.0,13.0,8.0,14.0,13.0,7.0,13.0,4.0,10.0,13.0,10.0,12.0,14.0,11.0,13.0,14.0,13.0,13.0,12.0,14.0,15.0,10.0,13.0,12.0,13.0,16.0,17.0,13.0,13.0,12.0,7.0,10.0,14.0,12.0,20.0,14.0,9.0,14.0,11.0,15.0,10.0,12.0,20.0,13.0,13.0,15.0,14.0,13.0,12.0,8.0,22.0,2.0,0.0,0.0,0.0,169.0,59.0,3.0,1.0,3.0,1.0,1.0,1.0,1.0,1.0,3.0,3.0,2.0,13.0,13.0,15.0,13.0,15.0,13.0,7.0,13.0,8.0,6.0,13.0,13.0,5.0,16.0,10.0,10.0,8.0,13.0,11.0,14.0,12.0,12.0,14.0,10.0,12.0,6.0,10.0,8.0,16.0,15.0,17.0,6.0,12.0,12.0,15.0,20.0,13.0,9.0,12.0,8.0,12.0,8.0,12.0,13.0,13.0,13.0,14.0,12.0,10.0,13.0,9.0,31.0,1.0,0.0,0.0,0.0,178.0,74.0,1.0,3.0,2.0,2.0,2.0,1.0,2.0,2.0,3.0,1.0,3.0,12.0,13.0,13.0,7.0,15.0,13.0,10.0,12.0,7.0,6.0,14.0,11.0,8.0,15.0,14.0,14.0,13.0,13.0,12.0,13.0,13.0,15.0,14.0,10.0,12.0,10.0,10.0,12.0,12.0,13.0,14.0,10.0,10.0,15.0,12.0,20.0,14.0,12.0,11.0,14.0,14.0,6.0,14.0,12.0,14.0,10.0,12.0,13.0,10.0,6.0,14.0,26.0,0.0,0.0,0.0,0.0,171.0,69.0,2.0,3.0,4.0,3.0,1.0,1.0,1.0,2.0,1.0,2.0,1.0,7.0,7.0,12.0,14.0,14.0,7.0,7.0,9.0,6.0,8.0,8.0,5.0,6.0,11.0,9.0,11.0,8.0,10.0,8.0,9.0,12.0,11.0,15.0,7.0,13.0,8.0,7.0,9.0,12.0,12.0,12.0,10.0,10.0,10.0,14.0,20.0,8.0,8.0,14.0,9.0,11.0,4.0,9.0,13.0,12.0,10.0,12.0,10.0,3.0,7.0,8.0
3,0,20.0,0.0,0.0,0.0,0.0,184.0,88.0,12.0,10.0,12.0,13.0,11.0,13.0,12.0,14.0,8.0,13.0,13.0,9.0,3.0,3.0,1.0,9.0,11.0,2.0,1.0,3.0,3.0,11.0,4.0,1.0,10.0,10.0,13.0,16.0,11.0,11.0,12.0,11.0,14.0,9.0,12.0,1.0,12.0,12.0,12.0,15.0,13.0,14.0,11.0,20.0,13.0,12.0,8.0,13.0,15.0,12.0,11.0,15.0,6.0,1.0,19.0,14.0,16.0,14.0,8.0,7.0,6.0,15.0,28.0,0.0,0.0,0.0,0.0,190.0,85.0,3.0,2.0,3.0,3.0,2.0,2.0,2.0,4.0,3.0,1.0,2.0,5.0,9.0,8.0,9.0,8.0,7.0,14.0,10.0,9.0,15.0,9.0,6.0,14.0,9.0,16.0,13.0,16.0,10.0,13.0,10.0,12.0,15.0,6.0,13.0,7.0,13.0,14.0,16.0,12.0,11.0,17.0,13.0,20.0,15.0,13.0,8.0,15.0,15.0,12.0,14.0,14.0,9.0,8.0,14.0,13.0,14.0,11.0,12.0,13.0,16.0,14.0,30.0,27.0,2.0,2.0,0.0,178.0,78.0,2.0,2.0,1.0,1.0,1.0,1.0,3.0,2.0,1.0,1.0,1.0,8.0,13.0,13.0,8.0,12.0,7.0,14.0,9.0,12.0,14.0,11.0,8.0,16.0,11.0,14.0,14.0,17.0,12.0,14.0,12.0,13.0,17.0,11.0,12.0,13.0,15.0,14.0,15.0,13.0,13.0,13.0,12.0,9.0,12.0,13.0,20.0,13.0,11.0,14.0,14.0,14.0,13.0,18.0,14.0,13.0,13.0,15.0,16.0,13.0,12.0,8.0,26.0,0.0,0.0,0.0,0.0,176.0,70.0,2.0,1.0,4.0,3.0,3.0,3.0,1.0,3.0,3.0,2.0,1.0,10.0,11.0,11.0,6.0,13.0,9.0,5.0,12.0,11.0,13.0,13.0,7.0,14.0,13.0,15.0,11.0,14.0,12.0,11.0,9.0,12.0,13.0,9.0,9.0,13.0,12.0,15.0,14.0,12.0,16.0,12.0,7.0,20.0,13.0,13.0,10.0,15.0,11.0,13.0,14.0,13.0,11.0,9.0,8.0,9.0,17.0,12.0,14.0,14.0,15.0,3.0,21.0,0.0,0.0,1.0,0.0,177.0,68.0,4.0,1.0,2.0,1.0,1.0,1.0,1.0,1.0,2.0,1.0,2.0,5.0,12.0,9.0,7.0,12.0,8.0,13.0,10.0,16.0,13.0,12.0,8.0,14.0,12.0,12.0,13.0,12.0,12.0,12.0,10.0,13.0,15.0,11.0,13.0,11.0,13.0,13.0,14.0,13.0,14.0,13.0,11.0,10.0,14.0,12.0,20.0,12.0,14.0,12.0,11.0,12.0,8.0,14.0,13.0,10.0,14.0,12.0,14.0,12.0,11.0,5.0,34.0,103.0,7.0,16.0,1.0,182.0,72.0,2.0,1.0,1.0,1.0,3.0,1.0,4.0,3.0,3.0,2.0,1.0,11.0,13.0,12.0,8.0,15.0,13.0,9.0,13.0,6.0,8.0,15.0,12.0,8.0,15.0,11.0,14.0,13.0,15.0,15.0,14.0,16.0,17.0,15.0,14.0,11.0,13.0,17.0,13.0,8.0,11.0,10.0,11.0,16.0,13.0,8.0,20.0,12.0,10.0,15.0,11.0,12.0,12.0,15.0,14.0,12.0,15.0,15.0,18.0,14.0,14.0,7.0,28.0,1.0,0.0,7.0,0.0,181.0,71.0,2.0,2.0,1.0,3.0,1.0,3.0,3.0,2.0,3.0,3.0,3.0,12.0,11.0,10.0,5.0,13.0,11.0,8.0,10.0,8.0,9.0,14.0,11.0,12.0,13.0,14.0,14.0,12.0,12.0,13.0,12.0,13.0,12.0,8.0,9.0,9.0,12.0,17.0,15.0,11.0,13.0,14.0,10.0,12.0,13.0,12.0,20.0,16.0,12.0,13.0,14.0,16.0,12.0,9.0,10.0,14.0,16.0,14.0,13.0,12.0,12.0,14.0,19.0,0.0,0.0,11.0,1.0,171.0,65.0,2.0,2.0,2.0,2.0,2.0,3.0,3.0,3.0,1.0,1.0,3.0,14.0,13.0,13.0,11.0,14.0,15.0,8.0,12.0,6.0,4.0,13.0,12.0,4.0,15.0,8.0,12.0,10.0,12.0,8.0,13.0,13.0,14.0,15.0,8.0,14.0,6.0,13.0,12.0,15.0,16.0,10.0,7.0,20.0,13.0,15.0,10.0,12.0,7.0,11.0,6.0,11.0,8.0,11.0,12.0,13.0,11.0,12.0,12.0,6.0,12.0,5.0,20.0,0.0,0.0,0.0,0.0,173.0,66.0,1.0,1.0,1.0,1.0,1.0,2.0,3.0,1.0,3.0,3.0,4.0,15.0,13.0,13.0,10.0,15.0,12.0,5.0,13.0,5.0,7.0,15.0,12.0,7.0,15.0,10.0,10.0,13.0,12.0,10.0,16.0,13.0,18.0,14.0,7.0,14.0,12.0,14.0,14.0,8.0,14.0,13.0,7.0,14.0,12.0,9.0,20.0,12.0,13.0,12.0,8.0,15.0,6.0,12.0,12.0,14.0,14.0,14.0,15.0,14.0,11.0,6.0,28.0,37.0,15.0,1.0,0.0,194.0,88.0,2.0,1.0,2.0,1.0,1.0,2.0,3.0,1.0,3.0,2.0,2.0,4.0,6.0,12.0,15.0,12.0,7.0,16.0,11.0,3.0,6.0,10.0,14.0,4.0,11.0,10.0,14.0,15.0,13.0,10.0,8.0,9.0,13.0,12.0,6.0,14.0,8.0,11.0,16.0,13.0,12.0,18.0,17.0,9.0,12.0,12.0,20.0,14.0,18.0,13.0,10.0,15.0,15.0,6.0,20.0,17.0,12.0,15.0,14.0,11.0,14.0,7.0,23.0,21.0,3.0,9.0,4.0,176.0,69.0,1.0,2.0,1.0,3.0,3.0,1.0,2.0,1.0,1.0,2.0,3.0,9.0,9.0,14.0,13.0,14.0,10.0,10.0,9.0,3.0,5.0,12.0,14.0,6.0,15.0,9.0,13.0,9.0,11.0,10.0,12.0,12.0,13.0,14.0,10.0,13.0,8.0,8.0,10.0,16.0,15.0,10.0,8.0,10.0,12.0,15.0,20.0,13.0,10.0,9.0,8.0,13.0,11.0,13.0,7.0,14.0,12.0,13.0,8.0,14.0,13.0,8.0,25.0,0.0,0.0,0.0,0.0,187.0,83.0,11.0,14.0,12.0,8.0,13.0,11.0,14.0,15.0,13.0,13.0,9.0,8.0,1.0,1.0,1.0,11.0,11.0,1.0,2.0,2.0,1.0,10.0,3.0,2.0,11.0,8.0,12.0,14.0,12.0,12.0,10.0,12.0,14.0,6.0,14.0,2.0,12.0,12.0,8.0,13.0,15.0,14.0,13.0,20.0,15.0,11.0,5.0,14.0,13.0,13.0,8.0,8.0,10.0,1.0,9.0,13.0,14.0,12.0,15.0,15.0,15.0,5.0,20.0,0.0,0.0,0.0,0.0,194.0,80.0,4.0,2.0,1.0,3.0,4.0,1.0,3.0,3.0,3.0,3.0,2.0,5.0,5.0,1.0,1.0,8.0,2.0,12.0,5.0,5.0,12.0,8.0,7.0,11.0,8.0,8.0,12.0,10.0,8.0,8.0,6.0,15.0,13.0,9.0,6.0,6.0,10.0,8.0,9.0,10.0,7.0,14.0,17.0,20.0,10.0,7.0,5.0,7.0,14.0,9.0,6.0,1.0,9.0,9.0,7.0,13.0,11.0,10.0,11.0,9.0,11.0,8.0,28.0,0.0,0.0,0.0,0.0,184.0,85.0,2.0,3.0,2.0,1.0,1.0,3.0,2.0,2.0,3.0,1.0,3.0,4.0,8.0,8.0,6.0,12.0,6.0,14.0,8.0,5.0,13.0,12.0,6.0,14.0,12.0,11.0,13.0,14.0,13.0,12.0,11.0,11.0,13.0,7.0,14.0,10.0,15.0,16.0,12.0,12.0,11.0,15.0,12.0,20.0,13.0,11.0,7.0,14.0,16.0,13.0,11.0,13.0,13.0,12.0,15.0,13.0,13.0,14.0,15.0,14.0,14.0,6.0,26.0,0.0,0.0,0.0,0.0,169.0,70.0,3.0,3.0,2.0,2.0,3.0,3.0,2.0,2.0,1.0,3.0,3.0,6.0,10.0,10.0,7.0,11.0,7.0,13.0,11.0,16.0,10.0,11.0,8.0,12.0,12.0,12.0,14.0,13.0,12.0,11.0,10.0,10.0,13.0,9.0,6.0,11.0,9.0,14.0,15.0,15.0,15.0,11.0,5.0,5.0,13.0,14.0,20.0,14.0,11.0,14.0,12.0,13.0,7.0,12.0,18.0,12.0,13.0,12.0,13.0,14.0,15.0,6.0,26.0,14.0,0.0,0.0,0.0,181.0,74.0,2.0,1.0,1.0,1.0,3.0,2.0,3.0,1.0,3.0,3.0,2.0,6.0,13.0,8.0,5.0,12.0,7.0,12.0,8.0,11.0,13.0,12.0,6.0,14.0,10.0,14.0,12.0,14.0,10.0,12.0,8.0,8.0,14.0,6.0,6.0,12.0,11.0,14.0,15.0,16.0,14.0,14.0,11.0,5.0,14.0,14.0,20.0,16.0,14.0,12.0,13.0,14.0,8.0,10.0,8.0,14.0,12.0,13.0,15.0,15.0,15.0,6.0,29.0,0.0,0.0,0.0,0.0,188.0,74.0,1.0,2.0,3.0,3.0,2.0,3.0,1.0,3.0,2.0,1.0,1.0,4.0,8.0,10.0,6.0,13.0,7.0,14.0,9.0,6.0,13.0,12.0,8.0,13.0,13.0,12.0,14.0,13.0,14.0,11.0,13.0,12.0,14.0,6.0,13.0,8.0,14.0,15.0,15.0,9.0,12.0,14.0,14.0,10.0,13.0,10.0,20.0,16.0,12.0,13.0,12.0,15.0,9.0,11.0,11.0,14.0,14.0,12.0,15.0,13.0,13.0,6.0,22.0,18.0,0.0,0.0,0.0,179.0,75.0,1.0,4.0,2.0,1.0,1.0,1.0,3.0,1.0,1.0,3.0,2.0,7.0,8.0,12.0,8.0,13.0,10.0,11.0,12.0,11.0,11.0,11.0,10.0,14.0,13.0,15.0,12.0,15.0,8.0,12.0,10.0,12.0,14.0,12.0,10.0,13.0,12.0,13.0,17.0,14.0,14.0,13.0,10.0,9.0,15.0,15.0,20.0,15.0,14.0,13.0,13.0,12.0,11.0,12.0,13.0,15.0,9.0,10.0,12.0,10.0,10.0,4.0,27.0,0.0,0.0,0.0,0.0,173.0,68.0,2.0,2.0,1.0,1.0,3.0,3.0,1.0,2.0,3.0,4.0,2.0,12.0,12.0,13.0,8.0,13.0,10.0,7.0,8.0,9.0,7.0,12.0,10.0,9.0,14.0,7.0,10.0,8.0,11.0,12.0,12.0,11.0,12.0,13.0,5.0,13.0,10.0,10.0,12.0,14.0,14.0,11.0,7.0,20.0,12.0,15.0,10.0,13.0,8.0,12.0,7.0,13.0,9.0,12.0,18.0,12.0,14.0,11.0,14.0,15.0,15.0,6.0,22.0,0.0,0.0,0.0,0.0,164.0,65.0,1.0,2.0,3.0,1.0,2.0,2.0,3.0,2.0,2.0,1.0,2.0,10.0,12.0,13.0,11.0,13.0,10.0,5.0,10.0,7.0,5.0,12.0,10.0,3.0,13.0,7.0,11.0,11.0,11.0,13.0,13.0,11.0,13.0,13.0,6.0,14.0,7.0,12.0,12.0,15.0,15.0,8.0,2.0,9.0,13.0,14.0,20.0,13.0,8.0,13.0,7.0,10.0,8.0,12.0,10.0,12.0,11.0,12.0,11.0,10.0,10.0,8.0,27.0,33.0,4.0,3.0,0.0,180.0,75.0,2.0,1.0,2.0,1.0,4.0,2.0,1.0,3.0,1.0,1.0,2.0,12.0,11.0,13.0,13.0,11.0,11.0,11.0,10.0,7.0,5.0,10.0,14.0,5.0,14.0,9.0,11.0,12.0,10.0,11.0,12.0,12.0,14.0,13.0,8.0,14.0,8.0,11.0,14.0,16.0,14.0,13.0,10.0,7.0,12.0,15.0,20.0,14.0,12.0,12.0,9.0,13.0,10.0,10.0,9.0,15.0,8.0,9.0,13.0,14.0,14.0,7.0,24.0,0.0,0.0,5.0,0.0,183.0,79.0,4.0,4.0,3.0,3.0,1.0,3.0,2.0,1.0,3.0,2.0,3.0,4.0,7.0,12.0,13.0,12.0,8.0,13.0,12.0,5.0,6.0,11.0,12.0,4.0,13.0,11.0,12.0,14.0,9.0,12.0,10.0,10.0,13.0,12.0,6.0,14.0,12.0,13.0,14.0,15.0,14.0,14.0,11.0,10.0,13.0,14.0,20.0,14.0,14.0,12.0,12.0,14.0,9.0,5.0,7.0,13.0,15.0,11.0,14.0,14.0,14.0,6.0
1,2,28.0,0.0,0.0,6.0,0.0,191.0,81.0,11.0,10.0,14.0,8.0,13.0,12.0,14.0,15.0,11.0,8.0,13.0,4.0,3.0,2.0,1.0,9.0,9.0,3.0,10.0,1.0,1.0,8.0,3.0,3.0,9.0,8.0,12.0,14.0,12.0,13.0,8.0,11.0,12.0,6.0,14.0,2.0,12.0,10.0,7.0,13.0,14.0,16.0,15.0,6.0,14.0,11.0,20.0,15.0,14.0,12.0,9.0,14.0,7.0,1.0,9.0,15.0,13.0,11.0,15.0,15.0,14.0,8.0,23.0,0.0,0.0,0.0,0.0,184.0,71.0,1.0,2.0,1.0,2.0,2.0,2.0,2.0,4.0,2.0,1.0,3.0,4.0,10.0,10.0,6.0,11.0,6.0,14.0,8.0,7.0,14.0,11.0,6.0,13.0,11.0,12.0,12.0,13.0,12.0,11.0,12.0,12.0,14.0,6.0,8.0,10.0,13.0,13.0,14.0,15.0,13.0,14.0,13.0,8.0,12.0,14.0,20.0,13.0,14.0,13.0,12.0,14.0,15.0,8.0,11.0,13.0,13.0,10.0,8.0,9.0,16.0,7.0,22.0,0.0,0.0,3.0,0.0,182.0,81.0,1.0,2.0,2.0,1.0,2.0,3.0,2.0,3.0,1.0,2.0,3.0,5.0,7.0,7.0,5.0,8.0,6.0,13.0,8.0,5.0,12.0,8.0,8.0,12.0,7.0,14.0,11.0,15.0,10.0,12.0,7.0,9.0,10.0,8.0,7.0,8.0,11.0,20.0,11.0,10.0,11.0,14.0,12.0,8.0,14.0,11.0,20.0,10.0,14.0,13.0,14.0,10.0,8.0,8.0,18.0,9.0,15.0,11.0,8.0,13.0,13.0,4.0,21.0,0.0,0.0,0.0,0.0,178.0,65.0,2.0,3.0,3.0,3.0,3.0,1.0,1.0,1.0,1.0,3.0,1.0,9.0,13.0,11.0,6.0,12.0,7.0,9.0,8.0,8.0,13.0,12.0,7.0,13.0,12.0,8.0,12.0,13.0,12.0,12.0,13.0,13.0,14.0,9.0,8.0,12.0,12.0,13.0,13.0,12.0,14.0,13.0,11.0,8.0,15.0,12.0,20.0,13.0,12.0,14.0,8.0,11.0,7.0,10.0,19.0,10.0,13.0,10.0,11.0,15.0,15.0,6.0,23.0,0.0,0.0,0.0,0.0,174.0,64.0,4.0,3.0,1.0,1.0,3.0,3.0,2.0,3.0,3.0,2.0,3.0,8.0,12.0,10.0,8.0,11.0,7.0,10.0,9.0,12.0,14.0,9.0,10.0,13.0,12.0,12.0,12.0,12.0,11.0,12.0,10.0,12.0,13.0,8.0,9.0,12.0,11.0,13.0,14.0,15.0,14.0,11.0,10.0,10.0,14.0,14.0,20.0,15.0,10.0,14.0,12.0,12.0,8.0,13.0,10.0,12.0,15.0,12.0,13.0,10.0,17.0,6.0,32.0,18.0,0.0,0.0,0.0,180.0,72.0,1.0,2.0,3.0,2.0,3.0,2.0,2.0,3.0,3.0,1.0,3.0,5.0,9.0,8.0,7.0,12.0,8.0,13.0,10.0,10.0,12.0,13.0,9.0,13.0,12.0,13.0,13.0,14.0,14.0,13.0,12.0,12.0,15.0,7.0,11.0,8.0,12.0,13.0,14.0,14.0,11.0,14.0,11.0,7.0,15.0,13.0,20.0,14.0,14.0,14.0,14.0,15.0,8.0,10.0,5.0,14.0,13.0,11.0,15.0,15.0,15.0,6.0,29.0,52.0,2.0,0.0,0.0,178.0,75.0,1.0,1.0,1.0,1.0,3.0,3.0,2.0,3.0,1.0,2.0,2.0,10.0,12.0,12.0,11.0,12.0,11.0,8.0,11.0,7.0,11.0,13.0,12.0,9.0,13.0,12.0,9.0,13.0,9.0,12.0,13.0,10.0,16.0,7.0,9.0,14.0,13.0,15.0,16.0,13.0,13.0,12.0,10.0,8.0,15.0,13.0,20.0,15.0,11.0,10.0,13.0,14.0,3.0,13.0,13.0,15.0,8.0,13.0,16.0,12.0,14.0,3.0,32.0,22.0,1.0,6.0,1.0,186.0,79.0,1.0,2.0,1.0,1.0,2.0,3.0,1.0,2.0,1.0,2.0,1.0,11.0,12.0,13.0,11.0,13.0,11.0,14.0,11.0,8.0,12.0,13.0,13.0,13.0,13.0,14.0,13.0,14.0,14.0,13.0,14.0,13.0,12.0,13.0,14.0,15.0,13.0,12.0,15.0,12.0,13.0,12.0,12.0,10.0,12.0,13.0,20.0,15.0,13.0,14.0,5.0,12.0,9.0,17.0,8.0,12.0,8.0,13.0,10.0,10.0,10.0,5.0,21.0,0.0,0.0,3.0,0.0,175.0,71.0,3.0,3.0,2.0,1.0,3.0,1.0,2.0,2.0,3.0,3.0,2.0,9.0,13.0,14.0,12.0,14.0,14.0,8.0,13.0,5.0,6.0,14.0,11.0,6.0,15.0,8.0,13.0,8.0,12.0,11.0,13.0,14.0,12.0,15.0,9.0,14.0,7.0,11.0,12.0,13.0,13.0,8.0,7.0,10.0,14.0,13.0,20.0,13.0,8.0,10.0,9.0,12.0,8.0,10.0,10.0,10.0,9.0,10.0,12.0,5.0,10.0,9.0,22.0,0.0,0.0,0.0,0.0,177.0,72.0,2.0,1.0,2.0,4.0,2.0,2.0,1.0,3.0,4.0,2.0,3.0,10.0,12.0,13.0,11.0,12.0,10.0,12.0,12.0,4.0,10.0,13.0,11.0,11.0,13.0,11.0,12.0,11.0,13.0,9.0,13.0,12.0,3.0,12.0,8.0,14.0,12.0,12.0,13.0,16.0,13.0,12.0,9.0,8.0,15.0,14.0,20.0,14.0,13.0,10.0,4.0,11.0,11.0,12.0,19.0,9.0,12.0,13.0,12.0,11.0,14.0,7.0,25.0,0.0,0.0,0.0,0.0,187.0,83.0,2.0,1.0,3.0,3.0,1.0,3.0,3.0,3.0,1.0,1.0,3.0,4.0,8.0,10.0,14.0,12.0,8.0,14.0,9.0,5.0,7.0,11.0,13.0,5.0,12.0,11.0,13.0,13.0,13.0,11.0,10.0,12.0,16.0,9.0,8.0,13.0,11.0,13.0,16.0,14.0,13.0,15.0,13.0,20.0,14.0,12.0,8.0,14.0,16.0,13.0,11.0,13.0,7.0,5.0,13.0,14.0,13.0,14.0,14.0,13.0,13.0,6.0,36.0,0.0,0.0,0.0,0.0,185.0,78.0,11.0,14.0,12.0,7.0,13.0,12.0,14.0,15.0,13.0,14.0,10.0,4.0,1.0,3.0,1.0,8.0,8.0,11.0,8.0,3.0,3.0,7.0,2.0,1.0,8.0,11.0,13.0,15.0,11.0,12.0,7.0,13.0,9.0,5.0,14.0,3.0,13.0,15.0,8.0,11.0,14.0,13.0,12.0,5.0,15.0,11.0,20.0,12.0,14.0,13.0,11.0,13.0,8.0,1.0,19.0,14.0,16.0,10.0,17.0,9.0,9.0,11.0,28.0,0.0,0.0,0.0,0.0,183.0,81.0,1.0,2.0,4.0,1.0,1.0,3.0,2.0,3.0,3.0,3.0,1.0,5.0,5.0,6.0,10.0,12.0,6.0,14.0,8.0,6.0,15.0,11.0,6.0,13.0,12.0,13.0,14.0,16.0,14.0,14.0,10.0,12.0,14.0,5.0,14.0,8.0,14.0,15.0,15.0,9.0,12.0,15.0,13.0,7.0,11.0,12.0,20.0,15.0,15.0,14.0,14.0,14.0,9.0,8.0,14.0,14.0,11.0,13.0,15.0,13.0,15.0,6.0,27.0,25.0,1.0,0.0,0.0,189.0,82.0,3.0,1.0,3.0,4.0,3.0,1.0,3.0,3.0,1.0,2.0,3.0,6.0,7.0,5.0,8.0,9.0,8.0,12.0,8.0,6.0,14.0,13.0,11.0,14.0,5.0,12.0,14.0,15.0,13.0,13.0,8.0,13.0,12.0,5.0,11.0,5.0,13.0,15.0,14.0,12.0,12.0,14.0,15.0,6.0,16.0,12.0,20.0,13.0,14.0,11.0,10.0,12.0,5.0,8.0,11.0,13.0,14.0,17.0,8.0,6.0,8.0,13.0,24.0,0.0,0.0,0.0,0.0,179.0,68.0,3.0,2.0,3.0,2.0,1.0,3.0,3.0,1.0,3.0,3.0,1.0,4.0,13.0,9.0,6.0,12.0,9.0,12.0,7.0,8.0,12.0,14.0,8.0,14.0,12.0,15.0,14.0,13.0,14.0,13.0,10.0,12.0,14.0,10.0,9.0,9.0,10.0,13.0,14.0,14.0,12.0,13.0,9.0,9.0,8.0,14.0,20.0,15.0,14.0,11.0,11.0,13.0,10.0,14.0,13.0,14.0,14.0,11.0,16.0,15.0,15.0,6.0,36.0,0.0,0.0,0.0,0.0,180.0,72.0,1.0,2.0,4.0,1.0,1.0,2.0,2.0,1.0,1.0,1.0,2.0,6.0,10.0,8.0,6.0,11.0,8.0,13.0,10.0,7.0,11.0,11.0,8.0,13.0,11.0,13.0,13.0,14.0,14.0,13.0,11.0,12.0,13.0,7.0,10.0,10.0,13.0,13.0,15.0,11.0,12.0,14.0,10.0,10.0,14.0,10.0,20.0,12.0,11.0,12.0,14.0,14.0,5.0,15.0,20.0,12.0,20.0,14.0,16.0,15.0,15.0,5.0,30.0,0.0,0.0,0.0,0.0,167.0,60.0,3.0,1.0,1.0,2.0,3.0,1.0,1.0,3.0,1.0,1.0,3.0,10.0,11.0,12.0,8.0,13.0,10.0,6.0,9.0,10.0,12.0,14.0,9.0,10.0,14.0,11.0,14.0,14.0,14.0,14.0,13.0,14.0,12.0,14.0,11.0,13.0,12.0,15.0,15.0,15.0,14.0,11.0,5.0,11.0,11.0,15.0,20.0,11.0,8.0,14.0,10.0,12.0,13.0,11.0,11.0,12.0,11.0,10.0,12.0,11.0,11.0,2.0,23.0,27.0,1.0,0.0,0.0,178.0,70.0,1.0,2.0,1.0,4.0,1.0,1.0,1.0,3.0,2.0,1.0,1.0,8.0,11.0,13.0,11.0,13.0,12.0,7.0,14.0,6.0,5.0,12.0,10.0,5.0,14.0,11.0,11.0,12.0,11.0,9.0,13.0,10.0,14.0,14.0,5.0,13.0,7.0,10.0,12.0,15.0,14.0,12.0,9.0,20.0,13.0,13.0,8.0,13.0,13.0,12.0,11.0,11.0,10.0,11.0,12.0,12.0,12.0,11.0,10.0,10.0,10.0,6.0,33.0,0.0,0.0,0.0,0.0,187.0,76.0,2.0,2.0,3.0,1.0,1.0,3.0,2.0,1.0,2.0,3.0,2.0,15.0,14.0,14.0,10.0,15.0,13.0,10.0,12.0,7.0,4.0,15.0,13.0,7.0,15.0,6.0,12.0,9.0,14.0,11.0,15.0,12.0,12.0,14.0,12.0,13.0,7.0,13.0,12.0,11.0,12.0,14.0,12.0,14.0,15.0,12.0,20.0,11.0,12.0,12.0,6.0,14.0,6.0,11.0,14.0,13.0,12.0,12.0,15.0,15.0,13.0,9.0,26.0,0.0,0.0,0.0,0.0,193.0,81.0,1.0,3.0,3.0,3.0,3.0,1.0,2.0,2.0,2.0,3.0,3.0,4.0,9.0,14.0,10.0,13.0,12.0,14.0,14.0,5.0,5.0,10.0,12.0,3.0,14.0,8.0,13.0,12.0,9.0,10.0,11.0,11.0,12.0,16.0,5.0,14.0,6.0,9.0,12.0,14.0,13.0,14.0,16.0,14.0,13.0,13.0,20.0,13.0,14.0,10.0,8.0,14.0,9.0,8.0,16.0,16.0,11.0,13.0,11.0,13.0,13.0,10.0,30.0,0.0,0.0,0.0,0.0,178.0,73.0,3.0,4.0,1.0,1.0,2.0,4.0,3.0,2.0,2.0,2.0,3.0,13.0,14.0,12.0,7.0,13.0,12.0,7.0,13.0,5.0,10.0,13.0,9.0,10.0,13.0,11.0,11.0,12.0,12.0,13.0,11.0,14.0,14.0,11.0,7.0,11.0,10.0,13.0,15.0,13.0,15.0,15.0,8.0,20.0,14.0,14.0,8.0,14.0,11.0,13.0,11.0,14.0,8.0,10.0,19.0,12.0,12.0,9.0,12.0,12.0,10.0,10.0,24.0,0.0,0.0,0.0,0.0,182.0,82.0,3.0,3.0,2.0,1.0,1.0,3.0,2.0,2.0,3.0,2.0,2.0,4.0,7.0,13.0,14.0,13.0,12.0,14.0,12.0,5.0,7.0,10.0,14.0,6.0,15.0,13.0,13.0,16.0,8.0,12.0,11.0,11.0,12.0,14.0,7.0,13.0,8.0,12.0,13.0,14.0,14.0,15.0,12.0,10.0,10.0,12.0,20.0,16.0,15.0,12.0,13.0,14.0,10.0,8.0,8.0,13.0,5.0,10.0,11.0,9.0,9.0,13.0
0,4,30.0,0.0,0.0,0.0,0.0,182.0,78.0,13.0,14.0,10.0,5.0,12.0,13.0,12.0,13.0,11.0,11.0,9.0,3.0,3.0,3.0,2.0,8.0,7.0,3.0,3.0,2.0,2.0,8.0,1.0,1.0,8.0,9.0,13.0,13.0,13.0,13.0,9.0,13.0,14.0,5.0,9.0,1.0,11.0,12.0,6.0,12.0,13.0,14.0,11.0,20.0,15.0,10.0,5.0,13.0,14.0,13.0,9.0,14.0,6.0,1.0,20.0,13.0,13.0,13.0,15.0,15.0,15.0,5.0,27.0,0.0,0.0,0.0,0.0,187.0,80.0,1.0,3.0,3.0,4.0,3.0,1.0,2.0,4.0,1.0,2.0,1.0,4.0,9.0,8.0,5.0,9.0,6.0,14.0,6.0,9.0,13.0,7.0,6.0,13.0,10.0,14.0,13.0,15.0,9.0,11.0,6.0,10.0,16.0,7.0,8.0,10.0,12.0,13.0,14.0,15.0,12.0,14.0,13.0,5.0,13.0,14.0,20.0,14.0,14.0,12.0,14.0,14.0,8.0,8.0,16.0,13.0,14.0,13.0,13.0,12.0,12.0,7.0,33.0,24.0,1.0,3.0,0.0,193.0,90.0,1.0,2.0,2.0,2.0,3.0,2.0,3.0,1.0,3.0,2.0,3.0,3.0,6.0,8.0,8.0,11.0,10.0,17.0,8.0,5.0,13.0,10.0,7.0,14.0,11.0,14.0,14.0,16.0,11.0,10.0,9.0,10.0,14.0,7.0,13.0,7.0,13.0,14.0,11.0,9.0,10.0,15.0,15.0,7.0,13.0,10.0,20.0,10.0,13.0,10.0,13.0,15.0,9.0,8.0,12.0,15.0,13.0,11.0,15.0,12.0,13.0,7.0,24.0,0.0,0.0,8.0,1.0,185.0,75.0,3.0,3.0,1.0,4.0,3.0,1.0,2.0,1.0,3.0,1.0,4.0,9.0,12.0,10.0,6.0,13.0,10.0,12.0,11.0,5.0,10.0,14.0,8.0,12.0,13.0,8.0,13.0,11.0,13.0,13.0,13.0,12.0,15.0,9.0,10.0,8.0,12.0,15.0,14.0,11.0,12.0,14.0,12.0,10.0,16.0,12.0,20.0,15.0,13.0,13.0,8.0,14.0,9.0,16.0,5.0,14.0,14.0,13.0,16.0,15.0,15.0,6.0,27.0,0.0,0.0,0.0,0.0,185.0,90.0,1.0,1.0,1.0,2.0,3.0,1.0,4.0,1.0,1.0,2.0,1.0,3.0,7.0,6.0,8.0,10.0,5.0,14.0,7.0,5.0,13.0,10.0,8.0,14.0,8.0,15.0,13.0,16.0,11.0,13.0,7.0,12.0,15.0,6.0,10.0,8.0,12.0,13.0,15.0,10.0,10.0,15.0,12.0,5.0,14.0,11.0,20.0,14.0,17.0,14.0,14.0,15.0,8.0,5.0,8.0,12.0,14.0,14.0,11.0,13.0,12.0,8.0,16.0,0.0,0.0,0.0,0.0,177.0,0.0,3.0,2.0,1.0,1.0,3.0,3.0,2.0,2.0,2.0,1.0,3.0,1.0,3.0,2.0,2.0,4.0,1.0,3.0,1.0,6.0,9.0,2.0,1.0,9.0,6.0,14.0,4.0,5.0,5.0,3.0,2.0,5.0,4.0,5.0,7.0,4.0,8.0,4.0,3.0,10.0,7.0,13.0,7.0,15.0,13.0,9.0,20.0,5.0,8.0,7.0,11.0,5.0,8.0,8.0,11.0,11.0,5.0,14.0,20.0,7.0,12.0,5.0,38.0,0.0,0.0,0.0,0.0,177.0,68.0,2.0,3.0,2.0,3.0,1.0,2.0,2.0,1.0,3.0,4.0,4.0,9.0,13.0,10.0,7.0,11.0,7.0,10.0,12.0,11.0,11.0,13.0,7.0,12.0,12.0,11.0,13.0,14.0,14.0,14.0,11.0,12.0,14.0,9.0,15.0,10.0,13.0,17.0,15.0,10.0,12.0,12.0,8.0,10.0,13.0,11.0,20.0,10.0,9.0,14.0,11.0,13.0,5.0,17.0,11.0,12.0,16.0,14.0,18.0,16.0,15.0,5.0,22.0,25.0,0.0,0.0,0.0,180.0,75.0,2.0,3.0,1.0,1.0,4.0,3.0,1.0,1.0,4.0,2.0,2.0,11.0,13.0,14.0,10.0,12.0,9.0,12.0,9.0,13.0,13.0,12.0,9.0,13.0,12.0,13.0,12.0,14.0,13.0,12.0,10.0,11.0,5.0,8.0,6.0,10.0,12.0,13.0,15.0,15.0,14.0,13.0,10.0,20.0,14.0,14.0,5.0,15.0,13.0,12.0,13.0,6.0,7.0,11.0,14.0,11.0,12.0,12.0,14.0,9.0,11.0,5.0,33.0,0.0,0.0,0.0,0.0,188.0,77.0,1.0,2.0,3.0,1.0,2.0,1.0,1.0,3.0,3.0,3.0,3.0,7.0,12.0,10.0,10.0,13.0,14.0,14.0,13.0,5.0,11.0,14.0,12.0,12.0,12.0,14.0,14.0,14.0,13.0,13.0,13.0,12.0,14.0,9.0,15.0,8.0,14.0,15.0,14.0,10.0,11.0,14.0,14.0,8.0,14.0,11.0,20.0,14.0,14.0,16.0,12.0,14.0,7.0,10.0,13.0,13.0,14.0,13.0,16.0,14.0,13.0,6.0,24.0,14.0,0.0,7.0,3.0,186.0,84.0,2.0,1.0,3.0,2.0,3.0,3.0,4.0,2.0,3.0,2.0,2.0,7.0,9.0,13.0,10.0,13.0,7.0,12.0,9.0,6.0,5.0,10.0,11.0,6.0,12.0,13.0,9.0,15.0,8.0,11.0,10.0,12.0,14.0,13.0,7.0,10.0,8.0,15.0,13.0,12.0,12.0,16.0,14.0,14.0,15.0,16.0,20.0,13.0,15.0,11.0,7.0,10.0,10.0,10.0,13.0,15.0,12.0,9.0,12.0,10.0,10.0,7.0,29.0,1.0,0.0,0.0,0.0,190.0,80.0,1.0,2.0,2.0,3.0,4.0,3.0,2.0,3.0,2.0,1.0,1.0,4.0,7.0,12.0,13.0,14.0,7.0,14.0,13.0,5.0,5.0,11.0,13.0,5.0,12.0,11.0,13.0,14.0,11.0,13.0,10.0,12.0,8.0,9.0,7.0,13.0,12.0,11.0,13.0,13.0,12.0,16.0,15.0,8.0,14.0,12.0,20.0,14.0,15.0,13.0,10.0,8.0,7.0,5.0,7.0,12.0,11.0,11.0,13.0,9.0,13.0,7.0,25.0,0.0,0.0,11.0,0.0,189.0,83.0,12.0,12.0,11.0,7.0,13.0,12.0,17.0,17.0,16.0,12.0,13.0,6.0,2.0,1.0,1.0,10.0,10.0,7.0,1.0,1.0,1.0,9.0,5.0,1.0,10.0,8.0,15.0,14.0,14.0,12.0,7.0,13.0,12.0,6.0,9.0,3.0,16.0,17.0,10.0,13.0,16.0,14.0,12.0,8.0,15.0,10.0,20.0,13.0,14.0,14.0,5.0,14.0,4.0,12.0,15.0,15.0,13.0,13.0,17.0,15.0,17.0,4.0,29.0,56.0,3.0,0.0,0.0,189.0,84.0,3.0,2.0,2.0,1.0,2.0,2.0,2.0,2.0,2.0,1.0,3.0,8.0,9.0,13.0,12.0,13.0,14.0,14.0,12.0,18.0,17.0,12.0,15.0,16.0,13.0,17.0,16.0,16.0,12.0,10.0,10.0,11.0,17.0,12.0,15.0,12.0,11.0,13.0,16.0,17.0,15.0,16.0,16.0,10.0,16.0,15.0,20.0,14.0,13.0,10.0,12.0,13.0,10.0,13.0,15.0,16.0,18.0,13.0,16.0,11.0,10.0,7.0,31.0,0.0,0.0,0.0,0.0,171.0,65.0,1.0,3.0,1.0,3.0,2.0,2.0,3.0,1.0,2.0,2.0,3.0,8.0,9.0,11.0,7.0,5.0,6.0,5.0,6.0,7.0,14.0,14.0,6.0,14.0,13.0,14.0,12.0,13.0,12.0,11.0,11.0,12.0,12.0,11.0,7.0,12.0,12.0,12.0,10.0,15.0,15.0,7.0,9.0,9.0,12.0,14.0,20.0,12.0,13.0,11.0,13.0,11.0,9.0,10.0,15.0,14.0,12.0,11.0,14.0,13.0,12.0,7.0,29.0,0.0,0.0,0.0,0.0,170.0,65.0,2.0,1.0,3.0,3.0,1.0,3.0,2.0,1.0,2.0,3.0,2.0,5.0,11.0,4.0,6.0,7.0,4.0,7.0,5.0,6.0,6.0,6.0,2.0,6.0,7.0,9.0,10.0,13.0,8.0,12.0,8.0,13.0,15.0,2.0,7.0,5.0,9.0,8.0,8.0,12.0,12.0,14.0,4.0,9.0,12.0,11.0,20.0,12.0,5.0,9.0,9.0,9.0,9.0,9.0,10.0,12.0,12.0,12.0,12.0,7.0,5.0,8.0,23.0,2.0,0.0,5.0,3.0,182.0,73.0,3.0,1.0,1.0,1.0,2.0,1.0,2.0,1.0,3.0,4.0,2.0,12.0,14.0,14.0,10.0,13.0,12.0,16.0,11.0,13.0,12.0,13.0,13.0,14.0,14.0,12.0,11.0,14.0,13.0,11.0,13.0,11.0,15.0,15.0,9.0,15.0,10.0,14.0,15.0,16.0,15.0,13.0,13.0,20.0,14.0,15.0,6.0,15.0,12.0,13.0,9.0,13.0,14.0,15.0,17.0,15.0,13.0,12.0,12.0,15.0,13.0,9.0,33.0,30.0,1.0,0.0,0.0,187.0,83.0,1.0,3.0,4.0,2.0,1.0,1.0,2.0,3.0,1.0,1.0,3.0,13.0,13.0,12.0,8.0,16.0,10.0,16.0,13.0,10.0,14.0,16.0,13.0,16.0,15.0,13.0,15.0,14.0,16.0,15.0,14.0,14.0,13.0,11.0,13.0,10.0,17.0,18.0,10.0,10.0,12.0,17.0,14.0,20.0,12.0,12.0,10.0,13.0,16.0,16.0,16.0,15.0,13.0,11.0,16.0,16.0,13.0,15.0,12.0,8.0,8.0,11.0,25.0,0.0,0.0,14.0,0.0,180.0,82.0,1.0,3.0,3.0,1.0,3.0,2.0,3.0,1.0,1.0,3.0,1.0,5.0,10.0,10.0,7.0,13.0,7.0,12.0,8.0,10.0,14.0,12.0,8.0,17.0,13.0,13.0,16.0,16.0,14.0,15.0,10.0,12.0,15.0,8.0,13.0,10.0,14.0,18.0,15.0,10.0,12.0,16.0,11.0,10.0,15.0,12.0,20.0,16.0,15.0,17.0,10.0,16.0,6.0,10.0,12.0,16.0,12.0,13.0,17.0,14.0,14.0,5.0,18.0,0.0,0.0,0.0,0.0,178.0,68.0,1.0,2.0,1.0,3.0,2.0,1.0,1.0,2.0,2.0,1.0,3.0,12.0,10.0,12.0,6.0,13.0,13.0,8.0,8.0,5.0,8.0,14.0,3.0,9.0,14.0,13.0,11.0,12.0,12.0,11.0,13.0,12.0,12.0,12.0,6.0,12.0,8.0,13.0,13.0,15.0,13.0,12.0,8.0,10.0,13.0,14.0,20.0,12.0,8.0,12.0,12.0,12.0,7.0,12.0,10.0,13.0,12.0,12.0,12.0,11.0,13.0,7.0,28.0,66.0,15.0,13.0,3.0,180.0,70.0,2.0,2.0,1.0,2.0,1.0,1.0,3.0,2.0,3.0,3.0,1.0,14.0,15.0,16.0,13.0,17.0,15.0,6.0,15.0,4.0,5.0,16.0,14.0,8.0,17.0,13.0,16.0,11.0,15.0,13.0,16.0,14.0,13.0,17.0,10.0,14.0,9.0,13.0,13.0,16.0,18.0,12.0,10.0,20.0,14.0,15.0,8.0,16.0,9.0,13.0,14.0,12.0,10.0,15.0,14.0,15.0,10.0,16.0,14.0,6.0,12.0,10.0,29.0,76.0,27.0,13.0,9.0,188.0,72.0,2.0,3.0,1.0,2.0,3.0,3.0,1.0,3.0,3.0,3.0,3.0,5.0,10.0,13.0,16.0,13.0,11.0,17.0,13.0,5.0,10.0,13.0,14.0,10.0,13.0,15.0,16.0,18.0,14.0,15.0,10.0,13.0,14.0,13.0,10.0,18.0,12.0,14.0,19.0,15.0,14.0,16.0,14.0,10.0,18.0,16.0,20.0,18.0,14.0,14.0,8.0,15.0,5.0,16.0,10.0,16.0,12.0,14.0,16.0,14.0,10.0,10.0,34.0,116.0,62.0,7.0,6.0,195.0,95.0,1.0,1.0,3.0,1.0,1.0,3.0,4.0,1.0,2.0,3.0,2.0,5.0,12.0,15.0,16.0,18.0,14.0,14.0,16.0,8.0,6.0,15.0,18.0,6.0,18.0,16.0,16.0,15.0,13.0,13.0,16.0,14.0,14.0,19.0,16.0,15.0,4.0,13.0,8.0,12.0,15.0,20.0,18.0,16.0,16.0,14.0,20.0,15.0,18.0,16.0,13.0,11.0,11.0,8.0,15.0,20.0,11.0,15.0,14.0,7.0,7.0,13.0
6,1,25.0,4.0,0.0,11.0,0.0,184.0,81.0,14.0,14.0,13.0,9.0,15.0,12.0,16.0,16.0,13.0,7.0,11.0,8.0,1.0,2.0,1.0,11.0,12.0,6.0,1.0,3.0,3.0,11.0,5.0,3.0,11.0,8.0,15.0,15.0,13.0,14.0,10.0,11.0,14.0,8.0,13.0,5.0,13.0,10.0,10.0,14.0,16.0,14.0,13.0,20.0,14.0,12.0,5.0,14.0,14.0,15.0,9.0,16.0,6.0,1.0,17.0,11.0,15.0,13.0,14.0,12.0,12.0,4.0,27.0,4.0,0.0,5.0,1.0,184.0,83.0,2.0,4.0,3.0,1.0,1.0,2.0,1.0,2.0,4.0,2.0,3.0,4.0,8.0,11.0,4.0,10.0,4.0,14.0,4.0,4.0,15.0,12.0,5.0,16.0,11.0,14.0,14.0,16.0,14.0,10.0,11.0,12.0,17.0,7.0,10.0,9.0,13.0,14.0,15.0,14.0,13.0,16.0,13.0,10.0,15.0,13.0,20.0,15.0,16.0,12.0,12.0,14.0,6.0,12.0,11.0,13.0,12.0,12.0,16.0,15.0,14.0,6.0,22.0,3.0,0.0,7.0,1.0,182.0,75.0,3.0,3.0,1.0,3.0,2.0,3.0,1.0,1.0,2.0,2.0,1.0,4.0,11.0,10.0,6.0,14.0,7.0,13.0,10.0,9.0,16.0,14.0,8.0,15.0,14.0,13.0,17.0,15.0,16.0,14.0,11.0,14.0,15.0,8.0,11.0,10.0,15.0,16.0,14.0,14.0,14.0,14.0,11.0,20.0,15.0,14.0,10.0,15.0,15.0,15.0,12.0,15.0,8.0,11.0,12.0,14.0,16.0,15.0,14.0,14.0,14.0,5.0,19.0,0.0,0.0,3.0,1.0,181.0,69.0,3.0,2.0,3.0,3.0,2.0,1.0,1.0,1.0,3.0,3.0,4.0,10.0,10.0,12.0,12.0,12.0,7.0,8.0,11.0,5.0,7.0,10.0,10.0,7.0,11.0,8.0,10.0,10.0,12.0,8.0,11.0,8.0,14.0,13.0,6.0,14.0,8.0,13.0,13.0,16.0,14.0,13.0,9.0,20.0,15.0,16.0,10.0,15.0,13.0,12.0,8.0,11.0,7.0,12.0,11.0,11.0,15.0,10.0,12.0,14.0,14.0,1.0,32.0,11.0,1.0,0.0,0.0,176.0,68.0,2.0,1.0,3.0,2.0,2.0,2.0,2.0,3.0,3.0,2.0,2.0,8.0,10.0,10.0,7.0,11.0,8.0,10.0,11.0,12.0,11.0,13.0,12.0,14.0,12.0,9.0,14.0,15.0,13.0,12.0,11.0,12.0,17.0,8.0,14.0,14.0,11.0,18.0,18.0,14.0,14.0,12.0,10.0,10.0,14.0,13.0,20.0,17.0,13.0,15.0,9.0,13.0,8.0,13.0,17.0,13.0,15.0,16.0,16.0,16.0,18.0,5.0,32.0,0.0,0.0,0.0,0.0,172.0,71.0,2.0,1.0,3.0,1.0,2.0,3.0,2.0,3.0,2.0,2.0,2.0,8.0,9.0,7.0,6.0,10.0,6.0,10.0,9.0,10.0,14.0,11.0,6.0,14.0,11.0,10.0,16.0,15.0,12.0,12.0,7.0,12.0,15.0,9.0,13.0,8.0,14.0,15.0,15.0,14.0,14.0,14.0,10.0,20.0,14.0,14.0,8.0,15.0,13.0,13.0,11.0,13.0,7.0,13.0,17.0,14.0,17.0,8.0,13.0,15.0,15.0,6.0,27.0,8.0,0.0,6.0,0.0,187.0,76.0,3.0,2.0,3.0,2.0,2.0,1.0,1.0,3.0,3.0,1.0,2.0,5.0,7.0,11.0,5.0,14.0,5.0,14.0,9.0,5.0,15.0,15.0,8.0,14.0,13.0,15.0,16.0,15.0,14.0,12.0,14.0,14.0,18.0,8.0,17.0,9.0,12.0,18.0,15.0,13.0,14.0,15.0,14.0,10.0,17.0,12.0,20.0,17.0,15.0,14.0,13.0,16.0,4.0,12.0,10.0,14.0,17.0,12.0,15.0,13.0,13.0,6.0,24.0,0.0,0.0,6.0,1.0,172.0,70.0,3.0,1.0,1.0,3.0,1.0,2.0,3.0,1.0,1.0,3.0,3.0,11.0,12.0,11.0,8.0,12.0,10.0,6.0,14.0,7.0,11.0,15.0,8.0,12.0,13.0,14.0,14.0,18.0,13.0,12.0,13.0,13.0,15.0,12.0,12.0,12.0,11.0,18.0,18.0,13.0,14.0,13.0,7.0,10.0,16.0,12.0,20.0,14.0,12.0,14.0,14.0,15.0,4.0,8.0,7.0,14.0,14.0,13.0,14.0,12.0,10.0,6.0,22.0,0.0,0.0,4.0,0.0,180.0,80.0,4.0,1.0,1.0,3.0,2.0,3.0,1.0,3.0,3.0,3.0,4.0,7.0,10.0,11.0,8.0,15.0,11.0,10.0,14.0,5.0,14.0,15.0,10.0,15.0,15.0,13.0,14.0,13.0,12.0,14.0,15.0,13.0,16.0,12.0,8.0,15.0,13.0,13.0,13.0,13.0,13.0,12.0,10.0,12.0,12.0,12.0,20.0,13.0,12.0,13.0,10.0,12.0,7.0,11.0,12.0,15.0,12.0,16.0,15.0,10.0,10.0,7.0,24.0,6.0,1.0,0.0,0.0,183.0,66.0,1.0,1.0,2.0,2.0,1.0,2.0,1.0,2.0,3.0,2.0,1.0,14.0,14.0,14.0,10.0,14.0,14.0,9.0,10.0,8.0,8.0,14.0,10.0,8.0,15.0,9.0,11.0,13.0,11.0,11.0,13.0,10.0,14.0,13.0,5.0,12.0,9.0,14.0,13.0,14.0,16.0,12.0,9.0,20.0,13.0,14.0,5.0,15.0,9.0,12.0,10.0,12.0,8.0,9.0,16.0,9.0,16.0,13.0,11.0,12.0,13.0,9.0,25.0,10.0,1.0,11.0,4.0,175.0,73.0,1.0,3.0,3.0,3.0,3.0,3.0,3.0,1.0,2.0,3.0,1.0,5.0,10.0,15.0,17.0,15.0,10.0,11.0,12.0,5.0,5.0,14.0,15.0,5.0,16.0,8.0,15.0,12.0,15.0,14.0,13.0,15.0,15.0,15.0,14.0,14.0,10.0,10.0,12.0,16.0,16.0,15.0,9.0,10.0,15.0,16.0,20.0,13.0,15.0,14.0,8.0,14.0,7.0,10.0,8.0,16.0,17.0,13.0,15.0,15.0,14.0,5.0,31.0,25.0,0.0,6.0,0.0,191.0,84.0,11.0,14.0,13.0,12.0,15.0,14.0,15.0,16.0,13.0,14.0,14.0,8.0,2.0,10.0,5.0,11.0,11.0,7.0,10.0,2.0,5.0,10.0,11.0,11.0,9.0,12.0,13.0,15.0,13.0,13.0,8.0,13.0,16.0,12.0,14.0,1.0,16.0,13.0,11.0,12.0,13.0,16.0,16.0,8.0,16.0,13.0,20.0,15.0,15.0,17.0,8.0,15.0,7.0,2.0,15.0,15.0,17.0,15.0,17.0,16.0,15.0,6.0,38.0,89.0,6.0,14.0,1.0,183.0,79.0,3.0,3.0,2.0,3.0,2.0,3.0,2.0,4.0,3.0,2.0,3.0,4.0,8.0,8.0,7.0,12.0,6.0,14.0,8.0,11.0,17.0,12.0,11.0,16.0,12.0,15.0,16.0,17.0,15.0,17.0,10.0,16.0,18.0,6.0,15.0,8.0,16.0,17.0,13.0,8.0,8.0,12.0,11.0,10.0,13.0,8.0,20.0,10.0,11.0,16.0,12.0,16.0,11.0,7.0,15.0,16.0,16.0,15.0,18.0,16.0,14.0,4.0,32.0,0.0,0.0,3.0,0.0,187.0,82.0,1.0,2.0,2.0,3.0,2.0,1.0,1.0,2.0,2.0,3.0,1.0,5.0,11.0,8.0,7.0,10.0,6.0,15.0,9.0,13.0,15.0,10.0,8.0,16.0,9.0,16.0,14.0,17.0,12.0,15.0,8.0,12.0,17.0,9.0,14.0,11.0,13.0,15.0,13.0,12.0,11.0,16.0,14.0,6.0,13.0,14.0,20.0,13.0,16.0,15.0,14.0,14.0,8.0,14.0,14.0,14.0,15.0,16.0,15.0,12.0,10.0,7.0,23.0,0.0,0.0,0.0,0.0,184.0,77.0,1.0,1.0,1.0,1.0,3.0,2.0,3.0,2.0,2.0,2.0,3.0,6.0,9.0,11.0,7.0,12.0,7.0,15.0,9.0,11.0,14.0,13.0,10.0,15.0,12.0,14.0,15.0,15.0,13.0,12.0,11.0,13.0,15.0,11.0,9.0,9.0,14.0,14.0,14.0,14.0,13.0,15.0,13.0,9.0,16.0,15.0,20.0,14.0,14.0,14.0,11.0,14.0,4.0,11.0,14.0,13.0,15.0,14.0,16.0,14.0,15.0,6.0,26.0,0.0,0.0,0.0,0.0,167.0,0.0,3.0,2.0,1.0,2.0,2.0,3.0,3.0,3.0,2.0,3.0,2.0,11.0,12.0,12.0,11.0,12.0,13.0,8.0,10.0,7.0,5.0,12.0,11.0,6.0,12.0,11.0,10.0,11.0,10.0,10.0,13.0,11.0,9.0,10.0,9.0,11.0,6.0,10.0,11.0,11.0,11.0,10.0,6.0,5.0,13.0,11.0,20.0,12.0,9.0,12.0,5.0,10.0,9.0,8.0,12.0,11.0,9.0,9.0,11.0,4.0,1.0,5.0,32.0,36.0,0.0,12.0,2.0,183.0,77.0,1.0,3.0,2.0,1.0,3.0,1.0,1.0,2.0,1.0,1.0,3.0,6.0,11.0,8.0,6.0,13.0,11.0,13.0,10.0,6.0,15.0,14.0,10.0,17.0,12.0,15.0,16.0,18.0,14.0,17.0,12.0,15.0,17.0,11.0,17.0,7.0,17.0,20.0,16.0,9.0,11.0,15.0,11.0,8.0,15.0,10.0,20.0,14.0,14.0,17.0,10.0,16.0,10.0,13.0,15.0,15.0,15.0,14.0,18.0,15.0,13.0,6.0,21.0,0.0,0.0,9.0,0.0,184.0,72.0,1.0,3.0,1.0,2.0,3.0,2.0,1.0,1.0,2.0,1.0,2.0,6.0,10.0,12.0,7.0,12.0,7.0,14.0,11.0,7.0,14.0,13.0,10.0,13.0,12.0,14.0,13.0,14.0,12.0,12.0,12.0,12.0,16.0,11.0,10.0,12.0,13.0,14.0,15.0,14.0,13.0,16.0,12.0,12.0,14.0,15.0,20.0,15.0,17.0,14.0,12.0,15.0,9.0,9.0,10.0,16.0,14.0,15.0,14.0,14.0,14.0,8.0,30.0,18.0,2.0,0.0,0.0,184.0,79.0,2.0,2.0,2.0,1.0,2.0,2.0,3.0,1.0,3.0,1.0,1.0,13.0,16.0,15.0,10.0,13.0,12.0,9.0,11.0,11.0,10.0,14.0,12.0,8.0,14.0,14.0,10.0,15.0,10.0,12.0,12.0,11.0,15.0,12.0,14.0,14.0,11.0,13.0,14.0,15.0,14.0,15.0,11.0,7.0,15.0,15.0,20.0,15.0,14.0,13.0,13.0,13.0,11.0,14.0,12.0,14.0,14.0,10.0,13.0,14.0,11.0,9.0,21.0,7.0,0.0,14.0,6.0,173.0,64.0,3.0,2.0,3.0,2.0,3.0,3.0,3.0,2.0,3.0,3.0,3.0,14.0,14.0,18.0,14.0,17.0,14.0,7.0,11.0,2.0,6.0,15.0,14.0,6.0,18.0,12.0,14.0,14.0,15.0,13.0,16.0,14.0,17.0,17.0,12.0,13.0,9.0,13.0,17.0,15.0,17.0,13.0,7.0,20.0,14.0,14.0,9.0,14.0,9.0,15.0,7.0,16.0,7.0,14.0,15.0,17.0,15.0,16.0,17.0,16.0,15.0,4.0,22.0,0.0,0.0,7.0,3.0,178.0,73.0,1.0,2.0,1.0,3.0,2.0,3.0,3.0,1.0,3.0,2.0,2.0,12.0,14.0,16.0,12.0,13.0,12.0,6.0,13.0,4.0,5.0,12.0,11.0,5.0,15.0,12.0,12.0,12.0,13.0,13.0,13.0,11.0,14.0,14.0,7.0,14.0,6.0,11.0,13.0,16.0,16.0,9.0,8.0,20.0,14.0,15.0,12.0,13.0,7.0,14.0,10.0,14.0,8.0,15.0,13.0,12.0,15.0,13.0,11.0,15.0,14.0,5.0,26.0,13.0,4.0,5.0,3.0,203.0,87.0,3.0,4.0,4.0,1.0,1.0,2.0,3.0,1.0,3.0,4.0,2.0,5.0,8.0,10.0,13.0,13.0,10.0,9.0,12.0,11.0,6.0,9.0,13.0,5.0,14.0,13.0,10.0,13.0,13.0,10.0,9.0,11.0,12.0,12.0,9.0,12.0,7.0,11.0,13.0,13.0,11.0,15.0,18.0,20.0,13.0,14.0,12.0,12.0,16.0,6.0,15.0,13.0,14.0,7.0,11.0,13.0,11.0,10.0,10.0,11.0,13.0,12.0
1,0,17.0,0.0,0.0,0.0,0.0,193.0,82.0,13.0,11.0,12.0,2.0,12.0,10.0,14.0,15.0,14.0,12.0,10.0,3.0,1.0,1.0,3.0,5.0,6.0,2.0,2.0,1.0,3.0,9.0,3.0,1.0,8.0,7.0,12.0,13.0,13.0,13.0,11.0,11.0,15.0,3.0,8.0,3.0,12.0,12.0,11.0,10.0,12.0,14.0,17.0,5.0,15.0,11.0,20.0,13.0,12.0,13.0,8.0,11.0,5.0,11.0,13.0,15.0,15.0,17.0,14.0,15.0,15.0,5.0,19.0,0.0,0.0,0.0,0.0,194.0,92.0,2.0,1.0,3.0,3.0,3.0,3.0,1.0,3.0,3.0,2.0,1.0,3.0,3.0,5.0,6.0,10.0,5.0,16.0,10.0,8.0,12.0,9.0,4.0,15.0,11.0,14.0,11.0,12.0,10.0,11.0,10.0,12.0,15.0,3.0,13.0,13.0,12.0,14.0,14.0,11.0,8.0,15.0,17.0,5.0,16.0,12.0,20.0,12.0,16.0,12.0,13.0,12.0,5.0,7.0,10.0,14.0,13.0,8.0,10.0,11.0,18.0,6.0,23.0,0.0,0.0,0.0,0.0,180.0,77.0,2.0,1.0,3.0,2.0,3.0,2.0,2.0,2.0,3.0,1.0,2.0,6.0,11.0,11.0,6.0,13.0,7.0,11.0,5.0,8.0,14.0,12.0,9.0,12.0,9.0,15.0,14.0,17.0,10.0,14.0,8.0,13.0,14.0,7.0,8.0,7.0,10.0,13.0,15.0,15.0,13.0,13.0,10.0,5.0,14.0,14.0,20.0,15.0,14.0,14.0,15.0,6.0,7.0,11.0,18.0,13.0,14.0,15.0,13.0,12.0,14.0,2.0,23.0,1.0,0.0,4.0,0.0,190.0,80.0,1.0,4.0,1.0,3.0,3.0,1.0,1.0,1.0,2.0,4.0,2.0,6.0,11.0,13.0,7.0,13.0,6.0,11.0,8.0,10.0,15.0,12.0,5.0,15.0,12.0,14.0,14.0,16.0,9.0,11.0,10.0,10.0,16.0,12.0,12.0,9.0,12.0,10.0,14.0,14.0,12.0,15.0,17.0,8.0,15.0,16.0,20.0,13.0,14.0,13.0,8.0,13.0,6.0,14.0,11.0,14.0,12.0,13.0,16.0,14.0,12.0,6.0,26.0,4.0,0.0,2.0,0.0,180.0,74.0,3.0,3.0,1.0,2.0,2.0,1.0,3.0,4.0,1.0,2.0,1.0,8.0,13.0,13.0,6.0,13.0,9.0,12.0,7.0,11.0,13.0,13.0,11.0,12.0,12.0,16.0,14.0,14.0,9.0,12.0,11.0,13.0,4.0,4.0,6.0,11.0,12.0,8.0,12.0,14.0,14.0,13.0,9.0,20.0,16.0,13.0,5.0,15.0,13.0,12.0,6.0,9.0,10.0,12.0,8.0,14.0,8.0,11.0,12.0,11.0,13.0,2.0,19.0,0.0,0.0,0.0,0.0,184.0,78.0,3.0,1.0,2.0,1.0,2.0,2.0,2.0,3.0,3.0,4.0,2.0,6.0,8.0,9.0,5.0,13.0,6.0,11.0,8.0,5.0,13.0,13.0,8.0,12.0,13.0,13.0,13.0,15.0,12.0,12.0,13.0,12.0,14.0,7.0,11.0,8.0,15.0,14.0,15.0,13.0,12.0,14.0,11.0,5.0,15.0,12.0,20.0,16.0,14.0,13.0,12.0,11.0,7.0,10.0,19.0,13.0,15.0,12.0,14.0,13.0,12.0,6.0,32.0,0.0,0.0,13.0,0.0,175.0,65.0,2.0,1.0,1.0,2.0,3.0,3.0,1.0,2.0,3.0,2.0,3.0,15.0,13.0,11.0,6.0,14.0,13.0,10.0,12.0,8.0,8.0,16.0,8.0,12.0,13.0,11.0,14.0,15.0,14.0,15.0,14.0,14.0,14.0,6.0,13.0,9.0,15.0,18.0,13.0,12.0,13.0,13.0,8.0,8.0,13.0,10.0,20.0,13.0,13.0,12.0,11.0,15.0,12.0,10.0,17.0,14.0,15.0,14.0,16.0,14.0,14.0,6.0,24.0,1.0,0.0,0.0,0.0,168.0,66.0,2.0,3.0,1.0,1.0,2.0,1.0,3.0,1.0,1.0,1.0,2.0,10.0,15.0,15.0,6.0,14.0,12.0,5.0,12.0,5.0,5.0,14.0,8.0,3.0,15.0,7.0,9.0,8.0,12.0,12.0,13.0,12.0,15.0,16.0,5.0,15.0,5.0,9.0,13.0,16.0,17.0,9.0,5.0,8.0,14.0,12.0,20.0,11.0,5.0,12.0,7.0,14.0,7.0,11.0,17.0,14.0,14.0,11.0,11.0,14.0,14.0,7.0,25.0,14.0,1.0,2.0,0.0,177.0,77.0,3.0,3.0,1.0,2.0,3.0,3.0,1.0,3.0,3.0,4.0,1.0,8.0,11.0,13.0,12.0,12.0,10.0,11.0,10.0,2.0,3.0,11.0,10.0,5.0,13.0,12.0,12.0,13.0,11.0,10.0,11.0,10.0,14.0,16.0,14.0,15.0,5.0,13.0,14.0,15.0,14.0,12.0,12.0,12.0,14.0,16.0,20.0,13.0,14.0,13.0,7.0,14.0,11.0,13.0,14.0,11.0,12.0,8.0,12.0,13.0,15.0,6.0,32.0,0.0,0.0,0.0,0.0,183.0,67.0,1.0,2.0,3.0,2.0,3.0,2.0,3.0,1.0,2.0,2.0,2.0,4.0,12.0,11.0,6.0,5.0,5.0,4.0,8.0,11.0,13.0,11.0,5.0,13.0,11.0,11.0,11.0,12.0,11.0,11.0,9.0,12.0,11.0,12.0,10.0,12.0,11.0,12.0,12.0,14.0,13.0,13.0,8.0,8.0,13.0,13.0,20.0,14.0,14.0,10.0,12.0,11.0,8.0,11.0,11.0,10.0,10.0,12.0,11.0,9.0,10.0,12.0,25.0,0.0,0.0,3.0,0.0,170.0,68.0,2.0,1.0,3.0,1.0,3.0,1.0,3.0,2.0,2.0,4.0,1.0,12.0,11.0,15.0,16.0,16.0,13.0,11.0,12.0,4.0,5.0,12.0,14.0,4.0,17.0,7.0,14.0,7.0,15.0,13.0,13.0,14.0,14.0,15.0,7.0,16.0,8.0,10.0,13.0,15.0,15.0,12.0,6.0,11.0,14.0,14.0,20.0,13.0,11.0,12.0,7.0,15.0,7.0,8.0,12.0,14.0,13.0,14.0,13.0,16.0,16.0,8.0,27.0,0.0,0.0,2.0,0.0,188.0,81.0,9.0,10.0,8.0,6.0,13.0,8.0,14.0,15.0,12.0,12.0,10.0,4.0,3.0,2.0,2.0,8.0,8.0,2.0,2.0,1.0,3.0,8.0,3.0,1.0,8.0,8.0,12.0,13.0,12.0,12.0,8.0,11.0,15.0,6.0,9.0,1.0,12.0,11.0,9.0,13.0,14.0,15.0,14.0,5.0,15.0,11.0,20.0,13.0,15.0,12.0,8.0,15.0,5.0,1.0,19.0,13.0,10.0,15.0,14.0,14.0,14.0,6.0,25.0,0.0,0.0,0.0,0.0,184.0,76.0,2.0,3.0,1.0,2.0,2.0,2.0,2.0,2.0,1.0,3.0,3.0,3.0,7.0,7.0,6.0,9.0,5.0,15.0,7.0,5.0,13.0,11.0,6.0,15.0,11.0,13.0,13.0,14.0,12.0,10.0,9.0,11.0,11.0,6.0,9.0,8.0,13.0,12.0,12.0,14.0,13.0,15.0,13.0,5.0,10.0,13.0,20.0,12.0,15.0,12.0,13.0,15.0,8.0,6.0,20.0,14.0,13.0,12.0,7.0,13.0,13.0,9.0,26.0,0.0,0.0,0.0,0.0,181.0,77.0,1.0,3.0,1.0,1.0,3.0,3.0,3.0,1.0,1.0,2.0,3.0,5.0,8.0,8.0,6.0,12.0,6.0,13.0,7.0,7.0,13.0,14.0,7.0,12.0,13.0,12.0,13.0,11.0,14.0,14.0,13.0,13.0,13.0,6.0,10.0,7.0,14.0,13.0,13.0,12.0,11.0,14.0,11.0,7.0,8.0,11.0,20.0,13.0,14.0,12.0,9.0,14.0,14.0,10.0,15.0,13.0,14.0,15.0,15.0,15.0,15.0,6.0,24.0,0.0,0.0,0.0,0.0,175.0,72.0,3.0,2.0,4.0,3.0,2.0,4.0,1.0,1.0,1.0,2.0,2.0,8.0,12.0,12.0,6.0,11.0,7.0,10.0,9.0,12.0,11.0,12.0,8.0,12.0,11.0,11.0,12.0,13.0,10.0,10.0,9.0,9.0,3.0,9.0,9.0,11.0,12.0,11.0,11.0,14.0,13.0,11.0,8.0,20.0,12.0,13.0,6.0,12.0,11.0,10.0,10.0,10.0,9.0,10.0,10.0,13.0,10.0,11.0,10.0,13.0,18.0,1.0,32.0,0.0,0.0,0.0,0.0,180.0,76.0,1.0,2.0,1.0,1.0,3.0,2.0,3.0,2.0,3.0,3.0,1.0,6.0,8.0,8.0,8.0,11.0,7.0,14.0,8.0,8.0,12.0,11.0,7.0,12.0,11.0,14.0,14.0,14.0,13.0,13.0,10.0,13.0,15.0,6.0,12.0,7.0,14.0,15.0,13.0,10.0,11.0,14.0,11.0,10.0,14.0,11.0,20.0,13.0,12.0,14.0,14.0,13.0,12.0,8.0,13.0,11.0,14.0,14.0,14.0,12.0,12.0,7.0,22.0,0.0,0.0,0.0,0.0,180.0,74.0,2.0,4.0,2.0,1.0,3.0,1.0,2.0,1.0,1.0,2.0,3.0,7.0,8.0,10.0,7.0,13.0,10.0,8.0,11.0,5.0,13.0,13.0,12.0,10.0,13.0,12.0,13.0,12.0,12.0,14.0,12.0,12.0,14.0,11.0,7.0,8.0,12.0,14.0,14.0,12.0,12.0,13.0,9.0,14.0,14.0,12.0,20.0,14.0,11.0,14.0,10.0,14.0,8.0,10.0,14.0,14.0,12.0,9.0,12.0,10.0,7.0,7.0,26.0,0.0,0.0,0.0,0.0,178.0,74.0,2.0,3.0,1.0,3.0,3.0,3.0,2.0,2.0,3.0,1.0,3.0,14.0,12.0,12.0,10.0,13.0,14.0,9.0,12.0,5.0,6.0,12.0,8.0,8.0,13.0,11.0,11.0,12.0,10.0,11.0,12.0,13.0,15.0,12.0,8.0,11.0,12.0,12.0,15.0,14.0,15.0,15.0,10.0,5.0,13.0,13.0,20.0,14.0,13.0,13.0,13.0,14.0,8.0,6.0,14.0,13.0,12.0,11.0,13.0,12.0,16.0,7.0,31.0,3.0,1.0,0.0,0.0,180.0,68.0,2.0,1.0,2.0,2.0,1.0,1.0,3.0,2.0,1.0,3.0,2.0,14.0,12.0,13.0,10.0,15.0,13.0,8.0,14.0,7.0,6.0,14.0,6.0,6.0,16.0,9.0,10.0,11.0,12.0,9.0,14.0,11.0,14.0,13.0,7.0,13.0,6.0,10.0,10.0,12.0,12.0,10.0,9.0,12.0,14.0,12.0,20.0,9.0,10.0,12.0,9.0,15.0,8.0,14.0,14.0,8.0,12.0,11.0,10.0,14.0,15.0,5.0,39.0,0.0,0.0,0.0,0.0,178.0,75.0,4.0,3.0,1.0,2.0,2.0,2.0,3.0,3.0,2.0,2.0,1.0,12.0,12.0,13.0,12.0,15.0,12.0,12.0,11.0,6.0,6.0,15.0,15.0,8.0,16.0,7.0,12.0,12.0,13.0,14.0,14.0,12.0,14.0,11.0,12.0,9.0,12.0,12.0,14.0,11.0,12.0,14.0,8.0,10.0,15.0,10.0,20.0,10.0,12.0,15.0,7.0,16.0,6.0,10.0,14.0,14.0,14.0,14.0,14.0,14.0,14.0,6.0,28.0,0.0,0.0,0.0,0.0,170.0,72.0,1.0,2.0,2.0,1.0,2.0,3.0,2.0,2.0,3.0,3.0,1.0,10.0,12.0,13.0,6.0,14.0,8.0,7.0,11.0,8.0,4.0,13.0,11.0,4.0,14.0,8.0,11.0,12.0,11.0,11.0,12.0,12.0,15.0,13.0,6.0,12.0,8.0,12.0,14.0,15.0,15.0,10.0,6.0,5.0,13.0,14.0,20.0,12.0,10.0,14.0,8.0,14.0,9.0,10.0,9.0,12.0,14.0,14.0,14.0,15.0,15.0,6.0,20.0,0.0,0.0,8.0,0.0,170.0,65.0,3.0,1.0,1.0,3.0,2.0,3.0,2.0,2.0,2.0,1.0,3.0,10.0,10.0,13.0,13.0,13.0,10.0,9.0,10.0,3.0,4.0,11.0,12.0,4.0,13.0,12.0,12.0,14.0,11.0,11.0,11.0,11.0,15.0,12.0,7.0,14.0,7.0,12.0,15.0,16.0,16.0,12.0,7.0,7.0,14.0,15.0,20.0,14.0,11.0,13.0,9.0,13.0,8.0,12.0,9.0,13.0,14.0,14.0,15.0,15.0,14.0,6.0
0,4,20.0,0.0,0.0,0.0,0.0,184.0,88.0,12.0,10.0,12.0,13.0,11.0,13.0,12.0,14.0,8.0,13.0,13.0,9.0,3.0,3.0,1.0,9.0,11.0,2.0,1.0,3.0,3.0,11.0,4.0,1.0,10.0,10.0,13.0,16.0,11.0,11.0,12.0,11.0,14.0,9.0,12.0,1.0,12.0,12.0,12.0,15.0,13.0,14.0,11.0,20.0,13.0,12.0,8.0,13.0,15.0,12.0,11.0,15.0,6.0,1.0,19.0,14.0,16.0,14.0,8.0,7.0,6.0,15.0,28.0,0.0,0.0,0.0,0.0,190.0,85.0,3.0,2.0,3.0,3.0,2.0,2.0,2.0,4.0,3.0,1.0,2.0,5.0,9.0,8.0,9.0,8.0,7.0,14.0,10.0,9.0,15.0,9.0,6.0,14.0,9.0,16.0,13.0,16.0,10.0,13.0,10.0,12.0,15.0,6.0,13.0,7.0,13.0,14.0,16.0,12.0,11.0,17.0,13.0,20.0,15.0,13.0,8.0,15.0,15.0,12.0,14.0,14.0,9.0,8.0,14.0,13.0,14.0,11.0,12.0,13.0,16.0,14.0,26.0,0.0,0.0,0.0,0.0,176.0,70.0,2.0,1.0,4.0,3.0,3.0,3.0,1.0,3.0,3.0,2.0,1.0,10.0,11.0,11.0,6.0,13.0,9.0,5.0,12.0,11.0,13.0,13.0,7.0,14.0,13.0,15.0,11.0,14.0,12.0,11.0,9.0,12.0,13.0,9.0,9.0,13.0,12.0,15.0,14.0,12.0,16.0,12.0,7.0,20.0,13.0,13.0,10.0,15.0,11.0,13.0,14.0,13.0,11.0,9.0,8.0,9.0,17.0,12.0,14.0,14.0,15.0,3.0,23.0,0.0,0.0,0.0,0.0,174.0,64.0,4.0,3.0,1.0,1.0,3.0,3.0,2.0,3.0,3.0,2.0,3.0,8.0,12.0,10.0,8.0,11.0,7.0,10.0,9.0,12.0,14.0,9.0,10.0,13.0,12.0,12.0,12.0,12.0,11.0,12.0,10.0,12.0,13.0,8.0,9.0,12.0,11.0,13.0,14.0,15.0,14.0,11.0,10.0,10.0,14.0,14.0,20.0,15.0,10.0,14.0,12.0,12.0,8.0,13.0,10.0,12.0,15.0,12.0,13.0,10.0,17.0,6.0,32.0,36.0,0.0,12.0,2.0,183.0,77.0,1.0,3.0,2.0,1.0,3.0,1.0,1.0,2.0,1.0,1.0,3.0,6.0,11.0,8.0,6.0,13.0,11.0,13.0,10.0,6.0,15.0,14.0,10.0,17.0,12.0,15.0,16.0,18.0,14.0,17.0,12.0,15.0,17.0,11.0,17.0,7.0,17.0,20.0,16.0,9.0,11.0,15.0,11.0,8.0,15.0,10.0,20.0,14.0,14.0,17.0,10.0,16.0,10.0,13.0,15.0,15.0,15.0,14.0,18.0,15.0,13.0,6.0,34.0,103.0,7.0,16.0,1.0,182.0,72.0,2.0,1.0,1.0,1.0,3.0,1.0,4.0,3.0,3.0,2.0,1.0,11.0,13.0,12.0,8.0,15.0,13.0,9.0,13.0,6.0,8.0,15.0,12.0,8.0,15.0,11.0,14.0,13.0,15.0,15.0,14.0,16.0,17.0,15.0,14.0,11.0,13.0,17.0,13.0,8.0,11.0,10.0,11.0,16.0,13.0,8.0,20.0,12.0,10.0,15.0,11.0,12.0,12.0,15.0,14.0,12.0,15.0,15.0,18.0,14.0,14.0,7.0,26.0,0.0,0.0,0.0,0.0,183.0,76.0,2.0,2.0,1.0,1.0,1.0,2.0,3.0,1.0,3.0,1.0,1.0,13.0,12.0,12.0,7.0,14.0,14.0,12.0,14.0,5.0,10.0,14.0,12.0,10.0,14.0,6.0,13.0,14.0,13.0,13.0,13.0,12.0,15.0,10.0,13.0,12.0,12.0,13.0,14.0,11.0,13.0,14.0,9.0,12.0,11.0,12.0,20.0,14.0,13.0,13.0,7.0,13.0,8.0,15.0,18.0,14.0,12.0,11.0,14.0,13.0,13.0,6.0,19.0,0.0,0.0,11.0,1.0,171.0,65.0,2.0,2.0,2.0,2.0,2.0,3.0,3.0,3.0,1.0,1.0,3.0,14.0,13.0,13.0,11.0,14.0,15.0,8.0,12.0,6.0,4.0,13.0,12.0,4.0,15.0,8.0,12.0,10.0,12.0,8.0,13.0,13.0,14.0,15.0,8.0,14.0,6.0,13.0,12.0,15.0,16.0,10.0,7.0,20.0,13.0,15.0,10.0,12.0,7.0,11.0,6.0,11.0,8.0,11.0,12.0,13.0,11.0,12.0,12.0,6.0,12.0,5.0,29.0,24.0,2.0,3.0,0.0,181.0,77.0,2.0,1.0,2.0,1.0,1.0,2.0,3.0,3.0,1.0,4.0,1.0,8.0,12.0,16.0,13.0,16.0,11.0,7.0,13.0,4.0,3.0,13.0,17.0,3.0,16.0,11.0,13.0,12.0,14.0,10.0,14.0,10.0,12.0,17.0,8.0,16.0,5.0,7.0,7.0,16.0,15.0,12.0,10.0,12.0,13.0,15.0,20.0,12.0,12.0,8.0,12.0,14.0,14.0,10.0,15.0,15.0,8.0,11.0,8.0,10.0,9.0,13.0,22.0,0.0,0.0,0.0,0.0,181.0,81.0,2.0,3.0,2.0,1.0,3.0,3.0,4.0,2.0,1.0,1.0,2.0,5.0,11.0,12.0,14.0,12.0,6.0,13.0,10.0,5.0,4.0,12.0,12.0,4.0,13.0,8.0,12.0,13.0,12.0,12.0,11.0,11.0,15.0,14.0,5.0,14.0,10.0,13.0,15.0,13.0,12.0,14.0,10.0,20.0,15.0,12.0,14.0,13.0,14.0,13.0,8.0,12.0,5.0,14.0,8.0,12.0,12.0,9.0,13.0,12.0,14.0,7.0,19.0,0.0,0.0,0.0,0.0,172.0,64.0,1.0,3.0,2.0,2.0,4.0,2.0,1.0,2.0,3.0,3.0,1.0,13.0,13.0,15.0,12.0,15.0,12.0,6.0,12.0,3.0,2.0,13.0,11.0,3.0,16.0,8.0,10.0,9.0,12.0,9.0,13.0,10.0,12.0,15.0,8.0,13.0,4.0,5.0,7.0,17.0,16.0,14.0,5.0,20.0,11.0,15.0,12.0,10.0,8.0,8.0,10.0,14.0,8.0,10.0,17.0,14.0,9.0,10.0,9.0,4.0,10.0,10.0,31.0,25.0,0.0,6.0,0.0,191.0,84.0,11.0,14.0,13.0,12.0,15.0,14.0,15.0,16.0,13.0,14.0,14.0,8.0,2.0,10.0,5.0,11.0,11.0,7.0,10.0,2.0,5.0,10.0,11.0,11.0,9.0,12.0,13.0,15.0,13.0,13.0,8.0,13.0,16.0,12.0,14.0,1.0,16.0,13.0,11.0,12.0,13.0,16.0,16.0,8.0,16.0,13.0,20.0,15.0,15.0,17.0,8.0,15.0,7.0,2.0,15.0,15.0,17.0,15.0,17.0,16.0,15.0,6.0,28.0,46.0,3.0,14.0,3.0,190.0,80.0,2.0,3.0,3.0,2.0,2.0,1.0,1.0,3.0,1.0,3.0,1.0,4.0,6.0,7.0,9.0,11.0,7.0,17.0,11.0,10.0,15.0,12.0,11.0,16.0,10.0,17.0,15.0,18.0,13.0,14.0,12.0,14.0,18.0,6.0,17.0,8.0,15.0,15.0,14.0,11.0,10.0,17.0,16.0,7.0,17.0,13.0,20.0,15.0,18.0,17.0,14.0,16.0,4.0,6.0,14.0,15.0,16.0,17.0,18.0,14.0,15.0,6.0,23.0,0.0,0.0,0.0,0.0,184.0,77.0,1.0,1.0,1.0,1.0,3.0,2.0,3.0,2.0,2.0,2.0,3.0,6.0,9.0,11.0,7.0,12.0,7.0,15.0,9.0,11.0,14.0,13.0,10.0,15.0,12.0,14.0,15.0,15.0,13.0,12.0,11.0,13.0,15.0,11.0,9.0,9.0,14.0,14.0,14.0,14.0,13.0,15.0,13.0,9.0,16.0,15.0,20.0,14.0,14.0,14.0,11.0,14.0,4.0,11.0,14.0,13.0,15.0,14.0,16.0,14.0,15.0,6.0,23.0,0.0,0.0,1.0,0.0,182.0,71.0,3.0,1.0,2.0,3.0,4.0,2.0,3.0,1.0,2.0,1.0,3.0,9.0,13.0,14.0,8.0,14.0,13.0,12.0,10.0,13.0,14.0,14.0,13.0,15.0,13.0,14.0,14.0,13.0,11.0,12.0,12.0,13.0,16.0,12.0,12.0,15.0,13.0,14.0,15.0,15.0,13.0,14.0,12.0,9.0,16.0,15.0,20.0,15.0,15.0,15.0,10.0,14.0,6.0,12.0,8.0,15.0,14.0,16.0,15.0,15.0,16.0,6.0,21.0,0.0,0.0,9.0,0.0,185.0,75.0,1.0,1.0,2.0,2.0,2.0,1.0,1.0,4.0,2.0,3.0,2.0,11.0,15.0,14.0,7.0,13.0,9.0,11.0,11.0,14.0,13.0,13.0,10.0,14.0,13.0,15.0,12.0,13.0,10.0,11.0,11.0,12.0,14.0,11.0,10.0,14.0,12.0,13.0,15.0,15.0,13.0,14.0,13.0,20.0,14.0,16.0,8.0,15.0,15.0,13.0,13.0,12.0,9.0,10.0,14.0,14.0,13.0,12.0,12.0,13.0,9.0,9.0,21.0,0.0,0.0,9.0,0.0,184.0,72.0,1.0,3.0,1.0,2.0,3.0,2.0,1.0,1.0,2.0,1.0,2.0,6.0,10.0,12.0,7.0,12.0,7.0,14.0,11.0,7.0,14.0,13.0,10.0,13.0,12.0,14.0,13.0,14.0,12.0,12.0,12.0,12.0,16.0,11.0,10.0,12.0,13.0,14.0,15.0,14.0,13.0,16.0,12.0,12.0,14.0,15.0,20.0,15.0,17.0,14.0,12.0,15.0,9.0,9.0,10.0,16.0,14.0,15.0,14.0,14.0,14.0,8.0,31.0,0.0,0.0,6.0,0.0,174.0,80.0,1.0,1.0,1.0,1.0,1.0,5.0,1.0,1.0,1.0,1.0,1.0,14.0,12.0,11.0,7.0,12.0,13.0,9.0,7.0,10.0,11.0,11.0,10.0,10.0,12.0,11.0,11.0,11.0,10.0,6.0,10.0,9.0,12.0,12.0,12.0,10.0,12.0,12.0,14.0,12.0,15.0,10.0,9.0,20.0,12.0,12.0,7.0,12.0,9.0,9.0,10.0,12.0,7.0,9.0,11.0,14.0,9.0,7.0,14.0,8.0,9.0,9.0,21.0,7.0,0.0,14.0,6.0,173.0,64.0,3.0,2.0,3.0,2.0,3.0,3.0,3.0,2.0,3.0,3.0,3.0,14.0,14.0,18.0,14.0,17.0,14.0,7.0,11.0,2.0,6.0,15.0,14.0,6.0,18.0,12.0,14.0,14.0,15.0,13.0,16.0,14.0,17.0,17.0,12.0,13.0,9.0,13.0,17.0,15.0,17.0,13.0,7.0,20.0,14.0,14.0,9.0,14.0,9.0,15.0,7.0,16.0,7.0,14.0,15.0,17.0,15.0,16.0,17.0,16.0,15.0,4.0,20.0,0.0,0.0,7.0,1.0,170.0,58.0,1.0,2.0,2.0,2.0,2.0,2.0,2.0,4.0,1.0,3.0,2.0,16.0,14.0,16.0,13.0,16.0,17.0,5.0,14.0,2.0,6.0,15.0,13.0,4.0,17.0,9.0,12.0,14.0,12.0,12.0,14.0,13.0,15.0,16.0,7.0,13.0,9.0,13.0,15.0,15.0,16.0,11.0,7.0,20.0,14.0,15.0,8.0,14.0,8.0,15.0,5.0,15.0,7.0,16.0,15.0,15.0,15.0,14.0,16.0,18.0,16.0,3.0,30.0,62.0,25.0,13.0,8.0,177.0,72.0,1.0,3.0,3.0,1.0,3.0,2.0,1.0,3.0,1.0,4.0,1.0,8.0,11.0,12.0,17.0,14.0,12.0,18.0,14.0,3.0,4.0,13.0,18.0,5.0,16.0,14.0,15.0,16.0,17.0,13.0,14.0,16.0,16.0,16.0,16.0,16.0,6.0,13.0,13.0,13.0,14.0,13.0,11.0,14.0,13.0,12.0,20.0,12.0,12.0,15.0,8.0,19.0,10.0,6.0,13.0,18.0,14.0,19.0,15.0,16.0,17.0,10.0,26.0,0.0,0.0,4.0,0.0,180.0,73.0,2.0,3.0,1.0,4.0,2.0,3.0,3.0,1.0,1.0,4.0,1.0,11.0,13.0,13.0,14.0,14.0,11.0,15.0,12.0,3.0,7.0,14.0,14.0,8.0,13.0,12.0,14.0,17.0,13.0,15.0,14.0,14.0,16.0,12.0,15.0,16.0,12.0,18.0,16.0,13.0,14.0,13.0,12.0,8.0,14.0,13.0,20.0,15.0,12.0,15.0,8.0,14.0,7.0,15.0,19.0,14.0,17.0,14.0,18.0,16.0,16.0,5.0
2,0,30.0,0.0,0.0,0.0,0.0,180.0,75.0,11.0,13.0,13.0,9.0,13.0,11.0,12.0,15.0,15.0,14.0,13.0,6.0,1.0,2.0,3.0,7.0,8.0,1.0,1.0,1.0,2.0,7.0,2.0,1.0,7.0,8.0,12.0,14.0,13.0,14.0,7.0,12.0,14.0,5.0,12.0,3.0,13.0,15.0,9.0,13.0,14.0,13.0,10.0,5.0,14.0,11.0,20.0,12.0,13.0,12.0,8.0,14.0,6.0,1.0,9.0,13.0,14.0,13.0,16.0,15.0,15.0,5.0,26.0,11.0,0.0,0.0,0.0,180.0,81.0,3.0,2.0,2.0,3.0,3.0,2.0,1.0,2.0,2.0,1.0,2.0,5.0,9.0,8.0,5.0,11.0,5.0,13.0,10.0,8.0,15.0,10.0,7.0,13.0,10.0,15.0,14.0,17.0,11.0,12.0,9.0,12.0,16.0,8.0,10.0,8.0,13.0,14.0,15.0,13.0,12.0,14.0,12.0,20.0,14.0,12.0,8.0,14.0,14.0,14.0,10.0,15.0,13.0,8.0,9.0,14.0,17.0,13.0,13.0,13.0,11.0,8.0,25.0,0.0,0.0,3.0,0.0,184.0,80.0,2.0,2.0,4.0,2.0,1.0,3.0,2.0,1.0,1.0,2.0,1.0,5.0,8.0,7.0,6.0,9.0,6.0,14.0,6.0,6.0,14.0,7.0,6.0,13.0,9.0,12.0,14.0,13.0,11.0,13.0,7.0,12.0,14.0,8.0,10.0,7.0,14.0,13.0,14.0,15.0,12.0,14.0,12.0,8.0,15.0,15.0,20.0,14.0,14.0,13.0,12.0,14.0,5.0,10.0,16.0,13.0,15.0,15.0,12.0,14.0,14.0,8.0,21.0,0.0,0.0,0.0,0.0,182.0,74.0,2.0,2.0,2.0,2.0,2.0,1.0,1.0,1.0,3.0,2.0,2.0,9.0,11.0,12.0,7.0,9.0,8.0,12.0,7.0,11.0,12.0,7.0,8.0,13.0,11.0,12.0,12.0,14.0,12.0,13.0,7.0,12.0,11.0,1.0,9.0,11.0,9.0,10.0,12.0,14.0,10.0,13.0,11.0,9.0,8.0,12.0,20.0,13.0,11.0,10.0,13.0,8.0,10.0,10.0,15.0,11.0,13.0,10.0,10.0,8.0,13.0,7.0,28.0,22.0,0.0,20.0,1.0,176.0,74.0,2.0,3.0,2.0,1.0,1.0,1.0,3.0,3.0,2.0,2.0,1.0,15.0,15.0,12.0,8.0,13.0,12.0,5.0,11.0,15.0,10.0,13.0,9.0,10.0,12.0,10.0,11.0,10.0,13.0,12.0,11.0,12.0,11.0,11.0,7.0,13.0,10.0,14.0,15.0,15.0,14.0,10.0,8.0,20.0,13.0,14.0,8.0,15.0,8.0,14.0,5.0,12.0,5.0,14.0,15.0,15.0,10.0,14.0,13.0,12.0,12.0,2.0,20.0,0.0,0.0,0.0,0.0,175.0,77.0,2.0,1.0,2.0,3.0,3.0,3.0,3.0,1.0,4.0,3.0,1.0,8.0,8.0,12.0,12.0,11.0,8.0,13.0,10.0,9.0,10.0,11.0,10.0,9.0,12.0,12.0,6.0,9.0,9.0,11.0,15.0,11.0,4.0,10.0,8.0,12.0,11.0,10.0,13.0,14.0,15.0,15.0,8.0,8.0,9.0,15.0,20.0,11.0,12.0,12.0,8.0,4.0,10.0,10.0,15.0,11.0,12.0,11.0,9.0,10.0,10.0,7.0,32.0,25.0,0.0,0.0,0.0,181.0,82.0,2.0,3.0,3.0,1.0,1.0,1.0,1.0,3.0,1.0,2.0,3.0,5.0,10.0,6.0,7.0,10.0,7.0,14.0,9.0,8.0,11.0,12.0,7.0,13.0,10.0,15.0,14.0,16.0,11.0,13.0,10.0,12.0,16.0,9.0,15.0,8.0,11.0,16.0,18.0,11.0,12.0,14.0,11.0,8.0,13.0,11.0,20.0,17.0,15.0,13.0,15.0,11.0,6.0,14.0,18.0,12.0,13.0,13.0,14.0,11.0,11.0,8.0,25.0,24.0,7.0,0.0,0.0,180.0,75.0,1.0,2.0,1.0,1.0,1.0,2.0,3.0,1.0,3.0,1.0,3.0,6.0,10.0,14.0,11.0,14.0,10.0,9.0,12.0,6.0,3.0,13.0,11.0,2.0,16.0,7.0,12.0,12.0,12.0,10.0,12.0,11.0,13.0,16.0,6.0,13.0,5.0,8.0,8.0,16.0,14.0,13.0,10.0,10.0,13.0,14.0,20.0,13.0,12.0,12.0,7.0,14.0,11.0,8.0,17.0,14.0,13.0,13.0,12.0,15.0,15.0,7.0,34.0,0.0,0.0,0.0,0.0,176.0,65.0,2.0,3.0,3.0,3.0,2.0,2.0,1.0,2.0,1.0,1.0,2.0,14.0,15.0,13.0,10.0,15.0,13.0,6.0,15.0,10.0,3.0,14.0,13.0,6.0,14.0,8.0,12.0,9.0,13.0,12.0,14.0,13.0,11.0,12.0,7.0,13.0,8.0,14.0,15.0,14.0,13.0,12.0,8.0,20.0,14.0,13.0,10.0,12.0,7.0,13.0,8.0,15.0,7.0,6.0,13.0,14.0,14.0,9.0,14.0,14.0,11.0,10.0,21.0,0.0,0.0,4.0,1.0,184.0,79.0,1.0,2.0,3.0,1.0,2.0,1.0,3.0,2.0,2.0,1.0,3.0,3.0,6.0,10.0,12.0,12.0,7.0,15.0,8.0,4.0,5.0,13.0,10.0,8.0,12.0,18.0,12.0,19.0,13.0,10.0,13.0,12.0,14.0,13.0,10.0,12.0,9.0,16.0,15.0,12.0,14.0,14.0,14.0,12.0,13.0,10.0,20.0,14.0,14.0,11.0,14.0,14.0,11.0,5.0,10.0,13.0,14.0,15.0,10.0,8.0,4.0,15.0,19.0,0.0,0.0,0.0,0.0,173.0,67.0,3.0,2.0,4.0,2.0,1.0,1.0,3.0,1.0,1.0,1.0,2.0,13.0,13.0,15.0,10.0,14.0,11.0,6.0,12.0,4.0,4.0,12.0,11.0,5.0,14.0,10.0,12.0,9.0,10.0,8.0,12.0,8.0,11.0,15.0,5.0,12.0,6.0,8.0,10.0,16.0,15.0,13.0,7.0,8.0,13.0,15.0,20.0,11.0,9.0,12.0,6.0,12.0,6.0,15.0,8.0,13.0,8.0,12.0,9.0,14.0,13.0,9.0,20.0,0.0,0.0,3.0,0.0,193.0,80.0,10.0,12.0,12.0,9.0,11.0,11.0,13.0,15.0,13.0,7.0,12.0,7.0,1.0,1.0,2.0,8.0,11.0,1.0,2.0,1.0,2.0,11.0,2.0,1.0,8.0,4.0,14.0,14.0,11.0,9.0,11.0,12.0,12.0,2.0,15.0,1.0,13.0,11.0,6.0,12.0,13.0,15.0,16.0,20.0,15.0,10.0,6.0,13.0,14.0,12.0,11.0,11.0,10.0,1.0,11.0,9.0,12.0,12.0,13.0,10.0,10.0,1.0,32.0,19.0,0.0,9.0,0.0,185.0,85.0,2.0,3.0,2.0,1.0,2.0,1.0,1.0,2.0,2.0,3.0,3.0,5.0,10.0,9.0,8.0,11.0,11.0,15.0,13.0,9.0,15.0,12.0,10.0,14.0,11.0,14.0,15.0,16.0,12.0,11.0,9.0,11.0,17.0,7.0,12.0,9.0,15.0,13.0,10.0,9.0,9.0,15.0,13.0,10.0,13.0,11.0,20.0,13.0,15.0,12.0,15.0,12.0,13.0,10.0,11.0,13.0,11.0,13.0,18.0,15.0,13.0,5.0,27.0,0.0,0.0,0.0,0.0,181.0,79.0,3.0,1.0,3.0,1.0,3.0,1.0,1.0,2.0,3.0,3.0,3.0,5.0,12.0,10.0,5.0,10.0,6.0,11.0,7.0,8.0,12.0,9.0,7.0,12.0,11.0,13.0,13.0,14.0,13.0,12.0,9.0,9.0,13.0,9.0,7.0,8.0,13.0,13.0,13.0,15.0,12.0,13.0,10.0,5.0,13.0,13.0,20.0,15.0,14.0,15.0,13.0,7.0,6.0,10.0,8.0,13.0,13.0,13.0,14.0,14.0,14.0,5.0,28.0,0.0,0.0,0.0,0.0,194.0,93.0,2.0,3.0,2.0,1.0,4.0,2.0,2.0,1.0,2.0,2.0,3.0,4.0,5.0,11.0,7.0,12.0,12.0,14.0,12.0,7.0,12.0,10.0,7.0,14.0,9.0,12.0,11.0,16.0,12.0,12.0,11.0,10.0,12.0,7.0,14.0,7.0,12.0,15.0,13.0,8.0,9.0,17.0,16.0,20.0,11.0,9.0,6.0,14.0,17.0,10.0,10.0,10.0,8.0,8.0,17.0,12.0,14.0,12.0,13.0,1.0,5.0,8.0,32.0,23.0,0.0,0.0,0.0,178.0,77.0,3.0,2.0,3.0,1.0,3.0,1.0,3.0,2.0,1.0,3.0,1.0,9.0,12.0,12.0,6.0,13.0,12.0,10.0,10.0,10.0,13.0,12.0,7.0,14.0,13.0,15.0,14.0,13.0,13.0,10.0,10.0,12.0,5.0,12.0,11.0,12.0,13.0,14.0,14.0,14.0,13.0,12.0,9.0,20.0,14.0,14.0,10.0,13.0,12.0,13.0,6.0,14.0,6.0,10.0,13.0,5.0,11.0,8.0,10.0,14.0,9.0,15.0,23.0,5.0,0.0,0.0,0.0,180.0,75.0,1.0,1.0,2.0,3.0,3.0,1.0,2.0,2.0,3.0,1.0,3.0,5.0,9.0,12.0,7.0,14.0,8.0,12.0,11.0,6.0,11.0,12.0,12.0,11.0,11.0,12.0,13.0,13.0,11.0,10.0,13.0,11.0,14.0,11.0,7.0,11.0,12.0,14.0,13.0,15.0,13.0,14.0,10.0,7.0,14.0,14.0,20.0,13.0,14.0,12.0,11.0,12.0,12.0,15.0,10.0,14.0,13.0,12.0,14.0,14.0,14.0,6.0,31.0,0.0,0.0,0.0,0.0,180.0,74.0,3.0,2.0,3.0,1.0,2.0,3.0,2.0,1.0,4.0,3.0,3.0,12.0,12.0,10.0,9.0,13.0,14.0,11.0,13.0,6.0,10.0,14.0,15.0,13.0,13.0,15.0,14.0,17.0,12.0,14.0,13.0,13.0,15.0,7.0,13.0,10.0,13.0,18.0,15.0,9.0,11.0,14.0,10.0,10.0,13.0,12.0,20.0,15.0,14.0,14.0,13.0,15.0,8.0,7.0,19.0,13.0,13.0,13.0,13.0,13.0,12.0,9.0,27.0,27.0,1.0,2.0,1.0,183.0,72.0,2.0,2.0,2.0,1.0,2.0,1.0,3.0,1.0,2.0,2.0,4.0,5.0,8.0,10.0,6.0,11.0,10.0,14.0,11.0,5.0,14.0,12.0,10.0,15.0,11.0,14.0,13.0,16.0,11.0,11.0,9.0,10.0,12.0,8.0,12.0,8.0,13.0,14.0,14.0,14.0,12.0,16.0,11.0,8.0,12.0,13.0,20.0,15.0,15.0,10.0,14.0,11.0,7.0,11.0,13.0,13.0,9.0,9.0,11.0,10.0,10.0,8.0,19.0,0.0,0.0,0.0,0.0,170.0,62.0,1.0,3.0,3.0,3.0,3.0,3.0,1.0,1.0,3.0,1.0,3.0,10.0,10.0,10.0,9.0,12.0,10.0,6.0,14.0,10.0,8.0,13.0,8.0,8.0,12.0,10.0,11.0,10.0,14.0,9.0,12.0,12.0,18.0,10.0,10.0,11.0,10.0,12.0,14.0,13.0,12.0,11.0,6.0,20.0,15.0,10.0,7.0,12.0,6.0,10.0,10.0,6.0,9.0,9.0,11.0,9.0,11.0,10.0,11.0,9.0,16.0,8.0,21.0,0.0,0.0,0.0,0.0,181.0,73.0,2.0,3.0,2.0,2.0,1.0,2.0,1.0,2.0,1.0,3.0,1.0,6.0,9.0,12.0,11.0,11.0,8.0,9.0,11.0,6.0,4.0,9.0,12.0,3.0,13.0,10.0,11.0,12.0,11.0,9.0,9.0,9.0,14.0,13.0,6.0,13.0,6.0,10.0,12.0,15.0,14.0,13.0,10.0,8.0,12.0,14.0,20.0,11.0,12.0,12.0,10.0,14.0,10.0,8.0,16.0,13.0,13.0,14.0,12.0,15.0,15.0,8.0,21.0,0.0,0.0,6.0,3.0,185.0,75.0,2.0,2.0,2.0,4.0,4.0,1.0,3.0,1.0,3.0,1.0,1.0,9.0,7.0,11.0,14.0,11.0,10.0,16.0,7.0,6.0,8.0,11.0,8.0,8.0,9.0,10.0,11.0,14.0,14.0,11.0,12.0,11.0,9.0,11.0,15.0,10.0,12.0,10.0,13.0,11.0,12.0,11.0,13.0,6.0,14.0,13.0,20.0,16.0,11.0,8.0,10.0,10.0,9.0,10.0,19.0,11.0,12.0,11.0,9.0,11.0,16.0,3.0
3,2,17.0,0.0,0.0,0.0,0.0,193.0,82.0,13.0,11.0,12.0,2.0,12.0,10.0,14.0,15.0,14.0,12.0,10.0,3.0,1.0,1.0,3.0,5.0,6.0,2.0,2.0,1.0,3.0,9.0,3.0,1.0,8.0,7.0,12.0,13.0,13.0,13.0,11.0,11.0,15.0,3.0,8.0,3.0,12.0,12.0,11.0,10.0,12.0,14.0,17.0,5.0,15.0,11.0,20.0,13.0,12.0,13.0,8.0,11.0,5.0,11.0,13.0,15.0,15.0,17.0,14.0,15.0,15.0,5.0,30.0,0.0,0.0,0.0,0.0,187.0,82.0,3.0,3.0,2.0,3.0,3.0,3.0,4.0,3.0,3.0,2.0,2.0,7.0,9.0,5.0,8.0,8.0,6.0,14.0,9.0,11.0,13.0,10.0,3.0,13.0,7.0,15.0,12.0,16.0,8.0,11.0,7.0,12.0,6.0,4.0,8.0,7.0,13.0,13.0,14.0,10.0,11.0,13.0,14.0,5.0,13.0,11.0,20.0,15.0,15.0,12.0,13.0,11.0,11.0,11.0,17.0,11.0,10.0,10.0,13.0,11.0,18.0,5.0,24.0,8.0,0.0,0.0,0.0,186.0,81.0,1.0,1.0,1.0,3.0,3.0,1.0,1.0,1.0,2.0,1.0,2.0,4.0,8.0,7.0,5.0,9.0,5.0,14.0,8.0,7.0,12.0,8.0,6.0,12.0,9.0,13.0,12.0,14.0,12.0,11.0,9.0,12.0,14.0,1.0,11.0,7.0,13.0,14.0,14.0,12.0,8.0,15.0,14.0,5.0,13.0,14.0,20.0,13.0,15.0,13.0,13.0,8.0,13.0,8.0,7.0,11.0,14.0,10.0,14.0,14.0,14.0,6.0,19.0,0.0,0.0,0.0,0.0,178.0,63.0,1.0,3.0,3.0,3.0,3.0,3.0,2.0,2.0,1.0,2.0,1.0,12.0,14.0,8.0,4.0,13.0,8.0,9.0,8.0,14.0,14.0,12.0,7.0,12.0,12.0,10.0,12.0,12.0,10.0,11.0,7.0,13.0,5.0,1.0,10.0,9.0,10.0,11.0,12.0,12.0,14.0,11.0,10.0,5.0,16.0,11.0,20.0,10.0,9.0,10.0,10.0,9.0,9.0,10.0,13.0,8.0,11.0,11.0,11.0,11.0,10.0,6.0,22.0,25.0,0.0,0.0,0.0,180.0,75.0,2.0,3.0,1.0,1.0,4.0,3.0,1.0,1.0,4.0,2.0,2.0,11.0,13.0,14.0,10.0,12.0,9.0,12.0,9.0,13.0,13.0,12.0,9.0,13.0,12.0,13.0,12.0,14.0,13.0,12.0,10.0,11.0,5.0,8.0,6.0,10.0,12.0,13.0,15.0,15.0,14.0,13.0,10.0,20.0,14.0,14.0,5.0,15.0,13.0,12.0,13.0,6.0,7.0,11.0,14.0,11.0,12.0,12.0,14.0,9.0,11.0,5.0,21.0,0.0,0.0,0.0,0.0,188.0,80.0,1.0,2.0,2.0,3.0,2.0,2.0,2.0,2.0,1.0,1.0,1.0,6.0,9.0,12.0,6.0,12.0,12.0,12.0,11.0,3.0,12.0,13.0,8.0,13.0,13.0,13.0,13.0,13.0,13.0,13.0,13.0,13.0,13.0,8.0,11.0,11.0,13.0,15.0,13.0,12.0,12.0,13.0,14.0,20.0,14.0,11.0,5.0,13.0,14.0,12.0,11.0,3.0,6.0,8.0,17.0,12.0,13.0,13.0,14.0,14.0,14.0,6.0,19.0,0.0,0.0,0.0,0.0,184.0,78.0,3.0,1.0,2.0,1.0,2.0,2.0,2.0,3.0,3.0,4.0,2.0,6.0,8.0,9.0,5.0,13.0,6.0,11.0,8.0,5.0,13.0,13.0,8.0,12.0,13.0,13.0,13.0,15.0,12.0,12.0,13.0,12.0,14.0,7.0,11.0,8.0,15.0,14.0,15.0,13.0,12.0,14.0,11.0,5.0,15.0,12.0,20.0,16.0,14.0,13.0,12.0,11.0,7.0,10.0,19.0,13.0,15.0,12.0,14.0,13.0,12.0,6.0,27.0,34.0,2.0,8.0,0.0,180.0,69.0,2.0,2.0,3.0,3.0,1.0,1.0,4.0,1.0,3.0,2.0,3.0,16.0,15.0,14.0,12.0,14.0,16.0,6.0,14.0,6.0,7.0,14.0,13.0,7.0,15.0,13.0,10.0,10.0,12.0,11.0,13.0,12.0,12.0,13.0,7.0,13.0,8.0,10.0,13.0,13.0,14.0,12.0,9.0,20.0,13.0,14.0,10.0,13.0,11.0,11.0,12.0,10.0,6.0,8.0,8.0,13.0,10.0,10.0,14.0,7.0,8.0,12.0,29.0,46.0,9.0,28.0,13.0,192.0,78.0,3.0,3.0,3.0,2.0,1.0,2.0,2.0,4.0,3.0,3.0,2.0,11.0,11.0,12.0,12.0,13.0,12.0,14.0,13.0,5.0,3.0,13.0,12.0,3.0,13.0,17.0,12.0,14.0,14.0,11.0,14.0,12.0,10.0,9.0,10.0,16.0,6.0,11.0,10.0,12.0,14.0,15.0,15.0,13.0,13.0,10.0,20.0,15.0,13.0,11.0,12.0,10.0,5.0,12.0,10.0,16.0,11.0,16.0,16.0,8.0,15.0,14.0,25.0,14.0,1.0,2.0,0.0,177.0,77.0,3.0,3.0,1.0,2.0,3.0,3.0,1.0,3.0,3.0,4.0,1.0,8.0,11.0,13.0,12.0,12.0,10.0,11.0,10.0,2.0,3.0,11.0,10.0,5.0,13.0,12.0,12.0,13.0,11.0,10.0,11.0,10.0,14.0,16.0,14.0,15.0,5.0,13.0,14.0,15.0,14.0,12.0,12.0,12.0,14.0,16.0,20.0,13.0,14.0,13.0,7.0,14.0,11.0,13.0,14.0,11.0,12.0,8.0,12.0,13.0,15.0,6.0,32.0,0.0,0.0,0.0,0.0,183.0,67.0,1.0,2.0,3.0,2.0,3.0,2.0,3.0,1.0,2.0,2.0,2.0,4.0,12.0,11.0,6.0,5.0,5.0,4.0,8.0,11.0,13.0,11.0,5.0,13.0,11.0,11.0,11.0,12.0,11.0,11.0,9.0,12.0,11.0,12.0,10.0,12.0,11.0,12.0,12.0,14.0,13.0,13.0,8.0,8.0,13.0,13.0,20.0,14.0,14.0,10.0,12.0,11.0,8.0,11.0,11.0,10.0,10.0,12.0,11.0,9.0,10.0,12.0,27.0,0.0,0.0,0.0,0.0,184.0,77.0,10.0,12.0,13.0,6.0,15.0,12.0,13.0,15.0,13.0,12.0,11.0,8.0,3.0,3.0,1.0,5.0,10.0,2.0,1.0,2.0,3.0,8.0,4.0,2.0,9.0,8.0,13.0,13.0,13.0,12.0,6.0,12.0,14.0,5.0,10.0,3.0,12.0,12.0,10.0,6.0,14.0,13.0,12.0,8.0,15.0,11.0,20.0,11.0,12.0,14.0,8.0,12.0,7.0,1.0,11.0,13.0,15.0,13.0,14.0,14.0,14.0,6.0,28.0,0.0,0.0,0.0,0.0,184.0,85.0,2.0,3.0,2.0,1.0,1.0,3.0,2.0,2.0,3.0,1.0,3.0,4.0,8.0,8.0,6.0,12.0,6.0,14.0,8.0,5.0,13.0,12.0,6.0,14.0,12.0,11.0,13.0,14.0,13.0,12.0,11.0,11.0,13.0,7.0,14.0,10.0,15.0,16.0,12.0,12.0,11.0,15.0,12.0,20.0,13.0,11.0,7.0,14.0,16.0,13.0,11.0,13.0,13.0,12.0,15.0,13.0,13.0,14.0,15.0,14.0,14.0,6.0,32.0,1.0,0.0,5.0,0.0,189.0,93.0,1.0,1.0,3.0,4.0,2.0,2.0,3.0,2.0,3.0,3.0,3.0,3.0,8.0,8.0,7.0,9.0,8.0,16.0,8.0,7.0,14.0,10.0,9.0,14.0,9.0,15.0,14.0,16.0,12.0,10.0,10.0,12.0,14.0,9.0,9.0,7.0,13.0,14.0,15.0,9.0,8.0,10.0,14.0,8.0,16.0,11.0,20.0,14.0,19.0,12.0,14.0,12.0,8.0,6.0,13.0,16.0,14.0,11.0,15.0,14.0,12.0,10.0,26.0,11.0,0.0,4.0,0.0,183.0,79.0,3.0,2.0,1.0,2.0,2.0,2.0,3.0,2.0,2.0,2.0,1.0,5.0,7.0,9.0,6.0,10.0,11.0,15.0,11.0,7.0,14.0,10.0,7.0,13.0,10.0,14.0,13.0,15.0,13.0,12.0,10.0,12.0,17.0,8.0,11.0,10.0,13.0,15.0,16.0,13.0,13.0,16.0,13.0,5.0,15.0,13.0,20.0,16.0,15.0,13.0,14.0,15.0,7.0,14.0,16.0,12.0,14.0,14.0,15.0,14.0,14.0,5.0,26.0,0.0,0.0,0.0,0.0,177.0,68.0,4.0,2.0,1.0,2.0,3.0,1.0,1.0,2.0,3.0,3.0,3.0,12.0,13.0,11.0,8.0,13.0,11.0,8.0,10.0,8.0,10.0,13.0,10.0,12.0,13.0,7.0,12.0,10.0,13.0,11.0,15.0,13.0,14.0,11.0,7.0,14.0,10.0,14.0,14.0,13.0,15.0,12.0,9.0,20.0,15.0,14.0,5.0,15.0,8.0,13.0,7.0,14.0,6.0,12.0,11.0,12.0,14.0,13.0,16.0,16.0,16.0,5.0,21.0,0.0,0.0,4.0,0.0,178.0,72.0,2.0,3.0,1.0,2.0,2.0,3.0,3.0,1.0,2.0,2.0,3.0,6.0,12.0,10.0,7.0,11.0,7.0,9.0,8.0,11.0,12.0,11.0,8.0,13.0,11.0,10.0,12.0,11.0,12.0,13.0,11.0,11.0,13.0,8.0,11.0,12.0,12.0,13.0,14.0,15.0,13.0,13.0,9.0,7.0,14.0,14.0,20.0,14.0,12.0,13.0,10.0,12.0,9.0,14.0,16.0,15.0,8.0,10.0,12.0,16.0,17.0,10.0,20.0,0.0,0.0,0.0,0.0,169.0,70.0,4.0,1.0,3.0,2.0,3.0,2.0,3.0,3.0,3.0,2.0,2.0,5.0,7.0,11.0,11.0,11.0,9.0,5.0,12.0,1.0,4.0,11.0,12.0,3.0,11.0,12.0,10.0,12.0,10.0,9.0,8.0,8.0,14.0,14.0,2.0,10.0,3.0,12.0,14.0,14.0,11.0,11.0,8.0,20.0,12.0,13.0,8.0,14.0,9.0,12.0,10.0,12.0,5.0,10.0,19.0,12.0,12.0,10.0,12.0,8.0,5.0,14.0,31.0,0.0,0.0,4.0,0.0,174.0,72.0,2.0,1.0,4.0,2.0,2.0,3.0,1.0,1.0,3.0,3.0,4.0,12.0,9.0,11.0,6.0,14.0,11.0,7.0,10.0,6.0,8.0,16.0,12.0,9.0,14.0,9.0,14.0,10.0,13.0,12.0,12.0,11.0,14.0,8.0,8.0,11.0,12.0,14.0,12.0,13.0,14.0,12.0,7.0,12.0,14.0,12.0,20.0,15.0,11.0,11.0,9.0,12.0,8.0,10.0,10.0,14.0,13.0,10.0,12.0,14.0,14.0,9.0,30.0,0.0,0.0,11.0,4.0,172.0,69.0,4.0,2.0,2.0,3.0,3.0,3.0,3.0,3.0,4.0,4.0,3.0,13.0,13.0,13.0,11.0,13.0,13.0,7.0,12.0,9.0,4.0,13.0,12.0,4.0,15.0,7.0,12.0,10.0,12.0,12.0,15.0,12.0,13.0,17.0,8.0,14.0,7.0,12.0,12.0,14.0,15.0,12.0,6.0,20.0,10.0,14.0,10.0,13.0,7.0,12.0,6.0,12.0,15.0,13.0,10.0,11.0,13.0,12.0,11.0,14.0,14.0,6.0,27.0,33.0,4.0,3.0,0.0,180.0,75.0,2.0,1.0,2.0,1.0,4.0,2.0,1.0,3.0,1.0,1.0,2.0,12.0,11.0,13.0,13.0,11.0,11.0,11.0,10.0,7.0,5.0,10.0,14.0,5.0,14.0,9.0,11.0,12.0,10.0,11.0,12.0,12.0,14.0,13.0,8.0,14.0,8.0,11.0,14.0,16.0,14.0,13.0,10.0,7.0,12.0,15.0,20.0,14.0,12.0,12.0,9.0,13.0,10.0,10.0,9.0,15.0,8.0,9.0,13.0,14.0,14.0,7.0,24.0,24.0,4.0,0.0,0.0,172.0,74.0,2.0,4.0,3.0,2.0,2.0,1.0,2.0,2.0,3.0,2.0,4.0,8.0,9.0,14.0,13.0,14.0,9.0,11.0,10.0,7.0,5.0,12.0,12.0,3.0,13.0,10.0,12.0,12.0,13.0,12.0,11.0,10.0,14.0,13.0,7.0,14.0,9.0,9.0,13.0,16.0,15.0,13.0,6.0,8.0,13.0,16.0,20.0,14.0,12.0,11.0,11.0,13.0,9.0,8.0,9.0,13.0,9.0,11.0,12.0,13.0,10.0,9.0
1,0,25.0,4.0,0.0,11.0,0.0,184.0,81.0,14.0,14.0,13.0,9.0,15.0,12.0,16.0,16.0,13.0,7.0,11.0,8.0,1.0,2.0,1.0,11.0,12.0,6.0,1.0,3.0,3.0,11.0,5.0,3.0,11.0,8.0,15.0,15.0,13.0,14.0,10.0,11.0,14.0,8.0,13.0,5.0,13.0,10.0,10.0,14.0,16.0,14.0,13.0,20.0,14.0,12.0,5.0,14.0,14.0,15.0,9.0,16.0,6.0,1.0,17.0,11.0,15.0,13.0,14.0,12.0,12.0,4.0,19.0,0.0,0.0,0.0,0.0,193.0,89.0,3.0,2.0,2.0,3.0,1.0,3.0,1.0,4.0,2.0,2.0,3.0,8.0,10.0,5.0,4.0,10.0,10.0,14.0,12.0,6.0,12.0,10.0,4.0,12.0,9.0,11.0,11.0,14.0,11.0,12.0,8.0,14.0,13.0,8.0,8.0,11.0,11.0,13.0,13.0,10.0,9.0,14.0,16.0,6.0,14.0,10.0,20.0,12.0,14.0,11.0,7.0,6.0,6.0,8.0,16.0,10.0,10.0,12.0,13.0,16.0,16.0,5.0,27.0,4.0,0.0,5.0,1.0,184.0,83.0,2.0,4.0,3.0,1.0,1.0,2.0,1.0,2.0,4.0,2.0,3.0,4.0,8.0,11.0,4.0,10.0,4.0,14.0,4.0,4.0,15.0,12.0,5.0,16.0,11.0,14.0,14.0,16.0,14.0,10.0,11.0,12.0,17.0,7.0,10.0,9.0,13.0,14.0,15.0,14.0,13.0,16.0,13.0,10.0,15.0,13.0,20.0,15.0,16.0,12.0,12.0,14.0,6.0,12.0,11.0,13.0,12.0,12.0,16.0,15.0,14.0,6.0,37.0,0.0,0.0,0.0,0.0,185.0,83.0,1.0,1.0,2.0,1.0,3.0,2.0,3.0,1.0,1.0,3.0,1.0,6.0,8.0,9.0,12.0,10.0,8.0,13.0,9.0,4.0,5.0,10.0,14.0,4.0,11.0,11.0,10.0,11.0,13.0,12.0,12.0,13.0,15.0,14.0,12.0,11.0,7.0,12.0,8.0,7.0,7.0,12.0,12.0,11.0,11.0,7.0,20.0,8.0,14.0,12.0,8.0,13.0,9.0,12.0,12.0,12.0,19.0,14.0,15.0,14.0,8.0,8.0,32.0,0.0,0.0,0.0,0.0,172.0,71.0,2.0,1.0,3.0,1.0,2.0,3.0,2.0,3.0,2.0,2.0,2.0,8.0,9.0,7.0,6.0,10.0,6.0,10.0,9.0,10.0,14.0,11.0,6.0,14.0,11.0,10.0,16.0,15.0,12.0,12.0,7.0,12.0,15.0,9.0,13.0,8.0,14.0,15.0,15.0,14.0,14.0,14.0,10.0,20.0,14.0,14.0,8.0,15.0,13.0,13.0,11.0,13.0,7.0,13.0,17.0,14.0,17.0,8.0,13.0,15.0,15.0,6.0,27.0,8.0,0.0,6.0,0.0,187.0,76.0,3.0,2.0,3.0,2.0,2.0,1.0,1.0,3.0,3.0,1.0,2.0,5.0,7.0,11.0,5.0,14.0,5.0,14.0,9.0,5.0,15.0,15.0,8.0,14.0,13.0,15.0,16.0,15.0,14.0,12.0,14.0,14.0,18.0,8.0,17.0,9.0,12.0,18.0,15.0,13.0,14.0,15.0,14.0,10.0,17.0,12.0,20.0,17.0,15.0,14.0,13.0,16.0,4.0,12.0,10.0,14.0,17.0,12.0,15.0,13.0,13.0,6.0,21.0,0.0,0.0,15.0,3.0,181.0,78.0,3.0,3.0,4.0,2.0,1.0,2.0,2.0,4.0,2.0,1.0,1.0,5.0,7.0,11.0,10.0,14.0,5.0,14.0,10.0,6.0,13.0,14.0,8.0,14.0,14.0,12.0,14.0,12.0,11.0,10.0,12.0,11.0,16.0,11.0,12.0,14.0,14.0,14.0,14.0,14.0,13.0,14.0,13.0,10.0,16.0,14.0,20.0,16.0,14.0,12.0,10.0,11.0,5.0,19.0,8.0,11.0,14.0,11.0,16.0,13.0,13.0,10.0,24.0,6.0,1.0,0.0,0.0,183.0,66.0,1.0,1.0,2.0,2.0,1.0,2.0,1.0,2.0,3.0,2.0,1.0,14.0,14.0,14.0,10.0,14.0,14.0,9.0,10.0,8.0,8.0,14.0,10.0,8.0,15.0,9.0,11.0,13.0,11.0,11.0,13.0,10.0,14.0,13.0,5.0,12.0,9.0,14.0,13.0,14.0,16.0,12.0,9.0,20.0,13.0,14.0,5.0,15.0,9.0,12.0,10.0,12.0,8.0,9.0,16.0,9.0,16.0,13.0,11.0,12.0,13.0,9.0,31.0,52.0,8.0,0.0,0.0,167.0,58.0,1.0,2.0,2.0,1.0,3.0,2.0,4.0,2.0,1.0,2.0,3.0,15.0,15.0,14.0,7.0,15.0,15.0,6.0,11.0,3.0,4.0,15.0,14.0,7.0,15.0,13.0,12.0,15.0,13.0,14.0,16.0,11.0,17.0,14.0,11.0,12.0,10.0,12.0,14.0,15.0,18.0,10.0,5.0,10.0,16.0,14.0,20.0,13.0,7.0,14.0,13.0,16.0,8.0,12.0,13.0,16.0,14.0,15.0,13.0,9.0,11.0,14.0,22.0,5.0,1.0,1.0,0.0,173.0,72.0,1.0,3.0,1.0,3.0,3.0,3.0,3.0,3.0,3.0,2.0,2.0,14.0,13.0,16.0,14.0,16.0,14.0,5.0,11.0,5.0,5.0,15.0,11.0,5.0,16.0,8.0,13.0,9.0,14.0,13.0,15.0,13.0,15.0,16.0,5.0,13.0,5.0,9.0,10.0,15.0,16.0,14.0,5.0,20.0,14.0,15.0,5.0,12.0,14.0,13.0,11.0,13.0,8.0,14.0,10.0,15.0,14.0,10.0,13.0,10.0,10.0,13.0,25.0,10.0,1.0,11.0,4.0,175.0,73.0,1.0,3.0,3.0,3.0,3.0,3.0,3.0,1.0,2.0,3.0,1.0,5.0,10.0,15.0,17.0,15.0,10.0,11.0,12.0,5.0,5.0,14.0,15.0,5.0,16.0,8.0,15.0,12.0,15.0,14.0,13.0,15.0,15.0,15.0,14.0,14.0,10.0,10.0,12.0,16.0,16.0,15.0,9.0,10.0,15.0,16.0,20.0,13.0,15.0,14.0,8.0,14.0,7.0,10.0,8.0,16.0,17.0,13.0,15.0,15.0,14.0,5.0,28.0,0.0,0.0,0.0,0.0,188.0,86.0,14.0,13.0,15.0,8.0,14.0,11.0,14.0,16.0,13.0,12.0,8.0,6.0,2.0,1.0,3.0,8.0,8.0,1.0,1.0,3.0,1.0,8.0,4.0,1.0,8.0,8.0,13.0,13.0,14.0,14.0,11.0,12.0,15.0,7.0,10.0,2.0,14.0,12.0,11.0,13.0,14.0,16.0,13.0,5.0,16.0,12.0,20.0,14.0,15.0,14.0,8.0,15.0,5.0,1.0,11.0,15.0,14.0,14.0,16.0,14.0,11.0,6.0,19.0,0.0,0.0,0.0,0.0,182.0,89.0,1.0,2.0,2.0,1.0,1.0,1.0,2.0,1.0,3.0,3.0,3.0,5.0,8.0,6.0,5.0,11.0,5.0,14.0,6.0,6.0,12.0,11.0,8.0,13.0,10.0,13.0,12.0,15.0,12.0,13.0,9.0,12.0,12.0,8.0,8.0,7.0,12.0,13.0,14.0,12.0,11.0,15.0,12.0,10.0,15.0,13.0,20.0,14.0,16.0,13.0,4.0,10.0,6.0,11.0,9.0,13.0,10.0,13.0,13.0,14.0,14.0,6.0,21.0,0.0,0.0,1.0,0.0,186.0,75.0,3.0,4.0,2.0,2.0,2.0,2.0,1.0,2.0,2.0,1.0,3.0,10.0,11.0,10.0,8.0,13.0,11.0,10.0,11.0,8.0,12.0,11.0,7.0,14.0,12.0,11.0,12.0,14.0,11.0,10.0,10.0,11.0,14.0,12.0,11.0,14.0,11.0,12.0,12.0,13.0,11.0,12.0,14.0,20.0,11.0,14.0,5.0,13.0,12.0,12.0,11.0,11.0,10.0,11.0,11.0,14.0,11.0,12.0,9.0,8.0,7.0,2.0,30.0,0.0,0.0,0.0,0.0,176.0,75.0,2.0,3.0,2.0,1.0,3.0,2.0,1.0,2.0,1.0,3.0,1.0,9.0,14.0,11.0,6.0,12.0,9.0,11.0,10.0,12.0,11.0,11.0,10.0,12.0,12.0,13.0,13.0,14.0,10.0,10.0,11.0,11.0,12.0,8.0,10.0,9.0,12.0,13.0,15.0,15.0,13.0,12.0,9.0,20.0,15.0,14.0,6.0,17.0,12.0,12.0,13.0,13.0,6.0,14.0,11.0,14.0,14.0,12.0,14.0,13.0,13.0,9.0,29.0,0.0,0.0,4.0,0.0,184.0,72.0,3.0,2.0,4.0,2.0,3.0,1.0,1.0,3.0,1.0,1.0,1.0,8.0,13.0,10.0,6.0,11.0,7.0,12.0,8.0,10.0,12.0,11.0,9.0,13.0,11.0,9.0,14.0,14.0,11.0,14.0,10.0,12.0,16.0,9.0,14.0,12.0,13.0,15.0,16.0,15.0,12.0,14.0,12.0,8.0,13.0,14.0,20.0,16.0,12.0,13.0,9.0,16.0,8.0,15.0,13.0,13.0,17.0,14.0,16.0,16.0,16.0,5.0,29.0,59.0,2.0,9.0,0.0,179.0,70.0,2.0,3.0,2.0,1.0,1.0,1.0,1.0,1.0,4.0,3.0,3.0,6.0,8.0,8.0,7.0,12.0,6.0,10.0,8.0,12.0,14.0,12.0,7.0,14.0,11.0,18.0,14.0,16.0,10.0,16.0,8.0,12.0,17.0,6.0,14.0,8.0,14.0,18.0,19.0,13.0,12.0,14.0,11.0,10.0,18.0,15.0,20.0,18.0,13.0,15.0,13.0,15.0,7.0,15.0,18.0,14.0,8.0,13.0,18.0,12.0,14.0,5.0,25.0,0.0,0.0,7.0,0.0,180.0,76.0,2.0,1.0,3.0,3.0,3.0,3.0,4.0,2.0,1.0,1.0,3.0,10.0,12.0,11.0,8.0,14.0,9.0,12.0,13.0,8.0,10.0,14.0,8.0,12.0,14.0,13.0,13.0,15.0,13.0,14.0,13.0,13.0,15.0,10.0,7.0,11.0,12.0,15.0,16.0,14.0,15.0,14.0,10.0,8.0,14.0,13.0,20.0,15.0,13.0,14.0,13.0,14.0,9.0,16.0,12.0,13.0,15.0,13.0,14.0,12.0,11.0,8.0,29.0,31.0,4.0,19.0,4.0,185.0,82.0,3.0,1.0,2.0,2.0,1.0,2.0,1.0,2.0,3.0,1.0,1.0,13.0,13.0,13.0,9.0,16.0,14.0,12.0,14.0,5.0,6.0,16.0,14.0,6.0,16.0,10.0,14.0,10.0,14.0,12.0,15.0,13.0,14.0,12.0,11.0,13.0,8.0,15.0,12.0,12.0,13.0,14.0,12.0,12.0,12.0,12.0,20.0,14.0,14.0,14.0,12.0,15.0,15.0,10.0,12.0,16.0,14.0,8.0,17.0,14.0,15.0,5.0,27.0,17.0,2.0,0.0,0.0,180.0,78.0,2.0,3.0,2.0,1.0,1.0,2.0,1.0,1.0,2.0,3.0,2.0,7.0,10.0,13.0,12.0,13.0,11.0,12.0,12.0,7.0,5.0,12.0,9.0,4.0,12.0,12.0,13.0,14.0,10.0,11.0,11.0,10.0,12.0,14.0,5.0,13.0,7.0,10.0,14.0,16.0,15.0,14.0,11.0,20.0,12.0,15.0,8.0,14.0,14.0,11.0,12.0,15.0,9.0,10.0,6.0,14.0,12.0,11.0,13.0,13.0,13.0,10.0,23.0,2.0,0.0,15.0,9.0,180.0,82.0,3.0,4.0,1.0,3.0,3.0,2.0,2.0,3.0,3.0,1.0,3.0,10.0,13.0,15.0,12.0,12.0,11.0,8.0,14.0,7.0,5.0,12.0,11.0,5.0,14.0,9.0,11.0,13.0,10.0,10.0,13.0,11.0,14.0,16.0,6.0,12.0,5.0,11.0,10.0,18.0,13.0,15.0,10.0,10.0,14.0,16.0,20.0,13.0,13.0,10.0,5.0,14.0,12.0,10.0,9.0,16.0,11.0,13.0,12.0,10.0,8.0,14.0,22.0,0.0,0.0,0.0,0.0,176.0,61.0,1.0,4.0,1.0,1.0,3.0,1.0,3.0,1.0,3.0,3.0,3.0,11.0,11.0,13.0,12.0,13.0,11.0,6.0,11.0,6.0,8.0,13.0,10.0,10.0,14.0,10.0,12.0,13.0,10.0,10.0,13.0,12.0,11.0,12.0,11.0,12.0,12.0,13.0,12.0,13.0,14.0,12.0,8.0,8.0,12.0,13.0,20.0,13.0,8.0,12.0,12.0,11.0,11.0,11.0,17.0,12.0,13.0,12.0,14.0,15.0,15.0,6.0
1,0,23.0,0.0,0.0,0.0,0.0,188.0,85.0,14.0,12.0,12.0,7.0,13.0,10.0,11.0,14.0,7.0,13.0,12.0,2.0,3.0,1.0,3.0,8.0,6.0,2.0,1.0,2.0,2.0,8.0,3.0,1.0,8.0,7.0,10.0,12.0,9.0,11.0,8.0,11.0,14.0,2.0,9.0,1.0,12.0,11.0,8.0,7.0,12.0,14.0,14.0,6.0,14.0,10.0,20.0,12.0,14.0,13.0,7.0,10.0,7.0,1.0,14.0,14.0,9.0,13.0,13.0,10.0,12.0,6.0,28.0,0.0,0.0,0.0,0.0,174.0,67.0,3.0,4.0,1.0,1.0,1.0,3.0,1.0,3.0,2.0,1.0,2.0,11.0,8.0,11.0,9.0,13.0,6.0,7.0,12.0,8.0,10.0,10.0,3.0,6.0,12.0,10.0,13.0,7.0,12.0,8.0,10.0,9.0,12.0,13.0,5.0,12.0,9.0,12.0,11.0,14.0,14.0,11.0,7.0,10.0,15.0,12.0,20.0,11.0,6.0,9.0,6.0,10.0,10.0,9.0,11.0,14.0,9.0,11.0,12.0,8.0,8.0,8.0,23.0,0.0,0.0,0.0,0.0,184.0,71.0,1.0,2.0,1.0,2.0,2.0,2.0,2.0,4.0,2.0,1.0,3.0,4.0,10.0,10.0,6.0,11.0,6.0,14.0,8.0,7.0,14.0,11.0,6.0,13.0,11.0,12.0,12.0,13.0,12.0,11.0,12.0,12.0,14.0,6.0,8.0,10.0,13.0,13.0,14.0,15.0,13.0,14.0,13.0,8.0,12.0,14.0,20.0,13.0,14.0,13.0,12.0,14.0,15.0,8.0,11.0,13.0,13.0,10.0,8.0,9.0,16.0,7.0,21.0,0.0,0.0,0.0,0.0,177.0,0.0,1.0,1.0,1.0,2.0,3.0,3.0,2.0,3.0,2.0,2.0,3.0,6.0,4.0,13.0,13.0,13.0,6.0,13.0,7.0,3.0,5.0,7.0,6.0,1.0,11.0,9.0,7.0,8.0,7.0,7.0,7.0,8.0,7.0,11.0,8.0,13.0,7.0,6.0,7.0,12.0,13.0,7.0,6.0,8.0,8.0,13.0,20.0,5.0,5.0,9.0,5.0,9.0,9.0,9.0,10.0,10.0,12.0,12.0,11.0,10.0,9.0,6.0,21.0,0.0,0.0,0.0,0.0,178.0,65.0,2.0,3.0,3.0,3.0,3.0,1.0,1.0,1.0,1.0,3.0,1.0,9.0,13.0,11.0,6.0,12.0,7.0,9.0,8.0,8.0,13.0,12.0,7.0,13.0,12.0,8.0,12.0,13.0,12.0,12.0,13.0,13.0,14.0,9.0,8.0,12.0,12.0,13.0,13.0,12.0,14.0,13.0,11.0,8.0,15.0,12.0,20.0,13.0,12.0,14.0,8.0,11.0,7.0,10.0,19.0,10.0,13.0,10.0,11.0,15.0,15.0,6.0,32.0,22.0,1.0,6.0,1.0,186.0,79.0,1.0,2.0,1.0,1.0,2.0,3.0,1.0,2.0,1.0,2.0,1.0,11.0,12.0,13.0,11.0,13.0,11.0,14.0,11.0,8.0,12.0,13.0,13.0,13.0,13.0,14.0,13.0,14.0,14.0,13.0,14.0,13.0,12.0,13.0,14.0,15.0,13.0,12.0,15.0,12.0,13.0,12.0,12.0,10.0,12.0,13.0,20.0,15.0,13.0,14.0,5.0,12.0,9.0,17.0,8.0,12.0,8.0,13.0,10.0,10.0,10.0,5.0,21.0,0.0,0.0,0.0,0.0,172.0,66.0,2.0,3.0,2.0,2.0,1.0,1.0,1.0,3.0,2.0,1.0,1.0,10.0,10.0,13.0,9.0,14.0,9.0,8.0,10.0,7.0,13.0,13.0,9.0,12.0,13.0,10.0,12.0,13.0,13.0,12.0,14.0,13.0,13.0,11.0,9.0,14.0,13.0,14.0,14.0,14.0,13.0,12.0,8.0,8.0,12.0,12.0,20.0,13.0,12.0,14.0,10.0,11.0,8.0,12.0,15.0,10.0,15.0,8.0,11.0,14.0,14.0,6.0,24.0,0.0,0.0,0.0,0.0,172.0,72.0,1.0,1.0,3.0,2.0,2.0,1.0,1.0,1.0,1.0,3.0,1.0,10.0,11.0,12.0,10.0,11.0,8.0,8.0,10.0,7.0,7.0,11.0,11.0,6.0,12.0,8.0,11.0,11.0,10.0,10.0,11.0,12.0,15.0,12.0,5.0,10.0,11.0,13.0,15.0,15.0,13.0,10.0,9.0,8.0,14.0,13.0,20.0,14.0,11.0,11.0,8.0,13.0,7.0,12.0,18.0,13.0,10.0,10.0,11.0,11.0,11.0,6.0,19.0,0.0,0.0,0.0,0.0,179.0,66.0,1.0,3.0,3.0,1.0,1.0,3.0,3.0,1.0,2.0,3.0,2.0,13.0,11.0,14.0,10.0,14.0,13.0,9.0,10.0,4.0,7.0,13.0,11.0,9.0,15.0,10.0,12.0,10.0,13.0,10.0,13.0,12.0,14.0,13.0,10.0,13.0,12.0,11.0,11.0,12.0,14.0,12.0,6.0,10.0,12.0,13.0,20.0,12.0,10.0,12.0,11.0,11.0,11.0,11.0,11.0,14.0,12.0,11.0,13.0,11.0,13.0,10.0,24.0,4.0,1.0,0.0,0.0,188.0,79.0,2.0,3.0,2.0,1.0,2.0,1.0,1.0,2.0,1.0,2.0,2.0,10.0,11.0,13.0,12.0,11.0,9.0,13.0,9.0,5.0,8.0,11.0,11.0,7.0,13.0,10.0,12.0,11.0,11.0,12.0,13.0,11.0,14.0,12.0,9.0,12.0,12.0,14.0,14.0,12.0,13.0,15.0,14.0,8.0,13.0,12.0,20.0,13.0,14.0,11.0,9.0,10.0,5.0,10.0,14.0,12.0,13.0,10.0,14.0,13.0,12.0,10.0,25.0,0.0,0.0,0.0,0.0,187.0,83.0,2.0,1.0,3.0,3.0,1.0,3.0,3.0,3.0,1.0,1.0,3.0,4.0,8.0,10.0,14.0,12.0,8.0,14.0,9.0,5.0,7.0,11.0,13.0,5.0,12.0,11.0,13.0,13.0,13.0,11.0,10.0,12.0,16.0,9.0,8.0,13.0,11.0,13.0,16.0,14.0,13.0,15.0,13.0,20.0,14.0,12.0,8.0,14.0,16.0,13.0,11.0,13.0,7.0,5.0,13.0,14.0,13.0,14.0,14.0,13.0,13.0,6.0,36.0,0.0,0.0,0.0,0.0,185.0,78.0,11.0,14.0,12.0,7.0,13.0,12.0,14.0,15.0,13.0,14.0,10.0,4.0,1.0,3.0,1.0,8.0,8.0,11.0,8.0,3.0,3.0,7.0,2.0,1.0,8.0,11.0,13.0,15.0,11.0,12.0,7.0,13.0,9.0,5.0,14.0,3.0,13.0,15.0,8.0,11.0,14.0,13.0,12.0,5.0,15.0,11.0,20.0,12.0,14.0,13.0,11.0,13.0,8.0,1.0,19.0,14.0,16.0,10.0,17.0,9.0,9.0,11.0,28.0,0.0,0.0,0.0,0.0,183.0,81.0,1.0,2.0,4.0,1.0,1.0,3.0,2.0,3.0,3.0,3.0,1.0,5.0,5.0,6.0,10.0,12.0,6.0,14.0,8.0,6.0,15.0,11.0,6.0,13.0,12.0,13.0,14.0,16.0,14.0,14.0,10.0,12.0,14.0,5.0,14.0,8.0,14.0,15.0,15.0,9.0,12.0,15.0,13.0,7.0,11.0,12.0,20.0,15.0,15.0,14.0,14.0,14.0,9.0,8.0,14.0,14.0,11.0,13.0,15.0,13.0,15.0,6.0,34.0,23.0,1.0,0.0,0.0,186.0,81.0,3.0,3.0,1.0,2.0,1.0,3.0,2.0,3.0,1.0,3.0,3.0,4.0,8.0,6.0,10.0,7.0,8.0,17.0,12.0,10.0,14.0,7.0,9.0,15.0,7.0,15.0,13.0,17.0,8.0,12.0,7.0,12.0,15.0,6.0,17.0,7.0,14.0,15.0,14.0,8.0,10.0,16.0,13.0,12.0,13.0,9.0,20.0,13.0,15.0,11.0,15.0,14.0,9.0,10.0,10.0,14.0,11.0,13.0,15.0,11.0,11.0,12.0,21.0,0.0,0.0,1.0,0.0,177.0,68.0,4.0,1.0,2.0,1.0,1.0,1.0,1.0,1.0,2.0,1.0,2.0,5.0,12.0,9.0,7.0,12.0,8.0,13.0,10.0,16.0,13.0,12.0,8.0,14.0,12.0,12.0,13.0,12.0,12.0,12.0,10.0,13.0,15.0,11.0,13.0,11.0,13.0,13.0,14.0,13.0,14.0,13.0,11.0,10.0,14.0,12.0,20.0,12.0,14.0,12.0,11.0,12.0,8.0,14.0,13.0,10.0,14.0,12.0,14.0,12.0,11.0,5.0,27.0,14.0,1.0,0.0,0.0,183.0,77.0,1.0,2.0,1.0,2.0,3.0,2.0,3.0,2.0,2.0,1.0,1.0,5.0,12.0,9.0,8.0,13.0,10.0,13.0,10.0,6.0,14.0,13.0,6.0,13.0,12.0,14.0,13.0,15.0,11.0,11.0,11.0,11.0,13.0,9.0,8.0,9.0,12.0,14.0,16.0,14.0,12.0,14.0,12.0,7.0,14.0,12.0,20.0,15.0,14.0,14.0,14.0,15.0,7.0,10.0,12.0,13.0,14.0,12.0,13.0,11.0,11.0,7.0,30.0,0.0,0.0,0.0,0.0,167.0,60.0,3.0,1.0,1.0,2.0,3.0,1.0,1.0,3.0,1.0,1.0,3.0,10.0,11.0,12.0,8.0,13.0,10.0,6.0,9.0,10.0,12.0,14.0,9.0,10.0,14.0,11.0,14.0,14.0,14.0,14.0,13.0,14.0,12.0,14.0,11.0,13.0,12.0,15.0,15.0,15.0,14.0,11.0,5.0,11.0,11.0,15.0,20.0,11.0,8.0,14.0,10.0,12.0,13.0,11.0,11.0,12.0,11.0,10.0,12.0,11.0,11.0,2.0,33.0,0.0,0.0,0.0,0.0,187.0,76.0,2.0,2.0,3.0,1.0,1.0,3.0,2.0,1.0,2.0,3.0,2.0,15.0,14.0,14.0,10.0,15.0,13.0,10.0,12.0,7.0,4.0,15.0,13.0,7.0,15.0,6.0,12.0,9.0,14.0,11.0,15.0,12.0,12.0,14.0,12.0,13.0,7.0,13.0,12.0,11.0,12.0,14.0,12.0,14.0,15.0,12.0,20.0,11.0,12.0,12.0,6.0,14.0,6.0,11.0,14.0,13.0,12.0,12.0,15.0,15.0,13.0,9.0,27.0,0.0,0.0,0.0,0.0,190.0,87.0,1.0,3.0,2.0,3.0,1.0,3.0,1.0,1.0,2.0,3.0,2.0,5.0,7.0,9.0,14.0,14.0,10.0,14.0,13.0,5.0,6.0,12.0,12.0,8.0,14.0,14.0,13.0,16.0,14.0,11.0,10.0,13.0,15.0,10.0,11.0,14.0,9.0,15.0,14.0,10.0,11.0,16.0,15.0,9.0,12.0,12.0,20.0,14.0,16.0,13.0,13.0,12.0,7.0,5.0,10.0,12.0,14.0,12.0,14.0,14.0,19.0,12.0,17.0,0.0,0.0,0.0,0.0,181.0,68.0,1.0,2.0,1.0,1.0,2.0,2.0,3.0,3.0,3.0,2.0,1.0,8.0,11.0,14.0,11.0,13.0,8.0,11.0,9.0,5.0,3.0,11.0,5.0,5.0,14.0,5.0,11.0,6.0,10.0,10.0,11.0,12.0,14.0,13.0,6.0,13.0,9.0,10.0,8.0,14.0,14.0,14.0,10.0,5.0,12.0,14.0,20.0,12.0,11.0,10.0,6.0,5.0,10.0,12.0,20.0,12.0,11.0,12.0,12.0,11.0,14.0,5.0,30.0,0.0,0.0,0.0,0.0,178.0,73.0,3.0,4.0,1.0,1.0,2.0,4.0,3.0,2.0,2.0,2.0,3.0,13.0,14.0,12.0,7.0,13.0,12.0,7.0,13.0,5.0,10.0,13.0,9.0,10.0,13.0,11.0,11.0,12.0,12.0,13.0,11.0,14.0,14.0,11.0,7.0,11.0,10.0,13.0,15.0,13.0,15.0,15.0,8.0,20.0,14.0,14.0,8.0,14.0,11.0,13.0,11.0,14.0,8.0,10.0,19.0,12.0,12.0,9.0,12.0,12.0,10.0,10.0,26.0,0.0,0.0,0.0,0.0,193.0,81.0,1.0,3.0,3.0,3.0,3.0,1.0,2.0,2.0,2.0,3.0,3.0,4.0,9.0,14.0,10.0,13.0,12.0,14.0,14.0,5.0,5.0,10.0,12.0,3.0,14.0,8.0,13.0,12.0,9.0,10.0,11.0,11.0,12.0,16.0,5.0,14.0,6.0,9.0,12.0,14.0,13.0,14.0,16.0,14.0,13.0,13.0,20.0,13.0,14.0,10.0,8.0,14.0,9.0,8.0,16.0,16.0,11.0,13.0,11.0,13.0,13.0,10.0
0,2,28.0,0.0,0.0,0.0,0.0,186.0,80.0,11.0,13.0,11.0,9.0,13.0,12.0,13.0,15.0,11.0,10.0,7.0,7.0,2.0,3.0,1.0,8.0,10.0,1.0,2.0,3.0,2.0,7.0,2.0,7.0,8.0,8.0,12.0,14.0,11.0,13.0,8.0,13.0,14.0,5.0,11.0,1.0,15.0,11.0,8.0,11.0,13.0,14.0,13.0,20.0,12.0,8.0,5.0,14.0,14.0,13.0,8.0,14.0,10.0,1.0,7.0,13.0,14.0,13.0,16.0,14.0,14.0,6.0,29.0,2.0,0.0,0.0,0.0,185.0,75.0,2.0,3.0,3.0,3.0,2.0,3.0,2.0,1.0,3.0,1.0,2.0,4.0,10.0,8.0,6.0,10.0,6.0,14.0,7.0,7.0,14.0,11.0,6.0,14.0,9.0,13.0,13.0,14.0,11.0,12.0,12.0,12.0,14.0,8.0,11.0,12.0,13.0,13.0,13.0,15.0,12.0,15.0,12.0,8.0,15.0,13.0,20.0,14.0,15.0,14.0,7.0,14.0,8.0,6.0,14.0,13.0,15.0,14.0,14.0,14.0,14.0,6.0,28.0,0.0,0.0,0.0,0.0,193.0,84.0,1.0,1.0,2.0,2.0,2.0,3.0,2.0,3.0,2.0,1.0,3.0,4.0,8.0,8.0,9.0,10.0,6.0,14.0,7.0,8.0,14.0,12.0,6.0,14.0,11.0,12.0,13.0,14.0,11.0,14.0,12.0,12.0,14.0,6.0,11.0,8.0,14.0,13.0,13.0,11.0,11.0,16.0,16.0,20.0,12.0,12.0,8.0,14.0,16.0,14.0,12.0,13.0,6.0,10.0,7.0,12.0,15.0,12.0,16.0,15.0,13.0,6.0,27.0,0.0,0.0,0.0,0.0,175.0,64.0,1.0,1.0,1.0,2.0,1.0,4.0,2.0,1.0,1.0,3.0,3.0,7.0,13.0,9.0,6.0,12.0,6.0,12.0,10.0,10.0,14.0,13.0,6.0,13.0,12.0,14.0,13.0,13.0,12.0,12.0,10.0,12.0,14.0,7.0,9.0,11.0,12.0,13.0,15.0,14.0,13.0,15.0,11.0,10.0,12.0,12.0,20.0,14.0,12.0,12.0,12.0,13.0,10.0,10.0,10.0,12.0,14.0,13.0,14.0,15.0,15.0,6.0,26.0,0.0,0.0,0.0,0.0,175.0,69.0,3.0,3.0,2.0,2.0,3.0,1.0,3.0,1.0,3.0,2.0,2.0,6.0,12.0,10.0,5.0,11.0,6.0,10.0,10.0,10.0,13.0,12.0,9.0,13.0,12.0,12.0,13.0,14.0,12.0,13.0,12.0,11.0,15.0,11.0,13.0,12.0,13.0,14.0,14.0,15.0,13.0,12.0,7.0,9.0,13.0,13.0,20.0,14.0,11.0,14.0,12.0,12.0,11.0,15.0,14.0,9.0,17.0,10.0,8.0,11.0,20.0,7.0,29.0,19.0,2.0,0.0,0.0,182.0,75.0,1.0,3.0,4.0,1.0,1.0,4.0,2.0,3.0,2.0,3.0,3.0,9.0,9.0,11.0,6.0,13.0,10.0,10.0,14.0,8.0,11.0,12.0,8.0,12.0,13.0,12.0,14.0,15.0,12.0,13.0,13.0,12.0,15.0,9.0,9.0,8.0,13.0,15.0,16.0,12.0,13.0,14.0,10.0,8.0,13.0,11.0,20.0,15.0,12.0,13.0,12.0,14.0,14.0,8.0,12.0,13.0,17.0,13.0,14.0,14.0,14.0,6.0,30.0,9.0,1.0,0.0,0.0,192.0,90.0,2.0,2.0,2.0,2.0,3.0,1.0,3.0,4.0,1.0,1.0,3.0,4.0,7.0,10.0,10.0,9.0,8.0,17.0,12.0,6.0,13.0,12.0,8.0,12.0,11.0,13.0,14.0,15.0,13.0,13.0,10.0,12.0,14.0,12.0,13.0,13.0,12.0,14.0,16.0,12.0,12.0,18.0,16.0,8.0,14.0,13.0,20.0,16.0,18.0,13.0,13.0,14.0,7.0,12.0,13.0,13.0,13.0,13.0,13.0,13.0,13.0,6.0,21.0,0.0,0.0,0.0,0.0,183.0,73.0,1.0,4.0,3.0,3.0,3.0,1.0,4.0,1.0,2.0,3.0,2.0,11.0,10.0,12.0,11.0,13.0,9.0,12.0,10.0,5.0,8.0,12.0,9.0,8.0,13.0,13.0,12.0,12.0,10.0,12.0,14.0,12.0,12.0,14.0,8.0,12.0,8.0,12.0,12.0,14.0,14.0,14.0,11.0,8.0,13.0,13.0,20.0,12.0,12.0,12.0,5.0,10.0,7.0,12.0,15.0,11.0,11.0,10.0,11.0,12.0,11.0,4.0,29.0,0.0,0.0,0.0,0.0,180.0,71.0,1.0,3.0,1.0,1.0,1.0,4.0,4.0,1.0,1.0,2.0,3.0,10.0,11.0,12.0,9.0,13.0,11.0,8.0,14.0,6.0,8.0,11.0,10.0,8.0,12.0,10.0,11.0,12.0,12.0,9.0,12.0,11.0,14.0,12.0,7.0,12.0,10.0,12.0,14.0,15.0,14.0,12.0,10.0,20.0,16.0,13.0,12.0,15.0,10.0,13.0,10.0,15.0,7.0,8.0,16.0,12.0,12.0,13.0,14.0,15.0,15.0,6.0,23.0,1.0,0.0,0.0,0.0,185.0,70.0,4.0,3.0,1.0,2.0,1.0,3.0,2.0,3.0,1.0,2.0,3.0,5.0,8.0,12.0,13.0,13.0,7.0,14.0,11.0,5.0,5.0,8.0,13.0,5.0,13.0,6.0,13.0,10.0,12.0,12.0,11.0,11.0,13.0,12.0,7.0,13.0,9.0,8.0,10.0,16.0,12.0,14.0,12.0,8.0,14.0,15.0,20.0,13.0,13.0,12.0,7.0,15.0,7.0,7.0,13.0,13.0,12.0,10.0,12.0,15.0,15.0,7.0,23.0,1.0,0.0,0.0,0.0,192.0,80.0,3.0,3.0,3.0,2.0,3.0,1.0,3.0,3.0,1.0,2.0,2.0,4.0,6.0,12.0,13.0,12.0,7.0,13.0,12.0,5.0,5.0,9.0,11.0,5.0,12.0,13.0,12.0,13.0,12.0,13.0,9.0,13.0,4.0,11.0,8.0,13.0,7.0,9.0,12.0,14.0,13.0,15.0,16.0,20.0,14.0,13.0,8.0,13.0,15.0,12.0,11.0,11.0,7.0,5.0,14.0,13.0,14.0,11.0,9.0,9.0,18.0,3.0,28.0,0.0,0.0,6.0,0.0,191.0,81.0,11.0,10.0,14.0,8.0,13.0,12.0,14.0,15.0,11.0,8.0,13.0,4.0,3.0,2.0,1.0,9.0,9.0,3.0,10.0,1.0,1.0,8.0,3.0,3.0,9.0,8.0,12.0,14.0,12.0,13.0,8.0,11.0,12.0,6.0,14.0,2.0,12.0,10.0,7.0,13.0,14.0,16.0,15.0,6.0,14.0,11.0,20.0,15.0,14.0,12.0,9.0,14.0,7.0,1.0,9.0,15.0,13.0,11.0,15.0,15.0,14.0,8.0,23.0,0.0,0.0,0.0,0.0,184.0,71.0,1.0,2.0,1.0,2.0,2.0,2.0,2.0,4.0,2.0,1.0,3.0,4.0,10.0,10.0,6.0,11.0,6.0,14.0,8.0,7.0,14.0,11.0,6.0,13.0,11.0,12.0,12.0,13.0,12.0,11.0,12.0,12.0,14.0,6.0,8.0,10.0,13.0,13.0,14.0,15.0,13.0,14.0,13.0,8.0,12.0,14.0,20.0,13.0,14.0,13.0,12.0,14.0,15.0,8.0,11.0,13.0,13.0,10.0,8.0,9.0,16.0,7.0,32.0,67.0,9.0,7.0,0.0,191.0,85.0,1.0,1.0,1.0,3.0,2.0,2.0,4.0,3.0,3.0,2.0,3.0,7.0,7.0,6.0,9.0,12.0,3.0,16.0,7.0,3.0,15.0,11.0,7.0,13.0,12.0,14.0,11.0,14.0,10.0,11.0,10.0,14.0,11.0,8.0,13.0,13.0,13.0,13.0,15.0,9.0,7.0,14.0,16.0,8.0,7.0,10.0,20.0,12.0,15.0,13.0,14.0,5.0,6.0,11.0,8.0,11.0,9.0,12.0,11.0,6.0,9.0,11.0,28.0,0.0,0.0,0.0,0.0,174.0,67.0,3.0,4.0,1.0,1.0,1.0,3.0,1.0,3.0,2.0,1.0,2.0,11.0,8.0,11.0,9.0,13.0,6.0,7.0,12.0,8.0,10.0,10.0,3.0,6.0,12.0,10.0,13.0,7.0,12.0,8.0,10.0,9.0,12.0,13.0,5.0,12.0,9.0,12.0,11.0,14.0,14.0,11.0,7.0,10.0,15.0,12.0,20.0,11.0,6.0,9.0,6.0,10.0,10.0,9.0,11.0,14.0,9.0,11.0,12.0,8.0,8.0,8.0,21.0,0.0,0.0,0.0,0.0,177.0,0.0,1.0,1.0,1.0,2.0,3.0,3.0,2.0,3.0,2.0,2.0,3.0,6.0,4.0,13.0,13.0,13.0,6.0,13.0,7.0,3.0,5.0,7.0,6.0,1.0,11.0,9.0,7.0,8.0,7.0,7.0,7.0,8.0,7.0,11.0,8.0,13.0,7.0,6.0,7.0,12.0,13.0,7.0,6.0,8.0,8.0,13.0,20.0,5.0,5.0,9.0,5.0,9.0,9.0,9.0,10.0,10.0,12.0,12.0,11.0,10.0,9.0,6.0,21.0,0.0,0.0,0.0,0.0,178.0,65.0,2.0,3.0,3.0,3.0,3.0,1.0,1.0,1.0,1.0,3.0,1.0,9.0,13.0,11.0,6.0,12.0,7.0,9.0,8.0,8.0,13.0,12.0,7.0,13.0,12.0,8.0,12.0,13.0,12.0,12.0,13.0,13.0,14.0,9.0,8.0,12.0,12.0,13.0,13.0,12.0,14.0,13.0,11.0,8.0,15.0,12.0,20.0,13.0,12.0,14.0,8.0,11.0,7.0,10.0,19.0,10.0,13.0,10.0,11.0,15.0,15.0,6.0,32.0,22.0,1.0,6.0,1.0,186.0,79.0,1.0,2.0,1.0,1.0,2.0,3.0,1.0,2.0,1.0,2.0,1.0,11.0,12.0,13.0,11.0,13.0,11.0,14.0,11.0,8.0,12.0,13.0,13.0,13.0,13.0,14.0,13.0,14.0,14.0,13.0,14.0,13.0,12.0,13.0,14.0,15.0,13.0,12.0,15.0,12.0,13.0,12.0,12.0,10.0,12.0,13.0,20.0,15.0,13.0,14.0,5.0,12.0,9.0,17.0,8.0,12.0,8.0,13.0,10.0,10.0,10.0,5.0,19.0,0.0,0.0,0.0,0.0,179.0,66.0,1.0,3.0,3.0,1.0,1.0,3.0,3.0,1.0,2.0,3.0,2.0,13.0,11.0,14.0,10.0,14.0,13.0,9.0,10.0,4.0,7.0,13.0,11.0,9.0,15.0,10.0,12.0,10.0,13.0,10.0,13.0,12.0,14.0,13.0,10.0,13.0,12.0,11.0,11.0,12.0,14.0,12.0,6.0,10.0,12.0,13.0,20.0,12.0,10.0,12.0,11.0,11.0,11.0,11.0,11.0,14.0,12.0,11.0,13.0,11.0,13.0,10.0,24.0,0.0,0.0,0.0,0.0,172.0,72.0,1.0,1.0,3.0,2.0,2.0,1.0,1.0,1.0,1.0,3.0,1.0,10.0,11.0,12.0,10.0,11.0,8.0,8.0,10.0,7.0,7.0,11.0,11.0,6.0,12.0,8.0,11.0,11.0,10.0,10.0,11.0,12.0,15.0,12.0,5.0,10.0,11.0,13.0,15.0,15.0,13.0,10.0,9.0,8.0,14.0,13.0,20.0,14.0,11.0,11.0,8.0,13.0,7.0,12.0,18.0,13.0,10.0,10.0,11.0,11.0,11.0,6.0,21.0,2.0,0.0,4.0,2.0,183.0,72.0,1.0,1.0,2.0,1.0,1.0,1.0,3.0,3.0,1.0,3.0,1.0,8.0,9.0,11.0,13.0,12.0,8.0,11.0,10.0,6.0,5.0,12.0,10.0,7.0,11.0,14.0,12.0,10.0,11.0,10.0,12.0,13.0,11.0,14.0,7.0,13.0,5.0,10.0,12.0,13.0,13.0,13.0,11.0,11.0,16.0,14.0,20.0,13.0,12.0,14.0,7.0,12.0,5.0,12.0,6.0,17.0,5.0,12.0,14.0,9.0,12.0,14.0,25.0,0.0,0.0,0.0,0.0,187.0,83.0,2.0,1.0,3.0,3.0,1.0,3.0,3.0,3.0,1.0,1.0,3.0,4.0,8.0,10.0,14.0,12.0,8.0,14.0,9.0,5.0,7.0,11.0,13.0,5.0,12.0,11.0,13.0,13.0,13.0,11.0,10.0,12.0,16.0,9.0,8.0,13.0,11.0,13.0,16.0,14.0,13.0,15.0,13.0,20.0,14.0,12.0,8.0,14.0,16.0,13.0,11.0,13.0,7.0,5.0,13.0,14.0,13.0,14.0,14.0,13.0,13.0,6.0
2,1,26.0,2.0,0.0,1.0,0.0,188.0,84.0,12.0,13.0,15.0,9.0,15.0,13.0,13.0,15.0,10.0,11.0,14.0,9.0,2.0,1.0,2.0,12.0,11.0,3.0,2.0,3.0,3.0,11.0,3.0,1.0,10.0,14.0,13.0,14.0,10.0,13.0,11.0,11.0,14.0,3.0,11.0,5.0,12.0,15.0,13.0,10.0,12.0,13.0,14.0,5.0,14.0,9.0,20.0,12.0,14.0,12.0,10.0,15.0,3.0,11.0,12.0,11.0,16.0,13.0,15.0,16.0,16.0,4.0,29.0,0.0,0.0,0.0,0.0,183.0,74.0,3.0,3.0,3.0,3.0,3.0,2.0,2.0,2.0,1.0,3.0,1.0,5.0,12.0,7.0,6.0,10.0,7.0,14.0,12.0,5.0,14.0,12.0,6.0,13.0,11.0,14.0,13.0,17.0,13.0,16.0,12.0,12.0,13.0,9.0,8.0,9.0,14.0,14.0,15.0,13.0,12.0,15.0,12.0,6.0,17.0,11.0,20.0,17.0,13.0,14.0,14.0,15.0,5.0,13.0,9.0,14.0,19.0,15.0,14.0,11.0,11.0,6.0,32.0,0.0,0.0,0.0,0.0,183.0,79.0,1.0,1.0,1.0,3.0,1.0,3.0,1.0,1.0,2.0,1.0,1.0,5.0,10.0,6.0,6.0,9.0,6.0,15.0,7.0,11.0,14.0,10.0,7.0,13.0,10.0,13.0,15.0,15.0,15.0,14.0,9.0,13.0,16.0,6.0,14.0,8.0,12.0,13.0,16.0,11.0,12.0,16.0,11.0,8.0,16.0,12.0,20.0,15.0,14.0,14.0,11.0,12.0,5.0,15.0,18.0,15.0,14.0,13.0,17.0,14.0,14.0,5.0,22.0,0.0,0.0,0.0,0.0,178.0,73.0,3.0,2.0,2.0,1.0,2.0,4.0,3.0,1.0,3.0,1.0,2.0,6.0,12.0,12.0,6.0,11.0,7.0,8.0,8.0,11.0,12.0,10.0,8.0,13.0,11.0,12.0,12.0,13.0,11.0,10.0,11.0,11.0,13.0,6.0,7.0,12.0,9.0,13.0,14.0,16.0,14.0,13.0,9.0,6.0,14.0,15.0,20.0,15.0,14.0,12.0,12.0,13.0,6.0,14.0,12.0,15.0,13.0,13.0,14.0,14.0,14.0,6.0,27.0,0.0,0.0,0.0,0.0,178.0,72.0,2.0,3.0,2.0,3.0,2.0,3.0,3.0,1.0,1.0,2.0,1.0,13.0,14.0,11.0,7.0,12.0,10.0,9.0,10.0,13.0,13.0,12.0,10.0,14.0,13.0,12.0,14.0,14.0,13.0,14.0,11.0,12.0,14.0,13.0,8.0,14.0,13.0,13.0,15.0,15.0,13.0,10.0,10.0,20.0,13.0,15.0,6.0,14.0,10.0,13.0,13.0,12.0,8.0,12.0,15.0,14.0,13.0,14.0,13.0,13.0,12.0,6.0,27.0,0.0,0.0,0.0,0.0,188.0,77.0,1.0,4.0,1.0,1.0,3.0,1.0,2.0,1.0,2.0,2.0,2.0,4.0,7.0,8.0,7.0,13.0,6.0,15.0,9.0,6.0,13.0,12.0,6.0,12.0,11.0,14.0,14.0,15.0,10.0,12.0,11.0,13.0,16.0,7.0,12.0,9.0,12.0,15.0,16.0,14.0,10.0,14.0,15.0,9.0,13.0,12.0,20.0,14.0,16.0,12.0,14.0,13.0,6.0,12.0,4.0,13.0,18.0,13.0,14.0,14.0,13.0,7.0,30.0,4.0,0.0,0.0,0.0,192.0,78.0,1.0,3.0,1.0,2.0,2.0,3.0,1.0,3.0,1.0,1.0,3.0,4.0,6.0,7.0,8.0,11.0,6.0,15.0,8.0,6.0,13.0,11.0,6.0,14.0,11.0,17.0,14.0,16.0,12.0,14.0,10.0,12.0,17.0,8.0,8.0,11.0,13.0,15.0,16.0,14.0,12.0,18.0,14.0,6.0,14.0,12.0,20.0,17.0,16.0,14.0,17.0,13.0,9.0,11.0,8.0,13.0,10.0,13.0,12.0,10.0,10.0,5.0,26.0,0.0,0.0,10.0,1.0,182.0,80.0,3.0,1.0,3.0,2.0,3.0,3.0,2.0,4.0,3.0,1.0,3.0,10.0,10.0,12.0,12.0,12.0,11.0,10.0,12.0,6.0,8.0,13.0,5.0,5.0,14.0,12.0,12.0,14.0,11.0,12.0,11.0,13.0,15.0,12.0,10.0,13.0,6.0,10.0,11.0,13.0,14.0,12.0,10.0,8.0,5.0,13.0,20.0,12.0,12.0,13.0,7.0,10.0,11.0,11.0,19.0,11.0,10.0,12.0,14.0,9.0,8.0,8.0,20.0,0.0,0.0,2.0,0.0,180.0,75.0,3.0,1.0,2.0,2.0,3.0,2.0,1.0,1.0,3.0,3.0,1.0,8.0,13.0,14.0,9.0,13.0,8.0,10.0,9.0,6.0,5.0,12.0,6.0,5.0,14.0,8.0,13.0,12.0,13.0,12.0,12.0,12.0,7.0,13.0,8.0,14.0,7.0,12.0,13.0,15.0,13.0,14.0,10.0,8.0,14.0,15.0,20.0,13.0,12.0,13.0,11.0,9.0,7.0,13.0,9.0,11.0,11.0,11.0,12.0,11.0,10.0,1.0,25.0,0.0,0.0,0.0,0.0,176.0,74.0,2.0,2.0,1.0,3.0,2.0,2.0,2.0,4.0,3.0,3.0,3.0,12.0,12.0,14.0,12.0,14.0,13.0,7.0,12.0,6.0,3.0,12.0,12.0,3.0,15.0,9.0,10.0,8.0,12.0,11.0,12.0,10.0,10.0,14.0,5.0,13.0,4.0,6.0,8.0,17.0,15.0,12.0,8.0,20.0,12.0,14.0,8.0,13.0,12.0,11.0,9.0,14.0,10.0,8.0,8.0,14.0,12.0,7.0,10.0,11.0,11.0,9.0,30.0,5.0,0.0,22.0,9.0,181.0,84.0,2.0,3.0,3.0,1.0,2.0,3.0,3.0,1.0,3.0,1.0,3.0,7.0,10.0,12.0,13.0,11.0,7.0,13.0,10.0,12.0,6.0,11.0,13.0,6.0,13.0,17.0,13.0,16.0,11.0,13.0,11.0,11.0,17.0,14.0,8.0,14.0,9.0,13.0,17.0,15.0,12.0,15.0,11.0,8.0,14.0,15.0,20.0,14.0,14.0,13.0,9.0,13.0,7.0,10.0,7.0,16.0,13.0,14.0,13.0,15.0,15.0,10.0,23.0,0.0,0.0,9.0,0.0,194.0,88.0,14.0,13.0,12.0,9.0,13.0,12.0,14.0,15.0,14.0,8.0,10.0,8.0,2.0,3.0,1.0,8.0,11.0,2.0,12.0,2.0,2.0,8.0,3.0,1.0,8.0,8.0,13.0,12.0,14.0,14.0,9.0,12.0,14.0,8.0,9.0,3.0,11.0,14.0,10.0,13.0,14.0,17.0,15.0,10.0,15.0,12.0,20.0,14.0,17.0,13.0,8.0,12.0,9.0,1.0,9.0,15.0,15.0,11.0,15.0,17.0,17.0,5.0,29.0,0.0,0.0,0.0,0.0,170.0,65.0,2.0,1.0,3.0,3.0,1.0,3.0,2.0,1.0,2.0,3.0,2.0,5.0,11.0,4.0,6.0,7.0,4.0,7.0,5.0,6.0,6.0,6.0,2.0,6.0,7.0,9.0,10.0,13.0,8.0,12.0,8.0,13.0,15.0,2.0,7.0,5.0,9.0,8.0,8.0,12.0,12.0,14.0,4.0,9.0,12.0,11.0,20.0,12.0,5.0,9.0,9.0,9.0,9.0,9.0,10.0,12.0,12.0,12.0,12.0,7.0,5.0,8.0,31.0,0.0,0.0,0.0,0.0,171.0,65.0,1.0,3.0,1.0,3.0,2.0,2.0,3.0,1.0,2.0,2.0,3.0,8.0,9.0,11.0,7.0,5.0,6.0,5.0,6.0,7.0,14.0,14.0,6.0,14.0,13.0,14.0,12.0,13.0,12.0,11.0,11.0,12.0,12.0,11.0,7.0,12.0,12.0,12.0,10.0,15.0,15.0,7.0,9.0,9.0,12.0,14.0,20.0,12.0,13.0,11.0,13.0,11.0,9.0,10.0,15.0,14.0,12.0,11.0,14.0,13.0,12.0,7.0,23.0,25.0,0.0,0.0,0.0,174.0,74.0,2.0,1.0,1.0,1.0,3.0,3.0,3.0,3.0,3.0,1.0,2.0,8.0,13.0,12.0,8.0,12.0,8.0,14.0,9.0,13.0,14.0,12.0,6.0,16.0,13.0,13.0,14.0,15.0,13.0,11.0,10.0,12.0,15.0,9.0,10.0,14.0,11.0,14.0,17.0,16.0,13.0,14.0,10.0,8.0,17.0,15.0,20.0,18.0,15.0,14.0,13.0,14.0,8.0,12.0,12.0,14.0,13.0,13.0,12.0,12.0,15.0,13.0,23.0,2.0,0.0,5.0,3.0,182.0,73.0,3.0,1.0,1.0,1.0,2.0,1.0,2.0,1.0,3.0,4.0,2.0,12.0,14.0,14.0,10.0,13.0,12.0,16.0,11.0,13.0,12.0,13.0,13.0,14.0,14.0,12.0,11.0,14.0,13.0,11.0,13.0,11.0,15.0,15.0,9.0,15.0,10.0,14.0,15.0,16.0,15.0,13.0,13.0,20.0,14.0,15.0,6.0,15.0,12.0,13.0,9.0,13.0,14.0,15.0,17.0,15.0,13.0,12.0,12.0,15.0,13.0,9.0,33.0,30.0,1.0,0.0,0.0,187.0,83.0,1.0,3.0,4.0,2.0,1.0,1.0,2.0,3.0,1.0,1.0,3.0,13.0,13.0,12.0,8.0,16.0,10.0,16.0,13.0,10.0,14.0,16.0,13.0,16.0,15.0,13.0,15.0,14.0,16.0,15.0,14.0,14.0,13.0,11.0,13.0,10.0,17.0,18.0,10.0,10.0,12.0,17.0,14.0,20.0,12.0,12.0,10.0,13.0,16.0,16.0,16.0,15.0,13.0,11.0,16.0,16.0,13.0,15.0,12.0,8.0,8.0,11.0,18.0,0.0,0.0,0.0,0.0,178.0,68.0,1.0,2.0,1.0,3.0,2.0,1.0,1.0,2.0,2.0,1.0,3.0,12.0,10.0,12.0,6.0,13.0,13.0,8.0,8.0,5.0,8.0,14.0,3.0,9.0,14.0,13.0,11.0,12.0,12.0,11.0,13.0,12.0,12.0,12.0,6.0,12.0,8.0,13.0,13.0,15.0,13.0,12.0,8.0,10.0,13.0,14.0,20.0,12.0,8.0,12.0,12.0,12.0,7.0,12.0,10.0,13.0,12.0,12.0,12.0,11.0,13.0,7.0,29.0,51.0,8.0,24.0,0.0,175.0,70.0,3.0,4.0,2.0,3.0,2.0,3.0,2.0,2.0,2.0,1.0,3.0,6.0,12.0,12.0,10.0,13.0,7.0,12.0,12.0,8.0,14.0,13.0,9.0,16.0,13.0,14.0,16.0,16.0,15.0,16.0,11.0,14.0,16.0,8.0,14.0,14.0,15.0,18.0,18.0,15.0,14.0,16.0,8.0,20.0,16.0,14.0,8.0,18.0,14.0,16.0,13.0,14.0,7.0,14.0,15.0,14.0,14.0,14.0,16.0,16.0,16.0,5.0,23.0,15.0,1.0,7.0,0.0,165.0,60.0,2.0,3.0,2.0,1.0,1.0,1.0,3.0,3.0,2.0,1.0,3.0,14.0,14.0,16.0,8.0,16.0,13.0,6.0,10.0,6.0,11.0,18.0,15.0,12.0,18.0,16.0,15.0,15.0,17.0,13.0,17.0,15.0,14.0,18.0,12.0,10.0,12.0,15.0,16.0,14.0,16.0,16.0,6.0,12.0,13.0,14.0,20.0,15.0,11.0,16.0,14.0,15.0,10.0,12.0,14.0,15.0,16.0,14.0,14.0,13.0,10.0,6.0,28.0,66.0,15.0,13.0,3.0,180.0,70.0,2.0,2.0,1.0,2.0,1.0,1.0,3.0,2.0,3.0,3.0,1.0,14.0,15.0,16.0,13.0,17.0,15.0,6.0,15.0,4.0,5.0,16.0,14.0,8.0,17.0,13.0,16.0,11.0,15.0,13.0,16.0,14.0,13.0,17.0,10.0,14.0,9.0,13.0,13.0,16.0,18.0,12.0,10.0,20.0,14.0,15.0,8.0,16.0,9.0,13.0,14.0,12.0,10.0,15.0,14.0,15.0,10.0,16.0,14.0,6.0,12.0,10.0,29.0,76.0,27.0,13.0,9.0,188.0,72.0,2.0,3.0,1.0,2.0,3.0,3.0,1.0,3.0,3.0,3.0,3.0,5.0,10.0,13.0,16.0,13.0,11.0,17.0,13.0,5.0,10.0,13.0,14.0,10.0,13.0,15.0,16.0,18.0,14.0,15.0,10.0,13.0,14.0,13.0,10.0,18.0,12.0,14.0,19.0,15.0,14.0,16.0,14.0,10.0,18.0,16.0,20.0,18.0,14.0,14.0,8.0,15.0,5.0,16.0,10.0,16.0,12.0,14.0,16.0,14.0,10.0,10.0
1,2,28.0,0.0,0.0,0.0,0.0,188.0,86.0,14.0,13.0,15.0,8.0,14.0,11.0,14.0,16.0,13.0,12.0,8.0,6.0,2.0,1.0,3.0,8.0,8.0,1.0,1.0,3.0,1.0,8.0,4.0,1.0,8.0,8.0,13.0,13.0,14.0,14.0,11.0,12.0,15.0,7.0,10.0,2.0,14.0,12.0,11.0,13.0,14.0,16.0,13.0,5.0,16.0,12.0,20.0,14.0,15.0,14.0,8.0,15.0,5.0,1.0,11.0,15.0,14.0,14.0,16.0,14.0,11.0,6.0,19.0,0.0,0.0,0.0,0.0,182.0,89.0,1.0,2.0,2.0,1.0,1.0,1.0,2.0,1.0,3.0,3.0,3.0,5.0,8.0,6.0,5.0,11.0,5.0,14.0,6.0,6.0,12.0,11.0,8.0,13.0,10.0,13.0,12.0,15.0,12.0,13.0,9.0,12.0,12.0,8.0,8.0,7.0,12.0,13.0,14.0,12.0,11.0,15.0,12.0,10.0,15.0,13.0,20.0,14.0,16.0,13.0,4.0,10.0,6.0,11.0,9.0,13.0,10.0,13.0,13.0,14.0,14.0,6.0,21.0,0.0,0.0,1.0,0.0,186.0,75.0,3.0,4.0,2.0,2.0,2.0,2.0,1.0,2.0,2.0,1.0,3.0,10.0,11.0,10.0,8.0,13.0,11.0,10.0,11.0,8.0,12.0,11.0,7.0,14.0,12.0,11.0,12.0,14.0,11.0,10.0,10.0,11.0,14.0,12.0,11.0,14.0,11.0,12.0,12.0,13.0,11.0,12.0,14.0,20.0,11.0,14.0,5.0,13.0,12.0,12.0,11.0,11.0,10.0,11.0,11.0,14.0,11.0,12.0,9.0,8.0,7.0,2.0,30.0,0.0,0.0,0.0,0.0,176.0,75.0,2.0,3.0,2.0,1.0,3.0,2.0,1.0,2.0,1.0,3.0,1.0,9.0,14.0,11.0,6.0,12.0,9.0,11.0,10.0,12.0,11.0,11.0,10.0,12.0,12.0,13.0,13.0,14.0,10.0,10.0,11.0,11.0,12.0,8.0,10.0,9.0,12.0,13.0,15.0,15.0,13.0,12.0,9.0,20.0,15.0,14.0,6.0,17.0,12.0,12.0,13.0,13.0,6.0,14.0,11.0,14.0,14.0,12.0,14.0,13.0,13.0,9.0,29.0,0.0,0.0,4.0,0.0,184.0,72.0,3.0,2.0,4.0,2.0,3.0,1.0,1.0,3.0,1.0,1.0,1.0,8.0,13.0,10.0,6.0,11.0,7.0,12.0,8.0,10.0,12.0,11.0,9.0,13.0,11.0,9.0,14.0,14.0,11.0,14.0,10.0,12.0,16.0,9.0,14.0,12.0,13.0,15.0,16.0,15.0,12.0,14.0,12.0,8.0,13.0,14.0,20.0,16.0,12.0,13.0,9.0,16.0,8.0,15.0,13.0,13.0,17.0,14.0,16.0,16.0,16.0,5.0,29.0,59.0,2.0,9.0,0.0,179.0,70.0,2.0,3.0,2.0,1.0,1.0,1.0,1.0,1.0,4.0,3.0,3.0,6.0,8.0,8.0,7.0,12.0,6.0,10.0,8.0,12.0,14.0,12.0,7.0,14.0,11.0,18.0,14.0,16.0,10.0,16.0,8.0,12.0,17.0,6.0,14.0,8.0,14.0,18.0,19.0,13.0,12.0,14.0,11.0,10.0,18.0,15.0,20.0,18.0,13.0,15.0,13.0,15.0,7.0,15.0,18.0,14.0,8.0,13.0,18.0,12.0,14.0,5.0,25.0,0.0,0.0,7.0,0.0,180.0,76.0,2.0,1.0,3.0,3.0,3.0,3.0,4.0,2.0,1.0,1.0,3.0,10.0,12.0,11.0,8.0,14.0,9.0,12.0,13.0,8.0,10.0,14.0,8.0,12.0,14.0,13.0,13.0,15.0,13.0,14.0,13.0,13.0,15.0,10.0,7.0,11.0,12.0,15.0,16.0,14.0,15.0,14.0,10.0,8.0,14.0,13.0,20.0,15.0,13.0,14.0,13.0,14.0,9.0,16.0,12.0,13.0,15.0,13.0,14.0,12.0,11.0,8.0,29.0,31.0,4.0,19.0,4.0,185.0,82.0,3.0,1.0,2.0,2.0,1.0,2.0,1.0,2.0,3.0,1.0,1.0,13.0,13.0,13.0,9.0,16.0,14.0,12.0,14.0,5.0,6.0,16.0,14.0,6.0,16.0,10.0,14.0,10.0,14.0,12.0,15.0,13.0,14.0,12.0,11.0,13.0,8.0,15.0,12.0,12.0,13.0,14.0,12.0,12.0,12.0,12.0,20.0,14.0,14.0,14.0,12.0,15.0,15.0,10.0,12.0,16.0,14.0,8.0,17.0,14.0,15.0,5.0,22.0,0.0,0.0,0.0,0.0,176.0,61.0,1.0,4.0,1.0,1.0,3.0,1.0,3.0,1.0,3.0,3.0,3.0,11.0,11.0,13.0,12.0,13.0,11.0,6.0,11.0,6.0,8.0,13.0,10.0,10.0,14.0,10.0,12.0,13.0,10.0,10.0,13.0,12.0,11.0,12.0,11.0,12.0,12.0,13.0,12.0,13.0,14.0,12.0,8.0,8.0,12.0,13.0,20.0,13.0,8.0,12.0,12.0,11.0,11.0,11.0,17.0,12.0,13.0,12.0,14.0,15.0,15.0,6.0,27.0,17.0,2.0,0.0,0.0,180.0,78.0,2.0,3.0,2.0,1.0,1.0,2.0,1.0,1.0,2.0,3.0,2.0,7.0,10.0,13.0,12.0,13.0,11.0,12.0,12.0,7.0,5.0,12.0,9.0,4.0,12.0,12.0,13.0,14.0,10.0,11.0,11.0,10.0,12.0,14.0,5.0,13.0,7.0,10.0,14.0,16.0,15.0,14.0,11.0,20.0,12.0,15.0,8.0,14.0,14.0,11.0,12.0,15.0,9.0,10.0,6.0,14.0,12.0,11.0,13.0,13.0,13.0,10.0,23.0,2.0,0.0,15.0,9.0,180.0,82.0,3.0,4.0,1.0,3.0,3.0,2.0,2.0,3.0,3.0,1.0,3.0,10.0,13.0,15.0,12.0,12.0,11.0,8.0,14.0,7.0,5.0,12.0,11.0,5.0,14.0,9.0,11.0,13.0,10.0,10.0,13.0,11.0,14.0,16.0,6.0,12.0,5.0,11.0,10.0,18.0,13.0,15.0,10.0,10.0,14.0,16.0,20.0,13.0,13.0,10.0,5.0,14.0,12.0,10.0,9.0,16.0,11.0,13.0,12.0,10.0,8.0,14.0,30.0,0.0,0.0,0.0,0.0,180.0,75.0,11.0,13.0,13.0,9.0,13.0,11.0,12.0,15.0,15.0,14.0,13.0,6.0,1.0,2.0,3.0,7.0,8.0,1.0,1.0,1.0,2.0,7.0,2.0,1.0,7.0,8.0,12.0,14.0,13.0,14.0,7.0,12.0,14.0,5.0,12.0,3.0,13.0,15.0,9.0,13.0,14.0,13.0,10.0,5.0,14.0,11.0,20.0,12.0,13.0,12.0,8.0,14.0,6.0,1.0,9.0,13.0,14.0,13.0,16.0,15.0,15.0,5.0,25.0,0.0,0.0,3.0,0.0,184.0,80.0,2.0,2.0,4.0,2.0,1.0,3.0,2.0,1.0,1.0,2.0,1.0,5.0,8.0,7.0,6.0,9.0,6.0,14.0,6.0,6.0,14.0,7.0,6.0,13.0,9.0,12.0,14.0,13.0,11.0,13.0,7.0,12.0,14.0,8.0,10.0,7.0,14.0,13.0,14.0,15.0,12.0,14.0,12.0,8.0,15.0,15.0,20.0,14.0,14.0,13.0,12.0,14.0,5.0,10.0,16.0,13.0,15.0,15.0,12.0,14.0,14.0,8.0,32.0,0.0,0.0,0.0,0.0,165.0,65.0,1.0,2.0,3.0,1.0,3.0,1.0,3.0,2.0,1.0,4.0,4.0,7.0,12.0,10.0,5.0,13.0,8.0,9.0,8.0,11.0,13.0,12.0,10.0,14.0,11.0,14.0,13.0,15.0,12.0,12.0,8.0,11.0,14.0,5.0,8.0,7.0,10.0,15.0,17.0,14.0,13.0,14.0,4.0,10.0,13.0,13.0,20.0,15.0,12.0,14.0,5.0,13.0,7.0,8.0,7.0,12.0,17.0,13.0,15.0,13.0,13.0,7.0,30.0,0.0,0.0,6.0,0.0,181.0,78.0,2.0,1.0,1.0,1.0,2.0,3.0,1.0,1.0,2.0,1.0,3.0,8.0,13.0,10.0,6.0,11.0,9.0,12.0,14.0,13.0,14.0,10.0,8.0,14.0,12.0,10.0,12.0,13.0,13.0,13.0,10.0,11.0,10.0,6.0,13.0,8.0,15.0,14.0,13.0,13.0,12.0,14.0,10.0,20.0,15.0,11.0,8.0,13.0,14.0,11.0,10.0,13.0,6.0,8.0,10.0,12.0,14.0,8.0,15.0,15.0,15.0,9.0,31.0,0.0,0.0,0.0,0.0,178.0,70.0,3.0,1.0,3.0,3.0,2.0,2.0,2.0,1.0,2.0,1.0,2.0,5.0,8.0,7.0,7.0,12.0,5.0,8.0,8.0,7.0,14.0,13.0,8.0,13.0,12.0,15.0,14.0,17.0,12.0,13.0,9.0,13.0,16.0,10.0,15.0,8.0,13.0,18.0,15.0,13.0,14.0,12.0,9.0,10.0,15.0,13.0,20.0,16.0,13.0,14.0,12.0,14.0,5.0,16.0,13.0,12.0,16.0,13.0,13.0,13.0,13.0,6.0,22.0,0.0,0.0,6.0,1.0,175.0,75.0,3.0,3.0,2.0,1.0,1.0,2.0,3.0,2.0,2.0,1.0,1.0,10.0,9.0,12.0,6.0,11.0,7.0,10.0,11.0,7.0,9.0,11.0,6.0,10.0,14.0,12.0,10.0,12.0,10.0,10.0,12.0,11.0,10.0,13.0,6.0,11.0,8.0,11.0,13.0,12.0,14.0,12.0,8.0,5.0,14.0,13.0,20.0,11.0,12.0,10.0,10.0,10.0,8.0,10.0,8.0,11.0,10.0,9.0,12.0,12.0,15.0,6.0,32.0,25.0,0.0,0.0,0.0,181.0,82.0,2.0,3.0,3.0,1.0,1.0,1.0,1.0,3.0,1.0,2.0,3.0,5.0,10.0,6.0,7.0,10.0,7.0,14.0,9.0,8.0,11.0,12.0,7.0,13.0,10.0,15.0,14.0,16.0,11.0,13.0,10.0,12.0,16.0,9.0,15.0,8.0,11.0,16.0,18.0,11.0,12.0,14.0,11.0,8.0,13.0,11.0,20.0,17.0,15.0,13.0,15.0,11.0,6.0,14.0,18.0,12.0,13.0,13.0,14.0,11.0,11.0,8.0,25.0,24.0,7.0,0.0,0.0,180.0,75.0,1.0,2.0,1.0,1.0,1.0,2.0,3.0,1.0,3.0,1.0,3.0,6.0,10.0,14.0,11.0,14.0,10.0,9.0,12.0,6.0,3.0,13.0,11.0,2.0,16.0,7.0,12.0,12.0,12.0,10.0,12.0,11.0,13.0,16.0,6.0,13.0,5.0,8.0,8.0,16.0,14.0,13.0,10.0,10.0,13.0,14.0,20.0,13.0,12.0,12.0,7.0,14.0,11.0,8.0,17.0,14.0,13.0,13.0,12.0,15.0,15.0,7.0,34.0,0.0,0.0,0.0,0.0,176.0,65.0,2.0,3.0,3.0,3.0,2.0,2.0,1.0,2.0,1.0,1.0,2.0,14.0,15.0,13.0,10.0,15.0,13.0,6.0,15.0,10.0,3.0,14.0,13.0,6.0,14.0,8.0,12.0,9.0,13.0,12.0,14.0,13.0,11.0,12.0,7.0,13.0,8.0,14.0,15.0,14.0,13.0,12.0,8.0,20.0,14.0,13.0,10.0,12.0,7.0,13.0,8.0,15.0,7.0,6.0,13.0,14.0,14.0,9.0,14.0,14.0,11.0,10.0,24.0,12.0,6.0,0.0,0.0,180.0,74.0,3.0,2.0,3.0,3.0,1.0,1.0,3.0,1.0,1.0,2.0,3.0,9.0,13.0,14.0,12.0,12.0,9.0,6.0,9.0,5.0,4.0,9.0,12.0,6.0,13.0,10.0,10.0,13.0,9.0,8.0,13.0,11.0,12.0,15.0,8.0,15.0,5.0,6.0,12.0,15.0,15.0,14.0,10.0,10.0,16.0,16.0,20.0,15.0,13.0,12.0,9.0,14.0,6.0,11.0,13.0,12.0,7.0,9.0,8.0,14.0,14.0,15.0,21.0,0.0,0.0,4.0,1.0,184.0,79.0,1.0,2.0,3.0,1.0,2.0,1.0,3.0,2.0,2.0,1.0,3.0,3.0,6.0,10.0,12.0,12.0,7.0,15.0,8.0,4.0,5.0,13.0,10.0,8.0,12.0,18.0,12.0,19.0,13.0,10.0,13.0,12.0,14.0,13.0,10.0,12.0,9.0,16.0,15.0,12.0,14.0,14.0,14.0,12.0,13.0,10.0,20.0,14.0,14.0,11.0,14.0,14.0,11.0,5.0,10.0,13.0,14.0,15.0,10.0,8.0,4.0,15.0
3,0,27.0,0.0,0.0,2.0,0.0,188.0,81.0,9.0,10.0,8.0,6.0,13.0,8.0,14.0,15.0,12.0,12.0,10.0,4.0,3.0,2.0,2.0,8.0,8.0,2.0,2.0,1.0,3.0,8.0,3.0,1.0,8.0,8.0,12.0,13.0,12.0,12.0,8.0,11.0,15.0,6.0,9.0,1.0,12.0,11.0,9.0,13.0,14.0,15.0,14.0,5.0,15.0,11.0,20.0,13.0,15.0,12.0,8.0,15.0,5.0,1.0,19.0,13.0,10.0,15.0,14.0,14.0,14.0,6.0,28.0,0.0,0.0,0.0,0.0,183.0,81.0,1.0,2.0,4.0,1.0,1.0,3.0,2.0,3.0,3.0,3.0,1.0,5.0,5.0,6.0,10.0,12.0,6.0,14.0,8.0,6.0,15.0,11.0,6.0,13.0,12.0,13.0,14.0,16.0,14.0,14.0,10.0,12.0,14.0,5.0,14.0,8.0,14.0,15.0,15.0,9.0,12.0,15.0,13.0,7.0,11.0,12.0,20.0,15.0,15.0,14.0,14.0,14.0,9.0,8.0,14.0,14.0,11.0,13.0,15.0,13.0,15.0,6.0,34.0,23.0,1.0,0.0,0.0,186.0,81.0,3.0,3.0,1.0,2.0,1.0,3.0,2.0,3.0,1.0,3.0,3.0,4.0,8.0,6.0,10.0,7.0,8.0,17.0,12.0,10.0,14.0,7.0,9.0,15.0,7.0,15.0,13.0,17.0,8.0,12.0,7.0,12.0,15.0,6.0,17.0,7.0,14.0,15.0,14.0,8.0,10.0,16.0,13.0,12.0,13.0,9.0,20.0,13.0,15.0,11.0,15.0,14.0,9.0,10.0,10.0,14.0,11.0,13.0,15.0,11.0,11.0,12.0,21.0,0.0,0.0,1.0,0.0,177.0,68.0,4.0,1.0,2.0,1.0,1.0,1.0,1.0,1.0,2.0,1.0,2.0,5.0,12.0,9.0,7.0,12.0,8.0,13.0,10.0,16.0,13.0,12.0,8.0,14.0,12.0,12.0,13.0,12.0,12.0,12.0,10.0,13.0,15.0,11.0,13.0,11.0,13.0,13.0,14.0,13.0,14.0,13.0,11.0,10.0,14.0,12.0,20.0,12.0,14.0,12.0,11.0,12.0,8.0,14.0,13.0,10.0,14.0,12.0,14.0,12.0,11.0,5.0,27.0,14.0,1.0,0.0,0.0,183.0,77.0,1.0,2.0,1.0,2.0,3.0,2.0,3.0,2.0,2.0,1.0,1.0,5.0,12.0,9.0,8.0,13.0,10.0,13.0,10.0,6.0,14.0,13.0,6.0,13.0,12.0,14.0,13.0,15.0,11.0,11.0,11.0,11.0,13.0,9.0,8.0,9.0,12.0,14.0,16.0,14.0,12.0,14.0,12.0,7.0,14.0,12.0,20.0,15.0,14.0,14.0,14.0,15.0,7.0,10.0,12.0,13.0,14.0,12.0,13.0,11.0,11.0,7.0,30.0,0.0,0.0,0.0,0.0,167.0,60.0,3.0,1.0,1.0,2.0,3.0,1.0,1.0,3.0,1.0,1.0,3.0,10.0,11.0,12.0,8.0,13.0,10.0,6.0,9.0,10.0,12.0,14.0,9.0,10.0,14.0,11.0,14.0,14.0,14.0,14.0,13.0,14.0,12.0,14.0,11.0,13.0,12.0,15.0,15.0,15.0,14.0,11.0,5.0,11.0,11.0,15.0,20.0,11.0,8.0,14.0,10.0,12.0,13.0,11.0,11.0,12.0,11.0,10.0,12.0,11.0,11.0,2.0,33.0,0.0,0.0,0.0,0.0,187.0,76.0,2.0,2.0,3.0,1.0,1.0,3.0,2.0,1.0,2.0,3.0,2.0,15.0,14.0,14.0,10.0,15.0,13.0,10.0,12.0,7.0,4.0,15.0,13.0,7.0,15.0,6.0,12.0,9.0,14.0,11.0,15.0,12.0,12.0,14.0,12.0,13.0,7.0,13.0,12.0,11.0,12.0,14.0,12.0,14.0,15.0,12.0,20.0,11.0,12.0,12.0,6.0,14.0,6.0,11.0,14.0,13.0,12.0,12.0,15.0,15.0,13.0,9.0,30.0,0.0,0.0,0.0,0.0,178.0,73.0,3.0,4.0,1.0,1.0,2.0,4.0,3.0,2.0,2.0,2.0,3.0,13.0,14.0,12.0,7.0,13.0,12.0,7.0,13.0,5.0,10.0,13.0,9.0,10.0,13.0,11.0,11.0,12.0,12.0,13.0,11.0,14.0,14.0,11.0,7.0,11.0,10.0,13.0,15.0,13.0,15.0,15.0,8.0,20.0,14.0,14.0,8.0,14.0,11.0,13.0,11.0,14.0,8.0,10.0,19.0,12.0,12.0,9.0,12.0,12.0,10.0,10.0,27.0,0.0,0.0,0.0,0.0,190.0,87.0,1.0,3.0,2.0,3.0,1.0,3.0,1.0,1.0,2.0,3.0,2.0,5.0,7.0,9.0,14.0,14.0,10.0,14.0,13.0,5.0,6.0,12.0,12.0,8.0,14.0,14.0,13.0,16.0,14.0,11.0,10.0,13.0,15.0,10.0,11.0,14.0,9.0,15.0,14.0,10.0,11.0,16.0,15.0,9.0,12.0,12.0,20.0,14.0,16.0,13.0,13.0,12.0,7.0,5.0,10.0,12.0,14.0,12.0,14.0,14.0,19.0,12.0,26.0,0.0,0.0,0.0,0.0,193.0,81.0,1.0,3.0,3.0,3.0,3.0,1.0,2.0,2.0,2.0,3.0,3.0,4.0,9.0,14.0,10.0,13.0,12.0,14.0,14.0,5.0,5.0,10.0,12.0,3.0,14.0,8.0,13.0,12.0,9.0,10.0,11.0,11.0,12.0,16.0,5.0,14.0,6.0,9.0,12.0,14.0,13.0,14.0,16.0,14.0,13.0,13.0,20.0,13.0,14.0,10.0,8.0,14.0,9.0,8.0,16.0,16.0,11.0,13.0,11.0,13.0,13.0,10.0,17.0,0.0,0.0,0.0,0.0,181.0,68.0,1.0,2.0,1.0,1.0,2.0,2.0,3.0,3.0,3.0,2.0,1.0,8.0,11.0,14.0,11.0,13.0,8.0,11.0,9.0,5.0,3.0,11.0,5.0,5.0,14.0,5.0,11.0,6.0,10.0,10.0,11.0,12.0,14.0,13.0,6.0,13.0,9.0,10.0,8.0,14.0,14.0,14.0,10.0,5.0,12.0,14.0,20.0,12.0,11.0,10.0,6.0,5.0,10.0,12.0,20.0,12.0,11.0,12.0,12.0,11.0,14.0,5.0,20.0,0.0,0.0,3.0,0.0,193.0,80.0,10.0,12.0,12.0,9.0,11.0,11.0,13.0,15.0,13.0,7.0,12.0,7.0,1.0,1.0,2.0,8.0,11.0,1.0,2.0,1.0,2.0,11.0,2.0,1.0,8.0,4.0,14.0,14.0,11.0,9.0,11.0,12.0,12.0,2.0,15.0,1.0,13.0,11.0,6.0,12.0,13.0,15.0,16.0,20.0,15.0,10.0,6.0,13.0,14.0,12.0,11.0,11.0,10.0,1.0,11.0,9.0,12.0,12.0,13.0,10.0,10.0,1.0,27.0,0.0,0.0,0.0,0.0,181.0,79.0,3.0,1.0,3.0,1.0,3.0,1.0,1.0,2.0,3.0,3.0,3.0,5.0,12.0,10.0,5.0,10.0,6.0,11.0,7.0,8.0,12.0,9.0,7.0,12.0,11.0,13.0,13.0,14.0,13.0,12.0,9.0,9.0,13.0,9.0,7.0,8.0,13.0,13.0,13.0,15.0,12.0,13.0,10.0,5.0,13.0,13.0,20.0,15.0,14.0,15.0,13.0,7.0,6.0,10.0,8.0,13.0,13.0,13.0,14.0,14.0,14.0,5.0,32.0,19.0,0.0,9.0,0.0,185.0,85.0,2.0,3.0,2.0,1.0,2.0,1.0,1.0,2.0,2.0,3.0,3.0,5.0,10.0,9.0,8.0,11.0,11.0,15.0,13.0,9.0,15.0,12.0,10.0,14.0,11.0,14.0,15.0,16.0,12.0,11.0,9.0,11.0,17.0,7.0,12.0,9.0,15.0,13.0,10.0,9.0,9.0,15.0,13.0,10.0,13.0,11.0,20.0,13.0,15.0,12.0,15.0,12.0,13.0,10.0,11.0,13.0,11.0,13.0,18.0,15.0,13.0,5.0,24.0,0.0,0.0,0.0,0.0,184.0,89.0,2.0,3.0,3.0,2.0,2.0,3.0,3.0,1.0,2.0,3.0,2.0,4.0,10.0,8.0,6.0,11.0,9.0,14.0,9.0,7.0,14.0,11.0,6.0,11.0,11.0,13.0,12.0,16.0,11.0,13.0,10.0,11.0,14.0,6.0,8.0,7.0,12.0,13.0,14.0,14.0,12.0,16.0,12.0,20.0,14.0,13.0,6.0,14.0,16.0,14.0,13.0,13.0,7.0,8.0,7.0,14.0,13.0,12.0,14.0,14.0,14.0,6.0,24.0,0.0,0.0,0.0,0.0,175.0,68.0,4.0,3.0,3.0,4.0,1.0,3.0,2.0,2.0,3.0,3.0,1.0,8.0,12.0,11.0,7.0,11.0,8.0,9.0,12.0,13.0,11.0,11.0,7.0,12.0,13.0,12.0,11.0,14.0,12.0,11.0,10.0,12.0,14.0,6.0,8.0,13.0,12.0,14.0,14.0,13.0,13.0,10.0,6.0,12.0,14.0,13.0,20.0,14.0,9.0,13.0,6.0,12.0,5.0,15.0,15.0,10.0,10.0,13.0,14.0,15.0,13.0,4.0,27.0,27.0,1.0,2.0,1.0,183.0,72.0,2.0,2.0,2.0,1.0,2.0,1.0,3.0,1.0,2.0,2.0,4.0,5.0,8.0,10.0,6.0,11.0,10.0,14.0,11.0,5.0,14.0,12.0,10.0,15.0,11.0,14.0,13.0,16.0,11.0,11.0,9.0,10.0,12.0,8.0,12.0,8.0,13.0,14.0,14.0,14.0,12.0,16.0,11.0,8.0,12.0,13.0,20.0,15.0,15.0,10.0,14.0,11.0,7.0,11.0,13.0,13.0,9.0,9.0,11.0,10.0,10.0,8.0,23.0,5.0,0.0,0.0,0.0,180.0,75.0,1.0,1.0,2.0,3.0,3.0,1.0,2.0,2.0,3.0,1.0,3.0,5.0,9.0,12.0,7.0,14.0,8.0,12.0,11.0,6.0,11.0,12.0,12.0,11.0,11.0,12.0,13.0,13.0,11.0,10.0,13.0,11.0,14.0,11.0,7.0,11.0,12.0,14.0,13.0,15.0,13.0,14.0,10.0,7.0,14.0,14.0,20.0,13.0,14.0,12.0,11.0,12.0,12.0,15.0,10.0,14.0,13.0,12.0,14.0,14.0,14.0,6.0,31.0,0.0,0.0,0.0,0.0,180.0,74.0,3.0,2.0,3.0,1.0,2.0,3.0,2.0,1.0,4.0,3.0,3.0,12.0,12.0,10.0,9.0,13.0,14.0,11.0,13.0,6.0,10.0,14.0,15.0,13.0,13.0,15.0,14.0,17.0,12.0,14.0,13.0,13.0,15.0,7.0,13.0,10.0,13.0,18.0,15.0,9.0,11.0,14.0,10.0,10.0,13.0,12.0,20.0,15.0,14.0,14.0,13.0,15.0,8.0,7.0,19.0,13.0,13.0,13.0,13.0,13.0,12.0,9.0,19.0,0.0,0.0,0.0,0.0,170.0,62.0,1.0,3.0,3.0,3.0,3.0,3.0,1.0,1.0,3.0,1.0,3.0,10.0,10.0,10.0,9.0,12.0,10.0,6.0,14.0,10.0,8.0,13.0,8.0,8.0,12.0,10.0,11.0,10.0,14.0,9.0,12.0,12.0,18.0,10.0,10.0,11.0,10.0,12.0,14.0,13.0,12.0,11.0,6.0,20.0,15.0,10.0,7.0,12.0,6.0,10.0,10.0,6.0,9.0,9.0,11.0,9.0,11.0,10.0,11.0,9.0,16.0,8.0,21.0,0.0,0.0,6.0,3.0,185.0,75.0,2.0,2.0,2.0,4.0,4.0,1.0,3.0,1.0,3.0,1.0,1.0,9.0,7.0,11.0,14.0,11.0,10.0,16.0,7.0,6.0,8.0,11.0,8.0,8.0,9.0,10.0,11.0,14.0,14.0,11.0,12.0,11.0,9.0,11.0,15.0,10.0,12.0,10.0,13.0,11.0,12.0,11.0,13.0,6.0,14.0,13.0,20.0,16.0,11.0,8.0,10.0,10.0,9.0,10.0,19.0,11.0,12.0,11.0,9.0,11.0,16.0,3.0,18.0,0.0,0.0,4.0,0.0,188.0,81.0,3.0,3.0,1.0,3.0,1.0,4.0,1.0,2.0,1.0,3.0,4.0,6.0,8.0,13.0,10.0,10.0,10.0,8.0,12.0,6.0,6.0,10.0,14.0,6.0,9.0,10.0,7.0,14.0,9.0,9.0,11.0,11.0,10.0,8.0,11.0,8.0,4.0,11.0,13.0,12.0,13.0,14.0,13.0,8.0,14.0,14.0,20.0,12.0,13.0,10.0,10.0,7.0,6.0,10.0,17.0,10.0,9.0,9.0,13.0,10.0,11.0,6.0
1,3,31.0,25.0,0.0,6.0,0.0,191.0,84.0,11.0,14.0,13.0,12.0,15.0,14.0,15.0,16.0,13.0,14.0,14.0,8.0,2.0,10.0,5.0,11.0,11.0,7.0,10.0,2.0,5.0,10.0,11.0,11.0,9.0,12.0,13.0,15.0,13.0,13.0,8.0,13.0,16.0,12.0,14.0,1.0,16.0,13.0,11.0,12.0,13.0,16.0,16.0,8.0,16.0,13.0,20.0,15.0,15.0,17.0,8.0,15.0,7.0,2.0,15.0,15.0,17.0,15.0,17.0,16.0,15.0,6.0,23.0,0.0,0.0,0.0,0.0,184.0,77.0,1.0,1.0,1.0,1.0,3.0,2.0,3.0,2.0,2.0,2.0,3.0,6.0,9.0,11.0,7.0,12.0,7.0,15.0,9.0,11.0,14.0,13.0,10.0,15.0,12.0,14.0,15.0,15.0,13.0,12.0,11.0,13.0,15.0,11.0,9.0,9.0,14.0,14.0,14.0,14.0,13.0,15.0,13.0,9.0,16.0,15.0,20.0,14.0,14.0,14.0,11.0,14.0,4.0,11.0,14.0,13.0,15.0,14.0,16.0,14.0,15.0,6.0,28.0,46.0,3.0,14.0,3.0,190.0,80.0,2.0,3.0,3.0,2.0,2.0,1.0,1.0,3.0,1.0,3.0,1.0,4.0,6.0,7.0,9.0,11.0,7.0,17.0,11.0,10.0,15.0,12.0,11.0,16.0,10.0,17.0,15.0,18.0,13.0,14.0,12.0,14.0,18.0,6.0,17.0,8.0,15.0,15.0,14.0,11.0,10.0,17.0,16.0,7.0,17.0,13.0,20.0,15.0,18.0,17.0,14.0,16.0,4.0,6.0,14.0,15.0,16.0,17.0,18.0,14.0,15.0,6.0,23.0,0.0,0.0,1.0,0.0,182.0,71.0,3.0,1.0,2.0,3.0,4.0,2.0,3.0,1.0,2.0,1.0,3.0,9.0,13.0,14.0,8.0,14.0,13.0,12.0,10.0,13.0,14.0,14.0,13.0,15.0,13.0,14.0,14.0,13.0,11.0,12.0,12.0,13.0,16.0,12.0,12.0,15.0,13.0,14.0,15.0,15.0,13.0,14.0,12.0,9.0,16.0,15.0,20.0,15.0,15.0,15.0,10.0,14.0,6.0,12.0,8.0,15.0,14.0,16.0,15.0,15.0,16.0,6.0,21.0,0.0,0.0,9.0,0.0,185.0,75.0,1.0,1.0,2.0,2.0,2.0,1.0,1.0,4.0,2.0,3.0,2.0,11.0,15.0,14.0,7.0,13.0,9.0,11.0,11.0,14.0,13.0,13.0,10.0,14.0,13.0,15.0,12.0,13.0,10.0,11.0,11.0,12.0,14.0,11.0,10.0,14.0,12.0,13.0,15.0,15.0,13.0,14.0,13.0,20.0,14.0,16.0,8.0,15.0,15.0,13.0,13.0,12.0,9.0,10.0,14.0,14.0,13.0,12.0,12.0,13.0,9.0,9.0,21.0,0.0,0.0,9.0,0.0,184.0,72.0,1.0,3.0,1.0,2.0,3.0,2.0,1.0,1.0,2.0,1.0,2.0,6.0,10.0,12.0,7.0,12.0,7.0,14.0,11.0,7.0,14.0,13.0,10.0,13.0,12.0,14.0,13.0,14.0,12.0,12.0,12.0,12.0,16.0,11.0,10.0,12.0,13.0,14.0,15.0,14.0,13.0,16.0,12.0,12.0,14.0,15.0,20.0,15.0,17.0,14.0,12.0,15.0,9.0,9.0,10.0,16.0,14.0,15.0,14.0,14.0,14.0,8.0,31.0,0.0,0.0,6.0,0.0,174.0,80.0,1.0,1.0,1.0,1.0,1.0,5.0,1.0,1.0,1.0,1.0,1.0,14.0,12.0,11.0,7.0,12.0,13.0,9.0,7.0,10.0,11.0,11.0,10.0,10.0,12.0,11.0,11.0,11.0,10.0,6.0,10.0,9.0,12.0,12.0,12.0,10.0,12.0,12.0,14.0,12.0,15.0,10.0,9.0,20.0,12.0,12.0,7.0,12.0,9.0,9.0,10.0,12.0,7.0,9.0,11.0,14.0,9.0,7.0,14.0,8.0,9.0,9.0,20.0,0.0,0.0,7.0,1.0,170.0,58.0,1.0,2.0,2.0,2.0,2.0,2.0,2.0,4.0,1.0,3.0,2.0,16.0,14.0,16.0,13.0,16.0,17.0,5.0,14.0,2.0,6.0,15.0,13.0,4.0,17.0,9.0,12.0,14.0,12.0,12.0,14.0,13.0,15.0,16.0,7.0,13.0,9.0,13.0,15.0,15.0,16.0,11.0,7.0,20.0,14.0,15.0,8.0,14.0,8.0,15.0,5.0,15.0,7.0,16.0,15.0,15.0,15.0,14.0,16.0,18.0,16.0,3.0,21.0,7.0,0.0,14.0,6.0,173.0,64.0,3.0,2.0,3.0,2.0,3.0,3.0,3.0,2.0,3.0,3.0,3.0,14.0,14.0,18.0,14.0,17.0,14.0,7.0,11.0,2.0,6.0,15.0,14.0,6.0,18.0,12.0,14.0,14.0,15.0,13.0,16.0,14.0,17.0,17.0,12.0,13.0,9.0,13.0,17.0,15.0,17.0,13.0,7.0,20.0,14.0,14.0,9.0,14.0,9.0,15.0,7.0,16.0,7.0,14.0,15.0,17.0,15.0,16.0,17.0,16.0,15.0,4.0,26.0,0.0,0.0,4.0,0.0,180.0,73.0,2.0,3.0,1.0,4.0,2.0,3.0,3.0,1.0,1.0,4.0,1.0,11.0,13.0,13.0,14.0,14.0,11.0,15.0,12.0,3.0,7.0,14.0,14.0,8.0,13.0,12.0,14.0,17.0,13.0,15.0,14.0,14.0,16.0,12.0,15.0,16.0,12.0,18.0,16.0,13.0,14.0,13.0,12.0,8.0,14.0,13.0,20.0,15.0,12.0,15.0,8.0,14.0,7.0,15.0,19.0,14.0,17.0,14.0,18.0,16.0,16.0,5.0,30.0,62.0,25.0,13.0,8.0,177.0,72.0,1.0,3.0,3.0,1.0,3.0,2.0,1.0,3.0,1.0,4.0,1.0,8.0,11.0,12.0,17.0,14.0,12.0,18.0,14.0,3.0,4.0,13.0,18.0,5.0,16.0,14.0,15.0,16.0,17.0,13.0,14.0,16.0,16.0,16.0,16.0,16.0,6.0,13.0,13.0,13.0,14.0,13.0,11.0,14.0,13.0,12.0,20.0,12.0,12.0,15.0,8.0,19.0,10.0,6.0,13.0,18.0,14.0,19.0,15.0,16.0,17.0,10.0,25.0,4.0,0.0,11.0,0.0,184.0,81.0,14.0,14.0,13.0,9.0,15.0,12.0,16.0,16.0,13.0,7.0,11.0,8.0,1.0,2.0,1.0,11.0,12.0,6.0,1.0,3.0,3.0,11.0,5.0,3.0,11.0,8.0,15.0,15.0,13.0,14.0,10.0,11.0,14.0,8.0,13.0,5.0,13.0,10.0,10.0,14.0,16.0,14.0,13.0,20.0,14.0,12.0,5.0,14.0,14.0,15.0,9.0,16.0,6.0,1.0,17.0,11.0,15.0,13.0,14.0,12.0,12.0,4.0,27.0,4.0,0.0,5.0,1.0,184.0,83.0,2.0,4.0,3.0,1.0,1.0,2.0,1.0,2.0,4.0,2.0,3.0,4.0,8.0,11.0,4.0,10.0,4.0,14.0,4.0,4.0,15.0,12.0,5.0,16.0,11.0,14.0,14.0,16.0,14.0,10.0,11.0,12.0,17.0,7.0,10.0,9.0,13.0,14.0,15.0,14.0,13.0,16.0,13.0,10.0,15.0,13.0,20.0,15.0,16.0,12.0,12.0,14.0,6.0,12.0,11.0,13.0,12.0,12.0,16.0,15.0,14.0,6.0,19.0,0.0,0.0,0.0,0.0,193.0,89.0,3.0,2.0,2.0,3.0,1.0,3.0,1.0,4.0,2.0,2.0,3.0,8.0,10.0,5.0,4.0,10.0,10.0,14.0,12.0,6.0,12.0,10.0,4.0,12.0,9.0,11.0,11.0,14.0,11.0,12.0,8.0,14.0,13.0,8.0,8.0,11.0,11.0,13.0,13.0,10.0,9.0,14.0,16.0,6.0,14.0,10.0,20.0,12.0,14.0,11.0,7.0,6.0,6.0,8.0,16.0,10.0,10.0,12.0,13.0,16.0,16.0,5.0,37.0,0.0,0.0,0.0,0.0,185.0,83.0,1.0,1.0,2.0,1.0,3.0,2.0,3.0,1.0,1.0,3.0,1.0,6.0,8.0,9.0,12.0,10.0,8.0,13.0,9.0,4.0,5.0,10.0,14.0,4.0,11.0,11.0,10.0,11.0,13.0,12.0,12.0,13.0,15.0,14.0,12.0,11.0,7.0,12.0,8.0,7.0,7.0,12.0,12.0,11.0,11.0,7.0,20.0,8.0,14.0,12.0,8.0,13.0,9.0,12.0,12.0,12.0,19.0,14.0,15.0,14.0,8.0,8.0,32.0,0.0,0.0,0.0,0.0,172.0,71.0,2.0,1.0,3.0,1.0,2.0,3.0,2.0,3.0,2.0,2.0,2.0,8.0,9.0,7.0,6.0,10.0,6.0,10.0,9.0,10.0,14.0,11.0,6.0,14.0,11.0,10.0,16.0,15.0,12.0,12.0,7.0,12.0,15.0,9.0,13.0,8.0,14.0,15.0,15.0,14.0,14.0,14.0,10.0,20.0,14.0,14.0,8.0,15.0,13.0,13.0,11.0,13.0,7.0,13.0,17.0,14.0,17.0,8.0,13.0,15.0,15.0,6.0,19.0,0.0,0.0,0.0,0.0,185.0,82.0,4.0,2.0,3.0,1.0,3.0,2.0,1.0,2.0,1.0,2.0,3.0,7.0,7.0,10.0,6.0,13.0,7.0,14.0,7.0,6.0,12.0,13.0,7.0,13.0,13.0,13.0,13.0,13.0,11.0,12.0,11.0,12.0,14.0,9.0,14.0,11.0,11.0,15.0,15.0,12.0,12.0,14.0,13.0,5.0,14.0,12.0,20.0,14.0,13.0,10.0,11.0,11.0,6.0,10.0,10.0,12.0,12.0,14.0,14.0,11.0,16.0,6.0,21.0,0.0,0.0,15.0,3.0,181.0,78.0,3.0,3.0,4.0,2.0,1.0,2.0,2.0,4.0,2.0,1.0,1.0,5.0,7.0,11.0,10.0,14.0,5.0,14.0,10.0,6.0,13.0,14.0,8.0,14.0,14.0,12.0,14.0,12.0,11.0,10.0,12.0,11.0,16.0,11.0,12.0,14.0,14.0,14.0,14.0,14.0,13.0,14.0,13.0,10.0,16.0,14.0,20.0,16.0,14.0,12.0,10.0,11.0,5.0,19.0,8.0,11.0,14.0,11.0,16.0,13.0,13.0,10.0,24.0,6.0,1.0,0.0,0.0,183.0,66.0,1.0,1.0,2.0,2.0,1.0,2.0,1.0,2.0,3.0,2.0,1.0,14.0,14.0,14.0,10.0,14.0,14.0,9.0,10.0,8.0,8.0,14.0,10.0,8.0,15.0,9.0,11.0,13.0,11.0,11.0,13.0,10.0,14.0,13.0,5.0,12.0,9.0,14.0,13.0,14.0,16.0,12.0,9.0,20.0,13.0,14.0,5.0,15.0,9.0,12.0,10.0,12.0,8.0,9.0,16.0,9.0,16.0,13.0,11.0,12.0,13.0,9.0,31.0,52.0,8.0,0.0,0.0,167.0,58.0,1.0,2.0,2.0,1.0,3.0,2.0,4.0,2.0,1.0,2.0,3.0,15.0,15.0,14.0,7.0,15.0,15.0,6.0,11.0,3.0,4.0,15.0,14.0,7.0,15.0,13.0,12.0,15.0,13.0,14.0,16.0,11.0,17.0,14.0,11.0,12.0,10.0,12.0,14.0,15.0,18.0,10.0,5.0,10.0,16.0,14.0,20.0,13.0,7.0,14.0,13.0,16.0,8.0,12.0,13.0,16.0,14.0,15.0,13.0,9.0,11.0,14.0,22.0,5.0,1.0,1.0,0.0,173.0,72.0,1.0,3.0,1.0,3.0,3.0,3.0,3.0,3.0,3.0,2.0,2.0,14.0,13.0,16.0,14.0,16.0,14.0,5.0,11.0,5.0,5.0,15.0,11.0,5.0,16.0,8.0,13.0,9.0,14.0,13.0,15.0,13.0,15.0,16.0,5.0,13.0,5.0,9.0,10.0,15.0,16.0,14.0,5.0,20.0,14.0,15.0,5.0,12.0,14.0,13.0,11.0,13.0,8.0,14.0,10.0,15.0,14.0,10.0,13.0,10.0,10.0,13.0,25.0,10.0,1.0,11.0,4.0,175.0,73.0,1.0,3.0,3.0,3.0,3.0,3.0,3.0,1.0,2.0,3.0,1.0,5.0,10.0,15.0,17.0,15.0,10.0,11.0,12.0,5.0,5.0,14.0,15.0,5.0,16.0,8.0,15.0,12.0,15.0,14.0,13.0,15.0,15.0,15.0,14.0,14.0,10.0,10.0,12.0,16.0,16.0,15.0,9.0,10.0,15.0,16.0,20.0,13.0,15.0,14.0,8.0,14.0,7.0,10.0,8.0,16.0,17.0,13.0,15.0,15.0,14.0,5.0
2,0,25.0,4.0,0.0,11.0,0.0,184.0,81.0,14.0,14.0,13.0,9.0,15.0,12.0,16.0,16.0,13.0,7.0,11.0,8.0,1.0,2.0,1.0,11.0,12.0,6.0,1.0,3.0,3.0,11.0,5.0,3.0,11.0,8.0,15.0,15.0,13.0,14.0,10.0,11.0,14.0,8.0,13.0,5.0,13.0,10.0,10.0,14.0,16.0,14.0,13.0,20.0,14.0,12.0,5.0,14.0,14.0,15.0,9.0,16.0,6.0,1.0,17.0,11.0,15.0,13.0,14.0,12.0,12.0,4.0,19.0,0.0,0.0,0.0,0.0,193.0,89.0,3.0,2.0,2.0,3.0,1.0,3.0,1.0,4.0,2.0,2.0,3.0,8.0,10.0,5.0,4.0,10.0,10.0,14.0,12.0,6.0,12.0,10.0,4.0,12.0,9.0,11.0,11.0,14.0,11.0,12.0,8.0,14.0,13.0,8.0,8.0,11.0,11.0,13.0,13.0,10.0,9.0,14.0,16.0,6.0,14.0,10.0,20.0,12.0,14.0,11.0,7.0,6.0,6.0,8.0,16.0,10.0,10.0,12.0,13.0,16.0,16.0,5.0,27.0,4.0,0.0,5.0,1.0,184.0,83.0,2.0,4.0,3.0,1.0,1.0,2.0,1.0,2.0,4.0,2.0,3.0,4.0,8.0,11.0,4.0,10.0,4.0,14.0,4.0,4.0,15.0,12.0,5.0,16.0,11.0,14.0,14.0,16.0,14.0,10.0,11.0,12.0,17.0,7.0,10.0,9.0,13.0,14.0,15.0,14.0,13.0,16.0,13.0,10.0,15.0,13.0,20.0,15.0,16.0,12.0,12.0,14.0,6.0,12.0,11.0,13.0,12.0,12.0,16.0,15.0,14.0,6.0,32.0,0.0,0.0,0.0,0.0,172.0,71.0,2.0,1.0,3.0,1.0,2.0,3.0,2.0,3.0,2.0,2.0,2.0,8.0,9.0,7.0,6.0,10.0,6.0,10.0,9.0,10.0,14.0,11.0,6.0,14.0,11.0,10.0,16.0,15.0,12.0,12.0,7.0,12.0,15.0,9.0,13.0,8.0,14.0,15.0,15.0,14.0,14.0,14.0,10.0,20.0,14.0,14.0,8.0,15.0,13.0,13.0,11.0,13.0,7.0,13.0,17.0,14.0,17.0,8.0,13.0,15.0,15.0,6.0,32.0,11.0,1.0,0.0,0.0,176.0,68.0,2.0,1.0,3.0,2.0,2.0,2.0,2.0,3.0,3.0,2.0,2.0,8.0,10.0,10.0,7.0,11.0,8.0,10.0,11.0,12.0,11.0,13.0,12.0,14.0,12.0,9.0,14.0,15.0,13.0,12.0,11.0,12.0,17.0,8.0,14.0,14.0,11.0,18.0,18.0,14.0,14.0,12.0,10.0,10.0,14.0,13.0,20.0,17.0,13.0,15.0,9.0,13.0,8.0,13.0,17.0,13.0,15.0,16.0,16.0,16.0,18.0,5.0,19.0,0.0,0.0,0.0,0.0,185.0,82.0,4.0,2.0,3.0,1.0,3.0,2.0,1.0,2.0,1.0,2.0,3.0,7.0,7.0,10.0,6.0,13.0,7.0,14.0,7.0,6.0,12.0,13.0,7.0,13.0,13.0,13.0,13.0,13.0,11.0,12.0,11.0,12.0,14.0,9.0,14.0,11.0,11.0,15.0,15.0,12.0,12.0,14.0,13.0,5.0,14.0,12.0,20.0,14.0,13.0,10.0,11.0,11.0,6.0,10.0,10.0,12.0,12.0,14.0,14.0,11.0,16.0,6.0,27.0,8.0,0.0,6.0,0.0,187.0,76.0,3.0,2.0,3.0,2.0,2.0,1.0,1.0,3.0,3.0,1.0,2.0,5.0,7.0,11.0,5.0,14.0,5.0,14.0,9.0,5.0,15.0,15.0,8.0,14.0,13.0,15.0,16.0,15.0,14.0,12.0,14.0,14.0,18.0,8.0,17.0,9.0,12.0,18.0,15.0,13.0,14.0,15.0,14.0,10.0,17.0,12.0,20.0,17.0,15.0,14.0,13.0,16.0,4.0,12.0,10.0,14.0,17.0,12.0,15.0,13.0,13.0,6.0,24.0,6.0,1.0,0.0,0.0,183.0,66.0,1.0,1.0,2.0,2.0,1.0,2.0,1.0,2.0,3.0,2.0,1.0,14.0,14.0,14.0,10.0,14.0,14.0,9.0,10.0,8.0,8.0,14.0,10.0,8.0,15.0,9.0,11.0,13.0,11.0,11.0,13.0,10.0,14.0,13.0,5.0,12.0,9.0,14.0,13.0,14.0,16.0,12.0,9.0,20.0,13.0,14.0,5.0,15.0,9.0,12.0,10.0,12.0,8.0,9.0,16.0,9.0,16.0,13.0,11.0,12.0,13.0,9.0,31.0,52.0,8.0,0.0,0.0,167.0,58.0,1.0,2.0,2.0,1.0,3.0,2.0,4.0,2.0,1.0,2.0,3.0,15.0,15.0,14.0,7.0,15.0,15.0,6.0,11.0,3.0,4.0,15.0,14.0,7.0,15.0,13.0,12.0,15.0,13.0,14.0,16.0,11.0,17.0,14.0,11.0,12.0,10.0,12.0,14.0,15.0,18.0,10.0,5.0,10.0,16.0,14.0,20.0,13.0,7.0,14.0,13.0,16.0,8.0,12.0,13.0,16.0,14.0,15.0,13.0,9.0,11.0,14.0,25.0,10.0,1.0,11.0,4.0,175.0,73.0,1.0,3.0,3.0,3.0,3.0,3.0,3.0,1.0,2.0,3.0,1.0,5.0,10.0,15.0,17.0,15.0,10.0,11.0,12.0,5.0,5.0,14.0,15.0,5.0,16.0,8.0,15.0,12.0,15.0,14.0,13.0,15.0,15.0,15.0,14.0,14.0,10.0,10.0,12.0,16.0,16.0,15.0,9.0,10.0,15.0,16.0,20.0,13.0,15.0,14.0,8.0,14.0,7.0,10.0,8.0,16.0,17.0,13.0,15.0,15.0,14.0,5.0,22.0,5.0,1.0,1.0,0.0,173.0,72.0,1.0,3.0,1.0,3.0,3.0,3.0,3.0,3.0,3.0,2.0,2.0,14.0,13.0,16.0,14.0,16.0,14.0,5.0,11.0,5.0,5.0,15.0,11.0,5.0,16.0,8.0,13.0,9.0,14.0,13.0,15.0,13.0,15.0,16.0,5.0,13.0,5.0,9.0,10.0,15.0,16.0,14.0,5.0,20.0,14.0,15.0,5.0,12.0,14.0,13.0,11.0,13.0,8.0,14.0,10.0,15.0,14.0,10.0,13.0,10.0,10.0,13.0,24.0,0.0,0.0,0.0,0.0,188.0,82.0,13.0,14.0,12.0,8.0,14.0,8.0,14.0,15.0,12.0,12.0,9.0,3.0,1.0,1.0,2.0,8.0,8.0,1.0,1.0,1.0,2.0,8.0,3.0,3.0,7.0,9.0,12.0,13.0,11.0,12.0,9.0,12.0,15.0,6.0,14.0,2.0,11.0,11.0,6.0,12.0,13.0,15.0,14.0,5.0,13.0,12.0,20.0,12.0,10.0,13.0,9.0,12.0,6.0,1.0,14.0,12.0,17.0,13.0,15.0,13.0,11.0,6.0,29.0,2.0,0.0,0.0,0.0,185.0,75.0,2.0,3.0,3.0,3.0,2.0,3.0,2.0,1.0,3.0,1.0,2.0,4.0,10.0,8.0,6.0,10.0,6.0,14.0,7.0,7.0,14.0,11.0,6.0,14.0,9.0,13.0,13.0,14.0,11.0,12.0,12.0,12.0,14.0,8.0,11.0,12.0,13.0,13.0,13.0,15.0,12.0,15.0,12.0,8.0,15.0,13.0,20.0,14.0,15.0,14.0,7.0,14.0,8.0,6.0,14.0,13.0,15.0,14.0,14.0,14.0,14.0,6.0,28.0,0.0,0.0,0.0,0.0,193.0,84.0,1.0,1.0,2.0,2.0,2.0,3.0,2.0,3.0,2.0,1.0,3.0,4.0,8.0,8.0,9.0,10.0,6.0,14.0,7.0,8.0,14.0,12.0,6.0,14.0,11.0,12.0,13.0,14.0,11.0,14.0,12.0,12.0,14.0,6.0,11.0,8.0,14.0,13.0,13.0,11.0,11.0,16.0,16.0,20.0,12.0,12.0,8.0,14.0,16.0,14.0,12.0,13.0,6.0,10.0,7.0,12.0,15.0,12.0,16.0,15.0,13.0,6.0,26.0,0.0,0.0,10.0,1.0,196.0,91.0,3.0,1.0,2.0,2.0,2.0,3.0,2.0,4.0,2.0,2.0,1.0,3.0,5.0,8.0,6.0,9.0,5.0,14.0,7.0,8.0,13.0,10.0,5.0,12.0,10.0,10.0,13.0,14.0,12.0,12.0,7.0,10.0,13.0,6.0,9.0,6.0,12.0,14.0,10.0,9.0,8.0,13.0,18.0,8.0,17.0,11.0,20.0,12.0,16.0,13.0,12.0,10.0,7.0,4.0,18.0,10.0,12.0,9.0,13.0,7.0,10.0,7.0,26.0,0.0,0.0,0.0,0.0,175.0,69.0,3.0,3.0,2.0,2.0,3.0,1.0,3.0,1.0,3.0,2.0,2.0,6.0,12.0,10.0,5.0,11.0,6.0,10.0,10.0,10.0,13.0,12.0,9.0,13.0,12.0,12.0,13.0,14.0,12.0,13.0,12.0,11.0,15.0,11.0,13.0,12.0,13.0,14.0,14.0,15.0,13.0,12.0,7.0,9.0,13.0,13.0,20.0,14.0,11.0,14.0,12.0,12.0,11.0,15.0,14.0,9.0,17.0,10.0,8.0,11.0,20.0,7.0,29.0,0.0,0.0,0.0,0.0,183.0,78.0,1.0,3.0,3.0,3.0,3.0,1.0,2.0,3.0,3.0,1.0,1.0,13.0,8.0,9.0,6.0,12.0,14.0,13.0,10.0,12.0,11.0,12.0,8.0,13.0,12.0,12.0,15.0,13.0,13.0,13.0,11.0,13.0,15.0,6.0,12.0,7.0,13.0,16.0,18.0,12.0,11.0,14.0,12.0,20.0,14.0,11.0,8.0,16.0,14.0,14.0,12.0,14.0,6.0,12.0,10.0,12.0,13.0,11.0,15.0,15.0,15.0,5.0,30.0,9.0,1.0,0.0,0.0,192.0,90.0,2.0,2.0,2.0,2.0,3.0,1.0,3.0,4.0,1.0,1.0,3.0,4.0,7.0,10.0,10.0,9.0,8.0,17.0,12.0,6.0,13.0,12.0,8.0,12.0,11.0,13.0,14.0,15.0,13.0,13.0,10.0,12.0,14.0,12.0,13.0,13.0,12.0,14.0,16.0,12.0,12.0,18.0,16.0,8.0,14.0,13.0,20.0,16.0,18.0,13.0,13.0,14.0,7.0,12.0,13.0,13.0,13.0,13.0,13.0,13.0,13.0,6.0,21.0,0.0,0.0,0.0,0.0,183.0,73.0,1.0,4.0,3.0,3.0,3.0,1.0,4.0,1.0,2.0,3.0,2.0,11.0,10.0,12.0,11.0,13.0,9.0,12.0,10.0,5.0,8.0,12.0,9.0,8.0,13.0,13.0,12.0,12.0,10.0,12.0,14.0,12.0,12.0,14.0,8.0,12.0,8.0,12.0,12.0,14.0,14.0,14.0,11.0,8.0,13.0,13.0,20.0,12.0,12.0,12.0,5.0,10.0,7.0,12.0,15.0,11.0,11.0,10.0,11.0,12.0,11.0,4.0,29.0,0.0,0.0,0.0,0.0,180.0,71.0,1.0,3.0,1.0,1.0,1.0,4.0,4.0,1.0,1.0,2.0,3.0,10.0,11.0,12.0,9.0,13.0,11.0,8.0,14.0,6.0,8.0,11.0,10.0,8.0,12.0,10.0,11.0,12.0,12.0,9.0,12.0,11.0,14.0,12.0,7.0,12.0,10.0,12.0,14.0,15.0,14.0,12.0,10.0,20.0,16.0,13.0,12.0,15.0,10.0,13.0,10.0,15.0,7.0,8.0,16.0,12.0,12.0,13.0,14.0,15.0,15.0,6.0,23.0,1.0,0.0,0.0,0.0,192.0,80.0,3.0,3.0,3.0,2.0,3.0,1.0,3.0,3.0,1.0,2.0,2.0,4.0,6.0,12.0,13.0,12.0,7.0,13.0,12.0,5.0,5.0,9.0,11.0,5.0,12.0,13.0,12.0,13.0,12.0,13.0,9.0,13.0,4.0,11.0,8.0,13.0,7.0,9.0,12.0,14.0,13.0,15.0,16.0,20.0,14.0,13.0,8.0,13.0,15.0,12.0,11.0,11.0,7.0,5.0,14.0,13.0,14.0,11.0,9.0,9.0,18.0,3.0,21.0,0.0,0.0,0.0,0.0,178.0,68.0,1.0,1.0,1.0,2.0,3.0,2.0,1.0,1.0,1.0,1.0,3.0,10.0,10.0,14.0,12.0,13.0,7.0,11.0,12.0,5.0,5.0,10.0,10.0,4.0,13.0,6.0,12.0,11.0,12.0,11.0,11.0,12.0,11.0,14.0,6.0,14.0,9.0,10.0,13.0,15.0,14.0,12.0,9.0,20.0,12.0,14.0,8.0,13.0,9.0,12.0,6.0,10.0,8.0,11.0,13.0,11.0,10.0,12.0,12.0,9.0,16.0,8.0
5,0,25.0,0.0,0.0,11.0,0.0,189.0,83.0,12.0,12.0,11.0,7.0,13.0,12.0,17.0,17.0,16.0,12.0,13.0,6.0,2.0,1.0,1.0,10.0,10.0,7.0,1.0,1.0,1.0,9.0,5.0,1.0,10.0,8.0,15.0,14.0,14.0,12.0,7.0,13.0,12.0,6.0,9.0,3.0,16.0,17.0,10.0,13.0,16.0,14.0,12.0,8.0,15.0,10.0,20.0,13.0,14.0,14.0,5.0,14.0,4.0,12.0,15.0,15.0,13.0,13.0,17.0,15.0,17.0,4.0,31.0,0.0,0.0,0.0,0.0,171.0,65.0,1.0,3.0,1.0,3.0,2.0,2.0,3.0,1.0,2.0,2.0,3.0,8.0,9.0,11.0,7.0,5.0,6.0,5.0,6.0,7.0,14.0,14.0,6.0,14.0,13.0,14.0,12.0,13.0,12.0,11.0,11.0,12.0,12.0,11.0,7.0,12.0,12.0,12.0,10.0,15.0,15.0,7.0,9.0,9.0,12.0,14.0,20.0,12.0,13.0,11.0,13.0,11.0,9.0,10.0,15.0,14.0,12.0,11.0,14.0,13.0,12.0,7.0,29.0,0.0,0.0,0.0,0.0,170.0,65.0,2.0,1.0,3.0,3.0,1.0,3.0,2.0,1.0,2.0,3.0,2.0,5.0,11.0,4.0,6.0,7.0,4.0,7.0,5.0,6.0,6.0,6.0,2.0,6.0,7.0,9.0,10.0,13.0,8.0,12.0,8.0,13.0,15.0,2.0,7.0,5.0,9.0,8.0,8.0,12.0,12.0,14.0,4.0,9.0,12.0,11.0,20.0,12.0,5.0,9.0,9.0,9.0,9.0,9.0,10.0,12.0,12.0,12.0,12.0,7.0,5.0,8.0,24.0,9.0,0.0,7.0,1.0,190.0,82.0,2.0,2.0,3.0,3.0,1.0,2.0,2.0,1.0,1.0,3.0,1.0,8.0,14.0,13.0,11.0,12.0,10.0,12.0,11.0,9.0,11.0,13.0,8.0,13.0,13.0,10.0,14.0,14.0,13.0,13.0,14.0,14.0,16.0,11.0,6.0,12.0,12.0,16.0,16.0,12.0,11.0,11.0,14.0,8.0,14.0,14.0,20.0,15.0,13.0,14.0,9.0,13.0,8.0,14.0,13.0,14.0,12.0,14.0,16.0,12.0,15.0,2.0,23.0,2.0,0.0,5.0,3.0,182.0,73.0,3.0,1.0,1.0,1.0,2.0,1.0,2.0,1.0,3.0,4.0,2.0,12.0,14.0,14.0,10.0,13.0,12.0,16.0,11.0,13.0,12.0,13.0,13.0,14.0,14.0,12.0,11.0,14.0,13.0,11.0,13.0,11.0,15.0,15.0,9.0,15.0,10.0,14.0,15.0,16.0,15.0,13.0,13.0,20.0,14.0,15.0,6.0,15.0,12.0,13.0,9.0,13.0,14.0,15.0,17.0,15.0,13.0,12.0,12.0,15.0,13.0,9.0,33.0,30.0,1.0,0.0,0.0,187.0,83.0,1.0,3.0,4.0,2.0,1.0,1.0,2.0,3.0,1.0,1.0,3.0,13.0,13.0,12.0,8.0,16.0,10.0,16.0,13.0,10.0,14.0,16.0,13.0,16.0,15.0,13.0,15.0,14.0,16.0,15.0,14.0,14.0,13.0,11.0,13.0,10.0,17.0,18.0,10.0,10.0,12.0,17.0,14.0,20.0,12.0,12.0,10.0,13.0,16.0,16.0,16.0,15.0,13.0,11.0,16.0,16.0,13.0,15.0,12.0,8.0,8.0,11.0,29.0,51.0,8.0,24.0,0.0,175.0,70.0,3.0,4.0,2.0,3.0,2.0,3.0,2.0,2.0,2.0,1.0,3.0,6.0,12.0,12.0,10.0,13.0,7.0,12.0,12.0,8.0,14.0,13.0,9.0,16.0,13.0,14.0,16.0,16.0,15.0,16.0,11.0,14.0,16.0,8.0,14.0,14.0,15.0,18.0,18.0,15.0,14.0,16.0,8.0,20.0,16.0,14.0,8.0,18.0,14.0,16.0,13.0,14.0,7.0,14.0,15.0,14.0,14.0,14.0,16.0,16.0,16.0,5.0,23.0,15.0,1.0,7.0,0.0,165.0,60.0,2.0,3.0,2.0,1.0,1.0,1.0,3.0,3.0,2.0,1.0,3.0,14.0,14.0,16.0,8.0,16.0,13.0,6.0,10.0,6.0,11.0,18.0,15.0,12.0,18.0,16.0,15.0,15.0,17.0,13.0,17.0,15.0,14.0,18.0,12.0,10.0,12.0,15.0,16.0,14.0,16.0,16.0,6.0,12.0,13.0,14.0,20.0,15.0,11.0,16.0,14.0,15.0,10.0,12.0,14.0,15.0,16.0,14.0,14.0,13.0,10.0,6.0,18.0,0.0,0.0,0.0,0.0,178.0,68.0,1.0,2.0,1.0,3.0,2.0,1.0,1.0,2.0,2.0,1.0,3.0,12.0,10.0,12.0,6.0,13.0,13.0,8.0,8.0,5.0,8.0,14.0,3.0,9.0,14.0,13.0,11.0,12.0,12.0,11.0,13.0,12.0,12.0,12.0,6.0,12.0,8.0,13.0,13.0,15.0,13.0,12.0,8.0,10.0,13.0,14.0,20.0,12.0,8.0,12.0,12.0,12.0,7.0,12.0,10.0,13.0,12.0,12.0,12.0,11.0,13.0,7.0,16.0,0.0,0.0,0.0,0.0,173.0,0.0,3.0,1.0,1.0,1.0,2.0,1.0,4.0,1.0,2.0,3.0,1.0,1.0,1.0,4.0,4.0,5.0,4.0,4.0,4.0,1.0,5.0,6.0,5.0,8.0,9.0,10.0,6.0,6.0,3.0,5.0,4.0,10.0,7.0,8.0,8.0,3.0,11.0,13.0,9.0,7.0,5.0,14.0,4.0,20.0,6.0,5.0,8.0,6.0,9.0,5.0,7.0,8.0,5.0,7.0,6.0,11.0,7.0,10.0,18.0,19.0,15.0,9.0,29.0,76.0,27.0,13.0,9.0,188.0,72.0,2.0,3.0,1.0,2.0,3.0,3.0,1.0,3.0,3.0,3.0,3.0,5.0,10.0,13.0,16.0,13.0,11.0,17.0,13.0,5.0,10.0,13.0,14.0,10.0,13.0,15.0,16.0,18.0,14.0,15.0,10.0,13.0,14.0,13.0,10.0,18.0,12.0,14.0,19.0,15.0,14.0,16.0,14.0,10.0,18.0,16.0,20.0,18.0,14.0,14.0,8.0,15.0,5.0,16.0,10.0,16.0,12.0,14.0,16.0,14.0,10.0,10.0,27.0,0.0,0.0,0.0,0.0,184.0,77.0,10.0,12.0,13.0,6.0,15.0,12.0,13.0,15.0,13.0,12.0,11.0,8.0,3.0,3.0,1.0,5.0,10.0,2.0,1.0,2.0,3.0,8.0,4.0,2.0,9.0,8.0,13.0,13.0,13.0,12.0,6.0,12.0,14.0,5.0,10.0,3.0,12.0,12.0,10.0,6.0,14.0,13.0,12.0,8.0,15.0,11.0,20.0,11.0,12.0,14.0,8.0,12.0,7.0,1.0,11.0,13.0,15.0,13.0,14.0,14.0,14.0,6.0,28.0,0.0,0.0,0.0,0.0,184.0,85.0,2.0,3.0,2.0,1.0,1.0,3.0,2.0,2.0,3.0,1.0,3.0,4.0,8.0,8.0,6.0,12.0,6.0,14.0,8.0,5.0,13.0,12.0,6.0,14.0,12.0,11.0,13.0,14.0,13.0,12.0,11.0,11.0,13.0,7.0,14.0,10.0,15.0,16.0,12.0,12.0,11.0,15.0,12.0,20.0,13.0,11.0,7.0,14.0,16.0,13.0,11.0,13.0,13.0,12.0,15.0,13.0,13.0,14.0,15.0,14.0,14.0,6.0,32.0,1.0,0.0,5.0,0.0,189.0,93.0,1.0,1.0,3.0,4.0,2.0,2.0,3.0,2.0,3.0,3.0,3.0,3.0,8.0,8.0,7.0,9.0,8.0,16.0,8.0,7.0,14.0,10.0,9.0,14.0,9.0,15.0,14.0,16.0,12.0,10.0,10.0,12.0,14.0,9.0,9.0,7.0,13.0,14.0,15.0,9.0,8.0,10.0,14.0,8.0,16.0,11.0,20.0,14.0,19.0,12.0,14.0,12.0,8.0,6.0,13.0,16.0,14.0,11.0,15.0,14.0,12.0,10.0,26.0,11.0,0.0,4.0,0.0,183.0,79.0,3.0,2.0,1.0,2.0,2.0,2.0,3.0,2.0,2.0,2.0,1.0,5.0,7.0,9.0,6.0,10.0,11.0,15.0,11.0,7.0,14.0,10.0,7.0,13.0,10.0,14.0,13.0,15.0,13.0,12.0,10.0,12.0,17.0,8.0,11.0,10.0,13.0,15.0,16.0,13.0,13.0,16.0,13.0,5.0,15.0,13.0,20.0,16.0,15.0,13.0,14.0,15.0,7.0,14.0,16.0,12.0,14.0,14.0,15.0,14.0,14.0,5.0,26.0,0.0,0.0,0.0,0.0,177.0,68.0,4.0,2.0,1.0,2.0,3.0,1.0,1.0,2.0,3.0,3.0,3.0,12.0,13.0,11.0,8.0,13.0,11.0,8.0,10.0,8.0,10.0,13.0,10.0,12.0,13.0,7.0,12.0,10.0,13.0,11.0,15.0,13.0,14.0,11.0,7.0,14.0,10.0,14.0,14.0,13.0,15.0,12.0,9.0,20.0,15.0,14.0,5.0,15.0,8.0,13.0,7.0,14.0,6.0,12.0,11.0,12.0,14.0,13.0,16.0,16.0,16.0,5.0,21.0,0.0,0.0,0.0,0.0,174.0,68.0,1.0,3.0,1.0,3.0,1.0,1.0,2.0,1.0,3.0,1.0,2.0,6.0,9.0,11.0,7.0,11.0,8.0,10.0,9.0,8.0,10.0,12.0,6.0,12.0,12.0,14.0,12.0,12.0,5.0,9.0,11.0,12.0,11.0,12.0,5.0,11.0,5.0,10.0,12.0,14.0,14.0,13.0,7.0,5.0,13.0,14.0,20.0,13.0,13.0,10.0,3.0,6.0,10.0,10.0,7.0,11.0,12.0,13.0,9.0,13.0,17.0,5.0,31.0,0.0,0.0,4.0,0.0,174.0,72.0,2.0,1.0,4.0,2.0,2.0,3.0,1.0,1.0,3.0,3.0,4.0,12.0,9.0,11.0,6.0,14.0,11.0,7.0,10.0,6.0,8.0,16.0,12.0,9.0,14.0,9.0,14.0,10.0,13.0,12.0,12.0,11.0,14.0,8.0,8.0,11.0,12.0,14.0,12.0,13.0,14.0,12.0,7.0,12.0,14.0,12.0,20.0,15.0,11.0,11.0,9.0,12.0,8.0,10.0,10.0,14.0,13.0,10.0,12.0,14.0,14.0,9.0,30.0,7.0,0.0,0.0,0.0,181.0,72.0,1.0,3.0,3.0,1.0,2.0,3.0,2.0,1.0,3.0,2.0,2.0,12.0,11.0,14.0,8.0,14.0,12.0,8.0,12.0,6.0,5.0,13.0,13.0,5.0,14.0,8.0,12.0,10.0,11.0,12.0,15.0,11.0,13.0,14.0,9.0,13.0,10.0,12.0,13.0,12.0,14.0,12.0,10.0,12.0,15.0,13.0,20.0,15.0,9.0,10.0,8.0,13.0,5.0,8.0,12.0,14.0,14.0,12.0,11.0,14.0,14.0,8.0,30.0,0.0,0.0,11.0,4.0,172.0,69.0,4.0,2.0,2.0,3.0,3.0,3.0,3.0,3.0,4.0,4.0,3.0,13.0,13.0,13.0,11.0,13.0,13.0,7.0,12.0,9.0,4.0,13.0,12.0,4.0,15.0,7.0,12.0,10.0,12.0,12.0,15.0,12.0,13.0,17.0,8.0,14.0,7.0,12.0,12.0,14.0,15.0,12.0,6.0,20.0,10.0,14.0,10.0,13.0,7.0,12.0,6.0,12.0,15.0,13.0,10.0,11.0,13.0,12.0,11.0,14.0,14.0,6.0,27.0,33.0,4.0,3.0,0.0,180.0,75.0,2.0,1.0,2.0,1.0,4.0,2.0,1.0,3.0,1.0,1.0,2.0,12.0,11.0,13.0,13.0,11.0,11.0,11.0,10.0,7.0,5.0,10.0,14.0,5.0,14.0,9.0,11.0,12.0,10.0,11.0,12.0,12.0,14.0,13.0,8.0,14.0,8.0,11.0,14.0,16.0,14.0,13.0,10.0,7.0,12.0,15.0,20.0,14.0,12.0,12.0,9.0,13.0,10.0,10.0,9.0,15.0,8.0,9.0,13.0,14.0,14.0,7.0,24.0,24.0,4.0,0.0,0.0,172.0,74.0,2.0,4.0,3.0,2.0,2.0,1.0,2.0,2.0,3.0,2.0,4.0,8.0,9.0,14.0,13.0,14.0,9.0,11.0,10.0,7.0,5.0,12.0,12.0,3.0,13.0,10.0,12.0,12.0,13.0,12.0,11.0,10.0,14.0,13.0,7.0,14.0,9.0,9.0,13.0,16.0,15.0,13.0,6.0,8.0,13.0,16.0,20.0,14.0,12.0,11.0,11.0,13.0,9.0,8.0,9.0,13.0,9.0,11.0,12.0,13.0,10.0,9.0
2,1,31.0,25.0,0.0,6.0,0.0,191.0,84.0,11.0,14.0,13.0,12.0,15.0,14.0,15.0,16.0,13.0,14.0,14.0,8.0,2.0,10.0,5.0,11.0,11.0,7.0,10.0,2.0,5.0,10.0,11.0,11.0,9.0,12.0,13.0,15.0,13.0,13.0,8.0,13.0,16.0,12.0,14.0,1.0,16.0,13.0,11.0,12.0,13.0,16.0,16.0,8.0,16.0,13.0,20.0,15.0,15.0,17.0,8.0,15.0,7.0,2.0,15.0,15.0,17.0,15.0,17.0,16.0,15.0,6.0,28.0,46.0,3.0,14.0,3.0,190.0,80.0,2.0,3.0,3.0,2.0,2.0,1.0,1.0,3.0,1.0,3.0,1.0,4.0,6.0,7.0,9.0,11.0,7.0,17.0,11.0,10.0,15.0,12.0,11.0,16.0,10.0,17.0,15.0,18.0,13.0,14.0,12.0,14.0,18.0,6.0,17.0,8.0,15.0,15.0,14.0,11.0,10.0,17.0,16.0,7.0,17.0,13.0,20.0,15.0,18.0,17.0,14.0,16.0,4.0,6.0,14.0,15.0,16.0,17.0,18.0,14.0,15.0,6.0,23.0,0.0,0.0,0.0,0.0,184.0,77.0,1.0,1.0,1.0,1.0,3.0,2.0,3.0,2.0,2.0,2.0,3.0,6.0,9.0,11.0,7.0,12.0,7.0,15.0,9.0,11.0,14.0,13.0,10.0,15.0,12.0,14.0,15.0,15.0,13.0,12.0,11.0,13.0,15.0,11.0,9.0,9.0,14.0,14.0,14.0,14.0,13.0,15.0,13.0,9.0,16.0,15.0,20.0,14.0,14.0,14.0,11.0,14.0,4.0,11.0,14.0,13.0,15.0,14.0,16.0,14.0,15.0,6.0,23.0,0.0,0.0,1.0,0.0,182.0,71.0,3.0,1.0,2.0,3.0,4.0,2.0,3.0,1.0,2.0,1.0,3.0,9.0,13.0,14.0,8.0,14.0,13.0,12.0,10.0,13.0,14.0,14.0,13.0,15.0,13.0,14.0,14.0,13.0,11.0,12.0,12.0,13.0,16.0,12.0,12.0,15.0,13.0,14.0,15.0,15.0,13.0,14.0,12.0,9.0,16.0,15.0,20.0,15.0,15.0,15.0,10.0,14.0,6.0,12.0,8.0,15.0,14.0,16.0,15.0,15.0,16.0,6.0,20.0,0.0,0.0,0.0,0.0,184.0,80.0,1.0,4.0,4.0,1.0,3.0,1.0,4.0,3.0,3.0,3.0,2.0,7.0,14.0,13.0,8.0,12.0,7.0,16.0,7.0,12.0,13.0,13.0,11.0,12.0,13.0,12.0,13.0,14.0,13.0,12.0,12.0,12.0,15.0,12.0,10.0,14.0,13.0,14.0,13.0,14.0,12.0,14.0,12.0,6.0,13.0,14.0,20.0,13.0,14.0,14.0,8.0,15.0,10.0,13.0,9.0,16.0,15.0,14.0,16.0,16.0,17.0,5.0,21.0,0.0,0.0,9.0,0.0,184.0,72.0,1.0,3.0,1.0,2.0,3.0,2.0,1.0,1.0,2.0,1.0,2.0,6.0,10.0,12.0,7.0,12.0,7.0,14.0,11.0,7.0,14.0,13.0,10.0,13.0,12.0,14.0,13.0,14.0,12.0,12.0,12.0,12.0,16.0,11.0,10.0,12.0,13.0,14.0,15.0,14.0,13.0,16.0,12.0,12.0,14.0,15.0,20.0,15.0,17.0,14.0,12.0,15.0,9.0,9.0,10.0,16.0,14.0,15.0,14.0,14.0,14.0,8.0,29.0,90.0,4.0,16.0,2.0,170.0,61.0,2.0,3.0,3.0,1.0,3.0,1.0,2.0,2.0,2.0,2.0,1.0,15.0,14.0,15.0,9.0,17.0,16.0,7.0,12.0,4.0,11.0,18.0,15.0,12.0,17.0,15.0,15.0,16.0,13.0,16.0,17.0,14.0,16.0,15.0,14.0,12.0,14.0,18.0,16.0,13.0,14.0,12.0,8.0,10.0,14.0,11.0,20.0,14.0,10.0,14.0,9.0,17.0,10.0,14.0,13.0,17.0,15.0,16.0,17.0,15.0,16.0,7.0,21.0,7.0,0.0,14.0,6.0,173.0,64.0,3.0,2.0,3.0,2.0,3.0,3.0,3.0,2.0,3.0,3.0,3.0,14.0,14.0,18.0,14.0,17.0,14.0,7.0,11.0,2.0,6.0,15.0,14.0,6.0,18.0,12.0,14.0,14.0,15.0,13.0,16.0,14.0,17.0,17.0,12.0,13.0,9.0,13.0,17.0,15.0,17.0,13.0,7.0,20.0,14.0,14.0,9.0,14.0,9.0,15.0,7.0,16.0,7.0,14.0,15.0,17.0,15.0,16.0,17.0,16.0,15.0,4.0,20.0,0.0,0.0,7.0,1.0,170.0,58.0,1.0,2.0,2.0,2.0,2.0,2.0,2.0,4.0,1.0,3.0,2.0,16.0,14.0,16.0,13.0,16.0,17.0,5.0,14.0,2.0,6.0,15.0,13.0,4.0,17.0,9.0,12.0,14.0,12.0,12.0,14.0,13.0,15.0,16.0,7.0,13.0,9.0,13.0,15.0,15.0,16.0,11.0,7.0,20.0,14.0,15.0,8.0,14.0,8.0,15.0,5.0,15.0,7.0,16.0,15.0,15.0,15.0,14.0,16.0,18.0,16.0,3.0,30.0,62.0,25.0,13.0,8.0,177.0,72.0,1.0,3.0,3.0,1.0,3.0,2.0,1.0,3.0,1.0,4.0,1.0,8.0,11.0,12.0,17.0,14.0,12.0,18.0,14.0,3.0,4.0,13.0,18.0,5.0,16.0,14.0,15.0,16.0,17.0,13.0,14.0,16.0,16.0,16.0,16.0,16.0,6.0,13.0,13.0,13.0,14.0,13.0,11.0,14.0,13.0,12.0,20.0,12.0,12.0,15.0,8.0,19.0,10.0,6.0,13.0,18.0,14.0,19.0,15.0,16.0,17.0,10.0,17.0,0.0,0.0,0.0,0.0,178.0,68.0,2.0,1.0,2.0,1.0,3.0,3.0,3.0,1.0,3.0,3.0,2.0,10.0,11.0,15.0,12.0,13.0,10.0,8.0,9.0,2.0,3.0,12.0,12.0,3.0,16.0,11.0,9.0,11.0,12.0,9.0,12.0,10.0,17.0,17.0,9.0,13.0,5.0,9.0,13.0,15.0,14.0,11.0,9.0,8.0,14.0,14.0,20.0,12.0,9.0,14.0,7.0,15.0,7.0,13.0,13.0,19.0,12.0,16.0,15.0,14.0,14.0,7.0,27.0,0.0,0.0,2.0,0.0,188.0,81.0,9.0,10.0,8.0,6.0,13.0,8.0,14.0,15.0,12.0,12.0,10.0,4.0,3.0,2.0,2.0,8.0,8.0,2.0,2.0,1.0,3.0,8.0,3.0,1.0,8.0,8.0,12.0,13.0,12.0,12.0,8.0,11.0,15.0,6.0,9.0,1.0,12.0,11.0,9.0,13.0,14.0,15.0,14.0,5.0,15.0,11.0,20.0,13.0,15.0,12.0,8.0,15.0,5.0,1.0,19.0,13.0,10.0,15.0,14.0,14.0,14.0,6.0,34.0,23.0,1.0,0.0,0.0,186.0,81.0,3.0,3.0,1.0,2.0,1.0,3.0,2.0,3.0,1.0,3.0,3.0,4.0,8.0,6.0,10.0,7.0,8.0,17.0,12.0,10.0,14.0,7.0,9.0,15.0,7.0,15.0,13.0,17.0,8.0,12.0,7.0,12.0,15.0,6.0,17.0,7.0,14.0,15.0,14.0,8.0,10.0,16.0,13.0,12.0,13.0,9.0,20.0,13.0,15.0,11.0,15.0,14.0,9.0,10.0,10.0,14.0,11.0,13.0,15.0,11.0,11.0,12.0,28.0,0.0,0.0,0.0,0.0,183.0,81.0,1.0,2.0,4.0,1.0,1.0,3.0,2.0,3.0,3.0,3.0,1.0,5.0,5.0,6.0,10.0,12.0,6.0,14.0,8.0,6.0,15.0,11.0,6.0,13.0,12.0,13.0,14.0,16.0,14.0,14.0,10.0,12.0,14.0,5.0,14.0,8.0,14.0,15.0,15.0,9.0,12.0,15.0,13.0,7.0,11.0,12.0,20.0,15.0,15.0,14.0,14.0,14.0,9.0,8.0,14.0,14.0,11.0,13.0,15.0,13.0,15.0,6.0,21.0,0.0,0.0,1.0,0.0,177.0,68.0,4.0,1.0,2.0,1.0,1.0,1.0,1.0,1.0,2.0,1.0,2.0,5.0,12.0,9.0,7.0,12.0,8.0,13.0,10.0,16.0,13.0,12.0,8.0,14.0,12.0,12.0,13.0,12.0,12.0,12.0,10.0,13.0,15.0,11.0,13.0,11.0,13.0,13.0,14.0,13.0,14.0,13.0,11.0,10.0,14.0,12.0,20.0,12.0,14.0,12.0,11.0,12.0,8.0,14.0,13.0,10.0,14.0,12.0,14.0,12.0,11.0,5.0,27.0,14.0,1.0,0.0,0.0,183.0,77.0,1.0,2.0,1.0,2.0,3.0,2.0,3.0,2.0,2.0,1.0,1.0,5.0,12.0,9.0,8.0,13.0,10.0,13.0,10.0,6.0,14.0,13.0,6.0,13.0,12.0,14.0,13.0,15.0,11.0,11.0,11.0,11.0,13.0,9.0,8.0,9.0,12.0,14.0,16.0,14.0,12.0,14.0,12.0,7.0,14.0,12.0,20.0,15.0,14.0,14.0,14.0,15.0,7.0,10.0,12.0,13.0,14.0,12.0,13.0,11.0,11.0,7.0,30.0,0.0,0.0,0.0,0.0,167.0,60.0,3.0,1.0,1.0,2.0,3.0,1.0,1.0,3.0,1.0,1.0,3.0,10.0,11.0,12.0,8.0,13.0,10.0,6.0,9.0,10.0,12.0,14.0,9.0,10.0,14.0,11.0,14.0,14.0,14.0,14.0,13.0,14.0,12.0,14.0,11.0,13.0,12.0,15.0,15.0,15.0,14.0,11.0,5.0,11.0,11.0,15.0,20.0,11.0,8.0,14.0,10.0,12.0,13.0,11.0,11.0,12.0,11.0,10.0,12.0,11.0,11.0,2.0,33.0,0.0,0.0,0.0,0.0,187.0,76.0,2.0,2.0,3.0,1.0,1.0,3.0,2.0,1.0,2.0,3.0,2.0,15.0,14.0,14.0,10.0,15.0,13.0,10.0,12.0,7.0,4.0,15.0,13.0,7.0,15.0,6.0,12.0,9.0,14.0,11.0,15.0,12.0,12.0,14.0,12.0,13.0,7.0,13.0,12.0,11.0,12.0,14.0,12.0,14.0,15.0,12.0,20.0,11.0,12.0,12.0,6.0,14.0,6.0,11.0,14.0,13.0,12.0,12.0,15.0,15.0,13.0,9.0,30.0,0.0,0.0,0.0,0.0,178.0,73.0,3.0,4.0,1.0,1.0,2.0,4.0,3.0,2.0,2.0,2.0,3.0,13.0,14.0,12.0,7.0,13.0,12.0,7.0,13.0,5.0,10.0,13.0,9.0,10.0,13.0,11.0,11.0,12.0,12.0,13.0,11.0,14.0,14.0,11.0,7.0,11.0,10.0,13.0,15.0,13.0,15.0,15.0,8.0,20.0,14.0,14.0,8.0,14.0,11.0,13.0,11.0,14.0,8.0,10.0,19.0,12.0,12.0,9.0,12.0,12.0,10.0,10.0,27.0,0.0,0.0,0.0,0.0,190.0,87.0,1.0,3.0,2.0,3.0,1.0,3.0,1.0,1.0,2.0,3.0,2.0,5.0,7.0,9.0,14.0,14.0,10.0,14.0,13.0,5.0,6.0,12.0,12.0,8.0,14.0,14.0,13.0,16.0,14.0,11.0,10.0,13.0,15.0,10.0,11.0,14.0,9.0,15.0,14.0,10.0,11.0,16.0,15.0,9.0,12.0,12.0,20.0,14.0,16.0,13.0,13.0,12.0,7.0,5.0,10.0,12.0,14.0,12.0,14.0,14.0,19.0,12.0,26.0,0.0,0.0,0.0,0.0,193.0,81.0,1.0,3.0,3.0,3.0,3.0,1.0,2.0,2.0,2.0,3.0,3.0,4.0,9.0,14.0,10.0,13.0,12.0,14.0,14.0,5.0,5.0,10.0,12.0,3.0,14.0,8.0,13.0,12.0,9.0,10.0,11.0,11.0,12.0,16.0,5.0,14.0,6.0,9.0,12.0,14.0,13.0,14.0,16.0,14.0,13.0,13.0,20.0,13.0,14.0,10.0,8.0,14.0,9.0,8.0,16.0,16.0,11.0,13.0,11.0,13.0,13.0,10.0,17.0,0.0,0.0,0.0,0.0,181.0,68.0,1.0,2.0,1.0,1.0,2.0,2.0,3.0,3.0,3.0,2.0,1.0,8.0,11.0,14.0,11.0,13.0,8.0,11.0,9.0,5.0,3.0,11.0,5.0,5.0,14.0,5.0,11.0,6.0,10.0,10.0,11.0,12.0,14.0,13.0,6.0,13.0,9.0,10.0,8.0,14.0,14.0,14.0,10.0,5.0,12.0,14.0,20.0,12.0,11.0,10.0,6.0,5.0,10.0,12.0,20.0,12.0,11.0,12.0,12.0,11.0,14.0,5.0
2,2,25.0,0.0,0.0,0.0,0.0,186.0,82.0,13.0,16.0,11.0,7.0,13.0,12.0,10.0,13.0,11.0,9.0,13.0,7.0,2.0,2.0,3.0,8.0,9.0,2.0,1.0,3.0,1.0,8.0,2.0,1.0,8.0,10.0,11.0,13.0,12.0,11.0,9.0,11.0,6.0,2.0,9.0,1.0,12.0,11.0,7.0,11.0,12.0,14.0,12.0,5.0,13.0,9.0,20.0,11.0,14.0,10.0,10.0,15.0,12.0,1.0,7.0,10.0,11.0,11.0,11.0,12.0,13.0,6.0,24.0,0.0,0.0,0.0,0.0,184.0,89.0,2.0,3.0,3.0,2.0,2.0,3.0,3.0,1.0,2.0,3.0,2.0,4.0,10.0,8.0,6.0,11.0,9.0,14.0,9.0,7.0,14.0,11.0,6.0,11.0,11.0,13.0,12.0,16.0,11.0,13.0,10.0,11.0,14.0,6.0,8.0,7.0,12.0,13.0,14.0,14.0,12.0,16.0,12.0,20.0,14.0,13.0,6.0,14.0,16.0,14.0,13.0,13.0,7.0,8.0,7.0,14.0,13.0,12.0,14.0,14.0,14.0,6.0,27.0,0.0,0.0,0.0,0.0,181.0,79.0,3.0,1.0,3.0,1.0,3.0,1.0,1.0,2.0,3.0,3.0,3.0,5.0,12.0,10.0,5.0,10.0,6.0,11.0,7.0,8.0,12.0,9.0,7.0,12.0,11.0,13.0,13.0,14.0,13.0,12.0,9.0,9.0,13.0,9.0,7.0,8.0,13.0,13.0,13.0,15.0,12.0,13.0,10.0,5.0,13.0,13.0,20.0,15.0,14.0,15.0,13.0,7.0,6.0,10.0,8.0,13.0,13.0,13.0,14.0,14.0,14.0,5.0,28.0,0.0,0.0,0.0,0.0,194.0,93.0,2.0,3.0,2.0,1.0,4.0,2.0,2.0,1.0,2.0,2.0,3.0,4.0,5.0,11.0,7.0,12.0,12.0,14.0,12.0,7.0,12.0,10.0,7.0,14.0,9.0,12.0,11.0,16.0,12.0,12.0,11.0,10.0,12.0,7.0,14.0,7.0,12.0,15.0,13.0,8.0,9.0,17.0,16.0,20.0,11.0,9.0,6.0,14.0,17.0,10.0,10.0,10.0,8.0,8.0,17.0,12.0,14.0,12.0,13.0,1.0,5.0,8.0,32.0,23.0,0.0,0.0,0.0,178.0,77.0,3.0,2.0,3.0,1.0,3.0,1.0,3.0,2.0,1.0,3.0,1.0,9.0,12.0,12.0,6.0,13.0,12.0,10.0,10.0,10.0,13.0,12.0,7.0,14.0,13.0,15.0,14.0,13.0,13.0,10.0,10.0,12.0,5.0,12.0,11.0,12.0,13.0,14.0,14.0,14.0,13.0,12.0,9.0,20.0,14.0,14.0,10.0,13.0,12.0,13.0,6.0,14.0,6.0,10.0,13.0,5.0,11.0,8.0,10.0,14.0,9.0,15.0,27.0,27.0,1.0,2.0,1.0,183.0,72.0,2.0,2.0,2.0,1.0,2.0,1.0,3.0,1.0,2.0,2.0,4.0,5.0,8.0,10.0,6.0,11.0,10.0,14.0,11.0,5.0,14.0,12.0,10.0,15.0,11.0,14.0,13.0,16.0,11.0,11.0,9.0,10.0,12.0,8.0,12.0,8.0,13.0,14.0,14.0,14.0,12.0,16.0,11.0,8.0,12.0,13.0,20.0,15.0,15.0,10.0,14.0,11.0,7.0,11.0,13.0,13.0,9.0,9.0,11.0,10.0,10.0,8.0,23.0,5.0,0.0,0.0,0.0,180.0,75.0,1.0,1.0,2.0,3.0,3.0,1.0,2.0,2.0,3.0,1.0,3.0,5.0,9.0,12.0,7.0,14.0,8.0,12.0,11.0,6.0,11.0,12.0,12.0,11.0,11.0,12.0,13.0,13.0,11.0,10.0,13.0,11.0,14.0,11.0,7.0,11.0,12.0,14.0,13.0,15.0,13.0,14.0,10.0,7.0,14.0,14.0,20.0,13.0,14.0,12.0,11.0,12.0,12.0,15.0,10.0,14.0,13.0,12.0,14.0,14.0,14.0,6.0,31.0,0.0,0.0,0.0,0.0,180.0,74.0,3.0,2.0,3.0,1.0,2.0,3.0,2.0,1.0,4.0,3.0,3.0,12.0,12.0,10.0,9.0,13.0,14.0,11.0,13.0,6.0,10.0,14.0,15.0,13.0,13.0,15.0,14.0,17.0,12.0,14.0,13.0,13.0,15.0,7.0,13.0,10.0,13.0,18.0,15.0,9.0,11.0,14.0,10.0,10.0,13.0,12.0,20.0,15.0,14.0,14.0,13.0,15.0,8.0,7.0,19.0,13.0,13.0,13.0,13.0,13.0,12.0,9.0,21.0,0.0,0.0,0.0,0.0,181.0,73.0,2.0,3.0,2.0,2.0,1.0,2.0,1.0,2.0,1.0,3.0,1.0,6.0,9.0,12.0,11.0,11.0,8.0,9.0,11.0,6.0,4.0,9.0,12.0,3.0,13.0,10.0,11.0,12.0,11.0,9.0,9.0,9.0,14.0,13.0,6.0,13.0,6.0,10.0,12.0,15.0,14.0,13.0,10.0,8.0,12.0,14.0,20.0,11.0,12.0,12.0,10.0,14.0,10.0,8.0,16.0,13.0,13.0,14.0,12.0,15.0,15.0,8.0,18.0,0.0,0.0,4.0,0.0,188.0,81.0,3.0,3.0,1.0,3.0,1.0,4.0,1.0,2.0,1.0,3.0,4.0,6.0,8.0,13.0,10.0,10.0,10.0,8.0,12.0,6.0,6.0,10.0,14.0,6.0,9.0,10.0,7.0,14.0,9.0,9.0,11.0,11.0,10.0,8.0,11.0,8.0,4.0,11.0,13.0,12.0,13.0,14.0,13.0,8.0,14.0,14.0,20.0,12.0,13.0,10.0,10.0,7.0,6.0,10.0,17.0,10.0,9.0,9.0,13.0,10.0,11.0,6.0,22.0,0.0,0.0,0.0,0.0,183.0,78.0,4.0,3.0,1.0,1.0,3.0,1.0,2.0,1.0,3.0,1.0,2.0,10.0,10.0,11.0,14.0,11.0,7.0,12.0,9.0,7.0,7.0,9.0,13.0,7.0,11.0,13.0,10.0,13.0,11.0,12.0,9.0,11.0,15.0,12.0,6.0,14.0,9.0,9.0,12.0,11.0,11.0,13.0,11.0,8.0,10.0,12.0,20.0,11.0,12.0,13.0,6.0,12.0,8.0,5.0,15.0,14.0,13.0,14.0,10.0,14.0,16.0,7.0,26.0,2.0,0.0,1.0,0.0,188.0,84.0,12.0,13.0,15.0,9.0,15.0,13.0,13.0,15.0,10.0,11.0,14.0,9.0,2.0,1.0,2.0,12.0,11.0,3.0,2.0,3.0,3.0,11.0,3.0,1.0,10.0,14.0,13.0,14.0,10.0,13.0,11.0,11.0,14.0,3.0,11.0,5.0,12.0,15.0,13.0,10.0,12.0,13.0,14.0,5.0,14.0,9.0,20.0,12.0,14.0,12.0,10.0,15.0,3.0,11.0,12.0,11.0,16.0,13.0,15.0,16.0,16.0,4.0,29.0,17.0,1.0,4.0,0.0,183.0,72.0,2.0,2.0,1.0,2.0,4.0,3.0,3.0,2.0,1.0,1.0,2.0,4.0,9.0,6.0,6.0,8.0,5.0,15.0,7.0,10.0,15.0,8.0,6.0,14.0,8.0,13.0,13.0,16.0,11.0,13.0,9.0,11.0,13.0,9.0,8.0,8.0,12.0,15.0,14.0,11.0,12.0,14.0,12.0,10.0,13.0,14.0,20.0,15.0,14.0,14.0,13.0,13.0,8.0,12.0,14.0,12.0,13.0,13.0,14.0,11.0,11.0,7.0,29.0,0.0,0.0,0.0,0.0,183.0,74.0,3.0,3.0,3.0,3.0,3.0,2.0,2.0,2.0,1.0,3.0,1.0,5.0,12.0,7.0,6.0,10.0,7.0,14.0,12.0,5.0,14.0,12.0,6.0,13.0,11.0,14.0,13.0,17.0,13.0,16.0,12.0,12.0,13.0,9.0,8.0,9.0,14.0,14.0,15.0,13.0,12.0,15.0,12.0,6.0,17.0,11.0,20.0,17.0,13.0,14.0,14.0,15.0,5.0,13.0,9.0,14.0,19.0,15.0,14.0,11.0,11.0,6.0,22.0,0.0,0.0,0.0,0.0,178.0,73.0,3.0,2.0,2.0,1.0,2.0,4.0,3.0,1.0,3.0,1.0,2.0,6.0,12.0,12.0,6.0,11.0,7.0,8.0,8.0,11.0,12.0,10.0,8.0,13.0,11.0,12.0,12.0,13.0,11.0,10.0,11.0,11.0,13.0,6.0,7.0,12.0,9.0,13.0,14.0,16.0,14.0,13.0,9.0,6.0,14.0,15.0,20.0,15.0,14.0,12.0,12.0,13.0,6.0,14.0,12.0,15.0,13.0,13.0,14.0,14.0,14.0,6.0,27.0,0.0,0.0,0.0,0.0,178.0,72.0,2.0,3.0,2.0,3.0,2.0,3.0,3.0,1.0,1.0,2.0,1.0,13.0,14.0,11.0,7.0,12.0,10.0,9.0,10.0,13.0,13.0,12.0,10.0,14.0,13.0,12.0,14.0,14.0,13.0,14.0,11.0,12.0,14.0,13.0,8.0,14.0,13.0,13.0,15.0,15.0,13.0,10.0,10.0,20.0,13.0,15.0,6.0,14.0,10.0,13.0,13.0,12.0,8.0,12.0,15.0,14.0,13.0,14.0,13.0,13.0,12.0,6.0,32.0,0.0,0.0,13.0,0.0,175.0,65.0,2.0,1.0,1.0,2.0,3.0,3.0,1.0,2.0,3.0,2.0,3.0,15.0,13.0,11.0,6.0,14.0,13.0,10.0,12.0,8.0,8.0,16.0,8.0,12.0,13.0,11.0,14.0,15.0,14.0,15.0,14.0,14.0,14.0,6.0,13.0,9.0,15.0,18.0,13.0,12.0,13.0,13.0,8.0,8.0,13.0,10.0,20.0,13.0,13.0,12.0,11.0,15.0,12.0,10.0,17.0,14.0,15.0,14.0,16.0,14.0,14.0,6.0,27.0,0.0,0.0,0.0,0.0,188.0,77.0,1.0,4.0,1.0,1.0,3.0,1.0,2.0,1.0,2.0,2.0,2.0,4.0,7.0,8.0,7.0,13.0,6.0,15.0,9.0,6.0,13.0,12.0,6.0,12.0,11.0,14.0,14.0,15.0,10.0,12.0,11.0,13.0,16.0,7.0,12.0,9.0,12.0,15.0,16.0,14.0,10.0,14.0,15.0,9.0,13.0,12.0,20.0,14.0,16.0,12.0,14.0,13.0,6.0,12.0,4.0,13.0,18.0,13.0,14.0,14.0,13.0,7.0,30.0,4.0,0.0,0.0,0.0,192.0,78.0,1.0,3.0,1.0,2.0,2.0,3.0,1.0,3.0,1.0,1.0,3.0,4.0,6.0,7.0,8.0,11.0,6.0,15.0,8.0,6.0,13.0,11.0,6.0,14.0,11.0,17.0,14.0,16.0,12.0,14.0,10.0,12.0,17.0,8.0,8.0,11.0,13.0,15.0,16.0,14.0,12.0,18.0,14.0,6.0,14.0,12.0,20.0,17.0,16.0,14.0,17.0,13.0,9.0,11.0,8.0,13.0,10.0,13.0,12.0,10.0,10.0,5.0,32.0,0.0,0.0,0.0,0.0,187.0,76.0,1.0,3.0,1.0,2.0,3.0,2.0,3.0,3.0,2.0,1.0,2.0,5.0,8.0,11.0,6.0,12.0,6.0,9.0,8.0,8.0,11.0,12.0,8.0,13.0,14.0,8.0,14.0,12.0,11.0,10.0,10.0,10.0,12.0,14.0,5.0,11.0,8.0,13.0,15.0,11.0,11.0,13.0,13.0,7.0,10.0,13.0,20.0,9.0,11.0,13.0,4.0,12.0,6.0,15.0,17.0,9.0,11.0,11.0,14.0,17.0,16.0,2.0,30.0,5.0,0.0,22.0,9.0,181.0,84.0,2.0,3.0,3.0,1.0,2.0,3.0,3.0,1.0,3.0,1.0,3.0,7.0,10.0,12.0,13.0,11.0,7.0,13.0,10.0,12.0,6.0,11.0,13.0,6.0,13.0,17.0,13.0,16.0,11.0,13.0,11.0,11.0,17.0,14.0,8.0,14.0,9.0,13.0,17.0,15.0,12.0,15.0,11.0,8.0,14.0,15.0,20.0,14.0,14.0,13.0,9.0,13.0,7.0,10.0,7.0,16.0,13.0,14.0,13.0,15.0,15.0,10.0,25.0,0.0,0.0,0.0,0.0,176.0,74.0,2.0,2.0,1.0,3.0,2.0,2.0,2.0,4.0,3.0,3.0,3.0,12.0,12.0,14.0,12.0,14.0,13.0,7.0,12.0,6.0,3.0,12.0,12.0,3.0,15.0,9.0,10.0,8.0,12.0,11.0,12.0,10.0,10.0,14.0,5.0,13.0,4.0,6.0,8.0,17.0,15.0,12.0,8.0,20.0,12.0,14.0,8.0,13.0,12.0,11.0,9.0,14.0,10.0,8.0,8.0,14.0,12.0,7.0,10.0,11.0,11.0,9.0
3,1,25.0,0.0,0.0,0.0,0.0,187.0,83.0,11.0,14.0,12.0,8.0,13.0,11.0,14.0,15.0,13.0,13.0,9.0,8.0,1.0,1.0,1.0,11.0,11.0,1.0,2.0,2.0,1.0,10.0,3.0,2.0,11.0,8.0,12.0,14.0,12.0,12.0,10.0,12.0,14.0,6.0,14.0,2.0,12.0,12.0,8.0,13.0,15.0,14.0,13.0,20.0,15.0,11.0,5.0,14.0,13.0,13.0,8.0,8.0,10.0,1.0,9.0,13.0,14.0,12.0,15.0,15.0,15.0,5.0,28.0,0.0,0.0,0.0,0.0,184.0,85.0,2.0,3.0,2.0,1.0,1.0,3.0,2.0,2.0,3.0,1.0,3.0,4.0,8.0,8.0,6.0,12.0,6.0,14.0,8.0,5.0,13.0,12.0,6.0,14.0,12.0,11.0,13.0,14.0,13.0,12.0,11.0,11.0,13.0,7.0,14.0,10.0,15.0,16.0,12.0,12.0,11.0,15.0,12.0,20.0,13.0,11.0,7.0,14.0,16.0,13.0,11.0,13.0,13.0,12.0,15.0,13.0,13.0,14.0,15.0,14.0,14.0,6.0,32.0,1.0,0.0,5.0,0.0,189.0,93.0,1.0,1.0,3.0,4.0,2.0,2.0,3.0,2.0,3.0,3.0,3.0,3.0,8.0,8.0,7.0,9.0,8.0,16.0,8.0,7.0,14.0,10.0,9.0,14.0,9.0,15.0,14.0,16.0,12.0,10.0,10.0,12.0,14.0,9.0,9.0,7.0,13.0,14.0,15.0,9.0,8.0,10.0,14.0,8.0,16.0,11.0,20.0,14.0,19.0,12.0,14.0,12.0,8.0,6.0,13.0,16.0,14.0,11.0,15.0,14.0,12.0,10.0,25.0,0.0,0.0,3.0,0.0,184.0,80.0,2.0,2.0,4.0,2.0,1.0,3.0,2.0,1.0,1.0,2.0,1.0,5.0,8.0,7.0,6.0,9.0,6.0,14.0,6.0,6.0,14.0,7.0,6.0,13.0,9.0,12.0,14.0,13.0,11.0,13.0,7.0,12.0,14.0,8.0,10.0,7.0,14.0,13.0,14.0,15.0,12.0,14.0,12.0,8.0,15.0,15.0,20.0,14.0,14.0,13.0,12.0,14.0,5.0,10.0,16.0,13.0,15.0,15.0,12.0,14.0,14.0,8.0,26.0,0.0,0.0,0.0,0.0,177.0,68.0,4.0,2.0,1.0,2.0,3.0,1.0,1.0,2.0,3.0,3.0,3.0,12.0,13.0,11.0,8.0,13.0,11.0,8.0,10.0,8.0,10.0,13.0,10.0,12.0,13.0,7.0,12.0,10.0,13.0,11.0,15.0,13.0,14.0,11.0,7.0,14.0,10.0,14.0,14.0,13.0,15.0,12.0,9.0,20.0,15.0,14.0,5.0,15.0,8.0,13.0,7.0,14.0,6.0,12.0,11.0,12.0,14.0,13.0,16.0,16.0,16.0,5.0,21.0,0.0,0.0,4.0,0.0,178.0,72.0,2.0,3.0,1.0,2.0,2.0,3.0,3.0,1.0,2.0,2.0,3.0,6.0,12.0,10.0,7.0,11.0,7.0,9.0,8.0,11.0,12.0,11.0,8.0,13.0,11.0,10.0,12.0,11.0,12.0,13.0,11.0,11.0,13.0,8.0,11.0,12.0,12.0,13.0,14.0,15.0,13.0,13.0,9.0,7.0,14.0,14.0,20.0,14.0,12.0,13.0,10.0,12.0,9.0,14.0,16.0,15.0,8.0,10.0,12.0,16.0,17.0,10.0,31.0,0.0,0.0,4.0,0.0,174.0,72.0,2.0,1.0,4.0,2.0,2.0,3.0,1.0,1.0,3.0,3.0,4.0,12.0,9.0,11.0,6.0,14.0,11.0,7.0,10.0,6.0,8.0,16.0,12.0,9.0,14.0,9.0,14.0,10.0,13.0,12.0,12.0,11.0,14.0,8.0,8.0,11.0,12.0,14.0,12.0,13.0,14.0,12.0,7.0,12.0,14.0,12.0,20.0,15.0,11.0,11.0,9.0,12.0,8.0,10.0,10.0,14.0,13.0,10.0,12.0,14.0,14.0,9.0,30.0,7.0,0.0,0.0,0.0,181.0,72.0,1.0,3.0,3.0,1.0,2.0,3.0,2.0,1.0,3.0,2.0,2.0,12.0,11.0,14.0,8.0,14.0,12.0,8.0,12.0,6.0,5.0,13.0,13.0,5.0,14.0,8.0,12.0,10.0,11.0,12.0,15.0,11.0,13.0,14.0,9.0,13.0,10.0,12.0,13.0,12.0,14.0,12.0,10.0,12.0,15.0,13.0,20.0,15.0,9.0,10.0,8.0,13.0,5.0,8.0,12.0,14.0,14.0,12.0,11.0,14.0,14.0,8.0,30.0,0.0,0.0,11.0,4.0,172.0,69.0,4.0,2.0,2.0,3.0,3.0,3.0,3.0,3.0,4.0,4.0,3.0,13.0,13.0,13.0,11.0,13.0,13.0,7.0,12.0,9.0,4.0,13.0,12.0,4.0,15.0,7.0,12.0,10.0,12.0,12.0,15.0,12.0,13.0,17.0,8.0,14.0,7.0,12.0,12.0,14.0,15.0,12.0,6.0,20.0,10.0,14.0,10.0,13.0,7.0,12.0,6.0,12.0,15.0,13.0,10.0,11.0,13.0,12.0,11.0,14.0,14.0,6.0,22.0,0.0,0.0,0.0,0.0,164.0,65.0,1.0,2.0,3.0,1.0,2.0,2.0,3.0,2.0,2.0,1.0,2.0,10.0,12.0,13.0,11.0,13.0,10.0,5.0,10.0,7.0,5.0,12.0,10.0,3.0,13.0,7.0,11.0,11.0,11.0,13.0,13.0,11.0,13.0,13.0,6.0,14.0,7.0,12.0,12.0,15.0,15.0,8.0,2.0,9.0,13.0,14.0,20.0,13.0,8.0,13.0,7.0,10.0,8.0,12.0,10.0,12.0,11.0,12.0,11.0,10.0,10.0,8.0,24.0,24.0,4.0,0.0,0.0,172.0,74.0,2.0,4.0,3.0,2.0,2.0,1.0,2.0,2.0,3.0,2.0,4.0,8.0,9.0,14.0,13.0,14.0,9.0,11.0,10.0,7.0,5.0,12.0,12.0,3.0,13.0,10.0,12.0,12.0,13.0,12.0,11.0,10.0,14.0,13.0,7.0,14.0,9.0,9.0,13.0,16.0,15.0,13.0,6.0,8.0,13.0,16.0,20.0,14.0,12.0,11.0,11.0,13.0,9.0,8.0,9.0,13.0,9.0,11.0,12.0,13.0,10.0,9.0,26.0,2.0,0.0,1.0,0.0,188.0,84.0,12.0,13.0,15.0,9.0,15.0,13.0,13.0,15.0,10.0,11.0,14.0,9.0,2.0,1.0,2.0,12.0,11.0,3.0,2.0,3.0,3.0,11.0,3.0,1.0,10.0,14.0,13.0,14.0,10.0,13.0,11.0,11.0,14.0,3.0,11.0,5.0,12.0,15.0,13.0,10.0,12.0,13.0,14.0,5.0,14.0,9.0,20.0,12.0,14.0,12.0,10.0,15.0,3.0,11.0,12.0,11.0,16.0,13.0,15.0,16.0,16.0,4.0,29.0,17.0,1.0,4.0,0.0,183.0,72.0,2.0,2.0,1.0,2.0,4.0,3.0,3.0,2.0,1.0,1.0,2.0,4.0,9.0,6.0,6.0,8.0,5.0,15.0,7.0,10.0,15.0,8.0,6.0,14.0,8.0,13.0,13.0,16.0,11.0,13.0,9.0,11.0,13.0,9.0,8.0,8.0,12.0,15.0,14.0,11.0,12.0,14.0,12.0,10.0,13.0,14.0,20.0,15.0,14.0,14.0,13.0,13.0,8.0,12.0,14.0,12.0,13.0,13.0,14.0,11.0,11.0,7.0,29.0,0.0,0.0,0.0,0.0,183.0,74.0,3.0,3.0,3.0,3.0,3.0,2.0,2.0,2.0,1.0,3.0,1.0,5.0,12.0,7.0,6.0,10.0,7.0,14.0,12.0,5.0,14.0,12.0,6.0,13.0,11.0,14.0,13.0,17.0,13.0,16.0,12.0,12.0,13.0,9.0,8.0,9.0,14.0,14.0,15.0,13.0,12.0,15.0,12.0,6.0,17.0,11.0,20.0,17.0,13.0,14.0,14.0,15.0,5.0,13.0,9.0,14.0,19.0,15.0,14.0,11.0,11.0,6.0,32.0,0.0,0.0,0.0,0.0,183.0,79.0,1.0,1.0,1.0,3.0,1.0,3.0,1.0,1.0,2.0,1.0,1.0,5.0,10.0,6.0,6.0,9.0,6.0,15.0,7.0,11.0,14.0,10.0,7.0,13.0,10.0,13.0,15.0,15.0,15.0,14.0,9.0,13.0,16.0,6.0,14.0,8.0,12.0,13.0,16.0,11.0,12.0,16.0,11.0,8.0,16.0,12.0,20.0,15.0,14.0,14.0,11.0,12.0,5.0,15.0,18.0,15.0,14.0,13.0,17.0,14.0,14.0,5.0,27.0,0.0,0.0,0.0,0.0,178.0,72.0,2.0,3.0,2.0,3.0,2.0,3.0,3.0,1.0,1.0,2.0,1.0,13.0,14.0,11.0,7.0,12.0,10.0,9.0,10.0,13.0,13.0,12.0,10.0,14.0,13.0,12.0,14.0,14.0,13.0,14.0,11.0,12.0,14.0,13.0,8.0,14.0,13.0,13.0,15.0,15.0,13.0,10.0,10.0,20.0,13.0,15.0,6.0,14.0,10.0,13.0,13.0,12.0,8.0,12.0,15.0,14.0,13.0,14.0,13.0,13.0,12.0,6.0,32.0,0.0,0.0,13.0,0.0,175.0,65.0,2.0,1.0,1.0,2.0,3.0,3.0,1.0,2.0,3.0,2.0,3.0,15.0,13.0,11.0,6.0,14.0,13.0,10.0,12.0,8.0,8.0,16.0,8.0,12.0,13.0,11.0,14.0,15.0,14.0,15.0,14.0,14.0,14.0,6.0,13.0,9.0,15.0,18.0,13.0,12.0,13.0,13.0,8.0,8.0,13.0,10.0,20.0,13.0,13.0,12.0,11.0,15.0,12.0,10.0,17.0,14.0,15.0,14.0,16.0,14.0,14.0,6.0,30.0,4.0,0.0,0.0,0.0,192.0,78.0,1.0,3.0,1.0,2.0,2.0,3.0,1.0,3.0,1.0,1.0,3.0,4.0,6.0,7.0,8.0,11.0,6.0,15.0,8.0,6.0,13.0,11.0,6.0,14.0,11.0,17.0,14.0,16.0,12.0,14.0,10.0,12.0,17.0,8.0,8.0,11.0,13.0,15.0,16.0,14.0,12.0,18.0,14.0,6.0,14.0,12.0,20.0,17.0,16.0,14.0,17.0,13.0,9.0,11.0,8.0,13.0,10.0,13.0,12.0,10.0,10.0,5.0,27.0,0.0,0.0,0.0,0.0,188.0,77.0,1.0,4.0,1.0,1.0,3.0,1.0,2.0,1.0,2.0,2.0,2.0,4.0,7.0,8.0,7.0,13.0,6.0,15.0,9.0,6.0,13.0,12.0,6.0,12.0,11.0,14.0,14.0,15.0,10.0,12.0,11.0,13.0,16.0,7.0,12.0,9.0,12.0,15.0,16.0,14.0,10.0,14.0,15.0,9.0,13.0,12.0,20.0,14.0,16.0,12.0,14.0,13.0,6.0,12.0,4.0,13.0,18.0,13.0,14.0,14.0,13.0,7.0,18.0,0.0,0.0,0.0,0.0,179.0,67.0,3.0,3.0,2.0,4.0,2.0,4.0,3.0,1.0,3.0,4.0,1.0,5.0,7.0,12.0,9.0,12.0,12.0,10.0,12.0,6.0,4.0,12.0,12.0,3.0,14.0,11.0,12.0,11.0,11.0,8.0,13.0,12.0,12.0,12.0,6.0,12.0,5.0,10.0,12.0,15.0,11.0,12.0,10.0,20.0,13.0,14.0,8.0,14.0,8.0,9.0,6.0,14.0,5.0,10.0,16.0,13.0,12.0,12.0,13.0,9.0,15.0,2.0,25.0,0.0,0.0,0.0,0.0,176.0,74.0,2.0,2.0,1.0,3.0,2.0,2.0,2.0,4.0,3.0,3.0,3.0,12.0,12.0,14.0,12.0,14.0,13.0,7.0,12.0,6.0,3.0,12.0,12.0,3.0,15.0,9.0,10.0,8.0,12.0,11.0,12.0,10.0,10.0,14.0,5.0,13.0,4.0,6.0,8.0,17.0,15.0,12.0,8.0,20.0,12.0,14.0,8.0,13.0,12.0,11.0,9.0,14.0,10.0,8.0,8.0,14.0,12.0,7.0,10.0,11.0,11.0,9.0,30.0,5.0,0.0,22.0,9.0,181.0,84.0,2.0,3.0,3.0,1.0,2.0,3.0,3.0,1.0,3.0,1.0,3.0,7.0,10.0,12.0,13.0,11.0,7.0,13.0,10.0,12.0,6.0,11.0,13.0,6.0,13.0,17.0,13.0,16.0,11.0,13.0,11.0,11.0,17.0,14.0,8.0,14.0,9.0,13.0,17.0,15.0,12.0,15.0,11.0,8.0,14.0,15.0,20.0,14.0,14.0,13.0,9.0,13.0,7.0,10.0,7.0,16.0,13.0,14.0,13.0,15.0,15.0,10.0
0,0,23.0,0.0,0.0,3.0,0.0,192.0,94.0,13.0,12.0,13.0,7.0,13.0,8.0,17.0,16.0,10.0,15.0,15.0,5.0,1.0,1.0,1.0,11.0,9.0,6.0,1.0,2.0,1.0,12.0,2.0,3.0,12.0,2.0,13.0,15.0,10.0,11.0,7.0,9.0,9.0,6.0,6.0,2.0,12.0,10.0,10.0,13.0,15.0,12.0,13.0,9.0,9.0,12.0,20.0,8.0,9.0,12.0,4.0,13.0,4.0,11.0,10.0,11.0,14.0,9.0,10.0,1.0,14.0,7.0,32.0,13.0,2.0,0.0,0.0,187.0,82.0,4.0,3.0,3.0,1.0,3.0,3.0,3.0,3.0,3.0,3.0,2.0,6.0,10.0,12.0,8.0,14.0,7.0,15.0,7.0,12.0,17.0,15.0,10.0,18.0,13.0,12.0,16.0,18.0,17.0,12.0,14.0,12.0,18.0,16.0,15.0,6.0,16.0,10.0,9.0,8.0,11.0,17.0,14.0,20.0,15.0,10.0,12.0,13.0,15.0,16.0,14.0,15.0,7.0,10.0,16.0,14.0,9.0,17.0,14.0,7.0,8.0,13.0,28.0,0.0,0.0,9.0,1.0,187.0,85.0,3.0,3.0,2.0,2.0,3.0,2.0,2.0,1.0,1.0,1.0,2.0,4.0,10.0,7.0,7.0,11.0,8.0,16.0,11.0,13.0,14.0,10.0,6.0,14.0,11.0,14.0,14.0,17.0,11.0,14.0,8.0,13.0,14.0,7.0,12.0,7.0,13.0,16.0,15.0,12.0,12.0,15.0,13.0,8.0,14.0,11.0,20.0,14.0,15.0,15.0,6.0,15.0,8.0,8.0,8.0,15.0,12.0,12.0,13.0,14.0,14.0,5.0,17.0,0.0,0.0,0.0,0.0,182.0,73.0,1.0,3.0,1.0,3.0,3.0,2.0,2.0,4.0,1.0,2.0,1.0,6.0,11.0,10.0,7.0,12.0,7.0,13.0,7.0,8.0,11.0,12.0,7.0,13.0,11.0,11.0,11.0,14.0,13.0,12.0,11.0,11.0,15.0,12.0,7.0,8.0,11.0,12.0,14.0,12.0,11.0,14.0,10.0,20.0,14.0,13.0,10.0,14.0,12.0,13.0,8.0,11.0,9.0,10.0,7.0,13.0,14.0,13.0,14.0,13.0,14.0,7.0,24.0,0.0,0.0,2.0,0.0,179.0,72.0,2.0,2.0,3.0,3.0,3.0,3.0,1.0,1.0,1.0,2.0,1.0,12.0,14.0,12.0,7.0,13.0,12.0,6.0,10.0,5.0,10.0,13.0,10.0,12.0,13.0,12.0,13.0,11.0,12.0,12.0,12.0,12.0,17.0,8.0,9.0,13.0,11.0,14.0,15.0,14.0,13.0,12.0,7.0,8.0,14.0,13.0,20.0,15.0,10.0,14.0,12.0,14.0,8.0,15.0,11.0,14.0,13.0,9.0,14.0,15.0,15.0,7.0,22.0,0.0,0.0,18.0,7.0,175.0,70.0,2.0,3.0,1.0,2.0,3.0,1.0,1.0,2.0,1.0,3.0,2.0,9.0,13.0,13.0,10.0,11.0,8.0,4.0,10.0,8.0,9.0,11.0,12.0,11.0,12.0,11.0,13.0,14.0,11.0,11.0,10.0,10.0,15.0,13.0,7.0,14.0,9.0,12.0,14.0,16.0,15.0,8.0,9.0,10.0,14.0,15.0,20.0,13.0,9.0,13.0,12.0,11.0,7.0,14.0,12.0,12.0,14.0,14.0,14.0,15.0,15.0,6.0,22.0,0.0,0.0,0.0,0.0,181.0,74.0,1.0,1.0,2.0,3.0,1.0,3.0,3.0,2.0,3.0,2.0,2.0,12.0,13.0,12.0,8.0,13.0,11.0,9.0,11.0,13.0,10.0,12.0,9.0,12.0,13.0,16.0,12.0,14.0,13.0,11.0,11.0,13.0,13.0,12.0,8.0,14.0,10.0,11.0,14.0,14.0,14.0,12.0,11.0,20.0,13.0,15.0,8.0,15.0,12.0,14.0,13.0,11.0,10.0,10.0,13.0,15.0,10.0,12.0,12.0,12.0,13.0,5.0,21.0,0.0,0.0,0.0,0.0,182.0,75.0,4.0,4.0,3.0,1.0,4.0,2.0,1.0,2.0,1.0,1.0,1.0,10.0,13.0,12.0,10.0,14.0,15.0,9.0,15.0,6.0,8.0,14.0,10.0,10.0,14.0,10.0,11.0,12.0,13.0,11.0,13.0,12.0,14.0,11.0,6.0,12.0,10.0,13.0,12.0,15.0,14.0,13.0,11.0,10.0,14.0,12.0,20.0,15.0,12.0,14.0,8.0,13.0,6.0,13.0,8.0,14.0,13.0,11.0,8.0,13.0,16.0,9.0,20.0,0.0,0.0,1.0,0.0,168.0,58.0,2.0,3.0,2.0,1.0,2.0,1.0,2.0,3.0,1.0,3.0,3.0,10.0,13.0,13.0,10.0,14.0,10.0,8.0,8.0,5.0,12.0,14.0,10.0,12.0,13.0,14.0,13.0,12.0,13.0,14.0,13.0,13.0,13.0,12.0,8.0,12.0,12.0,14.0,14.0,14.0,15.0,14.0,6.0,12.0,14.0,13.0,20.0,14.0,7.0,14.0,6.0,12.0,5.0,10.0,9.0,13.0,14.0,13.0,14.0,13.0,15.0,7.0,19.0,0.0,0.0,0.0,0.0,179.0,67.0,3.0,3.0,1.0,3.0,4.0,2.0,3.0,1.0,1.0,1.0,1.0,10.0,12.0,14.0,12.0,14.0,7.0,9.0,11.0,5.0,9.0,13.0,3.0,10.0,14.0,10.0,10.0,10.0,11.0,12.0,13.0,12.0,1.0,12.0,7.0,13.0,11.0,11.0,11.0,14.0,13.0,14.0,10.0,6.0,12.0,14.0,20.0,12.0,10.0,12.0,10.0,14.0,5.0,8.0,18.0,13.0,9.0,10.0,12.0,14.0,14.0,4.0,23.0,0.0,0.0,1.0,0.0,181.0,78.0,1.0,2.0,2.0,3.0,1.0,3.0,1.0,1.0,1.0,2.0,2.0,5.0,12.0,14.0,13.0,14.0,8.0,14.0,12.0,7.0,5.0,12.0,12.0,6.0,14.0,10.0,13.0,10.0,13.0,13.0,11.0,12.0,13.0,11.0,6.0,13.0,10.0,9.0,12.0,16.0,14.0,13.0,10.0,8.0,14.0,15.0,20.0,13.0,14.0,13.0,8.0,7.0,9.0,8.0,16.0,14.0,13.0,12.0,13.0,15.0,15.0,7.0,20.0,0.0,0.0,3.0,0.0,193.0,80.0,10.0,12.0,12.0,9.0,11.0,11.0,13.0,15.0,13.0,7.0,12.0,7.0,1.0,1.0,2.0,8.0,11.0,1.0,2.0,1.0,2.0,11.0,2.0,1.0,8.0,4.0,14.0,14.0,11.0,9.0,11.0,12.0,12.0,2.0,15.0,1.0,13.0,11.0,6.0,12.0,13.0,15.0,16.0,20.0,15.0,10.0,6.0,13.0,14.0,12.0,11.0,11.0,10.0,1.0,11.0,9.0,12.0,12.0,13.0,10.0,10.0,1.0,22.0,24.0,0.0,3.0,1.0,182.0,80.0,3.0,3.0,1.0,2.0,2.0,2.0,3.0,1.0,3.0,3.0,3.0,4.0,5.0,8.0,6.0,11.0,6.0,12.0,5.0,5.0,12.0,10.0,7.0,12.0,11.0,11.0,12.0,12.0,11.0,11.0,9.0,11.0,14.0,7.0,8.0,7.0,10.0,13.0,12.0,12.0,10.0,11.0,11.0,5.0,13.0,12.0,20.0,14.0,13.0,13.0,9.0,12.0,8.0,8.0,14.0,13.0,14.0,12.0,15.0,15.0,15.0,7.0,26.0,1.0,0.0,0.0,0.0,185.0,80.0,3.0,1.0,3.0,3.0,3.0,3.0,2.0,3.0,4.0,2.0,1.0,5.0,9.0,11.0,8.0,11.0,6.0,12.0,8.0,10.0,15.0,11.0,12.0,14.0,12.0,16.0,12.0,17.0,14.0,9.0,9.0,10.0,15.0,13.0,9.0,7.0,10.0,8.0,12.0,15.0,13.0,17.0,14.0,8.0,13.0,18.0,20.0,13.0,14.0,11.0,12.0,11.0,4.0,10.0,12.0,12.0,13.0,10.0,10.0,8.0,7.0,14.0,24.0,0.0,0.0,0.0,0.0,184.0,89.0,2.0,3.0,3.0,2.0,2.0,3.0,3.0,1.0,2.0,3.0,2.0,4.0,10.0,8.0,6.0,11.0,9.0,14.0,9.0,7.0,14.0,11.0,6.0,11.0,11.0,13.0,12.0,16.0,11.0,13.0,10.0,11.0,14.0,6.0,8.0,7.0,12.0,13.0,14.0,14.0,12.0,16.0,12.0,20.0,14.0,13.0,6.0,14.0,16.0,14.0,13.0,13.0,7.0,8.0,7.0,14.0,13.0,12.0,14.0,14.0,14.0,6.0,24.0,0.0,0.0,0.0,0.0,175.0,68.0,4.0,3.0,3.0,4.0,1.0,3.0,2.0,2.0,3.0,3.0,1.0,8.0,12.0,11.0,7.0,11.0,8.0,9.0,12.0,13.0,11.0,11.0,7.0,12.0,13.0,12.0,11.0,14.0,12.0,11.0,10.0,12.0,14.0,6.0,8.0,13.0,12.0,14.0,14.0,13.0,13.0,10.0,6.0,12.0,14.0,13.0,20.0,14.0,9.0,13.0,6.0,12.0,5.0,15.0,15.0,10.0,10.0,13.0,14.0,15.0,13.0,4.0,28.0,0.0,0.0,0.0,0.0,194.0,93.0,2.0,3.0,2.0,1.0,4.0,2.0,2.0,1.0,2.0,2.0,3.0,4.0,5.0,11.0,7.0,12.0,12.0,14.0,12.0,7.0,12.0,10.0,7.0,14.0,9.0,12.0,11.0,16.0,12.0,12.0,11.0,10.0,12.0,7.0,14.0,7.0,12.0,15.0,13.0,8.0,9.0,17.0,16.0,20.0,11.0,9.0,6.0,14.0,17.0,10.0,10.0,10.0,8.0,8.0,17.0,12.0,14.0,12.0,13.0,1.0,5.0,8.0,34.0,0.0,0.0,2.0,0.0,175.0,69.0,1.0,1.0,1.0,3.0,2.0,2.0,1.0,1.0,2.0,2.0,2.0,7.0,13.0,9.0,5.0,12.0,8.0,11.0,10.0,13.0,13.0,12.0,8.0,13.0,10.0,15.0,15.0,18.0,13.0,14.0,13.0,13.0,16.0,8.0,14.0,10.0,14.0,15.0,15.0,12.0,13.0,15.0,8.0,20.0,12.0,13.0,5.0,14.0,12.0,16.0,10.0,15.0,10.0,14.0,13.0,14.0,15.0,15.0,18.0,13.0,8.0,10.0,24.0,0.0,0.0,0.0,0.0,174.0,68.0,3.0,1.0,3.0,1.0,1.0,2.0,1.0,3.0,1.0,1.0,1.0,13.0,12.0,12.0,10.0,13.0,13.0,8.0,13.0,10.0,6.0,14.0,12.0,7.0,13.0,9.0,13.0,11.0,13.0,11.0,13.0,13.0,12.0,11.0,7.0,12.0,9.0,12.0,12.0,14.0,13.0,12.0,8.0,8.0,14.0,12.0,20.0,13.0,10.0,13.0,10.0,13.0,7.0,12.0,14.0,14.0,15.0,9.0,11.0,13.0,12.0,8.0,31.0,0.0,0.0,0.0,0.0,180.0,74.0,3.0,2.0,3.0,1.0,2.0,3.0,2.0,1.0,4.0,3.0,3.0,12.0,12.0,10.0,9.0,13.0,14.0,11.0,13.0,6.0,10.0,14.0,15.0,13.0,13.0,15.0,14.0,17.0,12.0,14.0,13.0,13.0,15.0,7.0,13.0,10.0,13.0,18.0,15.0,9.0,11.0,14.0,10.0,10.0,13.0,12.0,20.0,15.0,14.0,14.0,13.0,15.0,8.0,7.0,19.0,13.0,13.0,13.0,13.0,13.0,12.0,9.0,21.0,0.0,0.0,6.0,3.0,185.0,75.0,2.0,2.0,2.0,4.0,4.0,1.0,3.0,1.0,3.0,1.0,1.0,9.0,7.0,11.0,14.0,11.0,10.0,16.0,7.0,6.0,8.0,11.0,8.0,8.0,9.0,10.0,11.0,14.0,14.0,11.0,12.0,11.0,9.0,11.0,15.0,10.0,12.0,10.0,13.0,11.0,12.0,11.0,13.0,6.0,14.0,13.0,20.0,16.0,11.0,8.0,10.0,10.0,9.0,10.0,19.0,11.0,12.0,11.0,9.0,11.0,16.0,3.0,21.0,0.0,0.0,0.0,0.0,181.0,73.0,2.0,3.0,2.0,2.0,1.0,2.0,1.0,2.0,1.0,3.0,1.0,6.0,9.0,12.0,11.0,11.0,8.0,9.0,11.0,6.0,4.0,9.0,12.0,3.0,13.0,10.0,11.0,12.0,11.0,9.0,9.0,9.0,14.0,13.0,6.0,13.0,6.0,10.0,12.0,15.0,14.0,13.0,10.0,8.0,12.0,14.0,20.0,11.0,12.0,12.0,10.0,14.0,10.0,8.0,16.0,13.0,13.0,14.0,12.0,15.0,15.0,8.0
3,2,36.0,0.0,0.0,0.0,0.0,185.0,78.0,11.0,14.0,12.0,7.0,13.0,12.0,14.0,15.0,13.0,14.0,10.0,4.0,1.0,3.0,1.0,8.0,8.0,11.0,8.0,3.0,3.0,7.0,2.0,1.0,8.0,11.0,13.0,15.0,11.0,12.0,7.0,13.0,9.0,5.0,14.0,3.0,13.0,15.0,8.0,11.0,14.0,13.0,12.0,5.0,15.0,11.0,20.0,12.0,14.0,13.0,11.0,13.0,8.0,1.0,19.0,14.0,16.0,10.0,17.0,9.0,9.0,11.0,34.0,23.0,1.0,0.0,0.0,186.0,81.0,3.0,3.0,1.0,2.0,1.0,3.0,2.0,3.0,1.0,3.0,3.0,4.0,8.0,6.0,10.0,7.0,8.0,17.0,12.0,10.0,14.0,7.0,9.0,15.0,7.0,15.0,13.0,17.0,8.0,12.0,7.0,12.0,15.0,6.0,17.0,7.0,14.0,15.0,14.0,8.0,10.0,16.0,13.0,12.0,13.0,9.0,20.0,13.0,15.0,11.0,15.0,14.0,9.0,10.0,10.0,14.0,11.0,13.0,15.0,11.0,11.0,12.0,28.0,0.0,0.0,0.0,0.0,183.0,81.0,1.0,2.0,4.0,1.0,1.0,3.0,2.0,3.0,3.0,3.0,1.0,5.0,5.0,6.0,10.0,12.0,6.0,14.0,8.0,6.0,15.0,11.0,6.0,13.0,12.0,13.0,14.0,16.0,14.0,14.0,10.0,12.0,14.0,5.0,14.0,8.0,14.0,15.0,15.0,9.0,12.0,15.0,13.0,7.0,11.0,12.0,20.0,15.0,15.0,14.0,14.0,14.0,9.0,8.0,14.0,14.0,11.0,13.0,15.0,13.0,15.0,6.0,21.0,0.0,0.0,1.0,0.0,177.0,68.0,4.0,1.0,2.0,1.0,1.0,1.0,1.0,1.0,2.0,1.0,2.0,5.0,12.0,9.0,7.0,12.0,8.0,13.0,10.0,16.0,13.0,12.0,8.0,14.0,12.0,12.0,13.0,12.0,12.0,12.0,10.0,13.0,15.0,11.0,13.0,11.0,13.0,13.0,14.0,13.0,14.0,13.0,11.0,10.0,14.0,12.0,20.0,12.0,14.0,12.0,11.0,12.0,8.0,14.0,13.0,10.0,14.0,12.0,14.0,12.0,11.0,5.0,27.0,14.0,1.0,0.0,0.0,183.0,77.0,1.0,2.0,1.0,2.0,3.0,2.0,3.0,2.0,2.0,1.0,1.0,5.0,12.0,9.0,8.0,13.0,10.0,13.0,10.0,6.0,14.0,13.0,6.0,13.0,12.0,14.0,13.0,15.0,11.0,11.0,11.0,11.0,13.0,9.0,8.0,9.0,12.0,14.0,16.0,14.0,12.0,14.0,12.0,7.0,14.0,12.0,20.0,15.0,14.0,14.0,14.0,15.0,7.0,10.0,12.0,13.0,14.0,12.0,13.0,11.0,11.0,7.0,30.0,0.0,0.0,0.0,0.0,167.0,60.0,3.0,1.0,1.0,2.0,3.0,1.0,1.0,3.0,1.0,1.0,3.0,10.0,11.0,12.0,8.0,13.0,10.0,6.0,9.0,10.0,12.0,14.0,9.0,10.0,14.0,11.0,14.0,14.0,14.0,14.0,13.0,14.0,12.0,14.0,11.0,13.0,12.0,15.0,15.0,15.0,14.0,11.0,5.0,11.0,11.0,15.0,20.0,11.0,8.0,14.0,10.0,12.0,13.0,11.0,11.0,12.0,11.0,10.0,12.0,11.0,11.0,2.0,33.0,0.0,0.0,0.0,0.0,187.0,76.0,2.0,2.0,3.0,1.0,1.0,3.0,2.0,1.0,2.0,3.0,2.0,15.0,14.0,14.0,10.0,15.0,13.0,10.0,12.0,7.0,4.0,15.0,13.0,7.0,15.0,6.0,12.0,9.0,14.0,11.0,15.0,12.0,12.0,14.0,12.0,13.0,7.0,13.0,12.0,11.0,12.0,14.0,12.0,14.0,15.0,12.0,20.0,11.0,12.0,12.0,6.0,14.0,6.0,11.0,14.0,13.0,12.0,12.0,15.0,15.0,13.0,9.0,17.0,0.0,0.0,0.0,0.0,181.0,68.0,1.0,2.0,1.0,1.0,2.0,2.0,3.0,3.0,3.0,2.0,1.0,8.0,11.0,14.0,11.0,13.0,8.0,11.0,9.0,5.0,3.0,11.0,5.0,5.0,14.0,5.0,11.0,6.0,10.0,10.0,11.0,12.0,14.0,13.0,6.0,13.0,9.0,10.0,8.0,14.0,14.0,14.0,10.0,5.0,12.0,14.0,20.0,12.0,11.0,10.0,6.0,5.0,10.0,12.0,20.0,12.0,11.0,12.0,12.0,11.0,14.0,5.0,27.0,0.0,0.0,0.0,0.0,190.0,87.0,1.0,3.0,2.0,3.0,1.0,3.0,1.0,1.0,2.0,3.0,2.0,5.0,7.0,9.0,14.0,14.0,10.0,14.0,13.0,5.0,6.0,12.0,12.0,8.0,14.0,14.0,13.0,16.0,14.0,11.0,10.0,13.0,15.0,10.0,11.0,14.0,9.0,15.0,14.0,10.0,11.0,16.0,15.0,9.0,12.0,12.0,20.0,14.0,16.0,13.0,13.0,12.0,7.0,5.0,10.0,12.0,14.0,12.0,14.0,14.0,19.0,12.0,26.0,0.0,0.0,0.0,0.0,193.0,81.0,1.0,3.0,3.0,3.0,3.0,1.0,2.0,2.0,2.0,3.0,3.0,4.0,9.0,14.0,10.0,13.0,12.0,14.0,14.0,5.0,5.0,10.0,12.0,3.0,14.0,8.0,13.0,12.0,9.0,10.0,11.0,11.0,12.0,16.0,5.0,14.0,6.0,9.0,12.0,14.0,13.0,14.0,16.0,14.0,13.0,13.0,20.0,13.0,14.0,10.0,8.0,14.0,9.0,8.0,16.0,16.0,11.0,13.0,11.0,13.0,13.0,10.0,30.0,0.0,0.0,0.0,0.0,178.0,73.0,3.0,4.0,1.0,1.0,2.0,4.0,3.0,2.0,2.0,2.0,3.0,13.0,14.0,12.0,7.0,13.0,12.0,7.0,13.0,5.0,10.0,13.0,9.0,10.0,13.0,11.0,11.0,12.0,12.0,13.0,11.0,14.0,14.0,11.0,7.0,11.0,10.0,13.0,15.0,13.0,15.0,15.0,8.0,20.0,14.0,14.0,8.0,14.0,11.0,13.0,11.0,14.0,8.0,10.0,19.0,12.0,12.0,9.0,12.0,12.0,10.0,10.0,25.0,4.0,0.0,11.0,0.0,184.0,81.0,14.0,14.0,13.0,9.0,15.0,12.0,16.0,16.0,13.0,7.0,11.0,8.0,1.0,2.0,1.0,11.0,12.0,6.0,1.0,3.0,3.0,11.0,5.0,3.0,11.0,8.0,15.0,15.0,13.0,14.0,10.0,11.0,14.0,8.0,13.0,5.0,13.0,10.0,10.0,14.0,16.0,14.0,13.0,20.0,14.0,12.0,5.0,14.0,14.0,15.0,9.0,16.0,6.0,1.0,17.0,11.0,15.0,13.0,14.0,12.0,12.0,4.0,19.0,0.0,0.0,0.0,0.0,193.0,89.0,3.0,2.0,2.0,3.0,1.0,3.0,1.0,4.0,2.0,2.0,3.0,8.0,10.0,5.0,4.0,10.0,10.0,14.0,12.0,6.0,12.0,10.0,4.0,12.0,9.0,11.0,11.0,14.0,11.0,12.0,8.0,14.0,13.0,8.0,8.0,11.0,11.0,13.0,13.0,10.0,9.0,14.0,16.0,6.0,14.0,10.0,20.0,12.0,14.0,11.0,7.0,6.0,6.0,8.0,16.0,10.0,10.0,12.0,13.0,16.0,16.0,5.0,27.0,4.0,0.0,5.0,1.0,184.0,83.0,2.0,4.0,3.0,1.0,1.0,2.0,1.0,2.0,4.0,2.0,3.0,4.0,8.0,11.0,4.0,10.0,4.0,14.0,4.0,4.0,15.0,12.0,5.0,16.0,11.0,14.0,14.0,16.0,14.0,10.0,11.0,12.0,17.0,7.0,10.0,9.0,13.0,14.0,15.0,14.0,13.0,16.0,13.0,10.0,15.0,13.0,20.0,15.0,16.0,12.0,12.0,14.0,6.0,12.0,11.0,13.0,12.0,12.0,16.0,15.0,14.0,6.0,32.0,0.0,0.0,0.0,0.0,172.0,71.0,2.0,1.0,3.0,1.0,2.0,3.0,2.0,3.0,2.0,2.0,2.0,8.0,9.0,7.0,6.0,10.0,6.0,10.0,9.0,10.0,14.0,11.0,6.0,14.0,11.0,10.0,16.0,15.0,12.0,12.0,7.0,12.0,15.0,9.0,13.0,8.0,14.0,15.0,15.0,14.0,14.0,14.0,10.0,20.0,14.0,14.0,8.0,15.0,13.0,13.0,11.0,13.0,7.0,13.0,17.0,14.0,17.0,8.0,13.0,15.0,15.0,6.0,37.0,0.0,0.0,0.0,0.0,185.0,83.0,1.0,1.0,2.0,1.0,3.0,2.0,3.0,1.0,1.0,3.0,1.0,6.0,8.0,9.0,12.0,10.0,8.0,13.0,9.0,4.0,5.0,10.0,14.0,4.0,11.0,11.0,10.0,11.0,13.0,12.0,12.0,13.0,15.0,14.0,12.0,11.0,7.0,12.0,8.0,7.0,7.0,12.0,12.0,11.0,11.0,7.0,20.0,8.0,14.0,12.0,8.0,13.0,9.0,12.0,12.0,12.0,19.0,14.0,15.0,14.0,8.0,8.0,19.0,0.0,0.0,3.0,1.0,181.0,69.0,3.0,2.0,3.0,3.0,2.0,1.0,1.0,1.0,3.0,3.0,4.0,10.0,10.0,12.0,12.0,12.0,7.0,8.0,11.0,5.0,7.0,10.0,10.0,7.0,11.0,8.0,10.0,10.0,12.0,8.0,11.0,8.0,14.0,13.0,6.0,14.0,8.0,13.0,13.0,16.0,14.0,13.0,9.0,20.0,15.0,16.0,10.0,15.0,13.0,12.0,8.0,11.0,7.0,12.0,11.0,11.0,15.0,10.0,12.0,14.0,14.0,1.0,27.0,8.0,0.0,6.0,0.0,187.0,76.0,3.0,2.0,3.0,2.0,2.0,1.0,1.0,3.0,3.0,1.0,2.0,5.0,7.0,11.0,5.0,14.0,5.0,14.0,9.0,5.0,15.0,15.0,8.0,14.0,13.0,15.0,16.0,15.0,14.0,12.0,14.0,14.0,18.0,8.0,17.0,9.0,12.0,18.0,15.0,13.0,14.0,15.0,14.0,10.0,17.0,12.0,20.0,17.0,15.0,14.0,13.0,16.0,4.0,12.0,10.0,14.0,17.0,12.0,15.0,13.0,13.0,6.0,21.0,0.0,0.0,15.0,3.0,181.0,78.0,3.0,3.0,4.0,2.0,1.0,2.0,2.0,4.0,2.0,1.0,1.0,5.0,7.0,11.0,10.0,14.0,5.0,14.0,10.0,6.0,13.0,14.0,8.0,14.0,14.0,12.0,14.0,12.0,11.0,10.0,12.0,11.0,16.0,11.0,12.0,14.0,14.0,14.0,14.0,14.0,13.0,14.0,13.0,10.0,16.0,14.0,20.0,16.0,14.0,12.0,10.0,11.0,5.0,19.0,8.0,11.0,14.0,11.0,16.0,13.0,13.0,10.0,31.0,52.0,8.0,0.0,0.0,167.0,58.0,1.0,2.0,2.0,1.0,3.0,2.0,4.0,2.0,1.0,2.0,3.0,15.0,15.0,14.0,7.0,15.0,15.0,6.0,11.0,3.0,4.0,15.0,14.0,7.0,15.0,13.0,12.0,15.0,13.0,14.0,16.0,11.0,17.0,14.0,11.0,12.0,10.0,12.0,14.0,15.0,18.0,10.0,5.0,10.0,16.0,14.0,20.0,13.0,7.0,14.0,13.0,16.0,8.0,12.0,13.0,16.0,14.0,15.0,13.0,9.0,11.0,14.0,25.0,10.0,1.0,11.0,4.0,175.0,73.0,1.0,3.0,3.0,3.0,3.0,3.0,3.0,1.0,2.0,3.0,1.0,5.0,10.0,15.0,17.0,15.0,10.0,11.0,12.0,5.0,5.0,14.0,15.0,5.0,16.0,8.0,15.0,12.0,15.0,14.0,13.0,15.0,15.0,15.0,14.0,14.0,10.0,10.0,12.0,16.0,16.0,15.0,9.0,10.0,15.0,16.0,20.0,13.0,15.0,14.0,8.0,14.0,7.0,10.0,8.0,16.0,17.0,13.0,15.0,15.0,14.0,5.0,22.0,5.0,1.0,1.0,0.0,173.0,72.0,1.0,3.0,1.0,3.0,3.0,3.0,3.0,3.0,3.0,2.0,2.0,14.0,13.0,16.0,14.0,16.0,14.0,5.0,11.0,5.0,5.0,15.0,11.0,5.0,16.0,8.0,13.0,9.0,14.0,13.0,15.0,13.0,15.0,16.0,5.0,13.0,5.0,9.0,10.0,15.0,16.0,14.0,5.0,20.0,14.0,15.0,5.0,12.0,14.0,13.0,11.0,13.0,8.0,14.0,10.0,15.0,14.0,10.0,13.0,10.0,10.0,13.0
1,1,30.0,0.0,0.0,0.0,0.0,180.0,75.0,11.0,13.0,13.0,9.0,13.0,11.0,12.0,15.0,15.0,14.0,13.0,6.0,1.0,2.0,3.0,7.0,8.0,1.0,1.0,1.0,2.0,7.0,2.0,1.0,7.0,8.0,12.0,14.0,13.0,14.0,7.0,12.0,14.0,5.0,12.0,3.0,13.0,15.0,9.0,13.0,14.0,13.0,10.0,5.0,14.0,11.0,20.0,12.0,13.0,12.0,8.0,14.0,6.0,1.0,9.0,13.0,14.0,13.0,16.0,15.0,15.0,5.0,24.0,0.0,0.0,4.0,0.0,186.0,88.0,1.0,2.0,1.0,3.0,2.0,1.0,1.0,2.0,1.0,2.0,1.0,4.0,8.0,8.0,6.0,12.0,6.0,14.0,9.0,11.0,14.0,12.0,6.0,12.0,12.0,14.0,13.0,14.0,12.0,13.0,8.0,12.0,13.0,8.0,8.0,9.0,12.0,12.0,13.0,13.0,11.0,15.0,13.0,8.0,15.0,14.0,20.0,14.0,15.0,13.0,14.0,15.0,8.0,12.0,14.0,14.0,12.0,9.0,12.0,13.0,13.0,8.0,21.0,0.0,0.0,0.0,0.0,182.0,74.0,2.0,2.0,2.0,2.0,2.0,1.0,1.0,1.0,3.0,2.0,2.0,9.0,11.0,12.0,7.0,9.0,8.0,12.0,7.0,11.0,12.0,7.0,8.0,13.0,11.0,12.0,12.0,14.0,12.0,13.0,7.0,12.0,11.0,1.0,9.0,11.0,9.0,10.0,12.0,14.0,10.0,13.0,11.0,9.0,8.0,12.0,20.0,13.0,11.0,10.0,13.0,8.0,10.0,10.0,15.0,11.0,13.0,10.0,10.0,8.0,13.0,7.0,32.0,0.0,0.0,0.0,0.0,165.0,65.0,1.0,2.0,3.0,1.0,3.0,1.0,3.0,2.0,1.0,4.0,4.0,7.0,12.0,10.0,5.0,13.0,8.0,9.0,8.0,11.0,13.0,12.0,10.0,14.0,11.0,14.0,13.0,15.0,12.0,12.0,8.0,11.0,14.0,5.0,8.0,7.0,10.0,15.0,17.0,14.0,13.0,14.0,4.0,10.0,13.0,13.0,20.0,15.0,12.0,14.0,5.0,13.0,7.0,8.0,7.0,12.0,17.0,13.0,15.0,13.0,13.0,7.0,28.0,22.0,0.0,20.0,1.0,176.0,74.0,2.0,3.0,2.0,1.0,1.0,1.0,3.0,3.0,2.0,2.0,1.0,15.0,15.0,12.0,8.0,13.0,12.0,5.0,11.0,15.0,10.0,13.0,9.0,10.0,12.0,10.0,11.0,10.0,13.0,12.0,11.0,12.0,11.0,11.0,7.0,13.0,10.0,14.0,15.0,15.0,14.0,10.0,8.0,20.0,13.0,14.0,8.0,15.0,8.0,14.0,5.0,12.0,5.0,14.0,15.0,15.0,10.0,14.0,13.0,12.0,12.0,2.0,31.0,0.0,0.0,0.0,0.0,178.0,70.0,3.0,1.0,3.0,3.0,2.0,2.0,2.0,1.0,2.0,1.0,2.0,5.0,8.0,7.0,7.0,12.0,5.0,8.0,8.0,7.0,14.0,13.0,8.0,13.0,12.0,15.0,14.0,17.0,12.0,13.0,9.0,13.0,16.0,10.0,15.0,8.0,13.0,18.0,15.0,13.0,14.0,12.0,9.0,10.0,15.0,13.0,20.0,16.0,13.0,14.0,12.0,14.0,5.0,16.0,13.0,12.0,16.0,13.0,13.0,13.0,13.0,6.0,22.0,0.0,0.0,6.0,1.0,175.0,75.0,3.0,3.0,2.0,1.0,1.0,2.0,3.0,2.0,2.0,1.0,1.0,10.0,9.0,12.0,6.0,11.0,7.0,10.0,11.0,7.0,9.0,11.0,6.0,10.0,14.0,12.0,10.0,12.0,10.0,10.0,12.0,11.0,10.0,13.0,6.0,11.0,8.0,11.0,13.0,12.0,14.0,12.0,8.0,5.0,14.0,13.0,20.0,11.0,12.0,10.0,10.0,10.0,8.0,10.0,8.0,11.0,10.0,9.0,12.0,12.0,15.0,6.0,32.0,25.0,0.0,0.0,0.0,181.0,82.0,2.0,3.0,3.0,1.0,1.0,1.0,1.0,3.0,1.0,2.0,3.0,5.0,10.0,6.0,7.0,10.0,7.0,14.0,9.0,8.0,11.0,12.0,7.0,13.0,10.0,15.0,14.0,16.0,11.0,13.0,10.0,12.0,16.0,9.0,15.0,8.0,11.0,16.0,18.0,11.0,12.0,14.0,11.0,8.0,13.0,11.0,20.0,17.0,15.0,13.0,15.0,11.0,6.0,14.0,18.0,12.0,13.0,13.0,14.0,11.0,11.0,8.0,27.0,32.0,6.0,0.0,0.0,188.0,78.0,3.0,2.0,3.0,2.0,1.0,3.0,3.0,3.0,2.0,2.0,2.0,4.0,8.0,11.0,12.0,12.0,6.0,16.0,13.0,8.0,13.0,14.0,7.0,12.0,12.0,12.0,10.0,14.0,13.0,12.0,11.0,12.0,15.0,9.0,11.0,12.0,6.0,13.0,12.0,14.0,13.0,15.0,15.0,5.0,13.0,12.0,20.0,16.0,15.0,14.0,12.0,15.0,11.0,10.0,9.0,15.0,12.0,12.0,13.0,13.0,13.0,7.0,34.0,0.0,0.0,0.0,0.0,176.0,65.0,2.0,3.0,3.0,3.0,2.0,2.0,1.0,2.0,1.0,1.0,2.0,14.0,15.0,13.0,10.0,15.0,13.0,6.0,15.0,10.0,3.0,14.0,13.0,6.0,14.0,8.0,12.0,9.0,13.0,12.0,14.0,13.0,11.0,12.0,7.0,13.0,8.0,14.0,15.0,14.0,13.0,12.0,8.0,20.0,14.0,13.0,10.0,12.0,7.0,13.0,8.0,15.0,7.0,6.0,13.0,14.0,14.0,9.0,14.0,14.0,11.0,10.0,25.0,24.0,7.0,0.0,0.0,180.0,75.0,1.0,2.0,1.0,1.0,1.0,2.0,3.0,1.0,3.0,1.0,3.0,6.0,10.0,14.0,11.0,14.0,10.0,9.0,12.0,6.0,3.0,13.0,11.0,2.0,16.0,7.0,12.0,12.0,12.0,10.0,12.0,11.0,13.0,16.0,6.0,13.0,5.0,8.0,8.0,16.0,14.0,13.0,10.0,10.0,13.0,14.0,20.0,13.0,12.0,12.0,7.0,14.0,11.0,8.0,17.0,14.0,13.0,13.0,12.0,15.0,15.0,7.0,23.0,0.0,0.0,3.0,0.0,192.0,94.0,13.0,12.0,13.0,7.0,13.0,8.0,17.0,16.0,10.0,15.0,15.0,5.0,1.0,1.0,1.0,11.0,9.0,6.0,1.0,2.0,1.0,12.0,2.0,3.0,12.0,2.0,13.0,15.0,10.0,11.0,7.0,9.0,9.0,6.0,6.0,2.0,12.0,10.0,10.0,13.0,15.0,12.0,13.0,9.0,9.0,12.0,20.0,8.0,9.0,12.0,4.0,13.0,4.0,11.0,10.0,11.0,14.0,9.0,10.0,1.0,14.0,7.0,32.0,13.0,2.0,0.0,0.0,187.0,82.0,4.0,3.0,3.0,1.0,3.0,3.0,3.0,3.0,3.0,3.0,2.0,6.0,10.0,12.0,8.0,14.0,7.0,15.0,7.0,12.0,17.0,15.0,10.0,18.0,13.0,12.0,16.0,18.0,17.0,12.0,14.0,12.0,18.0,16.0,15.0,6.0,16.0,10.0,9.0,8.0,11.0,17.0,14.0,20.0,15.0,10.0,12.0,13.0,15.0,16.0,14.0,15.0,7.0,10.0,16.0,14.0,9.0,17.0,14.0,7.0,8.0,13.0,17.0,0.0,0.0,0.0,0.0,182.0,73.0,1.0,3.0,1.0,3.0,3.0,2.0,2.0,4.0,1.0,2.0,1.0,6.0,11.0,10.0,7.0,12.0,7.0,13.0,7.0,8.0,11.0,12.0,7.0,13.0,11.0,11.0,11.0,14.0,13.0,12.0,11.0,11.0,15.0,12.0,7.0,8.0,11.0,12.0,14.0,12.0,11.0,14.0,10.0,20.0,14.0,13.0,10.0,14.0,12.0,13.0,8.0,11.0,9.0,10.0,7.0,13.0,14.0,13.0,14.0,13.0,14.0,7.0,24.0,0.0,0.0,2.0,0.0,179.0,72.0,2.0,2.0,3.0,3.0,3.0,3.0,1.0,1.0,1.0,2.0,1.0,12.0,14.0,12.0,7.0,13.0,12.0,6.0,10.0,5.0,10.0,13.0,10.0,12.0,13.0,12.0,13.0,11.0,12.0,12.0,12.0,12.0,17.0,8.0,9.0,13.0,11.0,14.0,15.0,14.0,13.0,12.0,7.0,8.0,14.0,13.0,20.0,15.0,10.0,14.0,12.0,14.0,8.0,15.0,11.0,14.0,13.0,9.0,14.0,15.0,15.0,7.0,22.0,0.0,0.0,0.0,0.0,181.0,74.0,1.0,1.0,2.0,3.0,1.0,3.0,3.0,2.0,3.0,2.0,2.0,12.0,13.0,12.0,8.0,13.0,11.0,9.0,11.0,13.0,10.0,12.0,9.0,12.0,13.0,16.0,12.0,14.0,13.0,11.0,11.0,13.0,13.0,12.0,8.0,14.0,10.0,11.0,14.0,14.0,14.0,12.0,11.0,20.0,13.0,15.0,8.0,15.0,12.0,14.0,13.0,11.0,10.0,10.0,13.0,15.0,10.0,12.0,12.0,12.0,13.0,5.0,20.0,0.0,0.0,0.0,0.0,170.0,65.0,1.0,1.0,3.0,3.0,2.0,4.0,1.0,1.0,2.0,2.0,2.0,10.0,9.0,10.0,6.0,12.0,7.0,11.0,10.0,10.0,12.0,11.0,8.0,11.0,10.0,10.0,12.0,11.0,12.0,10.0,10.0,13.0,10.0,3.0,4.0,9.0,12.0,11.0,12.0,13.0,12.0,6.0,7.0,5.0,13.0,12.0,20.0,11.0,7.0,10.0,5.0,10.0,10.0,10.0,15.0,11.0,12.0,13.0,12.0,8.0,10.0,2.0,21.0,0.0,0.0,3.0,0.0,174.0,70.0,3.0,1.0,3.0,3.0,2.0,2.0,1.0,3.0,3.0,2.0,1.0,10.0,11.0,12.0,10.0,13.0,8.0,7.0,11.0,6.0,10.0,14.0,11.0,8.0,13.0,7.0,11.0,11.0,12.0,12.0,14.0,11.0,8.0,11.0,10.0,12.0,8.0,13.0,14.0,13.0,14.0,13.0,9.0,20.0,11.0,12.0,8.0,13.0,11.0,13.0,7.0,10.0,5.0,12.0,13.0,11.0,12.0,9.0,11.0,12.0,10.0,5.0,21.0,0.0,0.0,0.0,0.0,182.0,75.0,4.0,4.0,3.0,1.0,4.0,2.0,1.0,2.0,1.0,1.0,1.0,10.0,13.0,12.0,10.0,14.0,15.0,9.0,15.0,6.0,8.0,14.0,10.0,10.0,14.0,10.0,11.0,12.0,13.0,11.0,13.0,12.0,14.0,11.0,6.0,12.0,10.0,13.0,12.0,15.0,14.0,13.0,11.0,10.0,14.0,12.0,20.0,15.0,12.0,14.0,8.0,13.0,6.0,13.0,8.0,14.0,13.0,11.0,8.0,13.0,16.0,9.0,20.0,0.0,0.0,1.0,0.0,168.0,58.0,2.0,3.0,2.0,1.0,2.0,1.0,2.0,3.0,1.0,3.0,3.0,10.0,13.0,13.0,10.0,14.0,10.0,8.0,8.0,5.0,12.0,14.0,10.0,12.0,13.0,14.0,13.0,12.0,13.0,14.0,13.0,13.0,13.0,12.0,8.0,12.0,12.0,14.0,14.0,14.0,15.0,14.0,6.0,12.0,14.0,13.0,20.0,14.0,7.0,14.0,6.0,12.0,5.0,10.0,9.0,13.0,14.0,13.0,14.0,13.0,15.0,7.0,23.0,0.0,0.0,1.0,0.0,181.0,78.0,1.0,2.0,2.0,3.0,1.0,3.0,1.0,1.0,1.0,2.0,2.0,5.0,12.0,14.0,13.0,14.0,8.0,14.0,12.0,7.0,5.0,12.0,12.0,6.0,14.0,10.0,13.0,10.0,13.0,13.0,11.0,12.0,13.0,11.0,6.0,13.0,10.0,9.0,12.0,16.0,14.0,13.0,10.0,8.0,14.0,15.0,20.0,13.0,14.0,13.0,8.0,7.0,9.0,8.0,16.0,14.0,13.0,12.0,13.0,15.0,15.0,7.0,25.0,33.0,13.0,16.0,6.0,189.0,88.0,2.0,4.0,1.0,2.0,3.0,1.0,2.0,3.0,2.0,1.0,2.0,12.0,13.0,15.0,15.0,15.0,17.0,16.0,16.0,8.0,5.0,14.0,19.0,7.0,16.0,13.0,14.0,12.0,16.0,9.0,14.0,12.0,7.0,15.0,8.0,12.0,5.0,2.0,4.0,13.0,15.0,14.0,14.0,12.0,12.0,15.0,20.0,13.0,15.0,7.0,16.0,13.0,14.0,11.0,8.0,13.0,4.0,11.0,8.0,3.0,4.0,16.0
0,2,23.0,0.0,0.0,0.0,0.0,188.0,85.0,14.0,12.0,12.0,7.0,13.0,10.0,11.0,14.0,7.0,13.0,12.0,2.0,3.0,1.0,3.0,8.0,6.0,2.0,1.0,2.0,2.0,8.0,3.0,1.0,8.0,7.0,10.0,12.0,9.0,11.0,8.0,11.0,14.0,2.0,9.0,1.0,12.0,11.0,8.0,7.0,12.0,14.0,14.0,6.0,14.0,10.0,20.0,12.0,14.0,13.0,7.0,10.0,7.0,1.0,14.0,14.0,9.0,13.0,13.0,10.0,12.0,6.0,23.0,0.0,0.0,0.0,0.0,184.0,71.0,1.0,2.0,1.0,2.0,2.0,2.0,2.0,4.0,2.0,1.0,3.0,4.0,10.0,10.0,6.0,11.0,6.0,14.0,8.0,7.0,14.0,11.0,6.0,13.0,11.0,12.0,12.0,13.0,12.0,11.0,12.0,12.0,14.0,6.0,8.0,10.0,13.0,13.0,14.0,15.0,13.0,14.0,13.0,8.0,12.0,14.0,20.0,13.0,14.0,13.0,12.0,14.0,15.0,8.0,11.0,13.0,13.0,10.0,8.0,9.0,16.0,7.0,28.0,0.0,0.0,0.0,0.0,174.0,67.0,3.0,4.0,1.0,1.0,1.0,3.0,1.0,3.0,2.0,1.0,2.0,11.0,8.0,11.0,9.0,13.0,6.0,7.0,12.0,8.0,10.0,10.0,3.0,6.0,12.0,10.0,13.0,7.0,12.0,8.0,10.0,9.0,12.0,13.0,5.0,12.0,9.0,12.0,11.0,14.0,14.0,11.0,7.0,10.0,15.0,12.0,20.0,11.0,6.0,9.0,6.0,10.0,10.0,9.0,11.0,14.0,9.0,11.0,12.0,8.0,8.0,8.0,21.0,0.0,0.0,0.0,0.0,177.0,0.0,1.0,1.0,1.0,2.0,3.0,3.0,2.0,3.0,2.0,2.0,3.0,6.0,4.0,13.0,13.0,13.0,6.0,13.0,7.0,3.0,5.0,7.0,6.0,1.0,11.0,9.0,7.0,8.0,7.0,7.0,7.0,8.0,7.0,11.0,8.0,13.0,7.0,6.0,7.0,12.0,13.0,7.0,6.0,8.0,8.0,13.0,20.0,5.0,5.0,9.0,5.0,9.0,9.0,9.0,10.0,10.0,12.0,12.0,11.0,10.0,9.0,6.0,21.0,0.0,0.0,0.0,0.0,178.0,65.0,2.0,3.0,3.0,3.0,3.0,1.0,1.0,1.0,1.0,3.0,1.0,9.0,13.0,11.0,6.0,12.0,7.0,9.0,8.0,8.0,13.0,12.0,7.0,13.0,12.0,8.0,12.0,13.0,12.0,12.0,13.0,13.0,14.0,9.0,8.0,12.0,12.0,13.0,13.0,12.0,14.0,13.0,11.0,8.0,15.0,12.0,20.0,13.0,12.0,14.0,8.0,11.0,7.0,10.0,19.0,10.0,13.0,10.0,11.0,15.0,15.0,6.0,32.0,22.0,1.0,6.0,1.0,186.0,79.0,1.0,2.0,1.0,1.0,2.0,3.0,1.0,2.0,1.0,2.0,1.0,11.0,12.0,13.0,11.0,13.0,11.0,14.0,11.0,8.0,12.0,13.0,13.0,13.0,13.0,14.0,13.0,14.0,14.0,13.0,14.0,13.0,12.0,13.0,14.0,15.0,13.0,12.0,15.0,12.0,13.0,12.0,12.0,10.0,12.0,13.0,20.0,15.0,13.0,14.0,5.0,12.0,9.0,17.0,8.0,12.0,8.0,13.0,10.0,10.0,10.0,5.0,21.0,0.0,0.0,0.0,0.0,172.0,66.0,2.0,3.0,2.0,2.0,1.0,1.0,1.0,3.0,2.0,1.0,1.0,10.0,10.0,13.0,9.0,14.0,9.0,8.0,10.0,7.0,13.0,13.0,9.0,12.0,13.0,10.0,12.0,13.0,13.0,12.0,14.0,13.0,13.0,11.0,9.0,14.0,13.0,14.0,14.0,14.0,13.0,12.0,8.0,8.0,12.0,12.0,20.0,13.0,12.0,14.0,10.0,11.0,8.0,12.0,15.0,10.0,15.0,8.0,11.0,14.0,14.0,6.0,19.0,0.0,0.0,0.0,0.0,179.0,66.0,1.0,3.0,3.0,1.0,1.0,3.0,3.0,1.0,2.0,3.0,2.0,13.0,11.0,14.0,10.0,14.0,13.0,9.0,10.0,4.0,7.0,13.0,11.0,9.0,15.0,10.0,12.0,10.0,13.0,10.0,13.0,12.0,14.0,13.0,10.0,13.0,12.0,11.0,11.0,12.0,14.0,12.0,6.0,10.0,12.0,13.0,20.0,12.0,10.0,12.0,11.0,11.0,11.0,11.0,11.0,14.0,12.0,11.0,13.0,11.0,13.0,10.0,24.0,0.0,0.0,0.0,0.0,172.0,72.0,1.0,1.0,3.0,2.0,2.0,1.0,1.0,1.0,1.0,3.0,1.0,10.0,11.0,12.0,10.0,11.0,8.0,8.0,10.0,7.0,7.0,11.0,11.0,6.0,12.0,8.0,11.0,11.0,10.0,10.0,11.0,12.0,15.0,12.0,5.0,10.0,11.0,13.0,15.0,15.0,13.0,10.0,9.0,8.0,14.0,13.0,20.0,14.0,11.0,11.0,8.0,13.0,7.0,12.0,18.0,13.0,10.0,10.0,11.0,11.0,11.0,6.0,24.0,4.0,1.0,0.0,0.0,188.0,79.0,2.0,3.0,2.0,1.0,2.0,1.0,1.0,2.0,1.0,2.0,2.0,10.0,11.0,13.0,12.0,11.0,9.0,13.0,9.0,5.0,8.0,11.0,11.0,7.0,13.0,10.0,12.0,11.0,11.0,12.0,13.0,11.0,14.0,12.0,9.0,12.0,12.0,14.0,14.0,12.0,13.0,15.0,14.0,8.0,13.0,12.0,20.0,13.0,14.0,11.0,9.0,10.0,5.0,10.0,14.0,12.0,13.0,10.0,14.0,13.0,12.0,10.0,25.0,0.0,0.0,0.0,0.0,187.0,83.0,2.0,1.0,3.0,3.0,1.0,3.0,3.0,3.0,1.0,1.0,3.0,4.0,8.0,10.0,14.0,12.0,8.0,14.0,9.0,5.0,7.0,11.0,13.0,5.0,12.0,11.0,13.0,13.0,13.0,11.0,10.0,12.0,16.0,9.0,8.0,13.0,11.0,13.0,16.0,14.0,13.0,15.0,13.0,20.0,14.0,12.0,8.0,14.0,16.0,13.0,11.0,13.0,7.0,5.0,13.0,14.0,13.0,14.0,14.0,13.0,13.0,6.0,25.0,0.0,0.0,11.0,0.0,189.0,83.0,12.0,12.0,11.0,7.0,13.0,12.0,17.0,17.0,16.0,12.0,13.0,6.0,2.0,1.0,1.0,10.0,10.0,7.0,1.0,1.0,1.0,9.0,5.0,1.0,10.0,8.0,15.0,14.0,14.0,12.0,7.0,13.0,12.0,6.0,9.0,3.0,16.0,17.0,10.0,13.0,16.0,14.0,12.0,8.0,15.0,10.0,20.0,13.0,14.0,14.0,5.0,14.0,4.0,12.0,15.0,15.0,13.0,13.0,17.0,15.0,17.0,4.0,31.0,0.0,0.0,0.0,0.0,171.0,65.0,1.0,3.0,1.0,3.0,2.0,2.0,3.0,1.0,2.0,2.0,3.0,8.0,9.0,11.0,7.0,5.0,6.0,5.0,6.0,7.0,14.0,14.0,6.0,14.0,13.0,14.0,12.0,13.0,12.0,11.0,11.0,12.0,12.0,11.0,7.0,12.0,12.0,12.0,10.0,15.0,15.0,7.0,9.0,9.0,12.0,14.0,20.0,12.0,13.0,11.0,13.0,11.0,9.0,10.0,15.0,14.0,12.0,11.0,14.0,13.0,12.0,7.0,29.0,0.0,0.0,0.0,0.0,170.0,65.0,2.0,1.0,3.0,3.0,1.0,3.0,2.0,1.0,2.0,3.0,2.0,5.0,11.0,4.0,6.0,7.0,4.0,7.0,5.0,6.0,6.0,6.0,2.0,6.0,7.0,9.0,10.0,13.0,8.0,12.0,8.0,13.0,15.0,2.0,7.0,5.0,9.0,8.0,8.0,12.0,12.0,14.0,4.0,9.0,12.0,11.0,20.0,12.0,5.0,9.0,9.0,9.0,9.0,9.0,10.0,12.0,12.0,12.0,12.0,7.0,5.0,8.0,28.0,0.0,0.0,0.0,0.0,169.0,0.0,3.0,3.0,2.0,3.0,3.0,1.0,1.0,3.0,2.0,1.0,3.0,5.0,8.0,11.0,9.0,8.0,8.0,7.0,8.0,4.0,2.0,9.0,5.0,3.0,11.0,11.0,11.0,13.0,9.0,11.0,8.0,15.0,14.0,11.0,7.0,10.0,8.0,8.0,10.0,11.0,11.0,6.0,5.0,14.0,11.0,12.0,20.0,14.0,5.0,9.0,12.0,9.0,5.0,6.0,9.0,12.0,11.0,9.0,9.0,10.0,12.0,11.0,24.0,9.0,0.0,7.0,1.0,190.0,82.0,2.0,2.0,3.0,3.0,1.0,2.0,2.0,1.0,1.0,3.0,1.0,8.0,14.0,13.0,11.0,12.0,10.0,12.0,11.0,9.0,11.0,13.0,8.0,13.0,13.0,10.0,14.0,14.0,13.0,13.0,14.0,14.0,16.0,11.0,6.0,12.0,12.0,16.0,16.0,12.0,11.0,11.0,14.0,8.0,14.0,14.0,20.0,15.0,13.0,14.0,9.0,13.0,8.0,14.0,13.0,14.0,12.0,14.0,16.0,12.0,15.0,2.0,33.0,30.0,1.0,0.0,0.0,187.0,83.0,1.0,3.0,4.0,2.0,1.0,1.0,2.0,3.0,1.0,1.0,3.0,13.0,13.0,12.0,8.0,16.0,10.0,16.0,13.0,10.0,14.0,16.0,13.0,16.0,15.0,13.0,15.0,14.0,16.0,15.0,14.0,14.0,13.0,11.0,13.0,10.0,17.0,18.0,10.0,10.0,12.0,17.0,14.0,20.0,12.0,12.0,10.0,13.0,16.0,16.0,16.0,15.0,13.0,11.0,16.0,16.0,13.0,15.0,12.0,8.0,8.0,11.0,23.0,15.0,1.0,7.0,0.0,165.0,60.0,2.0,3.0,2.0,1.0,1.0,1.0,3.0,3.0,2.0,1.0,3.0,14.0,14.0,16.0,8.0,16.0,13.0,6.0,10.0,6.0,11.0,18.0,15.0,12.0,18.0,16.0,15.0,15.0,17.0,13.0,17.0,15.0,14.0,18.0,12.0,10.0,12.0,15.0,16.0,14.0,16.0,16.0,6.0,12.0,13.0,14.0,20.0,15.0,11.0,16.0,14.0,15.0,10.0,12.0,14.0,15.0,16.0,14.0,14.0,13.0,10.0,6.0,29.0,51.0,8.0,24.0,0.0,175.0,70.0,3.0,4.0,2.0,3.0,2.0,3.0,2.0,2.0,2.0,1.0,3.0,6.0,12.0,12.0,10.0,13.0,7.0,12.0,12.0,8.0,14.0,13.0,9.0,16.0,13.0,14.0,16.0,16.0,15.0,16.0,11.0,14.0,16.0,8.0,14.0,14.0,15.0,18.0,18.0,15.0,14.0,16.0,8.0,20.0,16.0,14.0,8.0,18.0,14.0,16.0,13.0,14.0,7.0,14.0,15.0,14.0,14.0,14.0,16.0,16.0,16.0,5.0,22.0,24.0,2.0,1.0,1.0,187.0,75.0,1.0,2.0,1.0,1.0,2.0,1.0,2.0,1.0,2.0,3.0,3.0,13.0,13.0,16.0,13.0,17.0,10.0,9.0,17.0,8.0,6.0,14.0,10.0,8.0,16.0,10.0,12.0,9.0,12.0,10.0,15.0,11.0,10.0,15.0,7.0,13.0,8.0,12.0,11.0,15.0,14.0,10.0,16.0,18.0,12.0,13.0,20.0,14.0,11.0,8.0,5.0,15.0,12.0,13.0,11.0,17.0,8.0,10.0,16.0,12.0,14.0,13.0,16.0,0.0,0.0,0.0,0.0,173.0,0.0,3.0,1.0,1.0,1.0,2.0,1.0,4.0,1.0,2.0,3.0,1.0,1.0,1.0,4.0,4.0,5.0,4.0,4.0,4.0,1.0,5.0,6.0,5.0,8.0,9.0,10.0,6.0,6.0,3.0,5.0,4.0,10.0,7.0,8.0,8.0,3.0,11.0,13.0,9.0,7.0,5.0,14.0,4.0,20.0,6.0,5.0,8.0,6.0,9.0,5.0,7.0,8.0,5.0,7.0,6.0,11.0,7.0,10.0,18.0,19.0,15.0,9.0,29.0,76.0,27.0,13.0,9.0,188.0,72.0,2.0,3.0,1.0,2.0,3.0,3.0,1.0,3.0,3.0,3.0,3.0,5.0,10.0,13.0,16.0,13.0,11.0,17.0,13.0,5.0,10.0,13.0,14.0,10.0,13.0,15.0,16.0,18.0,14.0,15.0,10.0,13.0,14.0,13.0,10.0,18.0,12.0,14.0,19.0,15.0,14.0,16.0,14.0,10.0,18.0,16.0,20.0,18.0,14.0,14.0,8.0,15.0,5.0,16.0,10.0,16.0,12.0,14.0,16.0,14.0,10.0,10.0
1,1,30.0,0.0,0.0,0.0,0.0,180.0,75.0,11.0,13.0,13.0,9.0,13.0,11.0,12.0,15.0,15.0,14.0,13.0,6.0,1.0,2.0,3.0,7.0,8.0,1.0,1.0,1.0,2.0,7.0,2.0,1.0,7.0,8.0,12.0,14.0,13.0,14.0,7.0,12.0,14.0,5.0,12.0,3.0,13.0,15.0,9.0,13.0,14.0,13.0,10.0,5.0,14.0,11.0,20.0,12.0,13.0,12.0,8.0,14.0,6.0,1.0,9.0,13.0,14.0,13.0,16.0,15.0,15.0,5.0,21.0,0.0,0.0,0.0,0.0,182.0,74.0,2.0,2.0,2.0,2.0,2.0,1.0,1.0,1.0,3.0,2.0,2.0,9.0,11.0,12.0,7.0,9.0,8.0,12.0,7.0,11.0,12.0,7.0,8.0,13.0,11.0,12.0,12.0,14.0,12.0,13.0,7.0,12.0,11.0,1.0,9.0,11.0,9.0,10.0,12.0,14.0,10.0,13.0,11.0,9.0,8.0,12.0,20.0,13.0,11.0,10.0,13.0,8.0,10.0,10.0,15.0,11.0,13.0,10.0,10.0,8.0,13.0,7.0,24.0,0.0,0.0,4.0,0.0,186.0,88.0,1.0,2.0,1.0,3.0,2.0,1.0,1.0,2.0,1.0,2.0,1.0,4.0,8.0,8.0,6.0,12.0,6.0,14.0,9.0,11.0,14.0,12.0,6.0,12.0,12.0,14.0,13.0,14.0,12.0,13.0,8.0,12.0,13.0,8.0,8.0,9.0,12.0,12.0,13.0,13.0,11.0,15.0,13.0,8.0,15.0,14.0,20.0,14.0,15.0,13.0,14.0,15.0,8.0,12.0,14.0,14.0,12.0,9.0,12.0,13.0,13.0,8.0,30.0,0.0,0.0,6.0,0.0,181.0,78.0,2.0,1.0,1.0,1.0,2.0,3.0,1.0,1.0,2.0,1.0,3.0,8.0,13.0,10.0,6.0,11.0,9.0,12.0,14.0,13.0,14.0,10.0,8.0,14.0,12.0,10.0,12.0,13.0,13.0,13.0,10.0,11.0,10.0,6.0,13.0,8.0,15.0,14.0,13.0,13.0,12.0,14.0,10.0,20.0,15.0,11.0,8.0,13.0,14.0,11.0,10.0,13.0,6.0,8.0,10.0,12.0,14.0,8.0,15.0,15.0,15.0,9.0,28.0,22.0,0.0,20.0,1.0,176.0,74.0,2.0,3.0,2.0,1.0,1.0,1.0,3.0,3.0,2.0,2.0,1.0,15.0,15.0,12.0,8.0,13.0,12.0,5.0,11.0,15.0,10.0,13.0,9.0,10.0,12.0,10.0,11.0,10.0,13.0,12.0,11.0,12.0,11.0,11.0,7.0,13.0,10.0,14.0,15.0,15.0,14.0,10.0,8.0,20.0,13.0,14.0,8.0,15.0,8.0,14.0,5.0,12.0,5.0,14.0,15.0,15.0,10.0,14.0,13.0,12.0,12.0,2.0,27.0,32.0,6.0,0.0,0.0,188.0,78.0,3.0,2.0,3.0,2.0,1.0,3.0,3.0,3.0,2.0,2.0,2.0,4.0,8.0,11.0,12.0,12.0,6.0,16.0,13.0,8.0,13.0,14.0,7.0,12.0,12.0,12.0,10.0,14.0,13.0,12.0,11.0,12.0,15.0,9.0,11.0,12.0,6.0,13.0,12.0,14.0,13.0,15.0,15.0,5.0,13.0,12.0,20.0,16.0,15.0,14.0,12.0,15.0,11.0,10.0,9.0,15.0,12.0,12.0,13.0,13.0,13.0,7.0,22.0,0.0,0.0,4.0,0.0,179.0,71.0,1.0,3.0,1.0,3.0,2.0,1.0,3.0,2.0,1.0,2.0,4.0,11.0,13.0,12.0,8.0,15.0,11.0,6.0,11.0,6.0,4.0,14.0,12.0,6.0,16.0,7.0,12.0,10.0,12.0,11.0,13.0,13.0,13.0,9.0,6.0,12.0,9.0,15.0,12.0,13.0,14.0,12.0,9.0,20.0,14.0,12.0,10.0,13.0,10.0,13.0,7.0,14.0,7.0,8.0,18.0,13.0,14.0,14.0,16.0,15.0,15.0,5.0,32.0,25.0,0.0,0.0,0.0,181.0,82.0,2.0,3.0,3.0,1.0,1.0,1.0,1.0,3.0,1.0,2.0,3.0,5.0,10.0,6.0,7.0,10.0,7.0,14.0,9.0,8.0,11.0,12.0,7.0,13.0,10.0,15.0,14.0,16.0,11.0,13.0,10.0,12.0,16.0,9.0,15.0,8.0,11.0,16.0,18.0,11.0,12.0,14.0,11.0,8.0,13.0,11.0,20.0,17.0,15.0,13.0,15.0,11.0,6.0,14.0,18.0,12.0,13.0,13.0,14.0,11.0,11.0,8.0,25.0,24.0,7.0,0.0,0.0,180.0,75.0,1.0,2.0,1.0,1.0,1.0,2.0,3.0,1.0,3.0,1.0,3.0,6.0,10.0,14.0,11.0,14.0,10.0,9.0,12.0,6.0,3.0,13.0,11.0,2.0,16.0,7.0,12.0,12.0,12.0,10.0,12.0,11.0,13.0,16.0,6.0,13.0,5.0,8.0,8.0,16.0,14.0,13.0,10.0,10.0,13.0,14.0,20.0,13.0,12.0,12.0,7.0,14.0,11.0,8.0,17.0,14.0,13.0,13.0,12.0,15.0,15.0,7.0,34.0,0.0,0.0,0.0,0.0,176.0,65.0,2.0,3.0,3.0,3.0,2.0,2.0,1.0,2.0,1.0,1.0,2.0,14.0,15.0,13.0,10.0,15.0,13.0,6.0,15.0,10.0,3.0,14.0,13.0,6.0,14.0,8.0,12.0,9.0,13.0,12.0,14.0,13.0,11.0,12.0,7.0,13.0,8.0,14.0,15.0,14.0,13.0,12.0,8.0,20.0,14.0,13.0,10.0,12.0,7.0,13.0,8.0,15.0,7.0,6.0,13.0,14.0,14.0,9.0,14.0,14.0,11.0,10.0,19.0,0.0,0.0,0.0,0.0,173.0,67.0,3.0,2.0,4.0,2.0,1.0,1.0,3.0,1.0,1.0,1.0,2.0,13.0,13.0,15.0,10.0,14.0,11.0,6.0,12.0,4.0,4.0,12.0,11.0,5.0,14.0,10.0,12.0,9.0,10.0,8.0,12.0,8.0,11.0,15.0,5.0,12.0,6.0,8.0,10.0,16.0,15.0,13.0,7.0,8.0,13.0,15.0,20.0,11.0,9.0,12.0,6.0,12.0,6.0,15.0,8.0,13.0,8.0,12.0,9.0,14.0,13.0,9.0,36.0,0.0,0.0,0.0,0.0,185.0,78.0,11.0,14.0,12.0,7.0,13.0,12.0,14.0,15.0,13.0,14.0,10.0,4.0,1.0,3.0,1.0,8.0,8.0,11.0,8.0,3.0,3.0,7.0,2.0,1.0,8.0,11.0,13.0,15.0,11.0,12.0,7.0,13.0,9.0,5.0,14.0,3.0,13.0,15.0,8.0,11.0,14.0,13.0,12.0,5.0,15.0,11.0,20.0,12.0,14.0,13.0,11.0,13.0,8.0,1.0,19.0,14.0,16.0,10.0,17.0,9.0,9.0,11.0,34.0,23.0,1.0,0.0,0.0,186.0,81.0,3.0,3.0,1.0,2.0,1.0,3.0,2.0,3.0,1.0,3.0,3.0,4.0,8.0,6.0,10.0,7.0,8.0,17.0,12.0,10.0,14.0,7.0,9.0,15.0,7.0,15.0,13.0,17.0,8.0,12.0,7.0,12.0,15.0,6.0,17.0,7.0,14.0,15.0,14.0,8.0,10.0,16.0,13.0,12.0,13.0,9.0,20.0,13.0,15.0,11.0,15.0,14.0,9.0,10.0,10.0,14.0,11.0,13.0,15.0,11.0,11.0,12.0,28.0,0.0,0.0,0.0,0.0,183.0,81.0,1.0,2.0,4.0,1.0,1.0,3.0,2.0,3.0,3.0,3.0,1.0,5.0,5.0,6.0,10.0,12.0,6.0,14.0,8.0,6.0,15.0,11.0,6.0,13.0,12.0,13.0,14.0,16.0,14.0,14.0,10.0,12.0,14.0,5.0,14.0,8.0,14.0,15.0,15.0,9.0,12.0,15.0,13.0,7.0,11.0,12.0,20.0,15.0,15.0,14.0,14.0,14.0,9.0,8.0,14.0,14.0,11.0,13.0,15.0,13.0,15.0,6.0,21.0,0.0,0.0,1.0,0.0,177.0,68.0,4.0,1.0,2.0,1.0,1.0,1.0,1.0,1.0,2.0,1.0,2.0,5.0,12.0,9.0,7.0,12.0,8.0,13.0,10.0,16.0,13.0,12.0,8.0,14.0,12.0,12.0,13.0,12.0,12.0,12.0,10.0,13.0,15.0,11.0,13.0,11.0,13.0,13.0,14.0,13.0,14.0,13.0,11.0,10.0,14.0,12.0,20.0,12.0,14.0,12.0,11.0,12.0,8.0,14.0,13.0,10.0,14.0,12.0,14.0,12.0,11.0,5.0,27.0,14.0,1.0,0.0,0.0,183.0,77.0,1.0,2.0,1.0,2.0,3.0,2.0,3.0,2.0,2.0,1.0,1.0,5.0,12.0,9.0,8.0,13.0,10.0,13.0,10.0,6.0,14.0,13.0,6.0,13.0,12.0,14.0,13.0,15.0,11.0,11.0,11.0,11.0,13.0,9.0,8.0,9.0,12.0,14.0,16.0,14.0,12.0,14.0,12.0,7.0,14.0,12.0,20.0,15.0,14.0,14.0,14.0,15.0,7.0,10.0,12.0,13.0,14.0,12.0,13.0,11.0,11.0,7.0,30.0,0.0,0.0,0.0,0.0,167.0,60.0,3.0,1.0,1.0,2.0,3.0,1.0,1.0,3.0,1.0,1.0,3.0,10.0,11.0,12.0,8.0,13.0,10.0,6.0,9.0,10.0,12.0,14.0,9.0,10.0,14.0,11.0,14.0,14.0,14.0,14.0,13.0,14.0,12.0,14.0,11.0,13.0,12.0,15.0,15.0,15.0,14.0,11.0,5.0,11.0,11.0,15.0,20.0,11.0,8.0,14.0,10.0,12.0,13.0,11.0,11.0,12.0,11.0,10.0,12.0,11.0,11.0,2.0,23.0,27.0,1.0,0.0,0.0,178.0,70.0,1.0,2.0,1.0,4.0,1.0,1.0,1.0,3.0,2.0,1.0,1.0,8.0,11.0,13.0,11.0,13.0,12.0,7.0,14.0,6.0,5.0,12.0,10.0,5.0,14.0,11.0,11.0,12.0,11.0,9.0,13.0,10.0,14.0,14.0,5.0,13.0,7.0,10.0,12.0,15.0,14.0,12.0,9.0,20.0,13.0,13.0,8.0,13.0,13.0,12.0,11.0,11.0,10.0,11.0,12.0,12.0,12.0,11.0,10.0,10.0,10.0,6.0,33.0,0.0,0.0,0.0,0.0,187.0,76.0,2.0,2.0,3.0,1.0,1.0,3.0,2.0,1.0,2.0,3.0,2.0,15.0,14.0,14.0,10.0,15.0,13.0,10.0,12.0,7.0,4.0,15.0,13.0,7.0,15.0,6.0,12.0,9.0,14.0,11.0,15.0,12.0,12.0,14.0,12.0,13.0,7.0,13.0,12.0,11.0,12.0,14.0,12.0,14.0,15.0,12.0,20.0,11.0,12.0,12.0,6.0,14.0,6.0,11.0,14.0,13.0,12.0,12.0,15.0,15.0,13.0,9.0,24.0,1.0,0.0,0.0,0.0,187.0,85.0,1.0,2.0,2.0,1.0,1.0,3.0,3.0,1.0,3.0,3.0,3.0,6.0,7.0,13.0,13.0,12.0,7.0,13.0,12.0,8.0,6.0,10.0,12.0,4.0,12.0,11.0,11.0,13.0,10.0,11.0,8.0,10.0,14.0,9.0,5.0,14.0,4.0,12.0,15.0,14.0,13.0,15.0,13.0,6.0,12.0,14.0,20.0,12.0,15.0,14.0,6.0,5.0,10.0,8.0,9.0,12.0,11.0,11.0,13.0,12.0,10.0,1.0,30.0,0.0,0.0,0.0,0.0,178.0,73.0,3.0,4.0,1.0,1.0,2.0,4.0,3.0,2.0,2.0,2.0,3.0,13.0,14.0,12.0,7.0,13.0,12.0,7.0,13.0,5.0,10.0,13.0,9.0,10.0,13.0,11.0,11.0,12.0,12.0,13.0,11.0,14.0,14.0,11.0,7.0,11.0,10.0,13.0,15.0,13.0,15.0,15.0,8.0,20.0,14.0,14.0,8.0,14.0,11.0,13.0,11.0,14.0,8.0,10.0,19.0,12.0,12.0,9.0,12.0,12.0,10.0,10.0,26.0,0.0,0.0,0.0,0.0,193.0,81.0,1.0,3.0,3.0,3.0,3.0,1.0,2.0,2.0,2.0,3.0,3.0,4.0,9.0,14.0,10.0,13.0,12.0,14.0,14.0,5.0,5.0,10.0,12.0,3.0,14.0,8.0,13.0,12.0,9.0,10.0,11.0,11.0,12.0,16.0,5.0,14.0,6.0,9.0,12.0,14.0,13.0,14.0,16.0,14.0,13.0,13.0,20.0,13.0,14.0,10.0,8.0,14.0,9.0,8.0,16.0,16.0,11.0,13.0,11.0,13.0,13.0,10.0
1,1,25.0,0.0,0.0,11.0,0.0,189.0,83.0,12.0,12.0,11.0,7.0,13.0,12.0,17.0,17.0,16.0,12.0,13.0,6.0,2.0,1.0,1.0,10.0,10.0,7.0,1.0,1.0,1.0,9.0,5.0,1.0,10.0,8.0,15.0,14.0,14.0,12.0,7.0,13.0,12.0,6.0,9.0,3.0,16.0,17.0,10.0,13.0,16.0,14.0,12.0,8.0,15.0,10.0,20.0,13.0,14.0,14.0,5.0,14.0,4.0,12.0,15.0,15.0,13.0,13.0,17.0,15.0,17.0,4.0,31.0,0.0,0.0,0.0,0.0,171.0,65.0,1.0,3.0,1.0,3.0,2.0,2.0,3.0,1.0,2.0,2.0,3.0,8.0,9.0,11.0,7.0,5.0,6.0,5.0,6.0,7.0,14.0,14.0,6.0,14.0,13.0,14.0,12.0,13.0,12.0,11.0,11.0,12.0,12.0,11.0,7.0,12.0,12.0,12.0,10.0,15.0,15.0,7.0,9.0,9.0,12.0,14.0,20.0,12.0,13.0,11.0,13.0,11.0,9.0,10.0,15.0,14.0,12.0,11.0,14.0,13.0,12.0,7.0,29.0,0.0,0.0,0.0,0.0,170.0,65.0,2.0,1.0,3.0,3.0,1.0,3.0,2.0,1.0,2.0,3.0,2.0,5.0,11.0,4.0,6.0,7.0,4.0,7.0,5.0,6.0,6.0,6.0,2.0,6.0,7.0,9.0,10.0,13.0,8.0,12.0,8.0,13.0,15.0,2.0,7.0,5.0,9.0,8.0,8.0,12.0,12.0,14.0,4.0,9.0,12.0,11.0,20.0,12.0,5.0,9.0,9.0,9.0,9.0,9.0,10.0,12.0,12.0,12.0,12.0,7.0,5.0,8.0,23.0,2.0,0.0,5.0,3.0,182.0,73.0,3.0,1.0,1.0,1.0,2.0,1.0,2.0,1.0,3.0,4.0,2.0,12.0,14.0,14.0,10.0,13.0,12.0,16.0,11.0,13.0,12.0,13.0,13.0,14.0,14.0,12.0,11.0,14.0,13.0,11.0,13.0,11.0,15.0,15.0,9.0,15.0,10.0,14.0,15.0,16.0,15.0,13.0,13.0,20.0,14.0,15.0,6.0,15.0,12.0,13.0,9.0,13.0,14.0,15.0,17.0,15.0,13.0,12.0,12.0,15.0,13.0,9.0,24.0,9.0,0.0,7.0,1.0,190.0,82.0,2.0,2.0,3.0,3.0,1.0,2.0,2.0,1.0,1.0,3.0,1.0,8.0,14.0,13.0,11.0,12.0,10.0,12.0,11.0,9.0,11.0,13.0,8.0,13.0,13.0,10.0,14.0,14.0,13.0,13.0,14.0,14.0,16.0,11.0,6.0,12.0,12.0,16.0,16.0,12.0,11.0,11.0,14.0,8.0,14.0,14.0,20.0,15.0,13.0,14.0,9.0,13.0,8.0,14.0,13.0,14.0,12.0,14.0,16.0,12.0,15.0,2.0,33.0,30.0,1.0,0.0,0.0,187.0,83.0,1.0,3.0,4.0,2.0,1.0,1.0,2.0,3.0,1.0,1.0,3.0,13.0,13.0,12.0,8.0,16.0,10.0,16.0,13.0,10.0,14.0,16.0,13.0,16.0,15.0,13.0,15.0,14.0,16.0,15.0,14.0,14.0,13.0,11.0,13.0,10.0,17.0,18.0,10.0,10.0,12.0,17.0,14.0,20.0,12.0,12.0,10.0,13.0,16.0,16.0,16.0,15.0,13.0,11.0,16.0,16.0,13.0,15.0,12.0,8.0,8.0,11.0,29.0,51.0,8.0,24.0,0.0,175.0,70.0,3.0,4.0,2.0,3.0,2.0,3.0,2.0,2.0,2.0,1.0,3.0,6.0,12.0,12.0,10.0,13.0,7.0,12.0,12.0,8.0,14.0,13.0,9.0,16.0,13.0,14.0,16.0,16.0,15.0,16.0,11.0,14.0,16.0,8.0,14.0,14.0,15.0,18.0,18.0,15.0,14.0,16.0,8.0,20.0,16.0,14.0,8.0,18.0,14.0,16.0,13.0,14.0,7.0,14.0,15.0,14.0,14.0,14.0,16.0,16.0,16.0,5.0,21.0,0.0,0.0,15.0,1.0,189.0,75.0,3.0,3.0,3.0,3.0,1.0,1.0,3.0,3.0,3.0,2.0,3.0,10.0,12.0,13.0,7.0,14.0,8.0,14.0,12.0,5.0,13.0,15.0,8.0,15.0,14.0,14.0,14.0,15.0,14.0,14.0,13.0,14.0,15.0,12.0,10.0,12.0,14.0,15.0,16.0,12.0,13.0,15.0,14.0,20.0,14.0,13.0,10.0,16.0,13.0,14.0,11.0,14.0,7.0,10.0,8.0,16.0,10.0,12.0,13.0,13.0,11.0,14.0,16.0,0.0,0.0,0.0,0.0,173.0,0.0,3.0,1.0,1.0,1.0,2.0,1.0,4.0,1.0,2.0,3.0,1.0,1.0,1.0,4.0,4.0,5.0,4.0,4.0,4.0,1.0,5.0,6.0,5.0,8.0,9.0,10.0,6.0,6.0,3.0,5.0,4.0,10.0,7.0,8.0,8.0,3.0,11.0,13.0,9.0,7.0,5.0,14.0,4.0,20.0,6.0,5.0,8.0,6.0,9.0,5.0,7.0,8.0,5.0,7.0,6.0,11.0,7.0,10.0,18.0,19.0,15.0,9.0,22.0,24.0,2.0,1.0,1.0,187.0,75.0,1.0,2.0,1.0,1.0,2.0,1.0,2.0,1.0,2.0,3.0,3.0,13.0,13.0,16.0,13.0,17.0,10.0,9.0,17.0,8.0,6.0,14.0,10.0,8.0,16.0,10.0,12.0,9.0,12.0,10.0,15.0,11.0,10.0,15.0,7.0,13.0,8.0,12.0,11.0,15.0,14.0,10.0,16.0,18.0,12.0,13.0,20.0,14.0,11.0,8.0,5.0,15.0,12.0,13.0,11.0,17.0,8.0,10.0,16.0,12.0,14.0,13.0,29.0,76.0,27.0,13.0,9.0,188.0,72.0,2.0,3.0,1.0,2.0,3.0,3.0,1.0,3.0,3.0,3.0,3.0,5.0,10.0,13.0,16.0,13.0,11.0,17.0,13.0,5.0,10.0,13.0,14.0,10.0,13.0,15.0,16.0,18.0,14.0,15.0,10.0,13.0,14.0,13.0,10.0,18.0,12.0,14.0,19.0,15.0,14.0,16.0,14.0,10.0,18.0,16.0,20.0,18.0,14.0,14.0,8.0,15.0,5.0,16.0,10.0,16.0,12.0,14.0,16.0,14.0,10.0,10.0,31.0,25.0,0.0,6.0,0.0,191.0,84.0,11.0,14.0,13.0,12.0,15.0,14.0,15.0,16.0,13.0,14.0,14.0,8.0,2.0,10.0,5.0,11.0,11.0,7.0,10.0,2.0,5.0,10.0,11.0,11.0,9.0,12.0,13.0,15.0,13.0,13.0,8.0,13.0,16.0,12.0,14.0,1.0,16.0,13.0,11.0,12.0,13.0,16.0,16.0,8.0,16.0,13.0,20.0,15.0,15.0,17.0,8.0,15.0,7.0,2.0,15.0,15.0,17.0,15.0,17.0,16.0,15.0,6.0,23.0,0.0,0.0,0.0,0.0,184.0,77.0,1.0,1.0,1.0,1.0,3.0,2.0,3.0,2.0,2.0,2.0,3.0,6.0,9.0,11.0,7.0,12.0,7.0,15.0,9.0,11.0,14.0,13.0,10.0,15.0,12.0,14.0,15.0,15.0,13.0,12.0,11.0,13.0,15.0,11.0,9.0,9.0,14.0,14.0,14.0,14.0,13.0,15.0,13.0,9.0,16.0,15.0,20.0,14.0,14.0,14.0,11.0,14.0,4.0,11.0,14.0,13.0,15.0,14.0,16.0,14.0,15.0,6.0,28.0,46.0,3.0,14.0,3.0,190.0,80.0,2.0,3.0,3.0,2.0,2.0,1.0,1.0,3.0,1.0,3.0,1.0,4.0,6.0,7.0,9.0,11.0,7.0,17.0,11.0,10.0,15.0,12.0,11.0,16.0,10.0,17.0,15.0,18.0,13.0,14.0,12.0,14.0,18.0,6.0,17.0,8.0,15.0,15.0,14.0,11.0,10.0,17.0,16.0,7.0,17.0,13.0,20.0,15.0,18.0,17.0,14.0,16.0,4.0,6.0,14.0,15.0,16.0,17.0,18.0,14.0,15.0,6.0,23.0,0.0,0.0,1.0,0.0,182.0,71.0,3.0,1.0,2.0,3.0,4.0,2.0,3.0,1.0,2.0,1.0,3.0,9.0,13.0,14.0,8.0,14.0,13.0,12.0,10.0,13.0,14.0,14.0,13.0,15.0,13.0,14.0,14.0,13.0,11.0,12.0,12.0,13.0,16.0,12.0,12.0,15.0,13.0,14.0,15.0,15.0,13.0,14.0,12.0,9.0,16.0,15.0,20.0,15.0,15.0,15.0,10.0,14.0,6.0,12.0,8.0,15.0,14.0,16.0,15.0,15.0,16.0,6.0,21.0,0.0,0.0,9.0,0.0,185.0,75.0,1.0,1.0,2.0,2.0,2.0,1.0,1.0,4.0,2.0,3.0,2.0,11.0,15.0,14.0,7.0,13.0,9.0,11.0,11.0,14.0,13.0,13.0,10.0,14.0,13.0,15.0,12.0,13.0,10.0,11.0,11.0,12.0,14.0,11.0,10.0,14.0,12.0,13.0,15.0,15.0,13.0,14.0,13.0,20.0,14.0,16.0,8.0,15.0,15.0,13.0,13.0,12.0,9.0,10.0,14.0,14.0,13.0,12.0,12.0,13.0,9.0,9.0,21.0,0.0,0.0,9.0,0.0,184.0,72.0,1.0,3.0,1.0,2.0,3.0,2.0,1.0,1.0,2.0,1.0,2.0,6.0,10.0,12.0,7.0,12.0,7.0,14.0,11.0,7.0,14.0,13.0,10.0,13.0,12.0,14.0,13.0,14.0,12.0,12.0,12.0,12.0,16.0,11.0,10.0,12.0,13.0,14.0,15.0,14.0,13.0,16.0,12.0,12.0,14.0,15.0,20.0,15.0,17.0,14.0,12.0,15.0,9.0,9.0,10.0,16.0,14.0,15.0,14.0,14.0,14.0,8.0,31.0,0.0,0.0,6.0,0.0,174.0,80.0,1.0,1.0,1.0,1.0,1.0,5.0,1.0,1.0,1.0,1.0,1.0,14.0,12.0,11.0,7.0,12.0,13.0,9.0,7.0,10.0,11.0,11.0,10.0,10.0,12.0,11.0,11.0,11.0,10.0,6.0,10.0,9.0,12.0,12.0,12.0,10.0,12.0,12.0,14.0,12.0,15.0,10.0,9.0,20.0,12.0,12.0,7.0,12.0,9.0,9.0,10.0,12.0,7.0,9.0,11.0,14.0,9.0,7.0,14.0,8.0,9.0,9.0,20.0,0.0,0.0,7.0,1.0,170.0,58.0,1.0,2.0,2.0,2.0,2.0,2.0,2.0,4.0,1.0,3.0,2.0,16.0,14.0,16.0,13.0,16.0,17.0,5.0,14.0,2.0,6.0,15.0,13.0,4.0,17.0,9.0,12.0,14.0,12.0,12.0,14.0,13.0,15.0,16.0,7.0,13.0,9.0,13.0,15.0,15.0,16.0,11.0,7.0,20.0,14.0,15.0,8.0,14.0,8.0,15.0,5.0,15.0,7.0,16.0,15.0,15.0,15.0,14.0,16.0,18.0,16.0,3.0,21.0,7.0,0.0,14.0,6.0,173.0,64.0,3.0,2.0,3.0,2.0,3.0,3.0,3.0,2.0,3.0,3.0,3.0,14.0,14.0,18.0,14.0,17.0,14.0,7.0,11.0,2.0,6.0,15.0,14.0,6.0,18.0,12.0,14.0,14.0,15.0,13.0,16.0,14.0,17.0,17.0,12.0,13.0,9.0,13.0,17.0,15.0,17.0,13.0,7.0,20.0,14.0,14.0,9.0,14.0,9.0,15.0,7.0,16.0,7.0,14.0,15.0,17.0,15.0,16.0,17.0,16.0,15.0,4.0,26.0,0.0,0.0,4.0,0.0,180.0,73.0,2.0,3.0,1.0,4.0,2.0,3.0,3.0,1.0,1.0,4.0,1.0,11.0,13.0,13.0,14.0,14.0,11.0,15.0,12.0,3.0,7.0,14.0,14.0,8.0,13.0,12.0,14.0,17.0,13.0,15.0,14.0,14.0,16.0,12.0,15.0,16.0,12.0,18.0,16.0,13.0,14.0,13.0,12.0,8.0,14.0,13.0,20.0,15.0,12.0,15.0,8.0,14.0,7.0,15.0,19.0,14.0,17.0,14.0,18.0,16.0,16.0,5.0,30.0,62.0,25.0,13.0,8.0,177.0,72.0,1.0,3.0,3.0,1.0,3.0,2.0,1.0,3.0,1.0,4.0,1.0,8.0,11.0,12.0,17.0,14.0,12.0,18.0,14.0,3.0,4.0,13.0,18.0,5.0,16.0,14.0,15.0,16.0,17.0,13.0,14.0,16.0,16.0,16.0,16.0,16.0,6.0,13.0,13.0,13.0,14.0,13.0,11.0,14.0,13.0,12.0,20.0,12.0,12.0,15.0,8.0,19.0,10.0,6.0,13.0,18.0,14.0,19.0,15.0,16.0,17.0,10.0
1,1,34.0,1.0,0.0,0.0,0.0,187.0,87.0,13.0,14.0,15.0,7.0,13.0,11.0,14.0,15.0,11.0,17.0,12.0,2.0,1.0,1.0,3.0,8.0,7.0,2.0,1.0,2.0,1.0,9.0,8.0,2.0,6.0,12.0,15.0,17.0,14.0,15.0,8.0,13.0,17.0,7.0,14.0,6.0,14.0,12.0,6.0,7.0,13.0,14.0,13.0,8.0,13.0,8.0,20.0,11.0,16.0,14.0,10.0,14.0,6.0,1.0,12.0,12.0,15.0,16.0,16.0,14.0,15.0,6.0,31.0,2.0,0.0,0.0,0.0,187.0,83.0,3.0,1.0,3.0,1.0,3.0,2.0,1.0,3.0,3.0,1.0,1.0,8.0,11.0,10.0,8.0,11.0,8.0,15.0,8.0,13.0,14.0,11.0,11.0,14.0,8.0,16.0,13.0,15.0,14.0,12.0,5.0,12.0,13.0,9.0,9.0,11.0,14.0,12.0,13.0,13.0,8.0,16.0,14.0,5.0,14.0,13.0,20.0,12.0,14.0,14.0,15.0,12.0,5.0,8.0,12.0,14.0,11.0,11.0,14.0,12.0,13.0,5.0,28.0,0.0,0.0,0.0,0.0,190.0,85.0,3.0,2.0,3.0,3.0,2.0,2.0,2.0,4.0,3.0,1.0,2.0,5.0,9.0,8.0,9.0,8.0,7.0,14.0,10.0,9.0,15.0,9.0,6.0,14.0,9.0,16.0,13.0,16.0,10.0,13.0,10.0,12.0,15.0,6.0,13.0,7.0,13.0,14.0,16.0,12.0,11.0,17.0,13.0,20.0,15.0,13.0,8.0,15.0,15.0,12.0,14.0,14.0,9.0,8.0,14.0,13.0,14.0,11.0,12.0,13.0,16.0,14.0,22.0,0.0,0.0,0.0,0.0,182.0,71.0,1.0,3.0,1.0,1.0,1.0,2.0,4.0,1.0,3.0,3.0,1.0,10.0,13.0,12.0,6.0,12.0,11.0,12.0,5.0,7.0,12.0,10.0,5.0,13.0,11.0,12.0,13.0,12.0,10.0,11.0,13.0,12.0,19.0,13.0,2.0,10.0,9.0,11.0,12.0,14.0,12.0,12.0,12.0,20.0,7.0,13.0,5.0,13.0,9.0,10.0,14.0,4.0,10.0,10.0,12.0,12.0,11.0,10.0,10.0,12.0,14.0,3.0,29.0,0.0,0.0,0.0,0.0,182.0,76.0,1.0,4.0,2.0,3.0,1.0,1.0,1.0,2.0,2.0,1.0,1.0,7.0,12.0,11.0,9.0,11.0,12.0,7.0,12.0,8.0,12.0,13.0,8.0,12.0,13.0,14.0,12.0,14.0,10.0,13.0,12.0,12.0,13.0,15.0,8.0,11.0,12.0,13.0,13.0,11.0,12.0,11.0,12.0,20.0,10.0,11.0,10.0,14.0,11.0,13.0,11.0,10.0,11.0,10.0,14.0,15.0,13.0,9.0,14.0,12.0,13.0,6.0,32.0,36.0,0.0,12.0,2.0,183.0,77.0,1.0,3.0,2.0,1.0,3.0,1.0,1.0,2.0,1.0,1.0,3.0,6.0,11.0,8.0,6.0,13.0,11.0,13.0,10.0,6.0,15.0,14.0,10.0,17.0,12.0,15.0,16.0,18.0,14.0,17.0,12.0,15.0,17.0,11.0,17.0,7.0,17.0,20.0,16.0,9.0,11.0,15.0,11.0,8.0,15.0,10.0,20.0,14.0,14.0,17.0,10.0,16.0,10.0,13.0,15.0,15.0,15.0,14.0,18.0,15.0,13.0,6.0,34.0,103.0,7.0,16.0,1.0,182.0,72.0,2.0,1.0,1.0,1.0,3.0,1.0,4.0,3.0,3.0,2.0,1.0,11.0,13.0,12.0,8.0,15.0,13.0,9.0,13.0,6.0,8.0,15.0,12.0,8.0,15.0,11.0,14.0,13.0,15.0,15.0,14.0,16.0,17.0,15.0,14.0,11.0,13.0,17.0,13.0,8.0,11.0,10.0,11.0,16.0,13.0,8.0,20.0,12.0,10.0,15.0,11.0,12.0,12.0,15.0,14.0,12.0,15.0,15.0,18.0,14.0,14.0,7.0,20.0,0.0,0.0,0.0,0.0,173.0,66.0,1.0,1.0,1.0,1.0,1.0,2.0,3.0,1.0,3.0,3.0,4.0,15.0,13.0,13.0,10.0,15.0,12.0,5.0,13.0,5.0,7.0,15.0,12.0,7.0,15.0,10.0,10.0,13.0,12.0,10.0,16.0,13.0,18.0,14.0,7.0,14.0,12.0,14.0,14.0,8.0,14.0,13.0,7.0,14.0,12.0,9.0,20.0,12.0,13.0,12.0,8.0,15.0,6.0,12.0,12.0,14.0,14.0,14.0,15.0,14.0,11.0,6.0,29.0,24.0,2.0,3.0,0.0,181.0,77.0,2.0,1.0,2.0,1.0,1.0,2.0,3.0,3.0,1.0,4.0,1.0,8.0,12.0,16.0,13.0,16.0,11.0,7.0,13.0,4.0,3.0,13.0,17.0,3.0,16.0,11.0,13.0,12.0,14.0,10.0,14.0,10.0,12.0,17.0,8.0,16.0,5.0,7.0,7.0,16.0,15.0,12.0,10.0,12.0,13.0,15.0,20.0,12.0,12.0,8.0,12.0,14.0,14.0,10.0,15.0,15.0,8.0,11.0,8.0,10.0,9.0,13.0,19.0,0.0,0.0,0.0,0.0,172.0,64.0,1.0,3.0,2.0,2.0,4.0,2.0,1.0,2.0,3.0,3.0,1.0,13.0,13.0,15.0,12.0,15.0,12.0,6.0,12.0,3.0,2.0,13.0,11.0,3.0,16.0,8.0,10.0,9.0,12.0,9.0,13.0,10.0,12.0,15.0,8.0,13.0,4.0,5.0,7.0,17.0,16.0,14.0,5.0,20.0,11.0,15.0,12.0,10.0,8.0,8.0,10.0,14.0,8.0,10.0,17.0,14.0,9.0,10.0,9.0,4.0,10.0,10.0,22.0,0.0,0.0,0.0,0.0,181.0,81.0,2.0,3.0,2.0,1.0,3.0,3.0,4.0,2.0,1.0,1.0,2.0,5.0,11.0,12.0,14.0,12.0,6.0,13.0,10.0,5.0,4.0,12.0,12.0,4.0,13.0,8.0,12.0,13.0,12.0,12.0,11.0,11.0,15.0,14.0,5.0,14.0,10.0,13.0,15.0,13.0,12.0,14.0,10.0,20.0,15.0,12.0,14.0,13.0,14.0,13.0,8.0,12.0,5.0,14.0,8.0,12.0,12.0,9.0,13.0,12.0,14.0,7.0,28.0,0.0,0.0,0.0,0.0,188.0,86.0,14.0,13.0,15.0,8.0,14.0,11.0,14.0,16.0,13.0,12.0,8.0,6.0,2.0,1.0,3.0,8.0,8.0,1.0,1.0,3.0,1.0,8.0,4.0,1.0,8.0,8.0,13.0,13.0,14.0,14.0,11.0,12.0,15.0,7.0,10.0,2.0,14.0,12.0,11.0,13.0,14.0,16.0,13.0,5.0,16.0,12.0,20.0,14.0,15.0,14.0,8.0,15.0,5.0,1.0,11.0,15.0,14.0,14.0,16.0,14.0,11.0,6.0,26.0,0.0,0.0,0.0,0.0,183.0,79.0,1.0,1.0,3.0,4.0,3.0,2.0,2.0,1.0,2.0,1.0,1.0,9.0,8.0,12.0,11.0,10.0,11.0,10.0,9.0,7.0,6.0,8.0,9.0,5.0,12.0,10.0,9.0,8.0,11.0,11.0,9.0,8.0,11.0,14.0,6.0,12.0,8.0,10.0,11.0,11.0,12.0,11.0,10.0,10.0,10.0,12.0,20.0,11.0,11.0,9.0,9.0,9.0,6.0,13.0,17.0,11.0,10.0,11.0,12.0,10.0,10.0,4.0,19.0,0.0,0.0,0.0,0.0,182.0,89.0,1.0,2.0,2.0,1.0,1.0,1.0,2.0,1.0,3.0,3.0,3.0,5.0,8.0,6.0,5.0,11.0,5.0,14.0,6.0,6.0,12.0,11.0,8.0,13.0,10.0,13.0,12.0,15.0,12.0,13.0,9.0,12.0,12.0,8.0,8.0,7.0,12.0,13.0,14.0,12.0,11.0,15.0,12.0,10.0,15.0,13.0,20.0,14.0,16.0,13.0,4.0,10.0,6.0,11.0,9.0,13.0,10.0,13.0,13.0,14.0,14.0,6.0,30.0,0.0,0.0,0.0,0.0,176.0,75.0,2.0,3.0,2.0,1.0,3.0,2.0,1.0,2.0,1.0,3.0,1.0,9.0,14.0,11.0,6.0,12.0,9.0,11.0,10.0,12.0,11.0,11.0,10.0,12.0,12.0,13.0,13.0,14.0,10.0,10.0,11.0,11.0,12.0,8.0,10.0,9.0,12.0,13.0,15.0,15.0,13.0,12.0,9.0,20.0,15.0,14.0,6.0,17.0,12.0,12.0,13.0,13.0,6.0,14.0,11.0,14.0,14.0,12.0,14.0,13.0,13.0,9.0,29.0,0.0,0.0,4.0,0.0,184.0,72.0,3.0,2.0,4.0,2.0,3.0,1.0,1.0,3.0,1.0,1.0,1.0,8.0,13.0,10.0,6.0,11.0,7.0,12.0,8.0,10.0,12.0,11.0,9.0,13.0,11.0,9.0,14.0,14.0,11.0,14.0,10.0,12.0,16.0,9.0,14.0,12.0,13.0,15.0,16.0,15.0,12.0,14.0,12.0,8.0,13.0,14.0,20.0,16.0,12.0,13.0,9.0,16.0,8.0,15.0,13.0,13.0,17.0,14.0,16.0,16.0,16.0,5.0,25.0,0.0,0.0,7.0,0.0,180.0,76.0,2.0,1.0,3.0,3.0,3.0,3.0,4.0,2.0,1.0,1.0,3.0,10.0,12.0,11.0,8.0,14.0,9.0,12.0,13.0,8.0,10.0,14.0,8.0,12.0,14.0,13.0,13.0,15.0,13.0,14.0,13.0,13.0,15.0,10.0,7.0,11.0,12.0,15.0,16.0,14.0,15.0,14.0,10.0,8.0,14.0,13.0,20.0,15.0,13.0,14.0,13.0,14.0,9.0,16.0,12.0,13.0,15.0,13.0,14.0,12.0,11.0,8.0,22.0,5.0,0.0,9.0,2.0,181.0,73.0,3.0,1.0,2.0,1.0,3.0,2.0,2.0,3.0,3.0,1.0,1.0,12.0,13.0,12.0,7.0,14.0,12.0,9.0,11.0,6.0,7.0,14.0,10.0,8.0,15.0,13.0,11.0,12.0,13.0,12.0,15.0,12.0,12.0,11.0,10.0,11.0,11.0,14.0,13.0,11.0,13.0,14.0,10.0,10.0,16.0,12.0,20.0,14.0,12.0,12.0,11.0,14.0,9.0,8.0,12.0,13.0,16.0,12.0,14.0,13.0,14.0,5.0,29.0,31.0,4.0,19.0,4.0,185.0,82.0,3.0,1.0,2.0,2.0,1.0,2.0,1.0,2.0,3.0,1.0,1.0,13.0,13.0,13.0,9.0,16.0,14.0,12.0,14.0,5.0,6.0,16.0,14.0,6.0,16.0,10.0,14.0,10.0,14.0,12.0,15.0,13.0,14.0,12.0,11.0,13.0,8.0,15.0,12.0,12.0,13.0,14.0,12.0,12.0,12.0,12.0,20.0,14.0,14.0,14.0,12.0,15.0,15.0,10.0,12.0,16.0,14.0,8.0,17.0,14.0,15.0,5.0,31.0,1.0,0.0,0.0,0.0,178.0,74.0,1.0,3.0,2.0,2.0,2.0,1.0,2.0,2.0,3.0,1.0,3.0,12.0,13.0,13.0,7.0,15.0,13.0,10.0,12.0,7.0,6.0,14.0,11.0,8.0,15.0,14.0,14.0,13.0,13.0,12.0,13.0,13.0,15.0,14.0,10.0,12.0,10.0,10.0,12.0,12.0,13.0,14.0,10.0,10.0,15.0,12.0,20.0,14.0,12.0,11.0,14.0,14.0,6.0,14.0,12.0,14.0,10.0,12.0,13.0,10.0,6.0,14.0,20.0,0.0,0.0,0.0,0.0,165.0,62.0,2.0,2.0,2.0,1.0,3.0,2.0,3.0,3.0,3.0,3.0,1.0,6.0,11.0,13.0,12.0,13.0,7.0,5.0,7.0,5.0,5.0,10.0,10.0,5.0,13.0,10.0,10.0,12.0,12.0,9.0,11.0,9.0,14.0,12.0,7.0,13.0,7.0,10.0,10.0,16.0,16.0,8.0,5.0,5.0,13.0,16.0,20.0,10.0,8.0,10.0,10.0,11.0,11.0,11.0,14.0,9.0,14.0,12.0,14.0,12.0,12.0,1.0,27.0,17.0,2.0,0.0,0.0,180.0,78.0,2.0,3.0,2.0,1.0,1.0,2.0,1.0,1.0,2.0,3.0,2.0,7.0,10.0,13.0,12.0,13.0,11.0,12.0,12.0,7.0,5.0,12.0,9.0,4.0,12.0,12.0,13.0,14.0,10.0,11.0,11.0,10.0,12.0,14.0,5.0,13.0,7.0,10.0,14.0,16.0,15.0,14.0,11.0,20.0,12.0,15.0,8.0,14.0,14.0,11.0,12.0,15.0,9.0,10.0,6.0,14.0,12.0,11.0,13.0,13.0,13.0,10.0
1,3,25.0,0.0,0.0,0.0,0.0,185.0,85.0,14.0,11.0,14.0,10.0,12.0,14.0,13.0,14.0,11.0,15.0,9.0,4.0,1.0,3.0,1.0,9.0,8.0,3.0,11.0,1.0,2.0,8.0,2.0,7.0,9.0,8.0,13.0,13.0,12.0,12.0,8.0,11.0,16.0,6.0,14.0,1.0,12.0,12.0,7.0,10.0,13.0,15.0,12.0,5.0,17.0,9.0,20.0,13.0,15.0,14.0,8.0,13.0,3.0,1.0,17.0,13.0,13.0,13.0,14.0,14.0,14.0,5.0,36.0,0.0,0.0,0.0,0.0,182.0,70.0,2.0,1.0,3.0,3.0,1.0,2.0,1.0,1.0,1.0,1.0,3.0,8.0,11.0,8.0,6.0,11.0,7.0,10.0,8.0,12.0,13.0,10.0,6.0,14.0,11.0,15.0,13.0,15.0,11.0,12.0,7.0,10.0,12.0,6.0,13.0,7.0,14.0,14.0,14.0,12.0,11.0,14.0,11.0,12.0,12.0,10.0,20.0,13.0,12.0,12.0,15.0,13.0,9.0,10.0,6.0,12.0,14.0,11.0,15.0,12.0,12.0,6.0,31.0,0.0,0.0,0.0,0.0,190.0,82.0,1.0,1.0,2.0,2.0,2.0,1.0,3.0,1.0,1.0,1.0,2.0,4.0,8.0,8.0,6.0,12.0,10.0,15.0,13.0,8.0,14.0,13.0,7.0,14.0,13.0,14.0,14.0,15.0,11.0,11.0,12.0,12.0,13.0,7.0,11.0,10.0,13.0,14.0,16.0,12.0,10.0,9.0,15.0,5.0,13.0,13.0,20.0,13.0,15.0,12.0,14.0,14.0,13.0,12.0,10.0,13.0,14.0,11.0,14.0,13.0,13.0,9.0,28.0,1.0,0.0,0.0,0.0,183.0,76.0,1.0,1.0,1.0,2.0,2.0,2.0,2.0,1.0,3.0,1.0,1.0,12.0,13.0,10.0,6.0,12.0,7.0,11.0,11.0,12.0,10.0,11.0,4.0,13.0,12.0,16.0,11.0,13.0,11.0,12.0,10.0,11.0,4.0,6.0,11.0,10.0,12.0,14.0,14.0,12.0,10.0,12.0,9.0,16.0,11.0,13.0,20.0,14.0,12.0,10.0,10.0,12.0,6.0,10.0,20.0,10.0,11.0,12.0,11.0,7.0,8.0,14.0,29.0,6.0,0.0,0.0,0.0,183.0,72.0,3.0,3.0,3.0,4.0,1.0,3.0,3.0,3.0,1.0,3.0,3.0,2.0,13.0,13.0,8.0,14.0,8.0,10.0,12.0,10.0,12.0,13.0,8.0,14.0,10.0,14.0,13.0,10.0,12.0,12.0,10.0,12.0,4.0,12.0,4.0,14.0,12.0,13.0,14.0,14.0,13.0,13.0,11.0,5.0,14.0,15.0,20.0,14.0,11.0,13.0,2.0,12.0,7.0,8.0,16.0,10.0,11.0,13.0,10.0,3.0,19.0,8.0,36.0,0.0,0.0,3.0,0.0,168.0,72.0,3.0,2.0,1.0,3.0,1.0,3.0,3.0,1.0,3.0,3.0,1.0,11.0,8.0,12.0,5.0,13.0,11.0,8.0,13.0,6.0,12.0,13.0,8.0,14.0,13.0,17.0,14.0,17.0,14.0,15.0,13.0,14.0,17.0,12.0,16.0,10.0,15.0,16.0,14.0,10.0,13.0,14.0,4.0,8.0,16.0,8.0,20.0,12.0,13.0,17.0,14.0,14.0,7.0,10.0,19.0,15.0,14.0,16.0,15.0,9.0,9.0,7.0,23.0,2.0,0.0,5.0,0.0,180.0,77.0,3.0,2.0,2.0,3.0,2.0,3.0,2.0,2.0,3.0,3.0,4.0,14.0,12.0,12.0,10.0,13.0,14.0,6.0,14.0,8.0,8.0,13.0,12.0,9.0,14.0,13.0,12.0,12.0,11.0,10.0,12.0,13.0,13.0,10.0,6.0,13.0,10.0,12.0,14.0,13.0,14.0,13.0,10.0,8.0,13.0,14.0,20.0,14.0,14.0,9.0,8.0,14.0,6.0,16.0,13.0,12.0,13.0,12.0,13.0,13.0,14.0,6.0,28.0,15.0,2.0,8.0,1.0,171.0,68.0,3.0,1.0,4.0,2.0,3.0,1.0,3.0,2.0,3.0,2.0,1.0,14.0,14.0,14.0,7.0,14.0,14.0,7.0,13.0,6.0,4.0,15.0,12.0,7.0,14.0,11.0,13.0,10.0,13.0,11.0,14.0,12.0,14.0,12.0,8.0,13.0,9.0,15.0,10.0,14.0,15.0,12.0,6.0,12.0,12.0,13.0,20.0,12.0,8.0,12.0,11.0,13.0,15.0,10.0,20.0,15.0,15.0,9.0,13.0,16.0,16.0,7.0,23.0,0.0,0.0,0.0,0.0,185.0,67.0,3.0,1.0,3.0,1.0,2.0,2.0,3.0,1.0,2.0,2.0,1.0,13.0,11.0,14.0,13.0,13.0,12.0,3.0,14.0,5.0,5.0,15.0,11.0,5.0,14.0,6.0,12.0,11.0,13.0,13.0,12.0,12.0,15.0,11.0,2.0,12.0,12.0,14.0,13.0,11.0,13.0,12.0,7.0,10.0,7.0,13.0,20.0,14.0,8.0,13.0,10.0,13.0,10.0,9.0,9.0,11.0,12.0,10.0,12.0,10.0,17.0,3.0,27.0,11.0,1.0,0.0,0.0,187.0,86.0,3.0,1.0,2.0,2.0,4.0,3.0,2.0,1.0,1.0,3.0,1.0,3.0,9.0,13.0,15.0,12.0,10.0,17.0,11.0,5.0,5.0,9.0,14.0,4.0,11.0,9.0,12.0,13.0,12.0,11.0,9.0,10.0,13.0,11.0,10.0,13.0,10.0,15.0,15.0,14.0,12.0,15.0,13.0,7.0,15.0,13.0,20.0,13.0,15.0,14.0,9.0,13.0,7.0,5.0,15.0,13.0,13.0,11.0,10.0,12.0,18.0,6.0,23.0,0.0,0.0,0.0,0.0,183.0,80.0,3.0,2.0,1.0,3.0,1.0,3.0,2.0,3.0,1.0,2.0,3.0,4.0,12.0,13.0,14.0,12.0,9.0,10.0,14.0,5.0,5.0,12.0,11.0,7.0,12.0,11.0,12.0,12.0,10.0,12.0,10.0,11.0,5.0,11.0,9.0,14.0,10.0,13.0,12.0,15.0,14.0,13.0,11.0,8.0,12.0,14.0,20.0,13.0,14.0,10.0,8.0,13.0,7.0,7.0,16.0,14.0,11.0,10.0,12.0,9.0,9.0,2.0,23.0,0.0,0.0,9.0,0.0,194.0,88.0,14.0,13.0,12.0,9.0,13.0,12.0,14.0,15.0,14.0,8.0,10.0,8.0,2.0,3.0,1.0,8.0,11.0,2.0,12.0,2.0,2.0,8.0,3.0,1.0,8.0,8.0,13.0,12.0,14.0,14.0,9.0,12.0,14.0,8.0,9.0,3.0,11.0,14.0,10.0,13.0,14.0,17.0,15.0,10.0,15.0,12.0,20.0,14.0,17.0,13.0,8.0,12.0,9.0,1.0,9.0,15.0,15.0,11.0,15.0,17.0,17.0,5.0,31.0,0.0,0.0,0.0,0.0,171.0,65.0,1.0,3.0,1.0,3.0,2.0,2.0,3.0,1.0,2.0,2.0,3.0,8.0,9.0,11.0,7.0,5.0,6.0,5.0,6.0,7.0,14.0,14.0,6.0,14.0,13.0,14.0,12.0,13.0,12.0,11.0,11.0,12.0,12.0,11.0,7.0,12.0,12.0,12.0,10.0,15.0,15.0,7.0,9.0,9.0,12.0,14.0,20.0,12.0,13.0,11.0,13.0,11.0,9.0,10.0,15.0,14.0,12.0,11.0,14.0,13.0,12.0,7.0,29.0,0.0,0.0,0.0,0.0,170.0,65.0,2.0,1.0,3.0,3.0,1.0,3.0,2.0,1.0,2.0,3.0,2.0,5.0,11.0,4.0,6.0,7.0,4.0,7.0,5.0,6.0,6.0,6.0,2.0,6.0,7.0,9.0,10.0,13.0,8.0,12.0,8.0,13.0,15.0,2.0,7.0,5.0,9.0,8.0,8.0,12.0,12.0,14.0,4.0,9.0,12.0,11.0,20.0,12.0,5.0,9.0,9.0,9.0,9.0,9.0,10.0,12.0,12.0,12.0,12.0,7.0,5.0,8.0,23.0,25.0,0.0,0.0,0.0,174.0,74.0,2.0,1.0,1.0,1.0,3.0,3.0,3.0,3.0,3.0,1.0,2.0,8.0,13.0,12.0,8.0,12.0,8.0,14.0,9.0,13.0,14.0,12.0,6.0,16.0,13.0,13.0,14.0,15.0,13.0,11.0,10.0,12.0,15.0,9.0,10.0,14.0,11.0,14.0,17.0,16.0,13.0,14.0,10.0,8.0,17.0,15.0,20.0,18.0,15.0,14.0,13.0,14.0,8.0,12.0,12.0,14.0,13.0,13.0,12.0,12.0,15.0,13.0,23.0,2.0,0.0,5.0,3.0,182.0,73.0,3.0,1.0,1.0,1.0,2.0,1.0,2.0,1.0,3.0,4.0,2.0,12.0,14.0,14.0,10.0,13.0,12.0,16.0,11.0,13.0,12.0,13.0,13.0,14.0,14.0,12.0,11.0,14.0,13.0,11.0,13.0,11.0,15.0,15.0,9.0,15.0,10.0,14.0,15.0,16.0,15.0,13.0,13.0,20.0,14.0,15.0,6.0,15.0,12.0,13.0,9.0,13.0,14.0,15.0,17.0,15.0,13.0,12.0,12.0,15.0,13.0,9.0,33.0,30.0,1.0,0.0,0.0,187.0,83.0,1.0,3.0,4.0,2.0,1.0,1.0,2.0,3.0,1.0,1.0,3.0,13.0,13.0,12.0,8.0,16.0,10.0,16.0,13.0,10.0,14.0,16.0,13.0,16.0,15.0,13.0,15.0,14.0,16.0,15.0,14.0,14.0,13.0,11.0,13.0,10.0,17.0,18.0,10.0,10.0,12.0,17.0,14.0,20.0,12.0,12.0,10.0,13.0,16.0,16.0,16.0,15.0,13.0,11.0,16.0,16.0,13.0,15.0,12.0,8.0,8.0,11.0,29.0,51.0,8.0,24.0,0.0,175.0,70.0,3.0,4.0,2.0,3.0,2.0,3.0,2.0,2.0,2.0,1.0,3.0,6.0,12.0,12.0,10.0,13.0,7.0,12.0,12.0,8.0,14.0,13.0,9.0,16.0,13.0,14.0,16.0,16.0,15.0,16.0,11.0,14.0,16.0,8.0,14.0,14.0,15.0,18.0,18.0,15.0,14.0,16.0,8.0,20.0,16.0,14.0,8.0,18.0,14.0,16.0,13.0,14.0,7.0,14.0,15.0,14.0,14.0,14.0,16.0,16.0,16.0,5.0,21.0,0.0,0.0,15.0,1.0,189.0,75.0,3.0,3.0,3.0,3.0,1.0,1.0,3.0,3.0,3.0,2.0,3.0,10.0,12.0,13.0,7.0,14.0,8.0,14.0,12.0,5.0,13.0,15.0,8.0,15.0,14.0,14.0,14.0,15.0,14.0,14.0,13.0,14.0,15.0,12.0,10.0,12.0,14.0,15.0,16.0,12.0,13.0,15.0,14.0,20.0,14.0,13.0,10.0,16.0,13.0,14.0,11.0,14.0,7.0,10.0,8.0,16.0,10.0,12.0,13.0,13.0,11.0,14.0,16.0,0.0,0.0,0.0,0.0,173.0,0.0,3.0,1.0,1.0,1.0,2.0,1.0,4.0,1.0,2.0,3.0,1.0,1.0,1.0,4.0,4.0,5.0,4.0,4.0,4.0,1.0,5.0,6.0,5.0,8.0,9.0,10.0,6.0,6.0,3.0,5.0,4.0,10.0,7.0,8.0,8.0,3.0,11.0,13.0,9.0,7.0,5.0,14.0,4.0,20.0,6.0,5.0,8.0,6.0,9.0,5.0,7.0,8.0,5.0,7.0,6.0,11.0,7.0,10.0,18.0,19.0,15.0,9.0,22.0,24.0,2.0,1.0,1.0,187.0,75.0,1.0,2.0,1.0,1.0,2.0,1.0,2.0,1.0,2.0,3.0,3.0,13.0,13.0,16.0,13.0,17.0,10.0,9.0,17.0,8.0,6.0,14.0,10.0,8.0,16.0,10.0,12.0,9.0,12.0,10.0,15.0,11.0,10.0,15.0,7.0,13.0,8.0,12.0,11.0,15.0,14.0,10.0,16.0,18.0,12.0,13.0,20.0,14.0,11.0,8.0,5.0,15.0,12.0,13.0,11.0,17.0,8.0,10.0,16.0,12.0,14.0,13.0,29.0,76.0,27.0,13.0,9.0,188.0,72.0,2.0,3.0,1.0,2.0,3.0,3.0,1.0,3.0,3.0,3.0,3.0,5.0,10.0,13.0,16.0,13.0,11.0,17.0,13.0,5.0,10.0,13.0,14.0,10.0,13.0,15.0,16.0,18.0,14.0,15.0,10.0,13.0,14.0,13.0,10.0,18.0,12.0,14.0,19.0,15.0,14.0,16.0,14.0,10.0,18.0,16.0,20.0,18.0,14.0,14.0,8.0,15.0,5.0,16.0,10.0,16.0,12.0,14.0,16.0,14.0,10.0,10.0
0,1,26.0,2.0,0.0,1.0,0.0,188.0,84.0,12.0,13.0,15.0,9.0,15.0,13.0,13.0,15.0,10.0,11.0,14.0,9.0,2.0,1.0,2.0,12.0,11.0,3.0,2.0,3.0,3.0,11.0,3.0,1.0,10.0,14.0,13.0,14.0,10.0,13.0,11.0,11.0,14.0,3.0,11.0,5.0,12.0,15.0,13.0,10.0,12.0,13.0,14.0,5.0,14.0,9.0,20.0,12.0,14.0,12.0,10.0,15.0,3.0,11.0,12.0,11.0,16.0,13.0,15.0,16.0,16.0,4.0,32.0,0.0,0.0,0.0,0.0,183.0,79.0,1.0,1.0,1.0,3.0,1.0,3.0,1.0,1.0,2.0,1.0,1.0,5.0,10.0,6.0,6.0,9.0,6.0,15.0,7.0,11.0,14.0,10.0,7.0,13.0,10.0,13.0,15.0,15.0,15.0,14.0,9.0,13.0,16.0,6.0,14.0,8.0,12.0,13.0,16.0,11.0,12.0,16.0,11.0,8.0,16.0,12.0,20.0,15.0,14.0,14.0,11.0,12.0,5.0,15.0,18.0,15.0,14.0,13.0,17.0,14.0,14.0,5.0,29.0,0.0,0.0,0.0,0.0,183.0,74.0,3.0,3.0,3.0,3.0,3.0,2.0,2.0,2.0,1.0,3.0,1.0,5.0,12.0,7.0,6.0,10.0,7.0,14.0,12.0,5.0,14.0,12.0,6.0,13.0,11.0,14.0,13.0,17.0,13.0,16.0,12.0,12.0,13.0,9.0,8.0,9.0,14.0,14.0,15.0,13.0,12.0,15.0,12.0,6.0,17.0,11.0,20.0,17.0,13.0,14.0,14.0,15.0,5.0,13.0,9.0,14.0,19.0,15.0,14.0,11.0,11.0,6.0,30.0,0.0,0.0,0.0,0.0,182.0,71.0,3.0,2.0,1.0,3.0,3.0,2.0,3.0,2.0,1.0,2.0,1.0,5.0,12.0,12.0,7.0,12.0,7.0,13.0,7.0,11.0,12.0,11.0,6.0,13.0,13.0,14.0,13.0,14.0,8.0,12.0,9.0,11.0,14.0,11.0,9.0,11.0,10.0,13.0,15.0,14.0,13.0,14.0,11.0,8.0,13.0,13.0,20.0,14.0,14.0,13.0,14.0,14.0,10.0,8.0,12.0,13.0,13.0,12.0,14.0,11.0,11.0,7.0,27.0,0.0,0.0,0.0,0.0,178.0,72.0,2.0,3.0,2.0,3.0,2.0,3.0,3.0,1.0,1.0,2.0,1.0,13.0,14.0,11.0,7.0,12.0,10.0,9.0,10.0,13.0,13.0,12.0,10.0,14.0,13.0,12.0,14.0,14.0,13.0,14.0,11.0,12.0,14.0,13.0,8.0,14.0,13.0,13.0,15.0,15.0,13.0,10.0,10.0,20.0,13.0,15.0,6.0,14.0,10.0,13.0,13.0,12.0,8.0,12.0,15.0,14.0,13.0,14.0,13.0,13.0,12.0,6.0,30.0,4.0,0.0,0.0,0.0,192.0,78.0,1.0,3.0,1.0,2.0,2.0,3.0,1.0,3.0,1.0,1.0,3.0,4.0,6.0,7.0,8.0,11.0,6.0,15.0,8.0,6.0,13.0,11.0,6.0,14.0,11.0,17.0,14.0,16.0,12.0,14.0,10.0,12.0,17.0,8.0,8.0,11.0,13.0,15.0,16.0,14.0,12.0,18.0,14.0,6.0,14.0,12.0,20.0,17.0,16.0,14.0,17.0,13.0,9.0,11.0,8.0,13.0,10.0,13.0,12.0,10.0,10.0,5.0,32.0,0.0,0.0,13.0,0.0,175.0,65.0,2.0,1.0,1.0,2.0,3.0,3.0,1.0,2.0,3.0,2.0,3.0,15.0,13.0,11.0,6.0,14.0,13.0,10.0,12.0,8.0,8.0,16.0,8.0,12.0,13.0,11.0,14.0,15.0,14.0,15.0,14.0,14.0,14.0,6.0,13.0,9.0,15.0,18.0,13.0,12.0,13.0,13.0,8.0,8.0,13.0,10.0,20.0,13.0,13.0,12.0,11.0,15.0,12.0,10.0,17.0,14.0,15.0,14.0,16.0,14.0,14.0,6.0,27.0,0.0,0.0,0.0,0.0,188.0,77.0,1.0,4.0,1.0,1.0,3.0,1.0,2.0,1.0,2.0,2.0,2.0,4.0,7.0,8.0,7.0,13.0,6.0,15.0,9.0,6.0,13.0,12.0,6.0,12.0,11.0,14.0,14.0,15.0,10.0,12.0,11.0,13.0,16.0,7.0,12.0,9.0,12.0,15.0,16.0,14.0,10.0,14.0,15.0,9.0,13.0,12.0,20.0,14.0,16.0,12.0,14.0,13.0,6.0,12.0,4.0,13.0,18.0,13.0,14.0,14.0,13.0,7.0,26.0,0.0,0.0,10.0,1.0,182.0,80.0,3.0,1.0,3.0,2.0,3.0,3.0,2.0,4.0,3.0,1.0,3.0,10.0,10.0,12.0,12.0,12.0,11.0,10.0,12.0,6.0,8.0,13.0,5.0,5.0,14.0,12.0,12.0,14.0,11.0,12.0,11.0,13.0,15.0,12.0,10.0,13.0,6.0,10.0,11.0,13.0,14.0,12.0,10.0,8.0,5.0,13.0,20.0,12.0,12.0,13.0,7.0,10.0,11.0,11.0,19.0,11.0,10.0,12.0,14.0,9.0,8.0,8.0,20.0,0.0,0.0,2.0,0.0,180.0,75.0,3.0,1.0,2.0,2.0,3.0,2.0,1.0,1.0,3.0,3.0,1.0,8.0,13.0,14.0,9.0,13.0,8.0,10.0,9.0,6.0,5.0,12.0,6.0,5.0,14.0,8.0,13.0,12.0,13.0,12.0,12.0,12.0,7.0,13.0,8.0,14.0,7.0,12.0,13.0,15.0,13.0,14.0,10.0,8.0,14.0,15.0,20.0,13.0,12.0,13.0,11.0,9.0,7.0,13.0,9.0,11.0,11.0,11.0,12.0,11.0,10.0,1.0,30.0,5.0,0.0,22.0,9.0,181.0,84.0,2.0,3.0,3.0,1.0,2.0,3.0,3.0,1.0,3.0,1.0,3.0,7.0,10.0,12.0,13.0,11.0,7.0,13.0,10.0,12.0,6.0,11.0,13.0,6.0,13.0,17.0,13.0,16.0,11.0,13.0,11.0,11.0,17.0,14.0,8.0,14.0,9.0,13.0,17.0,15.0,12.0,15.0,11.0,8.0,14.0,15.0,20.0,14.0,14.0,13.0,9.0,13.0,7.0,10.0,7.0,16.0,13.0,14.0,13.0,15.0,15.0,10.0,36.0,0.0,0.0,0.0,0.0,185.0,78.0,11.0,14.0,12.0,7.0,13.0,12.0,14.0,15.0,13.0,14.0,10.0,4.0,1.0,3.0,1.0,8.0,8.0,11.0,8.0,3.0,3.0,7.0,2.0,1.0,8.0,11.0,13.0,15.0,11.0,12.0,7.0,13.0,9.0,5.0,14.0,3.0,13.0,15.0,8.0,11.0,14.0,13.0,12.0,5.0,15.0,11.0,20.0,12.0,14.0,13.0,11.0,13.0,8.0,1.0,19.0,14.0,16.0,10.0,17.0,9.0,9.0,11.0,34.0,23.0,1.0,0.0,0.0,186.0,81.0,3.0,3.0,1.0,2.0,1.0,3.0,2.0,3.0,1.0,3.0,3.0,4.0,8.0,6.0,10.0,7.0,8.0,17.0,12.0,10.0,14.0,7.0,9.0,15.0,7.0,15.0,13.0,17.0,8.0,12.0,7.0,12.0,15.0,6.0,17.0,7.0,14.0,15.0,14.0,8.0,10.0,16.0,13.0,12.0,13.0,9.0,20.0,13.0,15.0,11.0,15.0,14.0,9.0,10.0,10.0,14.0,11.0,13.0,15.0,11.0,11.0,12.0,28.0,0.0,0.0,0.0,0.0,183.0,81.0,1.0,2.0,4.0,1.0,1.0,3.0,2.0,3.0,3.0,3.0,1.0,5.0,5.0,6.0,10.0,12.0,6.0,14.0,8.0,6.0,15.0,11.0,6.0,13.0,12.0,13.0,14.0,16.0,14.0,14.0,10.0,12.0,14.0,5.0,14.0,8.0,14.0,15.0,15.0,9.0,12.0,15.0,13.0,7.0,11.0,12.0,20.0,15.0,15.0,14.0,14.0,14.0,9.0,8.0,14.0,14.0,11.0,13.0,15.0,13.0,15.0,6.0,21.0,0.0,0.0,1.0,0.0,177.0,68.0,4.0,1.0,2.0,1.0,1.0,1.0,1.0,1.0,2.0,1.0,2.0,5.0,12.0,9.0,7.0,12.0,8.0,13.0,10.0,16.0,13.0,12.0,8.0,14.0,12.0,12.0,13.0,12.0,12.0,12.0,10.0,13.0,15.0,11.0,13.0,11.0,13.0,13.0,14.0,13.0,14.0,13.0,11.0,10.0,14.0,12.0,20.0,12.0,14.0,12.0,11.0,12.0,8.0,14.0,13.0,10.0,14.0,12.0,14.0,12.0,11.0,5.0,27.0,14.0,1.0,0.0,0.0,183.0,77.0,1.0,2.0,1.0,2.0,3.0,2.0,3.0,2.0,2.0,1.0,1.0,5.0,12.0,9.0,8.0,13.0,10.0,13.0,10.0,6.0,14.0,13.0,6.0,13.0,12.0,14.0,13.0,15.0,11.0,11.0,11.0,11.0,13.0,9.0,8.0,9.0,12.0,14.0,16.0,14.0,12.0,14.0,12.0,7.0,14.0,12.0,20.0,15.0,14.0,14.0,14.0,15.0,7.0,10.0,12.0,13.0,14.0,12.0,13.0,11.0,11.0,7.0,30.0,0.0,0.0,0.0,0.0,167.0,60.0,3.0,1.0,1.0,2.0,3.0,1.0,1.0,3.0,1.0,1.0,3.0,10.0,11.0,12.0,8.0,13.0,10.0,6.0,9.0,10.0,12.0,14.0,9.0,10.0,14.0,11.0,14.0,14.0,14.0,14.0,13.0,14.0,12.0,14.0,11.0,13.0,12.0,15.0,15.0,15.0,14.0,11.0,5.0,11.0,11.0,15.0,20.0,11.0,8.0,14.0,10.0,12.0,13.0,11.0,11.0,12.0,11.0,10.0,12.0,11.0,11.0,2.0,23.0,27.0,1.0,0.0,0.0,178.0,70.0,1.0,2.0,1.0,4.0,1.0,1.0,1.0,3.0,2.0,1.0,1.0,8.0,11.0,13.0,11.0,13.0,12.0,7.0,14.0,6.0,5.0,12.0,10.0,5.0,14.0,11.0,11.0,12.0,11.0,9.0,13.0,10.0,14.0,14.0,5.0,13.0,7.0,10.0,12.0,15.0,14.0,12.0,9.0,20.0,13.0,13.0,8.0,13.0,13.0,12.0,11.0,11.0,10.0,11.0,12.0,12.0,12.0,11.0,10.0,10.0,10.0,6.0,33.0,0.0,0.0,0.0,0.0,187.0,76.0,2.0,2.0,3.0,1.0,1.0,3.0,2.0,1.0,2.0,3.0,2.0,15.0,14.0,14.0,10.0,15.0,13.0,10.0,12.0,7.0,4.0,15.0,13.0,7.0,15.0,6.0,12.0,9.0,14.0,11.0,15.0,12.0,12.0,14.0,12.0,13.0,7.0,13.0,12.0,11.0,12.0,14.0,12.0,14.0,15.0,12.0,20.0,11.0,12.0,12.0,6.0,14.0,6.0,11.0,14.0,13.0,12.0,12.0,15.0,15.0,13.0,9.0,26.0,0.0,0.0,0.0,0.0,193.0,81.0,1.0,3.0,3.0,3.0,3.0,1.0,2.0,2.0,2.0,3.0,3.0,4.0,9.0,14.0,10.0,13.0,12.0,14.0,14.0,5.0,5.0,10.0,12.0,3.0,14.0,8.0,13.0,12.0,9.0,10.0,11.0,11.0,12.0,16.0,5.0,14.0,6.0,9.0,12.0,14.0,13.0,14.0,16.0,14.0,13.0,13.0,20.0,13.0,14.0,10.0,8.0,14.0,9.0,8.0,16.0,16.0,11.0,13.0,11.0,13.0,13.0,10.0,27.0,0.0,0.0,0.0,0.0,190.0,87.0,1.0,3.0,2.0,3.0,1.0,3.0,1.0,1.0,2.0,3.0,2.0,5.0,7.0,9.0,14.0,14.0,10.0,14.0,13.0,5.0,6.0,12.0,12.0,8.0,14.0,14.0,13.0,16.0,14.0,11.0,10.0,13.0,15.0,10.0,11.0,14.0,9.0,15.0,14.0,10.0,11.0,16.0,15.0,9.0,12.0,12.0,20.0,14.0,16.0,13.0,13.0,12.0,7.0,5.0,10.0,12.0,14.0,12.0,14.0,14.0,19.0,12.0,30.0,0.0,0.0,0.0,0.0,178.0,73.0,3.0,4.0,1.0,1.0,2.0,4.0,3.0,2.0,2.0,2.0,3.0,13.0,14.0,12.0,7.0,13.0,12.0,7.0,13.0,5.0,10.0,13.0,9.0,10.0,13.0,11.0,11.0,12.0,12.0,13.0,11.0,14.0,14.0,11.0,7.0,11.0,10.0,13.0,15.0,13.0,15.0,15.0,8.0,20.0,14.0,14.0,8.0,14.0,11.0,13.0,11.0,14.0,8.0,10.0,19.0,12.0,12.0,9.0,12.0,12.0,10.0,10.0
0,3,34.0,1.0,0.0,0.0,0.0,187.0,87.0,13.0,14.0,15.0,7.0,13.0,11.0,14.0,15.0,11.0,17.0,12.0,2.0,1.0,1.0,3.0,8.0,7.0,2.0,1.0,2.0,1.0,9.0,8.0,2.0,6.0,12.0,15.0,17.0,14.0,15.0,8.0,13.0,17.0,7.0,14.0,6.0,14.0,12.0,6.0,7.0,13.0,14.0,13.0,8.0,13.0,8.0,20.0,11.0,16.0,14.0,10.0,14.0,6.0,1.0,12.0,12.0,15.0,16.0,16.0,14.0,15.0,6.0,28.0,0.0,0.0,0.0,0.0,190.0,85.0,3.0,2.0,3.0,3.0,2.0,2.0,2.0,4.0,3.0,1.0,2.0,5.0,9.0,8.0,9.0,8.0,7.0,14.0,10.0,9.0,15.0,9.0,6.0,14.0,9.0,16.0,13.0,16.0,10.0,13.0,10.0,12.0,15.0,6.0,13.0,7.0,13.0,14.0,16.0,12.0,11.0,17.0,13.0,20.0,15.0,13.0,8.0,15.0,15.0,12.0,14.0,14.0,9.0,8.0,14.0,13.0,14.0,11.0,12.0,13.0,16.0,14.0,20.0,0.0,0.0,6.0,0.0,188.0,79.0,2.0,3.0,2.0,1.0,1.0,3.0,2.0,1.0,2.0,2.0,1.0,4.0,4.0,11.0,6.0,11.0,8.0,13.0,8.0,9.0,13.0,12.0,9.0,13.0,11.0,14.0,13.0,15.0,14.0,13.0,8.0,12.0,14.0,9.0,11.0,10.0,12.0,12.0,13.0,11.0,11.0,11.0,13.0,8.0,12.0,13.0,20.0,13.0,12.0,13.0,14.0,13.0,10.0,11.0,11.0,13.0,12.0,14.0,14.0,15.0,10.0,7.0,23.0,0.0,0.0,0.0,0.0,174.0,64.0,4.0,3.0,1.0,1.0,3.0,3.0,2.0,3.0,3.0,2.0,3.0,8.0,12.0,10.0,8.0,11.0,7.0,10.0,9.0,12.0,14.0,9.0,10.0,13.0,12.0,12.0,12.0,12.0,11.0,12.0,10.0,12.0,13.0,8.0,9.0,12.0,11.0,13.0,14.0,15.0,14.0,11.0,10.0,10.0,14.0,14.0,20.0,15.0,10.0,14.0,12.0,12.0,8.0,13.0,10.0,12.0,15.0,12.0,13.0,10.0,17.0,6.0,29.0,0.0,0.0,0.0,0.0,182.0,76.0,1.0,4.0,2.0,3.0,1.0,1.0,1.0,2.0,2.0,1.0,1.0,7.0,12.0,11.0,9.0,11.0,12.0,7.0,12.0,8.0,12.0,13.0,8.0,12.0,13.0,14.0,12.0,14.0,10.0,13.0,12.0,12.0,13.0,15.0,8.0,11.0,12.0,13.0,13.0,11.0,12.0,11.0,12.0,20.0,10.0,11.0,10.0,14.0,11.0,13.0,11.0,10.0,11.0,10.0,14.0,15.0,13.0,9.0,14.0,12.0,13.0,6.0,32.0,36.0,0.0,12.0,2.0,183.0,77.0,1.0,3.0,2.0,1.0,3.0,1.0,1.0,2.0,1.0,1.0,3.0,6.0,11.0,8.0,6.0,13.0,11.0,13.0,10.0,6.0,15.0,14.0,10.0,17.0,12.0,15.0,16.0,18.0,14.0,17.0,12.0,15.0,17.0,11.0,17.0,7.0,17.0,20.0,16.0,9.0,11.0,15.0,11.0,8.0,15.0,10.0,20.0,14.0,14.0,17.0,10.0,16.0,10.0,13.0,15.0,15.0,15.0,14.0,18.0,15.0,13.0,6.0,34.0,103.0,7.0,16.0,1.0,182.0,72.0,2.0,1.0,1.0,1.0,3.0,1.0,4.0,3.0,3.0,2.0,1.0,11.0,13.0,12.0,8.0,15.0,13.0,9.0,13.0,6.0,8.0,15.0,12.0,8.0,15.0,11.0,14.0,13.0,15.0,15.0,14.0,16.0,17.0,15.0,14.0,11.0,13.0,17.0,13.0,8.0,11.0,10.0,11.0,16.0,13.0,8.0,20.0,12.0,10.0,15.0,11.0,12.0,12.0,15.0,14.0,12.0,15.0,15.0,18.0,14.0,14.0,7.0,26.0,0.0,0.0,0.0,0.0,184.0,76.0,3.0,1.0,3.0,1.0,3.0,2.0,3.0,2.0,1.0,1.0,3.0,10.0,11.0,13.0,9.0,13.0,12.0,13.0,10.0,6.0,11.0,13.0,9.0,14.0,12.0,12.0,13.0,12.0,12.0,11.0,13.0,12.0,13.0,13.0,10.0,12.0,13.0,12.0,16.0,15.0,13.0,15.0,13.0,20.0,15.0,14.0,5.0,16.0,15.0,13.0,12.0,14.0,5.0,12.0,18.0,14.0,10.0,7.0,11.0,11.0,13.0,10.0,29.0,24.0,2.0,3.0,0.0,181.0,77.0,2.0,1.0,2.0,1.0,1.0,2.0,3.0,3.0,1.0,4.0,1.0,8.0,12.0,16.0,13.0,16.0,11.0,7.0,13.0,4.0,3.0,13.0,17.0,3.0,16.0,11.0,13.0,12.0,14.0,10.0,14.0,10.0,12.0,17.0,8.0,16.0,5.0,7.0,7.0,16.0,15.0,12.0,10.0,12.0,13.0,15.0,20.0,12.0,12.0,8.0,12.0,14.0,14.0,10.0,15.0,15.0,8.0,11.0,8.0,10.0,9.0,13.0,19.0,0.0,0.0,11.0,1.0,171.0,65.0,2.0,2.0,2.0,2.0,2.0,3.0,3.0,3.0,1.0,1.0,3.0,14.0,13.0,13.0,11.0,14.0,15.0,8.0,12.0,6.0,4.0,13.0,12.0,4.0,15.0,8.0,12.0,10.0,12.0,8.0,13.0,13.0,14.0,15.0,8.0,14.0,6.0,13.0,12.0,15.0,16.0,10.0,7.0,20.0,13.0,15.0,10.0,12.0,7.0,11.0,6.0,11.0,8.0,11.0,12.0,13.0,11.0,12.0,12.0,6.0,12.0,5.0,23.0,21.0,3.0,9.0,4.0,176.0,69.0,1.0,2.0,1.0,3.0,3.0,1.0,2.0,1.0,1.0,2.0,3.0,9.0,9.0,14.0,13.0,14.0,10.0,10.0,9.0,3.0,5.0,12.0,14.0,6.0,15.0,9.0,13.0,9.0,11.0,10.0,12.0,12.0,13.0,14.0,10.0,13.0,8.0,8.0,10.0,16.0,15.0,10.0,8.0,10.0,12.0,15.0,20.0,13.0,10.0,9.0,8.0,13.0,11.0,13.0,7.0,14.0,12.0,13.0,8.0,14.0,13.0,8.0,25.0,0.0,0.0,11.0,0.0,189.0,83.0,12.0,12.0,11.0,7.0,13.0,12.0,17.0,17.0,16.0,12.0,13.0,6.0,2.0,1.0,1.0,10.0,10.0,7.0,1.0,1.0,1.0,9.0,5.0,1.0,10.0,8.0,15.0,14.0,14.0,12.0,7.0,13.0,12.0,6.0,9.0,3.0,16.0,17.0,10.0,13.0,16.0,14.0,12.0,8.0,15.0,10.0,20.0,13.0,14.0,14.0,5.0,14.0,4.0,12.0,15.0,15.0,13.0,13.0,17.0,15.0,17.0,4.0,20.0,0.0,0.0,7.0,0.0,186.0,72.0,3.0,3.0,2.0,3.0,3.0,4.0,3.0,3.0,2.0,2.0,2.0,4.0,9.0,8.0,6.0,13.0,6.0,14.0,6.0,7.0,14.0,12.0,8.0,13.0,13.0,11.0,13.0,14.0,14.0,14.0,9.0,13.0,13.0,8.0,8.0,8.0,13.0,14.0,14.0,13.0,13.0,15.0,13.0,20.0,15.0,14.0,8.0,14.0,13.0,12.0,8.0,12.0,4.0,10.0,8.0,15.0,14.0,12.0,14.0,15.0,14.0,7.0,29.0,0.0,0.0,0.0,0.0,170.0,65.0,2.0,1.0,3.0,3.0,1.0,3.0,2.0,1.0,2.0,3.0,2.0,5.0,11.0,4.0,6.0,7.0,4.0,7.0,5.0,6.0,6.0,6.0,2.0,6.0,7.0,9.0,10.0,13.0,8.0,12.0,8.0,13.0,15.0,2.0,7.0,5.0,9.0,8.0,8.0,12.0,12.0,14.0,4.0,9.0,12.0,11.0,20.0,12.0,5.0,9.0,9.0,9.0,9.0,9.0,10.0,12.0,12.0,12.0,12.0,7.0,5.0,8.0,23.0,2.0,0.0,5.0,3.0,182.0,73.0,3.0,1.0,1.0,1.0,2.0,1.0,2.0,1.0,3.0,4.0,2.0,12.0,14.0,14.0,10.0,13.0,12.0,16.0,11.0,13.0,12.0,13.0,13.0,14.0,14.0,12.0,11.0,14.0,13.0,11.0,13.0,11.0,15.0,15.0,9.0,15.0,10.0,14.0,15.0,16.0,15.0,13.0,13.0,20.0,14.0,15.0,6.0,15.0,12.0,13.0,9.0,13.0,14.0,15.0,17.0,15.0,13.0,12.0,12.0,15.0,13.0,9.0,24.0,9.0,0.0,7.0,1.0,190.0,82.0,2.0,2.0,3.0,3.0,1.0,2.0,2.0,1.0,1.0,3.0,1.0,8.0,14.0,13.0,11.0,12.0,10.0,12.0,11.0,9.0,11.0,13.0,8.0,13.0,13.0,10.0,14.0,14.0,13.0,13.0,14.0,14.0,16.0,11.0,6.0,12.0,12.0,16.0,16.0,12.0,11.0,11.0,14.0,8.0,14.0,14.0,20.0,15.0,13.0,14.0,9.0,13.0,8.0,14.0,13.0,14.0,12.0,14.0,16.0,12.0,15.0,2.0,33.0,30.0,1.0,0.0,0.0,187.0,83.0,1.0,3.0,4.0,2.0,1.0,1.0,2.0,3.0,1.0,1.0,3.0,13.0,13.0,12.0,8.0,16.0,10.0,16.0,13.0,10.0,14.0,16.0,13.0,16.0,15.0,13.0,15.0,14.0,16.0,15.0,14.0,14.0,13.0,11.0,13.0,10.0,17.0,18.0,10.0,10.0,12.0,17.0,14.0,20.0,12.0,12.0,10.0,13.0,16.0,16.0,16.0,15.0,13.0,11.0,16.0,16.0,13.0,15.0,12.0,8.0,8.0,11.0,23.0,15.0,1.0,7.0,0.0,165.0,60.0,2.0,3.0,2.0,1.0,1.0,1.0,3.0,3.0,2.0,1.0,3.0,14.0,14.0,16.0,8.0,16.0,13.0,6.0,10.0,6.0,11.0,18.0,15.0,12.0,18.0,16.0,15.0,15.0,17.0,13.0,17.0,15.0,14.0,18.0,12.0,10.0,12.0,15.0,16.0,14.0,16.0,16.0,6.0,12.0,13.0,14.0,20.0,15.0,11.0,16.0,14.0,15.0,10.0,12.0,14.0,15.0,16.0,14.0,14.0,13.0,10.0,6.0,21.0,0.0,0.0,15.0,1.0,189.0,75.0,3.0,3.0,3.0,3.0,1.0,1.0,3.0,3.0,3.0,2.0,3.0,10.0,12.0,13.0,7.0,14.0,8.0,14.0,12.0,5.0,13.0,15.0,8.0,15.0,14.0,14.0,14.0,15.0,14.0,14.0,13.0,14.0,15.0,12.0,10.0,12.0,14.0,15.0,16.0,12.0,13.0,15.0,14.0,20.0,14.0,13.0,10.0,16.0,13.0,14.0,11.0,14.0,7.0,10.0,8.0,16.0,10.0,12.0,13.0,13.0,11.0,14.0,28.0,66.0,15.0,13.0,3.0,180.0,70.0,2.0,2.0,1.0,2.0,1.0,1.0,3.0,2.0,3.0,3.0,1.0,14.0,15.0,16.0,13.0,17.0,15.0,6.0,15.0,4.0,5.0,16.0,14.0,8.0,17.0,13.0,16.0,11.0,15.0,13.0,16.0,14.0,13.0,17.0,10.0,14.0,9.0,13.0,13.0,16.0,18.0,12.0,10.0,20.0,14.0,15.0,8.0,16.0,9.0,13.0,14.0,12.0,10.0,15.0,14.0,15.0,10.0,16.0,14.0,6.0,12.0,10.0,16.0,0.0,0.0,0.0,0.0,173.0,0.0,3.0,1.0,1.0,1.0,2.0,1.0,4.0,1.0,2.0,3.0,1.0,1.0,1.0,4.0,4.0,5.0,4.0,4.0,4.0,1.0,5.0,6.0,5.0,8.0,9.0,10.0,6.0,6.0,3.0,5.0,4.0,10.0,7.0,8.0,8.0,3.0,11.0,13.0,9.0,7.0,5.0,14.0,4.0,20.0,6.0,5.0,8.0,6.0,9.0,5.0,7.0,8.0,5.0,7.0,6.0,11.0,7.0,10.0,18.0,19.0,15.0,9.0,29.0,76.0,27.0,13.0,9.0,188.0,72.0,2.0,3.0,1.0,2.0,3.0,3.0,1.0,3.0,3.0,3.0,3.0,5.0,10.0,13.0,16.0,13.0,11.0,17.0,13.0,5.0,10.0,13.0,14.0,10.0,13.0,15.0,16.0,18.0,14.0,15.0,10.0,13.0,14.0,13.0,10.0,18.0,12.0,14.0,19.0,15.0,14.0,16.0,14.0,10.0,18.0,16.0,20.0,18.0,14.0,14.0,8.0,15.0,5.0,16.0,10.0,16.0,12.0,14.0,16.0,14.0,10.0,10.0
2,1,26.0,2.0,0.0,1.0,0.0,188.0,84.0,12.0,13.0,15.0,9.0,15.0,13.0,13.0,15.0,10.0,11.0,14.0,9.0,2.0,1.0,2.0,12.0,11.0,3.0,2.0,3.0,3.0,11.0,3.0,1.0,10.0,14.0,13.0,14.0,10.0,13.0,11.0,11.0,14.0,3.0,11.0,5.0,12.0,15.0,13.0,10.0,12.0,13.0,14.0,5.0,14.0,9.0,20.0,12.0,14.0,12.0,10.0,15.0,3.0,11.0,12.0,11.0,16.0,13.0,15.0,16.0,16.0,4.0,29.0,0.0,0.0,0.0,0.0,183.0,74.0,3.0,3.0,3.0,3.0,3.0,2.0,2.0,2.0,1.0,3.0,1.0,5.0,12.0,7.0,6.0,10.0,7.0,14.0,12.0,5.0,14.0,12.0,6.0,13.0,11.0,14.0,13.0,17.0,13.0,16.0,12.0,12.0,13.0,9.0,8.0,9.0,14.0,14.0,15.0,13.0,12.0,15.0,12.0,6.0,17.0,11.0,20.0,17.0,13.0,14.0,14.0,15.0,5.0,13.0,9.0,14.0,19.0,15.0,14.0,11.0,11.0,6.0,27.0,0.0,0.0,0.0,0.0,178.0,72.0,2.0,3.0,2.0,3.0,2.0,3.0,3.0,1.0,1.0,2.0,1.0,13.0,14.0,11.0,7.0,12.0,10.0,9.0,10.0,13.0,13.0,12.0,10.0,14.0,13.0,12.0,14.0,14.0,13.0,14.0,11.0,12.0,14.0,13.0,8.0,14.0,13.0,13.0,15.0,15.0,13.0,10.0,10.0,20.0,13.0,15.0,6.0,14.0,10.0,13.0,13.0,12.0,8.0,12.0,15.0,14.0,13.0,14.0,13.0,13.0,12.0,6.0,30.0,0.0,0.0,0.0,0.0,182.0,71.0,3.0,2.0,1.0,3.0,3.0,2.0,3.0,2.0,1.0,2.0,1.0,5.0,12.0,12.0,7.0,12.0,7.0,13.0,7.0,11.0,12.0,11.0,6.0,13.0,13.0,14.0,13.0,14.0,8.0,12.0,9.0,11.0,14.0,11.0,9.0,11.0,10.0,13.0,15.0,14.0,13.0,14.0,11.0,8.0,13.0,13.0,20.0,14.0,14.0,13.0,14.0,14.0,10.0,8.0,12.0,13.0,13.0,12.0,14.0,11.0,11.0,7.0,24.0,10.0,0.0,0.0,0.0,180.0,73.0,3.0,2.0,3.0,1.0,1.0,1.0,1.0,3.0,3.0,3.0,2.0,5.0,10.0,8.0,5.0,8.0,6.0,13.0,8.0,6.0,14.0,12.0,6.0,13.0,10.0,12.0,13.0,13.0,11.0,12.0,9.0,12.0,14.0,1.0,7.0,7.0,12.0,12.0,13.0,15.0,11.0,13.0,10.0,5.0,15.0,14.0,20.0,12.0,14.0,12.0,12.0,11.0,8.0,11.0,8.0,11.0,9.0,15.0,12.0,11.0,19.0,6.0,32.0,0.0,0.0,13.0,0.0,175.0,65.0,2.0,1.0,1.0,2.0,3.0,3.0,1.0,2.0,3.0,2.0,3.0,15.0,13.0,11.0,6.0,14.0,13.0,10.0,12.0,8.0,8.0,16.0,8.0,12.0,13.0,11.0,14.0,15.0,14.0,15.0,14.0,14.0,14.0,6.0,13.0,9.0,15.0,18.0,13.0,12.0,13.0,13.0,8.0,8.0,13.0,10.0,20.0,13.0,13.0,12.0,11.0,15.0,12.0,10.0,17.0,14.0,15.0,14.0,16.0,14.0,14.0,6.0,30.0,4.0,0.0,0.0,0.0,192.0,78.0,1.0,3.0,1.0,2.0,2.0,3.0,1.0,3.0,1.0,1.0,3.0,4.0,6.0,7.0,8.0,11.0,6.0,15.0,8.0,6.0,13.0,11.0,6.0,14.0,11.0,17.0,14.0,16.0,12.0,14.0,10.0,12.0,17.0,8.0,8.0,11.0,13.0,15.0,16.0,14.0,12.0,18.0,14.0,6.0,14.0,12.0,20.0,17.0,16.0,14.0,17.0,13.0,9.0,11.0,8.0,13.0,10.0,13.0,12.0,10.0,10.0,5.0,27.0,0.0,0.0,0.0,0.0,188.0,77.0,1.0,4.0,1.0,1.0,3.0,1.0,2.0,1.0,2.0,2.0,2.0,4.0,7.0,8.0,7.0,13.0,6.0,15.0,9.0,6.0,13.0,12.0,6.0,12.0,11.0,14.0,14.0,15.0,10.0,12.0,11.0,13.0,16.0,7.0,12.0,9.0,12.0,15.0,16.0,14.0,10.0,14.0,15.0,9.0,13.0,12.0,20.0,14.0,16.0,12.0,14.0,13.0,6.0,12.0,4.0,13.0,18.0,13.0,14.0,14.0,13.0,7.0,25.0,0.0,0.0,3.0,2.0,170.0,61.0,2.0,3.0,2.0,2.0,1.0,3.0,2.0,2.0,1.0,2.0,1.0,11.0,12.0,13.0,10.0,13.0,8.0,5.0,8.0,7.0,4.0,14.0,10.0,4.0,15.0,11.0,10.0,9.0,7.0,10.0,14.0,8.0,13.0,13.0,6.0,12.0,8.0,8.0,12.0,16.0,14.0,7.0,5.0,12.0,15.0,16.0,20.0,14.0,6.0,12.0,11.0,13.0,8.0,8.0,8.0,13.0,15.0,10.0,10.0,14.0,14.0,8.0,25.0,0.0,0.0,0.0,0.0,176.0,74.0,2.0,2.0,1.0,3.0,2.0,2.0,2.0,4.0,3.0,3.0,3.0,12.0,12.0,14.0,12.0,14.0,13.0,7.0,12.0,6.0,3.0,12.0,12.0,3.0,15.0,9.0,10.0,8.0,12.0,11.0,12.0,10.0,10.0,14.0,5.0,13.0,4.0,6.0,8.0,17.0,15.0,12.0,8.0,20.0,12.0,14.0,8.0,13.0,12.0,11.0,9.0,14.0,10.0,8.0,8.0,14.0,12.0,7.0,10.0,11.0,11.0,9.0,30.0,5.0,0.0,22.0,9.0,181.0,84.0,2.0,3.0,3.0,1.0,2.0,3.0,3.0,1.0,3.0,1.0,3.0,7.0,10.0,12.0,13.0,11.0,7.0,13.0,10.0,12.0,6.0,11.0,13.0,6.0,13.0,17.0,13.0,16.0,11.0,13.0,11.0,11.0,17.0,14.0,8.0,14.0,9.0,13.0,17.0,15.0,12.0,15.0,11.0,8.0,14.0,15.0,20.0,14.0,14.0,13.0,9.0,13.0,7.0,10.0,7.0,16.0,13.0,14.0,13.0,15.0,15.0,10.0,25.0,4.0,0.0,11.0,0.0,184.0,81.0,14.0,14.0,13.0,9.0,15.0,12.0,16.0,16.0,13.0,7.0,11.0,8.0,1.0,2.0,1.0,11.0,12.0,6.0,1.0,3.0,3.0,11.0,5.0,3.0,11.0,8.0,15.0,15.0,13.0,14.0,10.0,11.0,14.0,8.0,13.0,5.0,13.0,10.0,10.0,14.0,16.0,14.0,13.0,20.0,14.0,12.0,5.0,14.0,14.0,15.0,9.0,16.0,6.0,1.0,17.0,11.0,15.0,13.0,14.0,12.0,12.0,4.0,27.0,4.0,0.0,5.0,1.0,184.0,83.0,2.0,4.0,3.0,1.0,1.0,2.0,1.0,2.0,4.0,2.0,3.0,4.0,8.0,11.0,4.0,10.0,4.0,14.0,4.0,4.0,15.0,12.0,5.0,16.0,11.0,14.0,14.0,16.0,14.0,10.0,11.0,12.0,17.0,7.0,10.0,9.0,13.0,14.0,15.0,14.0,13.0,16.0,13.0,10.0,15.0,13.0,20.0,15.0,16.0,12.0,12.0,14.0,6.0,12.0,11.0,13.0,12.0,12.0,16.0,15.0,14.0,6.0,19.0,0.0,0.0,0.0,0.0,193.0,89.0,3.0,2.0,2.0,3.0,1.0,3.0,1.0,4.0,2.0,2.0,3.0,8.0,10.0,5.0,4.0,10.0,10.0,14.0,12.0,6.0,12.0,10.0,4.0,12.0,9.0,11.0,11.0,14.0,11.0,12.0,8.0,14.0,13.0,8.0,8.0,11.0,11.0,13.0,13.0,10.0,9.0,14.0,16.0,6.0,14.0,10.0,20.0,12.0,14.0,11.0,7.0,6.0,6.0,8.0,16.0,10.0,10.0,12.0,13.0,16.0,16.0,5.0,19.0,0.0,0.0,3.0,1.0,181.0,69.0,3.0,2.0,3.0,3.0,2.0,1.0,1.0,1.0,3.0,3.0,4.0,10.0,10.0,12.0,12.0,12.0,7.0,8.0,11.0,5.0,7.0,10.0,10.0,7.0,11.0,8.0,10.0,10.0,12.0,8.0,11.0,8.0,14.0,13.0,6.0,14.0,8.0,13.0,13.0,16.0,14.0,13.0,9.0,20.0,15.0,16.0,10.0,15.0,13.0,12.0,8.0,11.0,7.0,12.0,11.0,11.0,15.0,10.0,12.0,14.0,14.0,1.0,32.0,0.0,0.0,0.0,0.0,172.0,71.0,2.0,1.0,3.0,1.0,2.0,3.0,2.0,3.0,2.0,2.0,2.0,8.0,9.0,7.0,6.0,10.0,6.0,10.0,9.0,10.0,14.0,11.0,6.0,14.0,11.0,10.0,16.0,15.0,12.0,12.0,7.0,12.0,15.0,9.0,13.0,8.0,14.0,15.0,15.0,14.0,14.0,14.0,10.0,20.0,14.0,14.0,8.0,15.0,13.0,13.0,11.0,13.0,7.0,13.0,17.0,14.0,17.0,8.0,13.0,15.0,15.0,6.0,32.0,11.0,1.0,0.0,0.0,176.0,68.0,2.0,1.0,3.0,2.0,2.0,2.0,2.0,3.0,3.0,2.0,2.0,8.0,10.0,10.0,7.0,11.0,8.0,10.0,11.0,12.0,11.0,13.0,12.0,14.0,12.0,9.0,14.0,15.0,13.0,12.0,11.0,12.0,17.0,8.0,14.0,14.0,11.0,18.0,18.0,14.0,14.0,12.0,10.0,10.0,14.0,13.0,20.0,17.0,13.0,15.0,9.0,13.0,8.0,13.0,17.0,13.0,15.0,16.0,16.0,16.0,18.0,5.0,19.0,0.0,0.0,0.0,0.0,185.0,82.0,4.0,2.0,3.0,1.0,3.0,2.0,1.0,2.0,1.0,2.0,3.0,7.0,7.0,10.0,6.0,13.0,7.0,14.0,7.0,6.0,12.0,13.0,7.0,13.0,13.0,13.0,13.0,13.0,11.0,12.0,11.0,12.0,14.0,9.0,14.0,11.0,11.0,15.0,15.0,12.0,12.0,14.0,13.0,5.0,14.0,12.0,20.0,14.0,13.0,10.0,11.0,11.0,6.0,10.0,10.0,12.0,12.0,14.0,14.0,11.0,16.0,6.0,27.0,8.0,0.0,6.0,0.0,187.0,76.0,3.0,2.0,3.0,2.0,2.0,1.0,1.0,3.0,3.0,1.0,2.0,5.0,7.0,11.0,5.0,14.0,5.0,14.0,9.0,5.0,15.0,15.0,8.0,14.0,13.0,15.0,16.0,15.0,14.0,12.0,14.0,14.0,18.0,8.0,17.0,9.0,12.0,18.0,15.0,13.0,14.0,15.0,14.0,10.0,17.0,12.0,20.0,17.0,15.0,14.0,13.0,16.0,4.0,12.0,10.0,14.0,17.0,12.0,15.0,13.0,13.0,6.0,24.0,6.0,1.0,0.0,0.0,183.0,66.0,1.0,1.0,2.0,2.0,1.0,2.0,1.0,2.0,3.0,2.0,1.0,14.0,14.0,14.0,10.0,14.0,14.0,9.0,10.0,8.0,8.0,14.0,10.0,8.0,15.0,9.0,11.0,13.0,11.0,11.0,13.0,10.0,14.0,13.0,5.0,12.0,9.0,14.0,13.0,14.0,16.0,12.0,9.0,20.0,13.0,14.0,5.0,15.0,9.0,12.0,10.0,12.0,8.0,9.0,16.0,9.0,16.0,13.0,11.0,12.0,13.0,9.0,25.0,10.0,1.0,11.0,4.0,175.0,73.0,1.0,3.0,3.0,3.0,3.0,3.0,3.0,1.0,2.0,3.0,1.0,5.0,10.0,15.0,17.0,15.0,10.0,11.0,12.0,5.0,5.0,14.0,15.0,5.0,16.0,8.0,15.0,12.0,15.0,14.0,13.0,15.0,15.0,15.0,14.0,14.0,10.0,10.0,12.0,16.0,16.0,15.0,9.0,10.0,15.0,16.0,20.0,13.0,15.0,14.0,8.0,14.0,7.0,10.0,8.0,16.0,17.0,13.0,15.0,15.0,14.0,5.0,22.0,5.0,1.0,1.0,0.0,173.0,72.0,1.0,3.0,1.0,3.0,3.0,3.0,3.0,3.0,3.0,2.0,2.0,14.0,13.0,16.0,14.0,16.0,14.0,5.0,11.0,5.0,5.0,15.0,11.0,5.0,16.0,8.0,13.0,9.0,14.0,13.0,15.0,13.0,15.0,16.0,5.0,13.0,5.0,9.0,10.0,15.0,16.0,14.0,5.0,20.0,14.0,15.0,5.0,12.0,14.0,13.0,11.0,13.0,8.0,14.0,10.0,15.0,14.0,10.0,13.0,10.0,10.0,13.0
2,0,25.0,0.0,0.0,0.0,0.0,185.0,85.0,14.0,11.0,14.0,10.0,12.0,14.0,13.0,14.0,11.0,15.0,9.0,4.0,1.0,3.0,1.0,9.0,8.0,3.0,11.0,1.0,2.0,8.0,2.0,7.0,9.0,8.0,13.0,13.0,12.0,12.0,8.0,11.0,16.0,6.0,14.0,1.0,12.0,12.0,7.0,10.0,13.0,15.0,12.0,5.0,17.0,9.0,20.0,13.0,15.0,14.0,8.0,13.0,3.0,1.0,17.0,13.0,13.0,13.0,14.0,14.0,14.0,5.0,28.0,0.0,0.0,0.0,0.0,190.0,83.0,1.0,1.0,3.0,2.0,1.0,1.0,3.0,3.0,1.0,2.0,1.0,2.0,9.0,5.0,6.0,10.0,5.0,13.0,7.0,4.0,12.0,9.0,7.0,10.0,11.0,13.0,14.0,15.0,13.0,11.0,8.0,11.0,13.0,8.0,12.0,7.0,12.0,12.0,12.0,11.0,11.0,15.0,15.0,20.0,15.0,11.0,5.0,13.0,16.0,15.0,13.0,11.0,7.0,5.0,12.0,12.0,14.0,12.0,15.0,13.0,12.0,6.0,23.0,16.0,0.0,5.0,0.0,186.0,81.0,3.0,1.0,1.0,3.0,3.0,1.0,3.0,3.0,2.0,2.0,2.0,4.0,8.0,7.0,3.0,12.0,5.0,12.0,8.0,8.0,14.0,13.0,6.0,12.0,8.0,12.0,13.0,11.0,13.0,13.0,11.0,12.0,15.0,5.0,7.0,6.0,15.0,14.0,12.0,11.0,9.0,13.0,13.0,6.0,8.0,11.0,20.0,13.0,13.0,10.0,5.0,12.0,4.0,12.0,8.0,12.0,10.0,7.0,16.0,15.0,14.0,4.0,36.0,0.0,0.0,0.0,0.0,182.0,70.0,2.0,1.0,3.0,3.0,1.0,2.0,1.0,1.0,1.0,1.0,3.0,8.0,11.0,8.0,6.0,11.0,7.0,10.0,8.0,12.0,13.0,10.0,6.0,14.0,11.0,15.0,13.0,15.0,11.0,12.0,7.0,10.0,12.0,6.0,13.0,7.0,14.0,14.0,14.0,12.0,11.0,14.0,11.0,12.0,12.0,10.0,20.0,13.0,12.0,12.0,15.0,13.0,9.0,10.0,6.0,12.0,14.0,11.0,15.0,12.0,12.0,6.0,29.0,6.0,0.0,0.0,0.0,183.0,72.0,3.0,3.0,3.0,4.0,1.0,3.0,3.0,3.0,1.0,3.0,3.0,2.0,13.0,13.0,8.0,14.0,8.0,10.0,12.0,10.0,12.0,13.0,8.0,14.0,10.0,14.0,13.0,10.0,12.0,12.0,10.0,12.0,4.0,12.0,4.0,14.0,12.0,13.0,14.0,14.0,13.0,13.0,11.0,5.0,14.0,15.0,20.0,14.0,11.0,13.0,2.0,12.0,7.0,8.0,16.0,10.0,11.0,13.0,10.0,3.0,19.0,8.0,28.0,1.0,0.0,0.0,0.0,183.0,76.0,1.0,1.0,1.0,2.0,2.0,2.0,2.0,1.0,3.0,1.0,1.0,12.0,13.0,10.0,6.0,12.0,7.0,11.0,11.0,12.0,10.0,11.0,4.0,13.0,12.0,16.0,11.0,13.0,11.0,12.0,10.0,11.0,4.0,6.0,11.0,10.0,12.0,14.0,14.0,12.0,10.0,12.0,9.0,16.0,11.0,13.0,20.0,14.0,12.0,10.0,10.0,12.0,6.0,10.0,20.0,10.0,11.0,12.0,11.0,7.0,8.0,14.0,23.0,2.0,0.0,5.0,0.0,180.0,77.0,3.0,2.0,2.0,3.0,2.0,3.0,2.0,2.0,3.0,3.0,4.0,14.0,12.0,12.0,10.0,13.0,14.0,6.0,14.0,8.0,8.0,13.0,12.0,9.0,14.0,13.0,12.0,12.0,11.0,10.0,12.0,13.0,13.0,10.0,6.0,13.0,10.0,12.0,14.0,13.0,14.0,13.0,10.0,8.0,13.0,14.0,20.0,14.0,14.0,9.0,8.0,14.0,6.0,16.0,13.0,12.0,13.0,12.0,13.0,13.0,14.0,6.0,24.0,0.0,0.0,0.0,0.0,177.0,70.0,2.0,4.0,2.0,1.0,1.0,3.0,1.0,3.0,4.0,2.0,1.0,6.0,10.0,11.0,7.0,13.0,6.0,9.0,13.0,7.0,12.0,14.0,7.0,13.0,13.0,13.0,13.0,13.0,11.0,11.0,11.0,12.0,13.0,10.0,7.0,11.0,11.0,14.0,15.0,13.0,13.0,14.0,9.0,6.0,15.0,14.0,20.0,15.0,12.0,13.0,11.0,13.0,7.0,12.0,19.0,12.0,17.0,10.0,13.0,13.0,13.0,6.0,36.0,0.0,0.0,3.0,0.0,168.0,72.0,3.0,2.0,1.0,3.0,1.0,3.0,3.0,1.0,3.0,3.0,1.0,11.0,8.0,12.0,5.0,13.0,11.0,8.0,13.0,6.0,12.0,13.0,8.0,14.0,13.0,17.0,14.0,17.0,14.0,15.0,13.0,14.0,17.0,12.0,16.0,10.0,15.0,16.0,14.0,10.0,13.0,14.0,4.0,8.0,16.0,8.0,20.0,12.0,13.0,17.0,14.0,14.0,7.0,10.0,19.0,15.0,14.0,16.0,15.0,9.0,9.0,7.0,23.0,0.0,0.0,0.0,0.0,183.0,80.0,3.0,2.0,1.0,3.0,1.0,3.0,2.0,3.0,1.0,2.0,3.0,4.0,12.0,13.0,14.0,12.0,9.0,10.0,14.0,5.0,5.0,12.0,11.0,7.0,12.0,11.0,12.0,12.0,10.0,12.0,10.0,11.0,5.0,11.0,9.0,14.0,10.0,13.0,12.0,15.0,14.0,13.0,11.0,8.0,12.0,14.0,20.0,13.0,14.0,10.0,8.0,13.0,7.0,7.0,16.0,14.0,11.0,10.0,12.0,9.0,9.0,2.0,27.0,11.0,1.0,0.0,0.0,187.0,86.0,3.0,1.0,2.0,2.0,4.0,3.0,2.0,1.0,1.0,3.0,1.0,3.0,9.0,13.0,15.0,12.0,10.0,17.0,11.0,5.0,5.0,9.0,14.0,4.0,11.0,9.0,12.0,13.0,12.0,11.0,9.0,10.0,13.0,11.0,10.0,13.0,10.0,15.0,15.0,14.0,12.0,15.0,13.0,7.0,15.0,13.0,20.0,13.0,15.0,14.0,9.0,13.0,7.0,5.0,15.0,13.0,13.0,11.0,10.0,12.0,18.0,6.0,36.0,0.0,0.0,0.0,0.0,185.0,78.0,11.0,14.0,12.0,7.0,13.0,12.0,14.0,15.0,13.0,14.0,10.0,4.0,1.0,3.0,1.0,8.0,8.0,11.0,8.0,3.0,3.0,7.0,2.0,1.0,8.0,11.0,13.0,15.0,11.0,12.0,7.0,13.0,9.0,5.0,14.0,3.0,13.0,15.0,8.0,11.0,14.0,13.0,12.0,5.0,15.0,11.0,20.0,12.0,14.0,13.0,11.0,13.0,8.0,1.0,19.0,14.0,16.0,10.0,17.0,9.0,9.0,11.0,28.0,0.0,0.0,0.0,0.0,183.0,81.0,1.0,2.0,4.0,1.0,1.0,3.0,2.0,3.0,3.0,3.0,1.0,5.0,5.0,6.0,10.0,12.0,6.0,14.0,8.0,6.0,15.0,11.0,6.0,13.0,12.0,13.0,14.0,16.0,14.0,14.0,10.0,12.0,14.0,5.0,14.0,8.0,14.0,15.0,15.0,9.0,12.0,15.0,13.0,7.0,11.0,12.0,20.0,15.0,15.0,14.0,14.0,14.0,9.0,8.0,14.0,14.0,11.0,13.0,15.0,13.0,15.0,6.0,34.0,23.0,1.0,0.0,0.0,186.0,81.0,3.0,3.0,1.0,2.0,1.0,3.0,2.0,3.0,1.0,3.0,3.0,4.0,8.0,6.0,10.0,7.0,8.0,17.0,12.0,10.0,14.0,7.0,9.0,15.0,7.0,15.0,13.0,17.0,8.0,12.0,7.0,12.0,15.0,6.0,17.0,7.0,14.0,15.0,14.0,8.0,10.0,16.0,13.0,12.0,13.0,9.0,20.0,13.0,15.0,11.0,15.0,14.0,9.0,10.0,10.0,14.0,11.0,13.0,15.0,11.0,11.0,12.0,21.0,0.0,0.0,1.0,0.0,177.0,68.0,4.0,1.0,2.0,1.0,1.0,1.0,1.0,1.0,2.0,1.0,2.0,5.0,12.0,9.0,7.0,12.0,8.0,13.0,10.0,16.0,13.0,12.0,8.0,14.0,12.0,12.0,13.0,12.0,12.0,12.0,10.0,13.0,15.0,11.0,13.0,11.0,13.0,13.0,14.0,13.0,14.0,13.0,11.0,10.0,14.0,12.0,20.0,12.0,14.0,12.0,11.0,12.0,8.0,14.0,13.0,10.0,14.0,12.0,14.0,12.0,11.0,5.0,36.0,0.0,0.0,0.0,0.0,180.0,72.0,1.0,2.0,4.0,1.0,1.0,2.0,2.0,1.0,1.0,1.0,2.0,6.0,10.0,8.0,6.0,11.0,8.0,13.0,10.0,7.0,11.0,11.0,8.0,13.0,11.0,13.0,13.0,14.0,14.0,13.0,11.0,12.0,13.0,7.0,10.0,10.0,13.0,13.0,15.0,11.0,12.0,14.0,10.0,10.0,14.0,10.0,20.0,12.0,11.0,12.0,14.0,14.0,5.0,15.0,20.0,12.0,20.0,14.0,16.0,15.0,15.0,5.0,27.0,14.0,1.0,0.0,0.0,183.0,77.0,1.0,2.0,1.0,2.0,3.0,2.0,3.0,2.0,2.0,1.0,1.0,5.0,12.0,9.0,8.0,13.0,10.0,13.0,10.0,6.0,14.0,13.0,6.0,13.0,12.0,14.0,13.0,15.0,11.0,11.0,11.0,11.0,13.0,9.0,8.0,9.0,12.0,14.0,16.0,14.0,12.0,14.0,12.0,7.0,14.0,12.0,20.0,15.0,14.0,14.0,14.0,15.0,7.0,10.0,12.0,13.0,14.0,12.0,13.0,11.0,11.0,7.0,18.0,0.0,0.0,0.0,0.0,178.0,70.0,1.0,2.0,3.0,1.0,1.0,3.0,2.0,2.0,3.0,3.0,2.0,6.0,9.0,11.0,6.0,13.0,8.0,6.0,10.0,5.0,10.0,14.0,6.0,8.0,13.0,10.0,10.0,10.0,13.0,12.0,12.0,10.0,16.0,12.0,5.0,12.0,6.0,10.0,11.0,12.0,13.0,12.0,9.0,20.0,14.0,14.0,5.0,8.0,11.0,10.0,6.0,2.0,8.0,10.0,20.0,9.0,11.0,11.0,10.0,12.0,12.0,1.0,33.0,0.0,0.0,0.0,0.0,187.0,76.0,2.0,2.0,3.0,1.0,1.0,3.0,2.0,1.0,2.0,3.0,2.0,15.0,14.0,14.0,10.0,15.0,13.0,10.0,12.0,7.0,4.0,15.0,13.0,7.0,15.0,6.0,12.0,9.0,14.0,11.0,15.0,12.0,12.0,14.0,12.0,13.0,7.0,13.0,12.0,11.0,12.0,14.0,12.0,14.0,15.0,12.0,20.0,11.0,12.0,12.0,6.0,14.0,6.0,11.0,14.0,13.0,12.0,12.0,15.0,15.0,13.0,9.0,23.0,27.0,1.0,0.0,0.0,178.0,70.0,1.0,2.0,1.0,4.0,1.0,1.0,1.0,3.0,2.0,1.0,1.0,8.0,11.0,13.0,11.0,13.0,12.0,7.0,14.0,6.0,5.0,12.0,10.0,5.0,14.0,11.0,11.0,12.0,11.0,9.0,13.0,10.0,14.0,14.0,5.0,13.0,7.0,10.0,12.0,15.0,14.0,12.0,9.0,20.0,13.0,13.0,8.0,13.0,13.0,12.0,11.0,11.0,10.0,11.0,12.0,12.0,12.0,11.0,10.0,10.0,10.0,6.0,30.0,0.0,0.0,0.0,0.0,178.0,73.0,3.0,4.0,1.0,1.0,2.0,4.0,3.0,2.0,2.0,2.0,3.0,13.0,14.0,12.0,7.0,13.0,12.0,7.0,13.0,5.0,10.0,13.0,9.0,10.0,13.0,11.0,11.0,12.0,12.0,13.0,11.0,14.0,14.0,11.0,7.0,11.0,10.0,13.0,15.0,13.0,15.0,15.0,8.0,20.0,14.0,14.0,8.0,14.0,11.0,13.0,11.0,14.0,8.0,10.0,19.0,12.0,12.0,9.0,12.0,12.0,10.0,10.0,27.0,0.0,0.0,0.0,0.0,190.0,87.0,1.0,3.0,2.0,3.0,1.0,3.0,1.0,1.0,2.0,3.0,2.0,5.0,7.0,9.0,14.0,14.0,10.0,14.0,13.0,5.0,6.0,12.0,12.0,8.0,14.0,14.0,13.0,16.0,14.0,11.0,10.0,13.0,15.0,10.0,11.0,14.0,9.0,15.0,14.0,10.0,11.0,16.0,15.0,9.0,12.0,12.0,20.0,14.0,16.0,13.0,13.0,12.0,7.0,5.0,10.0,12.0,14.0,12.0,14.0,14.0,19.0,12.0
3,2,28.0,0.0,0.0,6.0,0.0,191.0,81.0,11.0,10.0,14.0,8.0,13.0,12.0,14.0,15.0,11.0,8.0,13.0,4.0,3.0,2.0,1.0,9.0,9.0,3.0,10.0,1.0,1.0,8.0,3.0,3.0,9.0,8.0,12.0,14.0,12.0,13.0,8.0,11.0,12.0,6.0,14.0,2.0,12.0,10.0,7.0,13.0,14.0,16.0,15.0,6.0,14.0,11.0,20.0,15.0,14.0,12.0,9.0,14.0,7.0,1.0,9.0,15.0,13.0,11.0,15.0,15.0,14.0,8.0,23.0,0.0,0.0,0.0,0.0,184.0,71.0,1.0,2.0,1.0,2.0,2.0,2.0,2.0,4.0,2.0,1.0,3.0,4.0,10.0,10.0,6.0,11.0,6.0,14.0,8.0,7.0,14.0,11.0,6.0,13.0,11.0,12.0,12.0,13.0,12.0,11.0,12.0,12.0,14.0,6.0,8.0,10.0,13.0,13.0,14.0,15.0,13.0,14.0,13.0,8.0,12.0,14.0,20.0,13.0,14.0,13.0,12.0,14.0,15.0,8.0,11.0,13.0,13.0,10.0,8.0,9.0,16.0,7.0,28.0,0.0,0.0,0.0,0.0,174.0,67.0,3.0,4.0,1.0,1.0,1.0,3.0,1.0,3.0,2.0,1.0,2.0,11.0,8.0,11.0,9.0,13.0,6.0,7.0,12.0,8.0,10.0,10.0,3.0,6.0,12.0,10.0,13.0,7.0,12.0,8.0,10.0,9.0,12.0,13.0,5.0,12.0,9.0,12.0,11.0,14.0,14.0,11.0,7.0,10.0,15.0,12.0,20.0,11.0,6.0,9.0,6.0,10.0,10.0,9.0,11.0,14.0,9.0,11.0,12.0,8.0,8.0,8.0,21.0,0.0,0.0,0.0,0.0,177.0,0.0,1.0,1.0,1.0,2.0,3.0,3.0,2.0,3.0,2.0,2.0,3.0,6.0,4.0,13.0,13.0,13.0,6.0,13.0,7.0,3.0,5.0,7.0,6.0,1.0,11.0,9.0,7.0,8.0,7.0,7.0,7.0,8.0,7.0,11.0,8.0,13.0,7.0,6.0,7.0,12.0,13.0,7.0,6.0,8.0,8.0,13.0,20.0,5.0,5.0,9.0,5.0,9.0,9.0,9.0,10.0,10.0,12.0,12.0,11.0,10.0,9.0,6.0,21.0,0.0,0.0,0.0,0.0,178.0,65.0,2.0,3.0,3.0,3.0,3.0,1.0,1.0,1.0,1.0,3.0,1.0,9.0,13.0,11.0,6.0,12.0,7.0,9.0,8.0,8.0,13.0,12.0,7.0,13.0,12.0,8.0,12.0,13.0,12.0,12.0,13.0,13.0,14.0,9.0,8.0,12.0,12.0,13.0,13.0,12.0,14.0,13.0,11.0,8.0,15.0,12.0,20.0,13.0,12.0,14.0,8.0,11.0,7.0,10.0,19.0,10.0,13.0,10.0,11.0,15.0,15.0,6.0,21.0,0.0,0.0,0.0,0.0,172.0,66.0,2.0,3.0,2.0,2.0,1.0,1.0,1.0,3.0,2.0,1.0,1.0,10.0,10.0,13.0,9.0,14.0,9.0,8.0,10.0,7.0,13.0,13.0,9.0,12.0,13.0,10.0,12.0,13.0,13.0,12.0,14.0,13.0,13.0,11.0,9.0,14.0,13.0,14.0,14.0,14.0,13.0,12.0,8.0,8.0,12.0,12.0,20.0,13.0,12.0,14.0,10.0,11.0,8.0,12.0,15.0,10.0,15.0,8.0,11.0,14.0,14.0,6.0,32.0,22.0,1.0,6.0,1.0,186.0,79.0,1.0,2.0,1.0,1.0,2.0,3.0,1.0,2.0,1.0,2.0,1.0,11.0,12.0,13.0,11.0,13.0,11.0,14.0,11.0,8.0,12.0,13.0,13.0,13.0,13.0,14.0,13.0,14.0,14.0,13.0,14.0,13.0,12.0,13.0,14.0,15.0,13.0,12.0,15.0,12.0,13.0,12.0,12.0,10.0,12.0,13.0,20.0,15.0,13.0,14.0,5.0,12.0,9.0,17.0,8.0,12.0,8.0,13.0,10.0,10.0,10.0,5.0,25.0,1.0,0.0,7.0,3.0,178.0,85.0,2.0,3.0,3.0,2.0,3.0,3.0,2.0,3.0,2.0,2.0,2.0,9.0,12.0,12.0,12.0,11.0,8.0,9.0,12.0,6.0,7.0,11.0,12.0,7.0,13.0,12.0,11.0,14.0,12.0,9.0,10.0,10.0,14.0,13.0,7.0,13.0,9.0,9.0,12.0,14.0,12.0,15.0,10.0,14.0,11.0,14.0,20.0,13.0,15.0,10.0,11.0,12.0,6.0,14.0,14.0,13.0,12.0,13.0,10.0,13.0,12.0,12.0,22.0,0.0,0.0,0.0,0.0,177.0,72.0,2.0,1.0,2.0,4.0,2.0,2.0,1.0,3.0,4.0,2.0,3.0,10.0,12.0,13.0,11.0,12.0,10.0,12.0,12.0,4.0,10.0,13.0,11.0,11.0,13.0,11.0,12.0,11.0,13.0,9.0,13.0,12.0,3.0,12.0,8.0,14.0,12.0,12.0,13.0,16.0,13.0,12.0,9.0,8.0,15.0,14.0,20.0,14.0,13.0,10.0,4.0,11.0,11.0,12.0,19.0,9.0,12.0,13.0,12.0,11.0,14.0,7.0,21.0,2.0,0.0,4.0,2.0,183.0,72.0,1.0,1.0,2.0,1.0,1.0,1.0,3.0,3.0,1.0,3.0,1.0,8.0,9.0,11.0,13.0,12.0,8.0,11.0,10.0,6.0,5.0,12.0,10.0,7.0,11.0,14.0,12.0,10.0,11.0,10.0,12.0,13.0,11.0,14.0,7.0,13.0,5.0,10.0,12.0,13.0,13.0,13.0,11.0,11.0,16.0,14.0,20.0,13.0,12.0,14.0,7.0,12.0,5.0,12.0,6.0,17.0,5.0,12.0,14.0,9.0,12.0,14.0,25.0,0.0,0.0,0.0,0.0,187.0,83.0,2.0,1.0,3.0,3.0,1.0,3.0,3.0,3.0,1.0,1.0,3.0,4.0,8.0,10.0,14.0,12.0,8.0,14.0,9.0,5.0,7.0,11.0,13.0,5.0,12.0,11.0,13.0,13.0,13.0,11.0,10.0,12.0,16.0,9.0,8.0,13.0,11.0,13.0,16.0,14.0,13.0,15.0,13.0,20.0,14.0,12.0,8.0,14.0,16.0,13.0,11.0,13.0,7.0,5.0,13.0,14.0,13.0,14.0,14.0,13.0,13.0,6.0,33.0,0.0,0.0,2.0,0.0,196.0,89.0,15.0,13.0,12.0,7.0,14.0,10.0,14.0,14.0,11.0,9.0,12.0,4.0,3.0,1.0,1.0,9.0,7.0,2.0,2.0,1.0,1.0,10.0,2.0,2.0,9.0,10.0,14.0,14.0,13.0,12.0,11.0,12.0,14.0,6.0,12.0,1.0,13.0,11.0,6.0,9.0,13.0,16.0,18.0,5.0,12.0,10.0,20.0,12.0,16.0,14.0,10.0,15.0,13.0,1.0,8.0,14.0,14.0,14.0,10.0,15.0,15.0,9.0,34.0,5.0,0.0,2.0,1.0,186.0,78.0,2.0,1.0,3.0,3.0,1.0,3.0,2.0,3.0,1.0,3.0,1.0,7.0,11.0,10.0,6.0,12.0,8.0,14.0,7.0,14.0,14.0,10.0,9.0,14.0,12.0,13.0,13.0,15.0,13.0,13.0,9.0,12.0,15.0,10.0,13.0,8.0,13.0,13.0,14.0,11.0,12.0,14.0,13.0,8.0,13.0,12.0,20.0,14.0,14.0,13.0,13.0,15.0,9.0,12.0,8.0,16.0,13.0,14.0,13.0,16.0,16.0,7.0,30.0,19.0,0.0,7.0,0.0,189.0,77.0,3.0,2.0,3.0,2.0,3.0,3.0,1.0,3.0,3.0,1.0,2.0,5.0,8.0,7.0,10.0,10.0,9.0,15.0,9.0,8.0,14.0,12.0,10.0,15.0,10.0,15.0,14.0,13.0,13.0,14.0,10.0,12.0,14.0,10.0,14.0,11.0,12.0,14.0,14.0,8.0,10.0,12.0,16.0,10.0,16.0,10.0,20.0,13.0,16.0,13.0,11.0,13.0,7.0,10.0,6.0,14.0,12.0,13.0,14.0,13.0,13.0,7.0,26.0,27.0,0.0,0.0,0.0,183.0,70.0,1.0,3.0,1.0,3.0,4.0,1.0,3.0,3.0,2.0,1.0,3.0,9.0,14.0,12.0,8.0,10.0,8.0,12.0,13.0,14.0,9.0,12.0,7.0,13.0,11.0,14.0,9.0,15.0,10.0,12.0,9.0,10.0,16.0,10.0,9.0,12.0,8.0,12.0,17.0,14.0,11.0,13.0,12.0,10.0,16.0,16.0,20.0,16.0,13.0,13.0,10.0,14.0,6.0,15.0,10.0,15.0,14.0,10.0,16.0,13.0,13.0,4.0,35.0,80.0,0.0,11.0,0.0,174.0,74.0,3.0,4.0,2.0,2.0,2.0,2.0,1.0,2.0,2.0,3.0,2.0,8.0,14.0,13.0,7.0,15.0,8.0,14.0,4.0,14.0,14.0,13.0,9.0,16.0,15.0,15.0,15.0,16.0,17.0,13.0,11.0,15.0,19.0,14.0,18.0,14.0,17.0,16.0,14.0,12.0,13.0,15.0,9.0,20.0,17.0,12.0,9.0,13.0,11.0,16.0,14.0,16.0,4.0,10.0,18.0,14.0,17.0,17.0,14.0,14.0,14.0,12.0,18.0,0.0,0.0,0.0,0.0,167.0,60.0,2.0,1.0,2.0,2.0,2.0,1.0,2.0,1.0,1.0,1.0,1.0,10.0,11.0,12.0,8.0,13.0,10.0,3.0,10.0,5.0,6.0,13.0,12.0,8.0,15.0,8.0,11.0,8.0,12.0,11.0,13.0,12.0,13.0,12.0,6.0,11.0,11.0,12.0,13.0,15.0,14.0,8.0,5.0,8.0,15.0,12.0,20.0,12.0,7.0,8.0,8.0,14.0,7.0,8.0,18.0,11.0,12.0,11.0,12.0,15.0,15.0,7.0,27.0,0.0,0.0,2.0,0.0,179.0,73.0,3.0,2.0,2.0,2.0,1.0,2.0,1.0,1.0,2.0,2.0,1.0,9.0,10.0,12.0,8.0,13.0,9.0,12.0,13.0,6.0,12.0,13.0,10.0,14.0,13.0,14.0,13.0,13.0,14.0,9.0,13.0,11.0,8.0,12.0,7.0,12.0,12.0,11.0,13.0,14.0,14.0,13.0,9.0,12.0,14.0,12.0,20.0,16.0,12.0,13.0,14.0,14.0,10.0,8.0,12.0,12.0,12.0,9.0,13.0,11.0,11.0,13.0,21.0,0.0,0.0,11.0,2.0,180.0,72.0,2.0,3.0,3.0,3.0,3.0,2.0,2.0,1.0,3.0,2.0,3.0,12.0,13.0,14.0,9.0,14.0,13.0,8.0,12.0,5.0,8.0,14.0,10.0,9.0,14.0,12.0,12.0,9.0,13.0,12.0,15.0,13.0,14.0,15.0,8.0,13.0,10.0,16.0,14.0,15.0,14.0,12.0,9.0,8.0,15.0,14.0,20.0,13.0,12.0,12.0,8.0,11.0,10.0,11.0,10.0,14.0,16.0,14.0,15.0,15.0,15.0,6.0,26.0,4.0,0.0,17.0,4.0,171.0,62.0,2.0,3.0,2.0,2.0,2.0,1.0,3.0,2.0,3.0,1.0,4.0,12.0,12.0,14.0,12.0,15.0,12.0,6.0,12.0,5.0,3.0,14.0,14.0,4.0,15.0,10.0,13.0,11.0,13.0,12.0,12.0,11.0,14.0,15.0,7.0,15.0,7.0,11.0,10.0,16.0,15.0,10.0,6.0,12.0,14.0,15.0,20.0,13.0,7.0,12.0,10.0,13.0,6.0,12.0,13.0,13.0,15.0,13.0,14.0,12.0,15.0,5.0,29.0,26.0,6.0,12.0,4.0,175.0,77.0,1.0,2.0,1.0,3.0,3.0,2.0,1.0,2.0,1.0,2.0,2.0,16.0,14.0,16.0,15.0,15.0,18.0,6.0,15.0,6.0,6.0,18.0,11.0,5.0,17.0,9.0,12.0,10.0,16.0,12.0,16.0,14.0,14.0,16.0,6.0,16.0,6.0,10.0,10.0,13.0,15.0,14.0,8.0,15.0,15.0,14.0,20.0,13.0,12.0,11.0,9.0,16.0,7.0,8.0,8.0,11.0,8.0,13.0,12.0,13.0,11.0,10.0,30.0,12.0,3.0,0.0,0.0,184.0,77.0,1.0,2.0,1.0,1.0,1.0,4.0,2.0,1.0,1.0,2.0,3.0,4.0,8.0,12.0,15.0,12.0,9.0,16.0,11.0,5.0,6.0,11.0,16.0,4.0,13.0,9.0,14.0,15.0,13.0,13.0,9.0,12.0,12.0,15.0,10.0,14.0,5.0,12.0,10.0,12.0,13.0,14.0,13.0,10.0,11.0,13.0,20.0,15.0,16.0,11.0,9.0,14.0,6.0,5.0,10.0,17.0,11.0,14.0,14.0,15.0,17.0,10.0
1,1,30.0,0.0,0.0,0.0,0.0,180.0,75.0,11.0,13.0,13.0,9.0,13.0,11.0,12.0,15.0,15.0,14.0,13.0,6.0,1.0,2.0,3.0,7.0,8.0,1.0,1.0,1.0,2.0,7.0,2.0,1.0,7.0,8.0,12.0,14.0,13.0,14.0,7.0,12.0,14.0,5.0,12.0,3.0,13.0,15.0,9.0,13.0,14.0,13.0,10.0,5.0,14.0,11.0,20.0,12.0,13.0,12.0,8.0,14.0,6.0,1.0,9.0,13.0,14.0,13.0,16.0,15.0,15.0,5.0,26.0,11.0,0.0,0.0,0.0,180.0,81.0,3.0,2.0,2.0,3.0,3.0,2.0,1.0,2.0,2.0,1.0,2.0,5.0,9.0,8.0,5.0,11.0,5.0,13.0,10.0,8.0,15.0,10.0,7.0,13.0,10.0,15.0,14.0,17.0,11.0,12.0,9.0,12.0,16.0,8.0,10.0,8.0,13.0,14.0,15.0,13.0,12.0,14.0,12.0,20.0,14.0,12.0,8.0,14.0,14.0,14.0,10.0,15.0,13.0,8.0,9.0,14.0,17.0,13.0,13.0,13.0,11.0,8.0,21.0,0.0,0.0,0.0,0.0,182.0,74.0,2.0,2.0,2.0,2.0,2.0,1.0,1.0,1.0,3.0,2.0,2.0,9.0,11.0,12.0,7.0,9.0,8.0,12.0,7.0,11.0,12.0,7.0,8.0,13.0,11.0,12.0,12.0,14.0,12.0,13.0,7.0,12.0,11.0,1.0,9.0,11.0,9.0,10.0,12.0,14.0,10.0,13.0,11.0,9.0,8.0,12.0,20.0,13.0,11.0,10.0,13.0,8.0,10.0,10.0,15.0,11.0,13.0,10.0,10.0,8.0,13.0,7.0,30.0,0.0,0.0,6.0,0.0,181.0,78.0,2.0,1.0,1.0,1.0,2.0,3.0,1.0,1.0,2.0,1.0,3.0,8.0,13.0,10.0,6.0,11.0,9.0,12.0,14.0,13.0,14.0,10.0,8.0,14.0,12.0,10.0,12.0,13.0,13.0,13.0,10.0,11.0,10.0,6.0,13.0,8.0,15.0,14.0,13.0,13.0,12.0,14.0,10.0,20.0,15.0,11.0,8.0,13.0,14.0,11.0,10.0,13.0,6.0,8.0,10.0,12.0,14.0,8.0,15.0,15.0,15.0,9.0,28.0,22.0,0.0,20.0,1.0,176.0,74.0,2.0,3.0,2.0,1.0,1.0,1.0,3.0,3.0,2.0,2.0,1.0,15.0,15.0,12.0,8.0,13.0,12.0,5.0,11.0,15.0,10.0,13.0,9.0,10.0,12.0,10.0,11.0,10.0,13.0,12.0,11.0,12.0,11.0,11.0,7.0,13.0,10.0,14.0,15.0,15.0,14.0,10.0,8.0,20.0,13.0,14.0,8.0,15.0,8.0,14.0,5.0,12.0,5.0,14.0,15.0,15.0,10.0,14.0,13.0,12.0,12.0,2.0,22.0,0.0,0.0,6.0,1.0,175.0,75.0,3.0,3.0,2.0,1.0,1.0,2.0,3.0,2.0,2.0,1.0,1.0,10.0,9.0,12.0,6.0,11.0,7.0,10.0,11.0,7.0,9.0,11.0,6.0,10.0,14.0,12.0,10.0,12.0,10.0,10.0,12.0,11.0,10.0,13.0,6.0,11.0,8.0,11.0,13.0,12.0,14.0,12.0,8.0,5.0,14.0,13.0,20.0,11.0,12.0,10.0,10.0,10.0,8.0,10.0,8.0,11.0,10.0,9.0,12.0,12.0,15.0,6.0,20.0,0.0,0.0,0.0,0.0,175.0,77.0,2.0,1.0,2.0,3.0,3.0,3.0,3.0,1.0,4.0,3.0,1.0,8.0,8.0,12.0,12.0,11.0,8.0,13.0,10.0,9.0,10.0,11.0,10.0,9.0,12.0,12.0,6.0,9.0,9.0,11.0,15.0,11.0,4.0,10.0,8.0,12.0,11.0,10.0,13.0,14.0,15.0,15.0,8.0,8.0,9.0,15.0,20.0,11.0,12.0,12.0,8.0,4.0,10.0,10.0,15.0,11.0,12.0,11.0,9.0,10.0,10.0,7.0,27.0,32.0,6.0,0.0,0.0,188.0,78.0,3.0,2.0,3.0,2.0,1.0,3.0,3.0,3.0,2.0,2.0,2.0,4.0,8.0,11.0,12.0,12.0,6.0,16.0,13.0,8.0,13.0,14.0,7.0,12.0,12.0,12.0,10.0,14.0,13.0,12.0,11.0,12.0,15.0,9.0,11.0,12.0,6.0,13.0,12.0,14.0,13.0,15.0,15.0,5.0,13.0,12.0,20.0,16.0,15.0,14.0,12.0,15.0,11.0,10.0,9.0,15.0,12.0,12.0,13.0,13.0,13.0,7.0,32.0,25.0,0.0,0.0,0.0,181.0,82.0,2.0,3.0,3.0,1.0,1.0,1.0,1.0,3.0,1.0,2.0,3.0,5.0,10.0,6.0,7.0,10.0,7.0,14.0,9.0,8.0,11.0,12.0,7.0,13.0,10.0,15.0,14.0,16.0,11.0,13.0,10.0,12.0,16.0,9.0,15.0,8.0,11.0,16.0,18.0,11.0,12.0,14.0,11.0,8.0,13.0,11.0,20.0,17.0,15.0,13.0,15.0,11.0,6.0,14.0,18.0,12.0,13.0,13.0,14.0,11.0,11.0,8.0,25.0,24.0,7.0,0.0,0.0,180.0,75.0,1.0,2.0,1.0,1.0,1.0,2.0,3.0,1.0,3.0,1.0,3.0,6.0,10.0,14.0,11.0,14.0,10.0,9.0,12.0,6.0,3.0,13.0,11.0,2.0,16.0,7.0,12.0,12.0,12.0,10.0,12.0,11.0,13.0,16.0,6.0,13.0,5.0,8.0,8.0,16.0,14.0,13.0,10.0,10.0,13.0,14.0,20.0,13.0,12.0,12.0,7.0,14.0,11.0,8.0,17.0,14.0,13.0,13.0,12.0,15.0,15.0,7.0,34.0,0.0,0.0,0.0,0.0,176.0,65.0,2.0,3.0,3.0,3.0,2.0,2.0,1.0,2.0,1.0,1.0,2.0,14.0,15.0,13.0,10.0,15.0,13.0,6.0,15.0,10.0,3.0,14.0,13.0,6.0,14.0,8.0,12.0,9.0,13.0,12.0,14.0,13.0,11.0,12.0,7.0,13.0,8.0,14.0,15.0,14.0,13.0,12.0,8.0,20.0,14.0,13.0,10.0,12.0,7.0,13.0,8.0,15.0,7.0,6.0,13.0,14.0,14.0,9.0,14.0,14.0,11.0,10.0,31.0,25.0,0.0,6.0,0.0,191.0,84.0,11.0,14.0,13.0,12.0,15.0,14.0,15.0,16.0,13.0,14.0,14.0,8.0,2.0,10.0,5.0,11.0,11.0,7.0,10.0,2.0,5.0,10.0,11.0,11.0,9.0,12.0,13.0,15.0,13.0,13.0,8.0,13.0,16.0,12.0,14.0,1.0,16.0,13.0,11.0,12.0,13.0,16.0,16.0,8.0,16.0,13.0,20.0,15.0,15.0,17.0,8.0,15.0,7.0,2.0,15.0,15.0,17.0,15.0,17.0,16.0,15.0,6.0,28.0,46.0,3.0,14.0,3.0,190.0,80.0,2.0,3.0,3.0,2.0,2.0,1.0,1.0,3.0,1.0,3.0,1.0,4.0,6.0,7.0,9.0,11.0,7.0,17.0,11.0,10.0,15.0,12.0,11.0,16.0,10.0,17.0,15.0,18.0,13.0,14.0,12.0,14.0,18.0,6.0,17.0,8.0,15.0,15.0,14.0,11.0,10.0,17.0,16.0,7.0,17.0,13.0,20.0,15.0,18.0,17.0,14.0,16.0,4.0,6.0,14.0,15.0,16.0,17.0,18.0,14.0,15.0,6.0,23.0,0.0,0.0,0.0,0.0,184.0,77.0,1.0,1.0,1.0,1.0,3.0,2.0,3.0,2.0,2.0,2.0,3.0,6.0,9.0,11.0,7.0,12.0,7.0,15.0,9.0,11.0,14.0,13.0,10.0,15.0,12.0,14.0,15.0,15.0,13.0,12.0,11.0,13.0,15.0,11.0,9.0,9.0,14.0,14.0,14.0,14.0,13.0,15.0,13.0,9.0,16.0,15.0,20.0,14.0,14.0,14.0,11.0,14.0,4.0,11.0,14.0,13.0,15.0,14.0,16.0,14.0,15.0,6.0,20.0,0.0,0.0,0.0,0.0,184.0,80.0,1.0,4.0,4.0,1.0,3.0,1.0,4.0,3.0,3.0,3.0,2.0,7.0,14.0,13.0,8.0,12.0,7.0,16.0,7.0,12.0,13.0,13.0,11.0,12.0,13.0,12.0,13.0,14.0,13.0,12.0,12.0,12.0,15.0,12.0,10.0,14.0,13.0,14.0,13.0,14.0,12.0,14.0,12.0,6.0,13.0,14.0,20.0,13.0,14.0,14.0,8.0,15.0,10.0,13.0,9.0,16.0,15.0,14.0,16.0,16.0,17.0,5.0,21.0,0.0,0.0,9.0,0.0,185.0,75.0,1.0,1.0,2.0,2.0,2.0,1.0,1.0,4.0,2.0,3.0,2.0,11.0,15.0,14.0,7.0,13.0,9.0,11.0,11.0,14.0,13.0,13.0,10.0,14.0,13.0,15.0,12.0,13.0,10.0,11.0,11.0,12.0,14.0,11.0,10.0,14.0,12.0,13.0,15.0,15.0,13.0,14.0,13.0,20.0,14.0,16.0,8.0,15.0,15.0,13.0,13.0,12.0,9.0,10.0,14.0,14.0,13.0,12.0,12.0,13.0,9.0,9.0,21.0,0.0,0.0,9.0,0.0,184.0,72.0,1.0,3.0,1.0,2.0,3.0,2.0,1.0,1.0,2.0,1.0,2.0,6.0,10.0,12.0,7.0,12.0,7.0,14.0,11.0,7.0,14.0,13.0,10.0,13.0,12.0,14.0,13.0,14.0,12.0,12.0,12.0,12.0,16.0,11.0,10.0,12.0,13.0,14.0,15.0,14.0,13.0,16.0,12.0,12.0,14.0,15.0,20.0,15.0,17.0,14.0,12.0,15.0,9.0,9.0,10.0,16.0,14.0,15.0,14.0,14.0,14.0,8.0,29.0,90.0,4.0,16.0,2.0,170.0,61.0,2.0,3.0,3.0,1.0,3.0,1.0,2.0,2.0,2.0,2.0,1.0,15.0,14.0,15.0,9.0,17.0,16.0,7.0,12.0,4.0,11.0,18.0,15.0,12.0,17.0,15.0,15.0,16.0,13.0,16.0,17.0,14.0,16.0,15.0,14.0,12.0,14.0,18.0,16.0,13.0,14.0,12.0,8.0,10.0,14.0,11.0,20.0,14.0,10.0,14.0,9.0,17.0,10.0,14.0,13.0,17.0,15.0,16.0,17.0,15.0,16.0,7.0,21.0,7.0,0.0,14.0,6.0,173.0,64.0,3.0,2.0,3.0,2.0,3.0,3.0,3.0,2.0,3.0,3.0,3.0,14.0,14.0,18.0,14.0,17.0,14.0,7.0,11.0,2.0,6.0,15.0,14.0,6.0,18.0,12.0,14.0,14.0,15.0,13.0,16.0,14.0,17.0,17.0,12.0,13.0,9.0,13.0,17.0,15.0,17.0,13.0,7.0,20.0,14.0,14.0,9.0,14.0,9.0,15.0,7.0,16.0,7.0,14.0,15.0,17.0,15.0,16.0,17.0,16.0,15.0,4.0,20.0,0.0,0.0,7.0,1.0,170.0,58.0,1.0,2.0,2.0,2.0,2.0,2.0,2.0,4.0,1.0,3.0,2.0,16.0,14.0,16.0,13.0,16.0,17.0,5.0,14.0,2.0,6.0,15.0,13.0,4.0,17.0,9.0,12.0,14.0,12.0,12.0,14.0,13.0,15.0,16.0,7.0,13.0,9.0,13.0,15.0,15.0,16.0,11.0,7.0,20.0,14.0,15.0,8.0,14.0,8.0,15.0,5.0,15.0,7.0,16.0,15.0,15.0,15.0,14.0,16.0,18.0,16.0,3.0,26.0,0.0,0.0,4.0,0.0,180.0,73.0,2.0,3.0,1.0,4.0,2.0,3.0,3.0,1.0,1.0,4.0,1.0,11.0,13.0,13.0,14.0,14.0,11.0,15.0,12.0,3.0,7.0,14.0,14.0,8.0,13.0,12.0,14.0,17.0,13.0,15.0,14.0,14.0,16.0,12.0,15.0,16.0,12.0,18.0,16.0,13.0,14.0,13.0,12.0,8.0,14.0,13.0,20.0,15.0,12.0,15.0,8.0,14.0,7.0,15.0,19.0,14.0,17.0,14.0,18.0,16.0,16.0,5.0,30.0,62.0,25.0,13.0,8.0,177.0,72.0,1.0,3.0,3.0,1.0,3.0,2.0,1.0,3.0,1.0,4.0,1.0,8.0,11.0,12.0,17.0,14.0,12.0,18.0,14.0,3.0,4.0,13.0,18.0,5.0,16.0,14.0,15.0,16.0,17.0,13.0,14.0,16.0,16.0,16.0,16.0,16.0,6.0,13.0,13.0,13.0,14.0,13.0,11.0,14.0,13.0,12.0,20.0,12.0,12.0,15.0,8.0,19.0,10.0,6.0,13.0,18.0,14.0,19.0,15.0,16.0,17.0,10.0
1,1,20.0,0.0,0.0,3.0,0.0,193.0,80.0,10.0,12.0,12.0,9.0,11.0,11.0,13.0,15.0,13.0,7.0,12.0,7.0,1.0,1.0,2.0,8.0,11.0,1.0,2.0,1.0,2.0,11.0,2.0,1.0,8.0,4.0,14.0,14.0,11.0,9.0,11.0,12.0,12.0,2.0,15.0,1.0,13.0,11.0,6.0,12.0,13.0,15.0,16.0,20.0,15.0,10.0,6.0,13.0,14.0,12.0,11.0,11.0,10.0,1.0,11.0,9.0,12.0,12.0,13.0,10.0,10.0,1.0,26.0,1.0,0.0,0.0,0.0,185.0,80.0,3.0,1.0,3.0,3.0,3.0,3.0,2.0,3.0,4.0,2.0,1.0,5.0,9.0,11.0,8.0,11.0,6.0,12.0,8.0,10.0,15.0,11.0,12.0,14.0,12.0,16.0,12.0,17.0,14.0,9.0,9.0,10.0,15.0,13.0,9.0,7.0,10.0,8.0,12.0,15.0,13.0,17.0,14.0,8.0,13.0,18.0,20.0,13.0,14.0,11.0,12.0,11.0,4.0,10.0,12.0,12.0,13.0,10.0,10.0,8.0,7.0,14.0,24.0,0.0,0.0,0.0,0.0,175.0,68.0,4.0,3.0,3.0,4.0,1.0,3.0,2.0,2.0,3.0,3.0,1.0,8.0,12.0,11.0,7.0,11.0,8.0,9.0,12.0,13.0,11.0,11.0,7.0,12.0,13.0,12.0,11.0,14.0,12.0,11.0,10.0,12.0,14.0,6.0,8.0,13.0,12.0,14.0,14.0,13.0,13.0,10.0,6.0,12.0,14.0,13.0,20.0,14.0,9.0,13.0,6.0,12.0,5.0,15.0,15.0,10.0,10.0,13.0,14.0,15.0,13.0,4.0,32.0,19.0,0.0,9.0,0.0,185.0,85.0,2.0,3.0,2.0,1.0,2.0,1.0,1.0,2.0,2.0,3.0,3.0,5.0,10.0,9.0,8.0,11.0,11.0,15.0,13.0,9.0,15.0,12.0,10.0,14.0,11.0,14.0,15.0,16.0,12.0,11.0,9.0,11.0,17.0,7.0,12.0,9.0,15.0,13.0,10.0,9.0,9.0,15.0,13.0,10.0,13.0,11.0,20.0,13.0,15.0,12.0,15.0,12.0,13.0,10.0,11.0,13.0,11.0,13.0,18.0,15.0,13.0,5.0,24.0,0.0,0.0,0.0,0.0,184.0,89.0,2.0,3.0,3.0,2.0,2.0,3.0,3.0,1.0,2.0,3.0,2.0,4.0,10.0,8.0,6.0,11.0,9.0,14.0,9.0,7.0,14.0,11.0,6.0,11.0,11.0,13.0,12.0,16.0,11.0,13.0,10.0,11.0,14.0,6.0,8.0,7.0,12.0,13.0,14.0,14.0,12.0,16.0,12.0,20.0,14.0,13.0,6.0,14.0,16.0,14.0,13.0,13.0,7.0,8.0,7.0,14.0,13.0,12.0,14.0,14.0,14.0,6.0,32.0,23.0,0.0,0.0,0.0,178.0,77.0,3.0,2.0,3.0,1.0,3.0,1.0,3.0,2.0,1.0,3.0,1.0,9.0,12.0,12.0,6.0,13.0,12.0,10.0,10.0,10.0,13.0,12.0,7.0,14.0,13.0,15.0,14.0,13.0,13.0,10.0,10.0,12.0,5.0,12.0,11.0,12.0,13.0,14.0,14.0,14.0,13.0,12.0,9.0,20.0,14.0,14.0,10.0,13.0,12.0,13.0,6.0,14.0,6.0,10.0,13.0,5.0,11.0,8.0,10.0,14.0,9.0,15.0,27.0,27.0,1.0,2.0,1.0,183.0,72.0,2.0,2.0,2.0,1.0,2.0,1.0,3.0,1.0,2.0,2.0,4.0,5.0,8.0,10.0,6.0,11.0,10.0,14.0,11.0,5.0,14.0,12.0,10.0,15.0,11.0,14.0,13.0,16.0,11.0,11.0,9.0,10.0,12.0,8.0,12.0,8.0,13.0,14.0,14.0,14.0,12.0,16.0,11.0,8.0,12.0,13.0,20.0,15.0,15.0,10.0,14.0,11.0,7.0,11.0,13.0,13.0,9.0,9.0,11.0,10.0,10.0,8.0,31.0,0.0,0.0,0.0,0.0,180.0,74.0,3.0,2.0,3.0,1.0,2.0,3.0,2.0,1.0,4.0,3.0,3.0,12.0,12.0,10.0,9.0,13.0,14.0,11.0,13.0,6.0,10.0,14.0,15.0,13.0,13.0,15.0,14.0,17.0,12.0,14.0,13.0,13.0,15.0,7.0,13.0,10.0,13.0,18.0,15.0,9.0,11.0,14.0,10.0,10.0,13.0,12.0,20.0,15.0,14.0,14.0,13.0,15.0,8.0,7.0,19.0,13.0,13.0,13.0,13.0,13.0,12.0,9.0,21.0,0.0,0.0,0.0,0.0,181.0,73.0,2.0,3.0,2.0,2.0,1.0,2.0,1.0,2.0,1.0,3.0,1.0,6.0,9.0,12.0,11.0,11.0,8.0,9.0,11.0,6.0,4.0,9.0,12.0,3.0,13.0,10.0,11.0,12.0,11.0,9.0,9.0,9.0,14.0,13.0,6.0,13.0,6.0,10.0,12.0,15.0,14.0,13.0,10.0,8.0,12.0,14.0,20.0,11.0,12.0,12.0,10.0,14.0,10.0,8.0,16.0,13.0,13.0,14.0,12.0,15.0,15.0,8.0,28.0,37.0,15.0,1.0,0.0,194.0,88.0,2.0,1.0,2.0,1.0,1.0,2.0,3.0,1.0,3.0,2.0,2.0,4.0,6.0,12.0,15.0,12.0,7.0,16.0,11.0,3.0,6.0,10.0,14.0,4.0,11.0,10.0,14.0,15.0,13.0,10.0,8.0,9.0,13.0,12.0,6.0,14.0,8.0,11.0,16.0,13.0,12.0,18.0,17.0,9.0,12.0,12.0,20.0,14.0,18.0,13.0,10.0,15.0,15.0,6.0,20.0,17.0,12.0,15.0,14.0,11.0,14.0,7.0,18.0,0.0,0.0,4.0,0.0,188.0,81.0,3.0,3.0,1.0,3.0,1.0,4.0,1.0,2.0,1.0,3.0,4.0,6.0,8.0,13.0,10.0,10.0,10.0,8.0,12.0,6.0,6.0,10.0,14.0,6.0,9.0,10.0,7.0,14.0,9.0,9.0,11.0,11.0,10.0,8.0,11.0,8.0,4.0,11.0,13.0,12.0,13.0,14.0,13.0,8.0,14.0,14.0,20.0,12.0,13.0,10.0,10.0,7.0,6.0,10.0,17.0,10.0,9.0,9.0,13.0,10.0,11.0,6.0,28.0,0.0,0.0,6.0,0.0,191.0,81.0,11.0,10.0,14.0,8.0,13.0,12.0,14.0,15.0,11.0,8.0,13.0,4.0,3.0,2.0,1.0,9.0,9.0,3.0,10.0,1.0,1.0,8.0,3.0,3.0,9.0,8.0,12.0,14.0,12.0,13.0,8.0,11.0,12.0,6.0,14.0,2.0,12.0,10.0,7.0,13.0,14.0,16.0,15.0,6.0,14.0,11.0,20.0,15.0,14.0,12.0,9.0,14.0,7.0,1.0,9.0,15.0,13.0,11.0,15.0,15.0,14.0,8.0,23.0,0.0,0.0,0.0,0.0,184.0,71.0,1.0,2.0,1.0,2.0,2.0,2.0,2.0,4.0,2.0,1.0,3.0,4.0,10.0,10.0,6.0,11.0,6.0,14.0,8.0,7.0,14.0,11.0,6.0,13.0,11.0,12.0,12.0,13.0,12.0,11.0,12.0,12.0,14.0,6.0,8.0,10.0,13.0,13.0,14.0,15.0,13.0,14.0,13.0,8.0,12.0,14.0,20.0,13.0,14.0,13.0,12.0,14.0,15.0,8.0,11.0,13.0,13.0,10.0,8.0,9.0,16.0,7.0,28.0,0.0,0.0,0.0,0.0,174.0,67.0,3.0,4.0,1.0,1.0,1.0,3.0,1.0,3.0,2.0,1.0,2.0,11.0,8.0,11.0,9.0,13.0,6.0,7.0,12.0,8.0,10.0,10.0,3.0,6.0,12.0,10.0,13.0,7.0,12.0,8.0,10.0,9.0,12.0,13.0,5.0,12.0,9.0,12.0,11.0,14.0,14.0,11.0,7.0,10.0,15.0,12.0,20.0,11.0,6.0,9.0,6.0,10.0,10.0,9.0,11.0,14.0,9.0,11.0,12.0,8.0,8.0,8.0,21.0,0.0,0.0,0.0,0.0,177.0,0.0,1.0,1.0,1.0,2.0,3.0,3.0,2.0,3.0,2.0,2.0,3.0,6.0,4.0,13.0,13.0,13.0,6.0,13.0,7.0,3.0,5.0,7.0,6.0,1.0,11.0,9.0,7.0,8.0,7.0,7.0,7.0,8.0,7.0,11.0,8.0,13.0,7.0,6.0,7.0,12.0,13.0,7.0,6.0,8.0,8.0,13.0,20.0,5.0,5.0,9.0,5.0,9.0,9.0,9.0,10.0,10.0,12.0,12.0,11.0,10.0,9.0,6.0,21.0,0.0,0.0,0.0,0.0,178.0,65.0,2.0,3.0,3.0,3.0,3.0,1.0,1.0,1.0,1.0,3.0,1.0,9.0,13.0,11.0,6.0,12.0,7.0,9.0,8.0,8.0,13.0,12.0,7.0,13.0,12.0,8.0,12.0,13.0,12.0,12.0,13.0,13.0,14.0,9.0,8.0,12.0,12.0,13.0,13.0,12.0,14.0,13.0,11.0,8.0,15.0,12.0,20.0,13.0,12.0,14.0,8.0,11.0,7.0,10.0,19.0,10.0,13.0,10.0,11.0,15.0,15.0,6.0,32.0,22.0,1.0,6.0,1.0,186.0,79.0,1.0,2.0,1.0,1.0,2.0,3.0,1.0,2.0,1.0,2.0,1.0,11.0,12.0,13.0,11.0,13.0,11.0,14.0,11.0,8.0,12.0,13.0,13.0,13.0,13.0,14.0,13.0,14.0,14.0,13.0,14.0,13.0,12.0,13.0,14.0,15.0,13.0,12.0,15.0,12.0,13.0,12.0,12.0,10.0,12.0,13.0,20.0,15.0,13.0,14.0,5.0,12.0,9.0,17.0,8.0,12.0,8.0,13.0,10.0,10.0,10.0,5.0,21.0,0.0,0.0,0.0,0.0,172.0,66.0,2.0,3.0,2.0,2.0,1.0,1.0,1.0,3.0,2.0,1.0,1.0,10.0,10.0,13.0,9.0,14.0,9.0,8.0,10.0,7.0,13.0,13.0,9.0,12.0,13.0,10.0,12.0,13.0,13.0,12.0,14.0,13.0,13.0,11.0,9.0,14.0,13.0,14.0,14.0,14.0,13.0,12.0,8.0,8.0,12.0,12.0,20.0,13.0,12.0,14.0,10.0,11.0,8.0,12.0,15.0,10.0,15.0,8.0,11.0,14.0,14.0,6.0,25.0,1.0,0.0,7.0,3.0,178.0,85.0,2.0,3.0,3.0,2.0,3.0,3.0,2.0,3.0,2.0,2.0,2.0,9.0,12.0,12.0,12.0,11.0,8.0,9.0,12.0,6.0,7.0,11.0,12.0,7.0,13.0,12.0,11.0,14.0,12.0,9.0,10.0,10.0,14.0,13.0,7.0,13.0,9.0,9.0,12.0,14.0,12.0,15.0,10.0,14.0,11.0,14.0,20.0,13.0,15.0,10.0,11.0,12.0,6.0,14.0,14.0,13.0,12.0,13.0,10.0,13.0,12.0,12.0,22.0,0.0,0.0,0.0,0.0,177.0,72.0,2.0,1.0,2.0,4.0,2.0,2.0,1.0,3.0,4.0,2.0,3.0,10.0,12.0,13.0,11.0,12.0,10.0,12.0,12.0,4.0,10.0,13.0,11.0,11.0,13.0,11.0,12.0,11.0,13.0,9.0,13.0,12.0,3.0,12.0,8.0,14.0,12.0,12.0,13.0,16.0,13.0,12.0,9.0,8.0,15.0,14.0,20.0,14.0,13.0,10.0,4.0,11.0,11.0,12.0,19.0,9.0,12.0,13.0,12.0,11.0,14.0,7.0,21.0,2.0,0.0,4.0,2.0,183.0,72.0,1.0,1.0,2.0,1.0,1.0,1.0,3.0,3.0,1.0,3.0,1.0,8.0,9.0,11.0,13.0,12.0,8.0,11.0,10.0,6.0,5.0,12.0,10.0,7.0,11.0,14.0,12.0,10.0,11.0,10.0,12.0,13.0,11.0,14.0,7.0,13.0,5.0,10.0,12.0,13.0,13.0,13.0,11.0,11.0,16.0,14.0,20.0,13.0,12.0,14.0,7.0,12.0,5.0,12.0,6.0,17.0,5.0,12.0,14.0,9.0,12.0,14.0,25.0,0.0,0.0,0.0,0.0,187.0,83.0,2.0,1.0,3.0,3.0,1.0,3.0,3.0,3.0,1.0,1.0,3.0,4.0,8.0,10.0,14.0,12.0,8.0,14.0,9.0,5.0,7.0,11.0,13.0,5.0,12.0,11.0,13.0,13.0,13.0,11.0,10.0,12.0,16.0,9.0,8.0,13.0,11.0,13.0,16.0,14.0,13.0,15.0,13.0,20.0,14.0,12.0,8.0,14.0,16.0,13.0,11.0,13.0,7.0,5.0,13.0,14.0,13.0,14.0,14.0,13.0,13.0,6.0
3,0,34.0,1.0,0.0,0.0,0.0,187.0,87.0,13.0,14.0,15.0,7.0,13.0,11.0,14.0,15.0,11.0,17.0,12.0,2.0,1.0,1.0,3.0,8.0,7.0,2.0,1.0,2.0,1.0,9.0,8.0,2.0,6.0,12.0,15.0,17.0,14.0,15.0,8.0,13.0,17.0,7.0,14.0,6.0,14.0,12.0,6.0,7.0,13.0,14.0,13.0,8.0,13.0,8.0,20.0,11.0,16.0,14.0,10.0,14.0,6.0,1.0,12.0,12.0,15.0,16.0,16.0,14.0,15.0,6.0,28.0,0.0,0.0,0.0,0.0,190.0,85.0,3.0,2.0,3.0,3.0,2.0,2.0,2.0,4.0,3.0,1.0,2.0,5.0,9.0,8.0,9.0,8.0,7.0,14.0,10.0,9.0,15.0,9.0,6.0,14.0,9.0,16.0,13.0,16.0,10.0,13.0,10.0,12.0,15.0,6.0,13.0,7.0,13.0,14.0,16.0,12.0,11.0,17.0,13.0,20.0,15.0,13.0,8.0,15.0,15.0,12.0,14.0,14.0,9.0,8.0,14.0,13.0,14.0,11.0,12.0,13.0,16.0,14.0,20.0,0.0,0.0,6.0,0.0,188.0,79.0,2.0,3.0,2.0,1.0,1.0,3.0,2.0,1.0,2.0,2.0,1.0,4.0,4.0,11.0,6.0,11.0,8.0,13.0,8.0,9.0,13.0,12.0,9.0,13.0,11.0,14.0,13.0,15.0,14.0,13.0,8.0,12.0,14.0,9.0,11.0,10.0,12.0,12.0,13.0,11.0,11.0,11.0,13.0,8.0,12.0,13.0,20.0,13.0,12.0,13.0,14.0,13.0,10.0,11.0,11.0,13.0,12.0,14.0,14.0,15.0,10.0,7.0,26.0,0.0,0.0,0.0,0.0,176.0,70.0,2.0,1.0,4.0,3.0,3.0,3.0,1.0,3.0,3.0,2.0,1.0,10.0,11.0,11.0,6.0,13.0,9.0,5.0,12.0,11.0,13.0,13.0,7.0,14.0,13.0,15.0,11.0,14.0,12.0,11.0,9.0,12.0,13.0,9.0,9.0,13.0,12.0,15.0,14.0,12.0,16.0,12.0,7.0,20.0,13.0,13.0,10.0,15.0,11.0,13.0,14.0,13.0,11.0,9.0,8.0,9.0,17.0,12.0,14.0,14.0,15.0,3.0,29.0,0.0,0.0,0.0,0.0,182.0,76.0,1.0,4.0,2.0,3.0,1.0,1.0,1.0,2.0,2.0,1.0,1.0,7.0,12.0,11.0,9.0,11.0,12.0,7.0,12.0,8.0,12.0,13.0,8.0,12.0,13.0,14.0,12.0,14.0,10.0,13.0,12.0,12.0,13.0,15.0,8.0,11.0,12.0,13.0,13.0,11.0,12.0,11.0,12.0,20.0,10.0,11.0,10.0,14.0,11.0,13.0,11.0,10.0,11.0,10.0,14.0,15.0,13.0,9.0,14.0,12.0,13.0,6.0,32.0,36.0,0.0,12.0,2.0,183.0,77.0,1.0,3.0,2.0,1.0,3.0,1.0,1.0,2.0,1.0,1.0,3.0,6.0,11.0,8.0,6.0,13.0,11.0,13.0,10.0,6.0,15.0,14.0,10.0,17.0,12.0,15.0,16.0,18.0,14.0,17.0,12.0,15.0,17.0,11.0,17.0,7.0,17.0,20.0,16.0,9.0,11.0,15.0,11.0,8.0,15.0,10.0,20.0,14.0,14.0,17.0,10.0,16.0,10.0,13.0,15.0,15.0,15.0,14.0,18.0,15.0,13.0,6.0,26.0,0.0,0.0,0.0,0.0,184.0,76.0,3.0,1.0,3.0,1.0,3.0,2.0,3.0,2.0,1.0,1.0,3.0,10.0,11.0,13.0,9.0,13.0,12.0,13.0,10.0,6.0,11.0,13.0,9.0,14.0,12.0,12.0,13.0,12.0,12.0,11.0,13.0,12.0,13.0,13.0,10.0,12.0,13.0,12.0,16.0,15.0,13.0,15.0,13.0,20.0,15.0,14.0,5.0,16.0,15.0,13.0,12.0,14.0,5.0,12.0,18.0,14.0,10.0,7.0,11.0,11.0,13.0,10.0,20.0,0.0,0.0,0.0,0.0,173.0,66.0,1.0,1.0,1.0,1.0,1.0,2.0,3.0,1.0,3.0,3.0,4.0,15.0,13.0,13.0,10.0,15.0,12.0,5.0,13.0,5.0,7.0,15.0,12.0,7.0,15.0,10.0,10.0,13.0,12.0,10.0,16.0,13.0,18.0,14.0,7.0,14.0,12.0,14.0,14.0,8.0,14.0,13.0,7.0,14.0,12.0,9.0,20.0,12.0,13.0,12.0,8.0,15.0,6.0,12.0,12.0,14.0,14.0,14.0,15.0,14.0,11.0,6.0,19.0,0.0,0.0,11.0,1.0,171.0,65.0,2.0,2.0,2.0,2.0,2.0,3.0,3.0,3.0,1.0,1.0,3.0,14.0,13.0,13.0,11.0,14.0,15.0,8.0,12.0,6.0,4.0,13.0,12.0,4.0,15.0,8.0,12.0,10.0,12.0,8.0,13.0,13.0,14.0,15.0,8.0,14.0,6.0,13.0,12.0,15.0,16.0,10.0,7.0,20.0,13.0,15.0,10.0,12.0,7.0,11.0,6.0,11.0,8.0,11.0,12.0,13.0,11.0,12.0,12.0,6.0,12.0,5.0,22.0,0.0,0.0,0.0,0.0,181.0,81.0,2.0,3.0,2.0,1.0,3.0,3.0,4.0,2.0,1.0,1.0,2.0,5.0,11.0,12.0,14.0,12.0,6.0,13.0,10.0,5.0,4.0,12.0,12.0,4.0,13.0,8.0,12.0,13.0,12.0,12.0,11.0,11.0,15.0,14.0,5.0,14.0,10.0,13.0,15.0,13.0,12.0,14.0,10.0,20.0,15.0,12.0,14.0,13.0,14.0,13.0,8.0,12.0,5.0,14.0,8.0,12.0,12.0,9.0,13.0,12.0,14.0,7.0,20.0,7.0,1.0,0.0,0.0,182.0,75.0,2.0,1.0,3.0,2.0,2.0,1.0,3.0,1.0,3.0,2.0,1.0,11.0,11.0,13.0,12.0,13.0,11.0,12.0,10.0,5.0,4.0,12.0,8.0,5.0,13.0,11.0,12.0,11.0,11.0,8.0,10.0,10.0,3.0,10.0,1.0,13.0,8.0,12.0,12.0,15.0,14.0,13.0,11.0,6.0,14.0,13.0,20.0,12.0,13.0,12.0,9.0,11.0,9.0,11.0,9.0,9.0,9.0,12.0,11.0,9.0,17.0,7.0,26.0,2.0,0.0,1.0,0.0,188.0,84.0,12.0,13.0,15.0,9.0,15.0,13.0,13.0,15.0,10.0,11.0,14.0,9.0,2.0,1.0,2.0,12.0,11.0,3.0,2.0,3.0,3.0,11.0,3.0,1.0,10.0,14.0,13.0,14.0,10.0,13.0,11.0,11.0,14.0,3.0,11.0,5.0,12.0,15.0,13.0,10.0,12.0,13.0,14.0,5.0,14.0,9.0,20.0,12.0,14.0,12.0,10.0,15.0,3.0,11.0,12.0,11.0,16.0,13.0,15.0,16.0,16.0,4.0,33.0,0.0,0.0,3.0,0.0,190.0,90.0,2.0,2.0,3.0,3.0,1.0,1.0,2.0,1.0,2.0,2.0,4.0,8.0,12.0,12.0,8.0,15.0,13.0,14.0,14.0,7.0,13.0,15.0,12.0,13.0,15.0,7.0,14.0,14.0,14.0,14.0,14.0,13.0,14.0,13.0,12.0,11.0,15.0,14.0,10.0,7.0,10.0,16.0,14.0,10.0,9.0,8.0,20.0,13.0,15.0,14.0,7.0,14.0,12.0,18.0,10.0,15.0,15.0,15.0,13.0,16.0,13.0,10.0,29.0,0.0,0.0,0.0,0.0,183.0,74.0,3.0,3.0,3.0,3.0,3.0,2.0,2.0,2.0,1.0,3.0,1.0,5.0,12.0,7.0,6.0,10.0,7.0,14.0,12.0,5.0,14.0,12.0,6.0,13.0,11.0,14.0,13.0,17.0,13.0,16.0,12.0,12.0,13.0,9.0,8.0,9.0,14.0,14.0,15.0,13.0,12.0,15.0,12.0,6.0,17.0,11.0,20.0,17.0,13.0,14.0,14.0,15.0,5.0,13.0,9.0,14.0,19.0,15.0,14.0,11.0,11.0,6.0,26.0,0.0,0.0,0.0,0.0,180.0,74.0,3.0,1.0,4.0,2.0,3.0,2.0,1.0,1.0,2.0,4.0,2.0,10.0,12.0,12.0,7.0,12.0,12.0,8.0,10.0,8.0,11.0,13.0,8.0,13.0,14.0,7.0,12.0,13.0,11.0,12.0,13.0,12.0,13.0,9.0,6.0,12.0,10.0,12.0,14.0,14.0,14.0,13.0,9.0,20.0,15.0,14.0,5.0,14.0,11.0,12.0,7.0,14.0,6.0,12.0,18.0,12.0,13.0,14.0,13.0,16.0,16.0,5.0,30.0,0.0,0.0,0.0,0.0,182.0,71.0,3.0,2.0,1.0,3.0,3.0,2.0,3.0,2.0,1.0,2.0,1.0,5.0,12.0,12.0,7.0,12.0,7.0,13.0,7.0,11.0,12.0,11.0,6.0,13.0,13.0,14.0,13.0,14.0,8.0,12.0,9.0,11.0,14.0,11.0,9.0,11.0,10.0,13.0,15.0,14.0,13.0,14.0,11.0,8.0,13.0,13.0,20.0,14.0,14.0,13.0,14.0,14.0,10.0,8.0,12.0,13.0,13.0,12.0,14.0,11.0,11.0,7.0,32.0,0.0,0.0,13.0,0.0,175.0,65.0,2.0,1.0,1.0,2.0,3.0,3.0,1.0,2.0,3.0,2.0,3.0,15.0,13.0,11.0,6.0,14.0,13.0,10.0,12.0,8.0,8.0,16.0,8.0,12.0,13.0,11.0,14.0,15.0,14.0,15.0,14.0,14.0,14.0,6.0,13.0,9.0,15.0,18.0,13.0,12.0,13.0,13.0,8.0,8.0,13.0,10.0,20.0,13.0,13.0,12.0,11.0,15.0,12.0,10.0,17.0,14.0,15.0,14.0,16.0,14.0,14.0,6.0,27.0,0.0,0.0,0.0,0.0,188.0,77.0,1.0,4.0,1.0,1.0,3.0,1.0,2.0,1.0,2.0,2.0,2.0,4.0,7.0,8.0,7.0,13.0,6.0,15.0,9.0,6.0,13.0,12.0,6.0,12.0,11.0,14.0,14.0,15.0,10.0,12.0,11.0,13.0,16.0,7.0,12.0,9.0,12.0,15.0,16.0,14.0,10.0,14.0,15.0,9.0,13.0,12.0,20.0,14.0,16.0,12.0,14.0,13.0,6.0,12.0,4.0,13.0,18.0,13.0,14.0,14.0,13.0,7.0,30.0,4.0,0.0,0.0,0.0,192.0,78.0,1.0,3.0,1.0,2.0,2.0,3.0,1.0,3.0,1.0,1.0,3.0,4.0,6.0,7.0,8.0,11.0,6.0,15.0,8.0,6.0,13.0,11.0,6.0,14.0,11.0,17.0,14.0,16.0,12.0,14.0,10.0,12.0,17.0,8.0,8.0,11.0,13.0,15.0,16.0,14.0,12.0,18.0,14.0,6.0,14.0,12.0,20.0,17.0,16.0,14.0,17.0,13.0,9.0,11.0,8.0,13.0,10.0,13.0,12.0,10.0,10.0,5.0,25.0,0.0,0.0,3.0,2.0,170.0,61.0,2.0,3.0,2.0,2.0,1.0,3.0,2.0,2.0,1.0,2.0,1.0,11.0,12.0,13.0,10.0,13.0,8.0,5.0,8.0,7.0,4.0,14.0,10.0,4.0,15.0,11.0,10.0,9.0,7.0,10.0,14.0,8.0,13.0,13.0,6.0,12.0,8.0,8.0,12.0,16.0,14.0,7.0,5.0,12.0,15.0,16.0,20.0,14.0,6.0,12.0,11.0,13.0,8.0,8.0,8.0,13.0,15.0,10.0,10.0,14.0,14.0,8.0,26.0,0.0,0.0,10.0,1.0,182.0,80.0,3.0,1.0,3.0,2.0,3.0,3.0,2.0,4.0,3.0,1.0,3.0,10.0,10.0,12.0,12.0,12.0,11.0,10.0,12.0,6.0,8.0,13.0,5.0,5.0,14.0,12.0,12.0,14.0,11.0,12.0,11.0,13.0,15.0,12.0,10.0,13.0,6.0,10.0,11.0,13.0,14.0,12.0,10.0,8.0,5.0,13.0,20.0,12.0,12.0,13.0,7.0,10.0,11.0,11.0,19.0,11.0,10.0,12.0,14.0,9.0,8.0,8.0,25.0,0.0,0.0,0.0,0.0,176.0,74.0,2.0,2.0,1.0,3.0,2.0,2.0,2.0,4.0,3.0,3.0,3.0,12.0,12.0,14.0,12.0,14.0,13.0,7.0,12.0,6.0,3.0,12.0,12.0,3.0,15.0,9.0,10.0,8.0,12.0,11.0,12.0,10.0,10.0,14.0,5.0,13.0,4.0,6.0,8.0,17.0,15.0,12.0,8.0,20.0,12.0,14.0,8.0,13.0,12.0,11.0,9.0,14.0,10.0,8.0,8.0,14.0,12.0,7.0,10.0,11.0,11.0,9.0
4,2,25.0,0.0,0.0,3.0,0.0,187.0,83.0,15.0,9.0,12.0,8.0,13.0,11.0,12.0,14.0,7.0,12.0,8.0,4.0,2.0,3.0,2.0,9.0,9.0,6.0,2.0,2.0,1.0,9.0,2.0,1.0,9.0,8.0,13.0,15.0,12.0,10.0,7.0,9.0,15.0,5.0,9.0,3.0,12.0,13.0,8.0,12.0,12.0,15.0,14.0,20.0,13.0,9.0,5.0,14.0,14.0,12.0,8.0,10.0,7.0,1.0,14.0,11.0,16.0,11.0,14.0,14.0,14.0,6.0,20.0,1.0,0.0,10.0,0.0,183.0,73.0,2.0,4.0,4.0,2.0,1.0,2.0,2.0,3.0,3.0,3.0,3.0,8.0,9.0,10.0,6.0,14.0,7.0,12.0,5.0,9.0,14.0,12.0,9.0,15.0,13.0,11.0,15.0,13.0,14.0,13.0,12.0,10.0,16.0,13.0,11.0,9.0,14.0,13.0,13.0,12.0,12.0,13.0,13.0,10.0,13.0,13.0,20.0,13.0,12.0,12.0,11.0,8.0,7.0,10.0,17.0,14.0,8.0,14.0,14.0,5.0,15.0,7.0,19.0,0.0,0.0,0.0,0.0,193.0,89.0,3.0,2.0,2.0,3.0,1.0,3.0,1.0,4.0,2.0,2.0,3.0,8.0,10.0,5.0,4.0,10.0,10.0,14.0,12.0,6.0,12.0,10.0,4.0,12.0,9.0,11.0,11.0,14.0,11.0,12.0,8.0,14.0,13.0,8.0,8.0,11.0,11.0,13.0,13.0,10.0,9.0,14.0,16.0,6.0,14.0,10.0,20.0,12.0,14.0,11.0,7.0,6.0,6.0,8.0,16.0,10.0,10.0,12.0,13.0,16.0,16.0,5.0,32.0,0.0,0.0,0.0,0.0,172.0,71.0,2.0,1.0,3.0,1.0,2.0,3.0,2.0,3.0,2.0,2.0,2.0,8.0,9.0,7.0,6.0,10.0,6.0,10.0,9.0,10.0,14.0,11.0,6.0,14.0,11.0,10.0,16.0,15.0,12.0,12.0,7.0,12.0,15.0,9.0,13.0,8.0,14.0,15.0,15.0,14.0,14.0,14.0,10.0,20.0,14.0,14.0,8.0,15.0,13.0,13.0,11.0,13.0,7.0,13.0,17.0,14.0,17.0,8.0,13.0,15.0,15.0,6.0,32.0,11.0,1.0,0.0,0.0,176.0,68.0,2.0,1.0,3.0,2.0,2.0,2.0,2.0,3.0,3.0,2.0,2.0,8.0,10.0,10.0,7.0,11.0,8.0,10.0,11.0,12.0,11.0,13.0,12.0,14.0,12.0,9.0,14.0,15.0,13.0,12.0,11.0,12.0,17.0,8.0,14.0,14.0,11.0,18.0,18.0,14.0,14.0,12.0,10.0,10.0,14.0,13.0,20.0,17.0,13.0,15.0,9.0,13.0,8.0,13.0,17.0,13.0,15.0,16.0,16.0,16.0,18.0,5.0,27.0,8.0,0.0,6.0,0.0,187.0,76.0,3.0,2.0,3.0,2.0,2.0,1.0,1.0,3.0,3.0,1.0,2.0,5.0,7.0,11.0,5.0,14.0,5.0,14.0,9.0,5.0,15.0,15.0,8.0,14.0,13.0,15.0,16.0,15.0,14.0,12.0,14.0,14.0,18.0,8.0,17.0,9.0,12.0,18.0,15.0,13.0,14.0,15.0,14.0,10.0,17.0,12.0,20.0,17.0,15.0,14.0,13.0,16.0,4.0,12.0,10.0,14.0,17.0,12.0,15.0,13.0,13.0,6.0,19.0,0.0,0.0,0.0,0.0,185.0,82.0,4.0,2.0,3.0,1.0,3.0,2.0,1.0,2.0,1.0,2.0,3.0,7.0,7.0,10.0,6.0,13.0,7.0,14.0,7.0,6.0,12.0,13.0,7.0,13.0,13.0,13.0,13.0,13.0,11.0,12.0,11.0,12.0,14.0,9.0,14.0,11.0,11.0,15.0,15.0,12.0,12.0,14.0,13.0,5.0,14.0,12.0,20.0,14.0,13.0,10.0,11.0,11.0,6.0,10.0,10.0,12.0,12.0,14.0,14.0,11.0,16.0,6.0,21.0,0.0,0.0,15.0,3.0,181.0,78.0,3.0,3.0,4.0,2.0,1.0,2.0,2.0,4.0,2.0,1.0,1.0,5.0,7.0,11.0,10.0,14.0,5.0,14.0,10.0,6.0,13.0,14.0,8.0,14.0,14.0,12.0,14.0,12.0,11.0,10.0,12.0,11.0,16.0,11.0,12.0,14.0,14.0,14.0,14.0,14.0,13.0,14.0,13.0,10.0,16.0,14.0,20.0,16.0,14.0,12.0,10.0,11.0,5.0,19.0,8.0,11.0,14.0,11.0,16.0,13.0,13.0,10.0,24.0,6.0,1.0,0.0,0.0,183.0,66.0,1.0,1.0,2.0,2.0,1.0,2.0,1.0,2.0,3.0,2.0,1.0,14.0,14.0,14.0,10.0,14.0,14.0,9.0,10.0,8.0,8.0,14.0,10.0,8.0,15.0,9.0,11.0,13.0,11.0,11.0,13.0,10.0,14.0,13.0,5.0,12.0,9.0,14.0,13.0,14.0,16.0,12.0,9.0,20.0,13.0,14.0,5.0,15.0,9.0,12.0,10.0,12.0,8.0,9.0,16.0,9.0,16.0,13.0,11.0,12.0,13.0,9.0,25.0,10.0,1.0,11.0,4.0,175.0,73.0,1.0,3.0,3.0,3.0,3.0,3.0,3.0,1.0,2.0,3.0,1.0,5.0,10.0,15.0,17.0,15.0,10.0,11.0,12.0,5.0,5.0,14.0,15.0,5.0,16.0,8.0,15.0,12.0,15.0,14.0,13.0,15.0,15.0,15.0,14.0,14.0,10.0,10.0,12.0,16.0,16.0,15.0,9.0,10.0,15.0,16.0,20.0,13.0,15.0,14.0,8.0,14.0,7.0,10.0,8.0,16.0,17.0,13.0,15.0,15.0,14.0,5.0,22.0,24.0,3.0,7.0,0.0,177.0,78.0,2.0,1.0,2.0,3.0,2.0,2.0,4.0,3.0,3.0,2.0,1.0,10.0,13.0,16.0,14.0,16.0,16.0,8.0,16.0,4.0,4.0,15.0,12.0,4.0,16.0,12.0,11.0,12.0,13.0,10.0,11.0,8.0,13.0,17.0,5.0,14.0,5.0,10.0,12.0,15.0,14.0,13.0,9.0,10.0,17.0,16.0,20.0,15.0,14.0,12.0,11.0,15.0,4.0,12.0,19.0,16.0,14.0,14.0,11.0,13.0,10.0,12.0,25.0,0.0,0.0,0.0,0.0,185.0,85.0,14.0,11.0,14.0,10.0,12.0,14.0,13.0,14.0,11.0,15.0,9.0,4.0,1.0,3.0,1.0,9.0,8.0,3.0,11.0,1.0,2.0,8.0,2.0,7.0,9.0,8.0,13.0,13.0,12.0,12.0,8.0,11.0,16.0,6.0,14.0,1.0,12.0,12.0,7.0,10.0,13.0,15.0,12.0,5.0,17.0,9.0,20.0,13.0,15.0,14.0,8.0,13.0,3.0,1.0,17.0,13.0,13.0,13.0,14.0,14.0,14.0,5.0,36.0,0.0,0.0,0.0,0.0,182.0,70.0,2.0,1.0,3.0,3.0,1.0,2.0,1.0,1.0,1.0,1.0,3.0,8.0,11.0,8.0,6.0,11.0,7.0,10.0,8.0,12.0,13.0,10.0,6.0,14.0,11.0,15.0,13.0,15.0,11.0,12.0,7.0,10.0,12.0,6.0,13.0,7.0,14.0,14.0,14.0,12.0,11.0,14.0,11.0,12.0,12.0,10.0,20.0,13.0,12.0,12.0,15.0,13.0,9.0,10.0,6.0,12.0,14.0,11.0,15.0,12.0,12.0,6.0,31.0,0.0,0.0,0.0,0.0,190.0,82.0,1.0,1.0,2.0,2.0,2.0,1.0,3.0,1.0,1.0,1.0,2.0,4.0,8.0,8.0,6.0,12.0,10.0,15.0,13.0,8.0,14.0,13.0,7.0,14.0,13.0,14.0,14.0,15.0,11.0,11.0,12.0,12.0,13.0,7.0,11.0,10.0,13.0,14.0,16.0,12.0,10.0,9.0,15.0,5.0,13.0,13.0,20.0,13.0,15.0,12.0,14.0,14.0,13.0,12.0,10.0,13.0,14.0,11.0,14.0,13.0,13.0,9.0,24.0,2.0,0.0,0.0,0.0,188.0,83.0,2.0,2.0,2.0,1.0,3.0,2.0,3.0,3.0,1.0,2.0,1.0,11.0,12.0,11.0,6.0,12.0,11.0,11.0,9.0,13.0,11.0,11.0,10.0,12.0,12.0,13.0,13.0,12.0,12.0,9.0,11.0,11.0,2.0,12.0,11.0,12.0,8.0,12.0,12.0,11.0,10.0,13.0,13.0,20.0,12.0,12.0,4.0,12.0,13.0,12.0,9.0,5.0,7.0,11.0,8.0,10.0,14.0,12.0,12.0,1.0,18.0,8.0,23.0,16.0,0.0,5.0,0.0,186.0,81.0,3.0,1.0,1.0,3.0,3.0,1.0,3.0,3.0,2.0,2.0,2.0,4.0,8.0,7.0,3.0,12.0,5.0,12.0,8.0,8.0,14.0,13.0,6.0,12.0,8.0,12.0,13.0,11.0,13.0,13.0,11.0,12.0,15.0,5.0,7.0,6.0,15.0,14.0,12.0,11.0,9.0,13.0,13.0,6.0,8.0,11.0,20.0,13.0,13.0,10.0,5.0,12.0,4.0,12.0,8.0,12.0,10.0,7.0,16.0,15.0,14.0,4.0,29.0,6.0,0.0,0.0,0.0,183.0,72.0,3.0,3.0,3.0,4.0,1.0,3.0,3.0,3.0,1.0,3.0,3.0,2.0,13.0,13.0,8.0,14.0,8.0,10.0,12.0,10.0,12.0,13.0,8.0,14.0,10.0,14.0,13.0,10.0,12.0,12.0,10.0,12.0,4.0,12.0,4.0,14.0,12.0,13.0,14.0,14.0,13.0,13.0,11.0,5.0,14.0,15.0,20.0,14.0,11.0,13.0,2.0,12.0,7.0,8.0,16.0,10.0,11.0,13.0,10.0,3.0,19.0,8.0,24.0,0.0,0.0,0.0,0.0,177.0,70.0,2.0,4.0,2.0,1.0,1.0,3.0,1.0,3.0,4.0,2.0,1.0,6.0,10.0,11.0,7.0,13.0,6.0,9.0,13.0,7.0,12.0,14.0,7.0,13.0,13.0,13.0,13.0,13.0,11.0,11.0,11.0,12.0,13.0,10.0,7.0,11.0,11.0,14.0,15.0,13.0,13.0,14.0,9.0,6.0,15.0,14.0,20.0,15.0,12.0,13.0,11.0,13.0,7.0,12.0,19.0,12.0,17.0,10.0,13.0,13.0,13.0,6.0,20.0,0.0,0.0,0.0,0.0,185.0,69.0,2.0,2.0,2.0,4.0,3.0,2.0,2.0,2.0,1.0,1.0,3.0,7.0,8.0,7.0,4.0,11.0,7.0,11.0,12.0,7.0,12.0,15.0,3.0,12.0,11.0,10.0,11.0,12.0,14.0,12.0,10.0,11.0,10.0,10.0,5.0,8.0,13.0,12.0,13.0,12.0,11.0,10.0,11.0,5.0,12.0,8.0,20.0,12.0,10.0,11.0,8.0,9.0,14.0,8.0,14.0,10.0,12.0,13.0,11.0,13.0,19.0,5.0,36.0,0.0,0.0,3.0,0.0,168.0,72.0,3.0,2.0,1.0,3.0,1.0,3.0,3.0,1.0,3.0,3.0,1.0,11.0,8.0,12.0,5.0,13.0,11.0,8.0,13.0,6.0,12.0,13.0,8.0,14.0,13.0,17.0,14.0,17.0,14.0,15.0,13.0,14.0,17.0,12.0,16.0,10.0,15.0,16.0,14.0,10.0,13.0,14.0,4.0,8.0,16.0,8.0,20.0,12.0,13.0,17.0,14.0,14.0,7.0,10.0,19.0,15.0,14.0,16.0,15.0,9.0,9.0,7.0,27.0,11.0,1.0,0.0,0.0,187.0,86.0,3.0,1.0,2.0,2.0,4.0,3.0,2.0,1.0,1.0,3.0,1.0,3.0,9.0,13.0,15.0,12.0,10.0,17.0,11.0,5.0,5.0,9.0,14.0,4.0,11.0,9.0,12.0,13.0,12.0,11.0,9.0,10.0,13.0,11.0,10.0,13.0,10.0,15.0,15.0,14.0,12.0,15.0,13.0,7.0,15.0,13.0,20.0,13.0,15.0,14.0,9.0,13.0,7.0,5.0,15.0,13.0,13.0,11.0,10.0,12.0,18.0,6.0,23.0,0.0,0.0,0.0,0.0,183.0,80.0,3.0,2.0,1.0,3.0,1.0,3.0,2.0,3.0,1.0,2.0,3.0,4.0,12.0,13.0,14.0,12.0,9.0,10.0,14.0,5.0,5.0,12.0,11.0,7.0,12.0,11.0,12.0,12.0,10.0,12.0,10.0,11.0,5.0,11.0,9.0,14.0,10.0,13.0,12.0,15.0,14.0,13.0,11.0,8.0,12.0,14.0,20.0,13.0,14.0,10.0,8.0,13.0,7.0,7.0,16.0,14.0,11.0,10.0,12.0,9.0,9.0,2.0
3,1,28.0,0.0,0.0,6.0,0.0,191.0,81.0,11.0,10.0,14.0,8.0,13.0,12.0,14.0,15.0,11.0,8.0,13.0,4.0,3.0,2.0,1.0,9.0,9.0,3.0,10.0,1.0,1.0,8.0,3.0,3.0,9.0,8.0,12.0,14.0,12.0,13.0,8.0,11.0,12.0,6.0,14.0,2.0,12.0,10.0,7.0,13.0,14.0,16.0,15.0,6.0,14.0,11.0,20.0,15.0,14.0,12.0,9.0,14.0,7.0,1.0,9.0,15.0,13.0,11.0,15.0,15.0,14.0,8.0,32.0,67.0,9.0,7.0,0.0,191.0,85.0,1.0,1.0,1.0,3.0,2.0,2.0,4.0,3.0,3.0,2.0,3.0,7.0,7.0,6.0,9.0,12.0,3.0,16.0,7.0,3.0,15.0,11.0,7.0,13.0,12.0,14.0,11.0,14.0,10.0,11.0,10.0,14.0,11.0,8.0,13.0,13.0,13.0,13.0,15.0,9.0,7.0,14.0,16.0,8.0,7.0,10.0,20.0,12.0,15.0,13.0,14.0,5.0,6.0,11.0,8.0,11.0,9.0,12.0,11.0,6.0,9.0,11.0,28.0,0.0,0.0,0.0,0.0,174.0,67.0,3.0,4.0,1.0,1.0,1.0,3.0,1.0,3.0,2.0,1.0,2.0,11.0,8.0,11.0,9.0,13.0,6.0,7.0,12.0,8.0,10.0,10.0,3.0,6.0,12.0,10.0,13.0,7.0,12.0,8.0,10.0,9.0,12.0,13.0,5.0,12.0,9.0,12.0,11.0,14.0,14.0,11.0,7.0,10.0,15.0,12.0,20.0,11.0,6.0,9.0,6.0,10.0,10.0,9.0,11.0,14.0,9.0,11.0,12.0,8.0,8.0,8.0,21.0,0.0,0.0,0.0,0.0,177.0,0.0,1.0,1.0,1.0,2.0,3.0,3.0,2.0,3.0,2.0,2.0,3.0,6.0,4.0,13.0,13.0,13.0,6.0,13.0,7.0,3.0,5.0,7.0,6.0,1.0,11.0,9.0,7.0,8.0,7.0,7.0,7.0,8.0,7.0,11.0,8.0,13.0,7.0,6.0,7.0,12.0,13.0,7.0,6.0,8.0,8.0,13.0,20.0,5.0,5.0,9.0,5.0,9.0,9.0,9.0,10.0,10.0,12.0,12.0,11.0,10.0,9.0,6.0,21.0,0.0,0.0,0.0,0.0,178.0,65.0,2.0,3.0,3.0,3.0,3.0,1.0,1.0,1.0,1.0,3.0,1.0,9.0,13.0,11.0,6.0,12.0,7.0,9.0,8.0,8.0,13.0,12.0,7.0,13.0,12.0,8.0,12.0,13.0,12.0,12.0,13.0,13.0,14.0,9.0,8.0,12.0,12.0,13.0,13.0,12.0,14.0,13.0,11.0,8.0,15.0,12.0,20.0,13.0,12.0,14.0,8.0,11.0,7.0,10.0,19.0,10.0,13.0,10.0,11.0,15.0,15.0,6.0,21.0,0.0,0.0,0.0,0.0,172.0,66.0,2.0,3.0,2.0,2.0,1.0,1.0,1.0,3.0,2.0,1.0,1.0,10.0,10.0,13.0,9.0,14.0,9.0,8.0,10.0,7.0,13.0,13.0,9.0,12.0,13.0,10.0,12.0,13.0,13.0,12.0,14.0,13.0,13.0,11.0,9.0,14.0,13.0,14.0,14.0,14.0,13.0,12.0,8.0,8.0,12.0,12.0,20.0,13.0,12.0,14.0,10.0,11.0,8.0,12.0,15.0,10.0,15.0,8.0,11.0,14.0,14.0,6.0,32.0,22.0,1.0,6.0,1.0,186.0,79.0,1.0,2.0,1.0,1.0,2.0,3.0,1.0,2.0,1.0,2.0,1.0,11.0,12.0,13.0,11.0,13.0,11.0,14.0,11.0,8.0,12.0,13.0,13.0,13.0,13.0,14.0,13.0,14.0,14.0,13.0,14.0,13.0,12.0,13.0,14.0,15.0,13.0,12.0,15.0,12.0,13.0,12.0,12.0,10.0,12.0,13.0,20.0,15.0,13.0,14.0,5.0,12.0,9.0,17.0,8.0,12.0,8.0,13.0,10.0,10.0,10.0,5.0,24.0,0.0,0.0,0.0,0.0,172.0,72.0,1.0,1.0,3.0,2.0,2.0,1.0,1.0,1.0,1.0,3.0,1.0,10.0,11.0,12.0,10.0,11.0,8.0,8.0,10.0,7.0,7.0,11.0,11.0,6.0,12.0,8.0,11.0,11.0,10.0,10.0,11.0,12.0,15.0,12.0,5.0,10.0,11.0,13.0,15.0,15.0,13.0,10.0,9.0,8.0,14.0,13.0,20.0,14.0,11.0,11.0,8.0,13.0,7.0,12.0,18.0,13.0,10.0,10.0,11.0,11.0,11.0,6.0,22.0,0.0,0.0,0.0,0.0,177.0,72.0,2.0,1.0,2.0,4.0,2.0,2.0,1.0,3.0,4.0,2.0,3.0,10.0,12.0,13.0,11.0,12.0,10.0,12.0,12.0,4.0,10.0,13.0,11.0,11.0,13.0,11.0,12.0,11.0,13.0,9.0,13.0,12.0,3.0,12.0,8.0,14.0,12.0,12.0,13.0,16.0,13.0,12.0,9.0,8.0,15.0,14.0,20.0,14.0,13.0,10.0,4.0,11.0,11.0,12.0,19.0,9.0,12.0,13.0,12.0,11.0,14.0,7.0,25.0,0.0,0.0,0.0,0.0,187.0,83.0,2.0,1.0,3.0,3.0,1.0,3.0,3.0,3.0,1.0,1.0,3.0,4.0,8.0,10.0,14.0,12.0,8.0,14.0,9.0,5.0,7.0,11.0,13.0,5.0,12.0,11.0,13.0,13.0,13.0,11.0,10.0,12.0,16.0,9.0,8.0,13.0,11.0,13.0,16.0,14.0,13.0,15.0,13.0,20.0,14.0,12.0,8.0,14.0,16.0,13.0,11.0,13.0,7.0,5.0,13.0,14.0,13.0,14.0,14.0,13.0,13.0,6.0,24.0,4.0,1.0,0.0,0.0,188.0,79.0,2.0,3.0,2.0,1.0,2.0,1.0,1.0,2.0,1.0,2.0,2.0,10.0,11.0,13.0,12.0,11.0,9.0,13.0,9.0,5.0,8.0,11.0,11.0,7.0,13.0,10.0,12.0,11.0,11.0,12.0,13.0,11.0,14.0,12.0,9.0,12.0,12.0,14.0,14.0,12.0,13.0,15.0,14.0,8.0,13.0,12.0,20.0,13.0,14.0,11.0,9.0,10.0,5.0,10.0,14.0,12.0,13.0,10.0,14.0,13.0,12.0,10.0,25.0,0.0,0.0,0.0,0.0,185.0,85.0,14.0,11.0,14.0,10.0,12.0,14.0,13.0,14.0,11.0,15.0,9.0,4.0,1.0,3.0,1.0,9.0,8.0,3.0,11.0,1.0,2.0,8.0,2.0,7.0,9.0,8.0,13.0,13.0,12.0,12.0,8.0,11.0,16.0,6.0,14.0,1.0,12.0,12.0,7.0,10.0,13.0,15.0,12.0,5.0,17.0,9.0,20.0,13.0,15.0,14.0,8.0,13.0,3.0,1.0,17.0,13.0,13.0,13.0,14.0,14.0,14.0,5.0,31.0,0.0,0.0,0.0,0.0,190.0,82.0,1.0,1.0,2.0,2.0,2.0,1.0,3.0,1.0,1.0,1.0,2.0,4.0,8.0,8.0,6.0,12.0,10.0,15.0,13.0,8.0,14.0,13.0,7.0,14.0,13.0,14.0,14.0,15.0,11.0,11.0,12.0,12.0,13.0,7.0,11.0,10.0,13.0,14.0,16.0,12.0,10.0,9.0,15.0,5.0,13.0,13.0,20.0,13.0,15.0,12.0,14.0,14.0,13.0,12.0,10.0,13.0,14.0,11.0,14.0,13.0,13.0,9.0,24.0,2.0,0.0,0.0,0.0,188.0,83.0,2.0,2.0,2.0,1.0,3.0,2.0,3.0,3.0,1.0,2.0,1.0,11.0,12.0,11.0,6.0,12.0,11.0,11.0,9.0,13.0,11.0,11.0,10.0,12.0,12.0,13.0,13.0,12.0,12.0,9.0,11.0,11.0,2.0,12.0,11.0,12.0,8.0,12.0,12.0,11.0,10.0,13.0,13.0,20.0,12.0,12.0,4.0,12.0,13.0,12.0,9.0,5.0,7.0,11.0,8.0,10.0,14.0,12.0,12.0,1.0,18.0,8.0,36.0,0.0,0.0,0.0,0.0,182.0,70.0,2.0,1.0,3.0,3.0,1.0,2.0,1.0,1.0,1.0,1.0,3.0,8.0,11.0,8.0,6.0,11.0,7.0,10.0,8.0,12.0,13.0,10.0,6.0,14.0,11.0,15.0,13.0,15.0,11.0,12.0,7.0,10.0,12.0,6.0,13.0,7.0,14.0,14.0,14.0,12.0,11.0,14.0,11.0,12.0,12.0,10.0,20.0,13.0,12.0,12.0,15.0,13.0,9.0,10.0,6.0,12.0,14.0,11.0,15.0,12.0,12.0,6.0,28.0,0.0,0.0,0.0,0.0,190.0,83.0,1.0,1.0,3.0,2.0,1.0,1.0,3.0,3.0,1.0,2.0,1.0,2.0,9.0,5.0,6.0,10.0,5.0,13.0,7.0,4.0,12.0,9.0,7.0,10.0,11.0,13.0,14.0,15.0,13.0,11.0,8.0,11.0,13.0,8.0,12.0,7.0,12.0,12.0,12.0,11.0,11.0,15.0,15.0,20.0,15.0,11.0,5.0,13.0,16.0,15.0,13.0,11.0,7.0,5.0,12.0,12.0,14.0,12.0,15.0,13.0,12.0,6.0,28.0,1.0,0.0,0.0,0.0,183.0,76.0,1.0,1.0,1.0,2.0,2.0,2.0,2.0,1.0,3.0,1.0,1.0,12.0,13.0,10.0,6.0,12.0,7.0,11.0,11.0,12.0,10.0,11.0,4.0,13.0,12.0,16.0,11.0,13.0,11.0,12.0,10.0,11.0,4.0,6.0,11.0,10.0,12.0,14.0,14.0,12.0,10.0,12.0,9.0,16.0,11.0,13.0,20.0,14.0,12.0,10.0,10.0,12.0,6.0,10.0,20.0,10.0,11.0,12.0,11.0,7.0,8.0,14.0,20.0,0.0,0.0,0.0,0.0,185.0,69.0,2.0,2.0,2.0,4.0,3.0,2.0,2.0,2.0,1.0,1.0,3.0,7.0,8.0,7.0,4.0,11.0,7.0,11.0,12.0,7.0,12.0,15.0,3.0,12.0,11.0,10.0,11.0,12.0,14.0,12.0,10.0,11.0,10.0,10.0,5.0,8.0,13.0,12.0,13.0,12.0,11.0,10.0,11.0,5.0,12.0,8.0,20.0,12.0,10.0,11.0,8.0,9.0,14.0,8.0,14.0,10.0,12.0,13.0,11.0,13.0,19.0,5.0,26.0,0.0,0.0,0.0,0.0,175.0,70.0,2.0,1.0,1.0,2.0,2.0,2.0,3.0,2.0,2.0,1.0,1.0,13.0,12.0,11.0,8.0,14.0,11.0,7.0,11.0,6.0,5.0,14.0,11.0,6.0,15.0,11.0,12.0,12.0,15.0,10.0,13.0,12.0,14.0,13.0,7.0,12.0,12.0,16.0,12.0,12.0,14.0,12.0,8.0,8.0,11.0,13.0,20.0,11.0,9.0,8.0,8.0,12.0,15.0,14.0,12.0,13.0,11.0,13.0,12.0,15.0,15.0,7.0,36.0,0.0,0.0,3.0,0.0,168.0,72.0,3.0,2.0,1.0,3.0,1.0,3.0,3.0,1.0,3.0,3.0,1.0,11.0,8.0,12.0,5.0,13.0,11.0,8.0,13.0,6.0,12.0,13.0,8.0,14.0,13.0,17.0,14.0,17.0,14.0,15.0,13.0,14.0,17.0,12.0,16.0,10.0,15.0,16.0,14.0,10.0,13.0,14.0,4.0,8.0,16.0,8.0,20.0,12.0,13.0,17.0,14.0,14.0,7.0,10.0,19.0,15.0,14.0,16.0,15.0,9.0,9.0,7.0,27.0,11.0,1.0,0.0,0.0,187.0,86.0,3.0,1.0,2.0,2.0,4.0,3.0,2.0,1.0,1.0,3.0,1.0,3.0,9.0,13.0,15.0,12.0,10.0,17.0,11.0,5.0,5.0,9.0,14.0,4.0,11.0,9.0,12.0,13.0,12.0,11.0,9.0,10.0,13.0,11.0,10.0,13.0,10.0,15.0,15.0,14.0,12.0,15.0,13.0,7.0,15.0,13.0,20.0,13.0,15.0,14.0,9.0,13.0,7.0,5.0,15.0,13.0,13.0,11.0,10.0,12.0,18.0,6.0,23.0,0.0,0.0,0.0,0.0,183.0,80.0,3.0,2.0,1.0,3.0,1.0,3.0,2.0,3.0,1.0,2.0,3.0,4.0,12.0,13.0,14.0,12.0,9.0,10.0,14.0,5.0,5.0,12.0,11.0,7.0,12.0,11.0,12.0,12.0,10.0,12.0,10.0,11.0,5.0,11.0,9.0,14.0,10.0,13.0,12.0,15.0,14.0,13.0,11.0,8.0,12.0,14.0,20.0,13.0,14.0,10.0,8.0,13.0,7.0,7.0,16.0,14.0,11.0,10.0,12.0,9.0,9.0,2.0
1,2,26.0,2.0,0.0,1.0,0.0,188.0,84.0,12.0,13.0,15.0,9.0,15.0,13.0,13.0,15.0,10.0,11.0,14.0,9.0,2.0,1.0,2.0,12.0,11.0,3.0,2.0,3.0,3.0,11.0,3.0,1.0,10.0,14.0,13.0,14.0,10.0,13.0,11.0,11.0,14.0,3.0,11.0,5.0,12.0,15.0,13.0,10.0,12.0,13.0,14.0,5.0,14.0,9.0,20.0,12.0,14.0,12.0,10.0,15.0,3.0,11.0,12.0,11.0,16.0,13.0,15.0,16.0,16.0,4.0,32.0,0.0,0.0,0.0,0.0,183.0,79.0,1.0,1.0,1.0,3.0,1.0,3.0,1.0,1.0,2.0,1.0,1.0,5.0,10.0,6.0,6.0,9.0,6.0,15.0,7.0,11.0,14.0,10.0,7.0,13.0,10.0,13.0,15.0,15.0,15.0,14.0,9.0,13.0,16.0,6.0,14.0,8.0,12.0,13.0,16.0,11.0,12.0,16.0,11.0,8.0,16.0,12.0,20.0,15.0,14.0,14.0,11.0,12.0,5.0,15.0,18.0,15.0,14.0,13.0,17.0,14.0,14.0,5.0,29.0,0.0,0.0,0.0,0.0,183.0,74.0,3.0,3.0,3.0,3.0,3.0,2.0,2.0,2.0,1.0,3.0,1.0,5.0,12.0,7.0,6.0,10.0,7.0,14.0,12.0,5.0,14.0,12.0,6.0,13.0,11.0,14.0,13.0,17.0,13.0,16.0,12.0,12.0,13.0,9.0,8.0,9.0,14.0,14.0,15.0,13.0,12.0,15.0,12.0,6.0,17.0,11.0,20.0,17.0,13.0,14.0,14.0,15.0,5.0,13.0,9.0,14.0,19.0,15.0,14.0,11.0,11.0,6.0,22.0,0.0,0.0,0.0,0.0,178.0,73.0,3.0,2.0,2.0,1.0,2.0,4.0,3.0,1.0,3.0,1.0,2.0,6.0,12.0,12.0,6.0,11.0,7.0,8.0,8.0,11.0,12.0,10.0,8.0,13.0,11.0,12.0,12.0,13.0,11.0,10.0,11.0,11.0,13.0,6.0,7.0,12.0,9.0,13.0,14.0,16.0,14.0,13.0,9.0,6.0,14.0,15.0,20.0,15.0,14.0,12.0,12.0,13.0,6.0,14.0,12.0,15.0,13.0,13.0,14.0,14.0,14.0,6.0,27.0,0.0,0.0,0.0,0.0,178.0,72.0,2.0,3.0,2.0,3.0,2.0,3.0,3.0,1.0,1.0,2.0,1.0,13.0,14.0,11.0,7.0,12.0,10.0,9.0,10.0,13.0,13.0,12.0,10.0,14.0,13.0,12.0,14.0,14.0,13.0,14.0,11.0,12.0,14.0,13.0,8.0,14.0,13.0,13.0,15.0,15.0,13.0,10.0,10.0,20.0,13.0,15.0,6.0,14.0,10.0,13.0,13.0,12.0,8.0,12.0,15.0,14.0,13.0,14.0,13.0,13.0,12.0,6.0,27.0,0.0,0.0,0.0,0.0,188.0,77.0,1.0,4.0,1.0,1.0,3.0,1.0,2.0,1.0,2.0,2.0,2.0,4.0,7.0,8.0,7.0,13.0,6.0,15.0,9.0,6.0,13.0,12.0,6.0,12.0,11.0,14.0,14.0,15.0,10.0,12.0,11.0,13.0,16.0,7.0,12.0,9.0,12.0,15.0,16.0,14.0,10.0,14.0,15.0,9.0,13.0,12.0,20.0,14.0,16.0,12.0,14.0,13.0,6.0,12.0,4.0,13.0,18.0,13.0,14.0,14.0,13.0,7.0,30.0,4.0,0.0,0.0,0.0,192.0,78.0,1.0,3.0,1.0,2.0,2.0,3.0,1.0,3.0,1.0,1.0,3.0,4.0,6.0,7.0,8.0,11.0,6.0,15.0,8.0,6.0,13.0,11.0,6.0,14.0,11.0,17.0,14.0,16.0,12.0,14.0,10.0,12.0,17.0,8.0,8.0,11.0,13.0,15.0,16.0,14.0,12.0,18.0,14.0,6.0,14.0,12.0,20.0,17.0,16.0,14.0,17.0,13.0,9.0,11.0,8.0,13.0,10.0,13.0,12.0,10.0,10.0,5.0,32.0,0.0,0.0,13.0,0.0,175.0,65.0,2.0,1.0,1.0,2.0,3.0,3.0,1.0,2.0,3.0,2.0,3.0,15.0,13.0,11.0,6.0,14.0,13.0,10.0,12.0,8.0,8.0,16.0,8.0,12.0,13.0,11.0,14.0,15.0,14.0,15.0,14.0,14.0,14.0,6.0,13.0,9.0,15.0,18.0,13.0,12.0,13.0,13.0,8.0,8.0,13.0,10.0,20.0,13.0,13.0,12.0,11.0,15.0,12.0,10.0,17.0,14.0,15.0,14.0,16.0,14.0,14.0,6.0,20.0,0.0,0.0,2.0,0.0,180.0,75.0,3.0,1.0,2.0,2.0,3.0,2.0,1.0,1.0,3.0,3.0,1.0,8.0,13.0,14.0,9.0,13.0,8.0,10.0,9.0,6.0,5.0,12.0,6.0,5.0,14.0,8.0,13.0,12.0,13.0,12.0,12.0,12.0,7.0,13.0,8.0,14.0,7.0,12.0,13.0,15.0,13.0,14.0,10.0,8.0,14.0,15.0,20.0,13.0,12.0,13.0,11.0,9.0,7.0,13.0,9.0,11.0,11.0,11.0,12.0,11.0,10.0,1.0,25.0,0.0,0.0,0.0,0.0,176.0,74.0,2.0,2.0,1.0,3.0,2.0,2.0,2.0,4.0,3.0,3.0,3.0,12.0,12.0,14.0,12.0,14.0,13.0,7.0,12.0,6.0,3.0,12.0,12.0,3.0,15.0,9.0,10.0,8.0,12.0,11.0,12.0,10.0,10.0,14.0,5.0,13.0,4.0,6.0,8.0,17.0,15.0,12.0,8.0,20.0,12.0,14.0,8.0,13.0,12.0,11.0,9.0,14.0,10.0,8.0,8.0,14.0,12.0,7.0,10.0,11.0,11.0,9.0,30.0,5.0,0.0,22.0,9.0,181.0,84.0,2.0,3.0,3.0,1.0,2.0,3.0,3.0,1.0,3.0,1.0,3.0,7.0,10.0,12.0,13.0,11.0,7.0,13.0,10.0,12.0,6.0,11.0,13.0,6.0,13.0,17.0,13.0,16.0,11.0,13.0,11.0,11.0,17.0,14.0,8.0,14.0,9.0,13.0,17.0,15.0,12.0,15.0,11.0,8.0,14.0,15.0,20.0,14.0,14.0,13.0,9.0,13.0,7.0,10.0,7.0,16.0,13.0,14.0,13.0,15.0,15.0,10.0,31.0,25.0,0.0,6.0,0.0,191.0,84.0,11.0,14.0,13.0,12.0,15.0,14.0,15.0,16.0,13.0,14.0,14.0,8.0,2.0,10.0,5.0,11.0,11.0,7.0,10.0,2.0,5.0,10.0,11.0,11.0,9.0,12.0,13.0,15.0,13.0,13.0,8.0,13.0,16.0,12.0,14.0,1.0,16.0,13.0,11.0,12.0,13.0,16.0,16.0,8.0,16.0,13.0,20.0,15.0,15.0,17.0,8.0,15.0,7.0,2.0,15.0,15.0,17.0,15.0,17.0,16.0,15.0,6.0,23.0,0.0,0.0,0.0,0.0,184.0,77.0,1.0,1.0,1.0,1.0,3.0,2.0,3.0,2.0,2.0,2.0,3.0,6.0,9.0,11.0,7.0,12.0,7.0,15.0,9.0,11.0,14.0,13.0,10.0,15.0,12.0,14.0,15.0,15.0,13.0,12.0,11.0,13.0,15.0,11.0,9.0,9.0,14.0,14.0,14.0,14.0,13.0,15.0,13.0,9.0,16.0,15.0,20.0,14.0,14.0,14.0,11.0,14.0,4.0,11.0,14.0,13.0,15.0,14.0,16.0,14.0,15.0,6.0,28.0,46.0,3.0,14.0,3.0,190.0,80.0,2.0,3.0,3.0,2.0,2.0,1.0,1.0,3.0,1.0,3.0,1.0,4.0,6.0,7.0,9.0,11.0,7.0,17.0,11.0,10.0,15.0,12.0,11.0,16.0,10.0,17.0,15.0,18.0,13.0,14.0,12.0,14.0,18.0,6.0,17.0,8.0,15.0,15.0,14.0,11.0,10.0,17.0,16.0,7.0,17.0,13.0,20.0,15.0,18.0,17.0,14.0,16.0,4.0,6.0,14.0,15.0,16.0,17.0,18.0,14.0,15.0,6.0,23.0,0.0,0.0,1.0,0.0,182.0,71.0,3.0,1.0,2.0,3.0,4.0,2.0,3.0,1.0,2.0,1.0,3.0,9.0,13.0,14.0,8.0,14.0,13.0,12.0,10.0,13.0,14.0,14.0,13.0,15.0,13.0,14.0,14.0,13.0,11.0,12.0,12.0,13.0,16.0,12.0,12.0,15.0,13.0,14.0,15.0,15.0,13.0,14.0,12.0,9.0,16.0,15.0,20.0,15.0,15.0,15.0,10.0,14.0,6.0,12.0,8.0,15.0,14.0,16.0,15.0,15.0,16.0,6.0,20.0,0.0,0.0,0.0,0.0,184.0,80.0,1.0,4.0,4.0,1.0,3.0,1.0,4.0,3.0,3.0,3.0,2.0,7.0,14.0,13.0,8.0,12.0,7.0,16.0,7.0,12.0,13.0,13.0,11.0,12.0,13.0,12.0,13.0,14.0,13.0,12.0,12.0,12.0,15.0,12.0,10.0,14.0,13.0,14.0,13.0,14.0,12.0,14.0,12.0,6.0,13.0,14.0,20.0,13.0,14.0,14.0,8.0,15.0,10.0,13.0,9.0,16.0,15.0,14.0,16.0,16.0,17.0,5.0,29.0,90.0,4.0,16.0,2.0,170.0,61.0,2.0,3.0,3.0,1.0,3.0,1.0,2.0,2.0,2.0,2.0,1.0,15.0,14.0,15.0,9.0,17.0,16.0,7.0,12.0,4.0,11.0,18.0,15.0,12.0,17.0,15.0,15.0,16.0,13.0,16.0,17.0,14.0,16.0,15.0,14.0,12.0,14.0,18.0,16.0,13.0,14.0,12.0,8.0,10.0,14.0,11.0,20.0,14.0,10.0,14.0,9.0,17.0,10.0,14.0,13.0,17.0,15.0,16.0,17.0,15.0,16.0,7.0,31.0,0.0,0.0,6.0,0.0,174.0,80.0,1.0,1.0,1.0,1.0,1.0,5.0,1.0,1.0,1.0,1.0,1.0,14.0,12.0,11.0,7.0,12.0,13.0,9.0,7.0,10.0,11.0,11.0,10.0,10.0,12.0,11.0,11.0,11.0,10.0,6.0,10.0,9.0,12.0,12.0,12.0,10.0,12.0,12.0,14.0,12.0,15.0,10.0,9.0,20.0,12.0,12.0,7.0,12.0,9.0,9.0,10.0,12.0,7.0,9.0,11.0,14.0,9.0,7.0,14.0,8.0,9.0,9.0,20.0,0.0,0.0,7.0,1.0,170.0,58.0,1.0,2.0,2.0,2.0,2.0,2.0,2.0,4.0,1.0,3.0,2.0,16.0,14.0,16.0,13.0,16.0,17.0,5.0,14.0,2.0,6.0,15.0,13.0,4.0,17.0,9.0,12.0,14.0,12.0,12.0,14.0,13.0,15.0,16.0,7.0,13.0,9.0,13.0,15.0,15.0,16.0,11.0,7.0,20.0,14.0,15.0,8.0,14.0,8.0,15.0,5.0,15.0,7.0,16.0,15.0,15.0,15.0,14.0,16.0,18.0,16.0,3.0,21.0,7.0,0.0,14.0,6.0,173.0,64.0,3.0,2.0,3.0,2.0,3.0,3.0,3.0,2.0,3.0,3.0,3.0,14.0,14.0,18.0,14.0,17.0,14.0,7.0,11.0,2.0,6.0,15.0,14.0,6.0,18.0,12.0,14.0,14.0,15.0,13.0,16.0,14.0,17.0,17.0,12.0,13.0,9.0,13.0,17.0,15.0,17.0,13.0,7.0,20.0,14.0,14.0,9.0,14.0,9.0,15.0,7.0,16.0,7.0,14.0,15.0,17.0,15.0,16.0,17.0,16.0,15.0,4.0,26.0,0.0,0.0,4.0,0.0,180.0,73.0,2.0,3.0,1.0,4.0,2.0,3.0,3.0,1.0,1.0,4.0,1.0,11.0,13.0,13.0,14.0,14.0,11.0,15.0,12.0,3.0,7.0,14.0,14.0,8.0,13.0,12.0,14.0,17.0,13.0,15.0,14.0,14.0,16.0,12.0,15.0,16.0,12.0,18.0,16.0,13.0,14.0,13.0,12.0,8.0,14.0,13.0,20.0,15.0,12.0,15.0,8.0,14.0,7.0,15.0,19.0,14.0,17.0,14.0,18.0,16.0,16.0,5.0,30.0,62.0,25.0,13.0,8.0,177.0,72.0,1.0,3.0,3.0,1.0,3.0,2.0,1.0,3.0,1.0,4.0,1.0,8.0,11.0,12.0,17.0,14.0,12.0,18.0,14.0,3.0,4.0,13.0,18.0,5.0,16.0,14.0,15.0,16.0,17.0,13.0,14.0,16.0,16.0,16.0,16.0,16.0,6.0,13.0,13.0,13.0,14.0,13.0,11.0,14.0,13.0,12.0,20.0,12.0,12.0,15.0,8.0,19.0,10.0,6.0,13.0,18.0,14.0,19.0,15.0,16.0,17.0,10.0
3,0,24.0,0.0,0.0,0.0,0.0,188.0,82.0,13.0,14.0,12.0,8.0,14.0,8.0,14.0,15.0,12.0,12.0,9.0,3.0,1.0,1.0,2.0,8.0,8.0,1.0,1.0,1.0,2.0,8.0,3.0,3.0,7.0,9.0,12.0,13.0,11.0,12.0,9.0,12.0,15.0,6.0,14.0,2.0,11.0,11.0,6.0,12.0,13.0,15.0,14.0,5.0,13.0,12.0,20.0,12.0,10.0,13.0,9.0,12.0,6.0,1.0,14.0,12.0,17.0,13.0,15.0,13.0,11.0,6.0,32.0,0.0,0.0,14.0,0.0,187.0,74.0,3.0,1.0,3.0,2.0,1.0,3.0,1.0,3.0,2.0,1.0,3.0,7.0,12.0,12.0,6.0,13.0,10.0,13.0,10.0,6.0,8.0,13.0,7.0,13.0,13.0,8.0,13.0,5.0,13.0,13.0,12.0,13.0,13.0,6.0,10.0,9.0,13.0,10.0,9.0,11.0,11.0,15.0,14.0,10.0,13.0,13.0,20.0,12.0,13.0,12.0,9.0,10.0,9.0,8.0,11.0,14.0,14.0,8.0,15.0,15.0,15.0,5.0,28.0,0.0,0.0,0.0,0.0,193.0,84.0,1.0,1.0,2.0,2.0,2.0,3.0,2.0,3.0,2.0,1.0,3.0,4.0,8.0,8.0,9.0,10.0,6.0,14.0,7.0,8.0,14.0,12.0,6.0,14.0,11.0,12.0,13.0,14.0,11.0,14.0,12.0,12.0,14.0,6.0,11.0,8.0,14.0,13.0,13.0,11.0,11.0,16.0,16.0,20.0,12.0,12.0,8.0,14.0,16.0,14.0,12.0,13.0,6.0,10.0,7.0,12.0,15.0,12.0,16.0,15.0,13.0,6.0,31.0,4.0,0.0,0.0,0.0,173.0,73.0,2.0,3.0,2.0,2.0,4.0,2.0,3.0,1.0,1.0,2.0,4.0,7.0,13.0,9.0,6.0,11.0,10.0,6.0,8.0,11.0,12.0,13.0,8.0,13.0,11.0,11.0,12.0,13.0,10.0,12.0,8.0,8.0,16.0,11.0,6.0,12.0,8.0,12.0,14.0,14.0,13.0,12.0,7.0,8.0,15.0,14.0,20.0,14.0,14.0,12.0,11.0,13.0,8.0,16.0,7.0,13.0,14.0,12.0,14.0,16.0,16.0,6.0,26.0,0.0,0.0,0.0,0.0,182.0,68.0,1.0,4.0,3.0,2.0,3.0,1.0,2.0,1.0,2.0,4.0,1.0,7.0,12.0,9.0,5.0,10.0,6.0,12.0,7.0,15.0,12.0,9.0,6.0,12.0,10.0,12.0,13.0,14.0,11.0,10.0,9.0,9.0,13.0,7.0,6.0,10.0,10.0,14.0,15.0,16.0,13.0,13.0,11.0,5.0,15.0,15.0,20.0,14.0,10.0,12.0,12.0,13.0,7.0,12.0,12.0,14.0,14.0,15.0,13.0,14.0,14.0,7.0,29.0,0.0,0.0,0.0,0.0,183.0,78.0,1.0,3.0,3.0,3.0,3.0,1.0,2.0,3.0,3.0,1.0,1.0,13.0,8.0,9.0,6.0,12.0,14.0,13.0,10.0,12.0,11.0,12.0,8.0,13.0,12.0,12.0,15.0,13.0,13.0,13.0,11.0,13.0,15.0,6.0,12.0,7.0,13.0,16.0,18.0,12.0,11.0,14.0,12.0,20.0,14.0,11.0,8.0,16.0,14.0,14.0,12.0,14.0,6.0,12.0,10.0,12.0,13.0,11.0,15.0,15.0,15.0,5.0,30.0,9.0,1.0,0.0,0.0,192.0,90.0,2.0,2.0,2.0,2.0,3.0,1.0,3.0,4.0,1.0,1.0,3.0,4.0,7.0,10.0,10.0,9.0,8.0,17.0,12.0,6.0,13.0,12.0,8.0,12.0,11.0,13.0,14.0,15.0,13.0,13.0,10.0,12.0,14.0,12.0,13.0,13.0,12.0,14.0,16.0,12.0,12.0,18.0,16.0,8.0,14.0,13.0,20.0,16.0,18.0,13.0,13.0,14.0,7.0,12.0,13.0,13.0,13.0,13.0,13.0,13.0,13.0,6.0,21.0,0.0,0.0,0.0,0.0,183.0,73.0,1.0,4.0,3.0,3.0,3.0,1.0,4.0,1.0,2.0,3.0,2.0,11.0,10.0,12.0,11.0,13.0,9.0,12.0,10.0,5.0,8.0,12.0,9.0,8.0,13.0,13.0,12.0,12.0,10.0,12.0,14.0,12.0,12.0,14.0,8.0,12.0,8.0,12.0,12.0,14.0,14.0,14.0,11.0,8.0,13.0,13.0,20.0,12.0,12.0,12.0,5.0,10.0,7.0,12.0,15.0,11.0,11.0,10.0,11.0,12.0,11.0,4.0,20.0,0.0,0.0,0.0,0.0,173.0,67.0,2.0,2.0,4.0,3.0,3.0,2.0,3.0,3.0,2.0,1.0,1.0,11.0,12.0,12.0,9.0,12.0,8.0,5.0,10.0,7.0,4.0,8.0,10.0,4.0,14.0,12.0,7.0,11.0,8.0,6.0,10.0,10.0,3.0,11.0,5.0,10.0,11.0,8.0,13.0,15.0,14.0,14.0,6.0,5.0,14.0,15.0,20.0,12.0,8.0,10.0,5.0,10.0,10.0,10.0,17.0,12.0,12.0,10.0,7.0,10.0,19.0,8.0,23.0,0.0,0.0,0.0,0.0,175.0,70.0,2.0,1.0,2.0,2.0,1.0,2.0,2.0,3.0,4.0,1.0,2.0,10.0,11.0,12.0,9.0,13.0,8.0,6.0,13.0,2.0,5.0,13.0,10.0,6.0,13.0,7.0,13.0,9.0,13.0,11.0,13.0,12.0,13.0,12.0,10.0,12.0,10.0,13.0,12.0,11.0,12.0,13.0,8.0,8.0,14.0,12.0,20.0,14.0,12.0,13.0,9.0,11.0,10.0,11.0,19.0,12.0,14.0,11.0,13.0,10.0,16.0,7.0,23.0,1.0,0.0,0.0,0.0,185.0,70.0,4.0,3.0,1.0,2.0,1.0,3.0,2.0,3.0,1.0,2.0,3.0,5.0,8.0,12.0,13.0,13.0,7.0,14.0,11.0,5.0,5.0,8.0,13.0,5.0,13.0,6.0,13.0,10.0,12.0,12.0,11.0,11.0,13.0,12.0,7.0,13.0,9.0,8.0,10.0,16.0,12.0,14.0,12.0,8.0,14.0,15.0,20.0,13.0,13.0,12.0,7.0,15.0,7.0,7.0,13.0,13.0,12.0,10.0,12.0,15.0,15.0,7.0,22.0,0.0,0.0,0.0,0.0,184.0,79.0,12.0,12.0,10.0,1.0,10.0,12.0,11.0,13.0,10.0,10.0,8.0,8.0,2.0,1.0,3.0,9.0,10.0,3.0,2.0,1.0,3.0,5.0,3.0,3.0,9.0,10.0,13.0,16.0,11.0,10.0,10.0,14.0,13.0,3.0,4.0,2.0,10.0,11.0,7.0,10.0,12.0,14.0,12.0,5.0,15.0,11.0,20.0,12.0,14.0,12.0,8.0,7.0,5.0,1.0,10.0,10.0,17.0,11.0,12.0,9.0,16.0,5.0,26.0,11.0,0.0,0.0,0.0,180.0,81.0,3.0,2.0,2.0,3.0,3.0,2.0,1.0,2.0,2.0,1.0,2.0,5.0,9.0,8.0,5.0,11.0,5.0,13.0,10.0,8.0,15.0,10.0,7.0,13.0,10.0,15.0,14.0,17.0,11.0,12.0,9.0,12.0,16.0,8.0,10.0,8.0,13.0,14.0,15.0,13.0,12.0,14.0,12.0,20.0,14.0,12.0,8.0,14.0,14.0,14.0,10.0,15.0,13.0,8.0,9.0,14.0,17.0,13.0,13.0,13.0,11.0,8.0,21.0,0.0,0.0,0.0,0.0,182.0,74.0,2.0,2.0,2.0,2.0,2.0,1.0,1.0,1.0,3.0,2.0,2.0,9.0,11.0,12.0,7.0,9.0,8.0,12.0,7.0,11.0,12.0,7.0,8.0,13.0,11.0,12.0,12.0,14.0,12.0,13.0,7.0,12.0,11.0,1.0,9.0,11.0,9.0,10.0,12.0,14.0,10.0,13.0,11.0,9.0,8.0,12.0,20.0,13.0,11.0,10.0,13.0,8.0,10.0,10.0,15.0,11.0,13.0,10.0,10.0,8.0,13.0,7.0,28.0,22.0,0.0,20.0,1.0,176.0,74.0,2.0,3.0,2.0,1.0,1.0,1.0,3.0,3.0,2.0,2.0,1.0,15.0,15.0,12.0,8.0,13.0,12.0,5.0,11.0,15.0,10.0,13.0,9.0,10.0,12.0,10.0,11.0,10.0,13.0,12.0,11.0,12.0,11.0,11.0,7.0,13.0,10.0,14.0,15.0,15.0,14.0,10.0,8.0,20.0,13.0,14.0,8.0,15.0,8.0,14.0,5.0,12.0,5.0,14.0,15.0,15.0,10.0,14.0,13.0,12.0,12.0,2.0,30.0,0.0,0.0,6.0,0.0,181.0,78.0,2.0,1.0,1.0,1.0,2.0,3.0,1.0,1.0,2.0,1.0,3.0,8.0,13.0,10.0,6.0,11.0,9.0,12.0,14.0,13.0,14.0,10.0,8.0,14.0,12.0,10.0,12.0,13.0,13.0,13.0,10.0,11.0,10.0,6.0,13.0,8.0,15.0,14.0,13.0,13.0,12.0,14.0,10.0,20.0,15.0,11.0,8.0,13.0,14.0,11.0,10.0,13.0,6.0,8.0,10.0,12.0,14.0,8.0,15.0,15.0,15.0,9.0,31.0,0.0,0.0,0.0,0.0,178.0,70.0,3.0,1.0,3.0,3.0,2.0,2.0,2.0,1.0,2.0,1.0,2.0,5.0,8.0,7.0,7.0,12.0,5.0,8.0,8.0,7.0,14.0,13.0,8.0,13.0,12.0,15.0,14.0,17.0,12.0,13.0,9.0,13.0,16.0,10.0,15.0,8.0,13.0,18.0,15.0,13.0,14.0,12.0,9.0,10.0,15.0,13.0,20.0,16.0,13.0,14.0,12.0,14.0,5.0,16.0,13.0,12.0,16.0,13.0,13.0,13.0,13.0,6.0,22.0,0.0,0.0,6.0,1.0,175.0,75.0,3.0,3.0,2.0,1.0,1.0,2.0,3.0,2.0,2.0,1.0,1.0,10.0,9.0,12.0,6.0,11.0,7.0,10.0,11.0,7.0,9.0,11.0,6.0,10.0,14.0,12.0,10.0,12.0,10.0,10.0,12.0,11.0,10.0,13.0,6.0,11.0,8.0,11.0,13.0,12.0,14.0,12.0,8.0,5.0,14.0,13.0,20.0,11.0,12.0,10.0,10.0,10.0,8.0,10.0,8.0,11.0,10.0,9.0,12.0,12.0,15.0,6.0,32.0,25.0,0.0,0.0,0.0,181.0,82.0,2.0,3.0,3.0,1.0,1.0,1.0,1.0,3.0,1.0,2.0,3.0,5.0,10.0,6.0,7.0,10.0,7.0,14.0,9.0,8.0,11.0,12.0,7.0,13.0,10.0,15.0,14.0,16.0,11.0,13.0,10.0,12.0,16.0,9.0,15.0,8.0,11.0,16.0,18.0,11.0,12.0,14.0,11.0,8.0,13.0,11.0,20.0,17.0,15.0,13.0,15.0,11.0,6.0,14.0,18.0,12.0,13.0,13.0,14.0,11.0,11.0,8.0,27.0,32.0,6.0,0.0,0.0,188.0,78.0,3.0,2.0,3.0,2.0,1.0,3.0,3.0,3.0,2.0,2.0,2.0,4.0,8.0,11.0,12.0,12.0,6.0,16.0,13.0,8.0,13.0,14.0,7.0,12.0,12.0,12.0,10.0,14.0,13.0,12.0,11.0,12.0,15.0,9.0,11.0,12.0,6.0,13.0,12.0,14.0,13.0,15.0,15.0,5.0,13.0,12.0,20.0,16.0,15.0,14.0,12.0,15.0,11.0,10.0,9.0,15.0,12.0,12.0,13.0,13.0,13.0,7.0,34.0,0.0,0.0,0.0,0.0,176.0,65.0,2.0,3.0,3.0,3.0,2.0,2.0,1.0,2.0,1.0,1.0,2.0,14.0,15.0,13.0,10.0,15.0,13.0,6.0,15.0,10.0,3.0,14.0,13.0,6.0,14.0,8.0,12.0,9.0,13.0,12.0,14.0,13.0,11.0,12.0,7.0,13.0,8.0,14.0,15.0,14.0,13.0,12.0,8.0,20.0,14.0,13.0,10.0,12.0,7.0,13.0,8.0,15.0,7.0,6.0,13.0,14.0,14.0,9.0,14.0,14.0,11.0,10.0,19.0,0.0,0.0,0.0,0.0,173.0,67.0,3.0,2.0,4.0,2.0,1.0,1.0,3.0,1.0,1.0,1.0,2.0,13.0,13.0,15.0,10.0,14.0,11.0,6.0,12.0,4.0,4.0,12.0,11.0,5.0,14.0,10.0,12.0,9.0,10.0,8.0,12.0,8.0,11.0,15.0,5.0,12.0,6.0,8.0,10.0,16.0,15.0,13.0,7.0,8.0,13.0,15.0,20.0,11.0,9.0,12.0,6.0,12.0,6.0,15.0,8.0,13.0,8.0,12.0,9.0,14.0,13.0,9.0
1,1,34.0,1.0,0.0,0.0,0.0,187.0,87.0,13.0,14.0,15.0,7.0,13.0,11.0,14.0,15.0,11.0,17.0,12.0,2.0,1.0,1.0,3.0,8.0,7.0,2.0,1.0,2.0,1.0,9.0,8.0,2.0,6.0,12.0,15.0,17.0,14.0,15.0,8.0,13.0,17.0,7.0,14.0,6.0,14.0,12.0,6.0,7.0,13.0,14.0,13.0,8.0,13.0,8.0,20.0,11.0,16.0,14.0,10.0,14.0,6.0,1.0,12.0,12.0,15.0,16.0,16.0,14.0,15.0,6.0,28.0,0.0,0.0,0.0,0.0,190.0,85.0,3.0,2.0,3.0,3.0,2.0,2.0,2.0,4.0,3.0,1.0,2.0,5.0,9.0,8.0,9.0,8.0,7.0,14.0,10.0,9.0,15.0,9.0,6.0,14.0,9.0,16.0,13.0,16.0,10.0,13.0,10.0,12.0,15.0,6.0,13.0,7.0,13.0,14.0,16.0,12.0,11.0,17.0,13.0,20.0,15.0,13.0,8.0,15.0,15.0,12.0,14.0,14.0,9.0,8.0,14.0,13.0,14.0,11.0,12.0,13.0,16.0,14.0,20.0,0.0,0.0,6.0,0.0,188.0,79.0,2.0,3.0,2.0,1.0,1.0,3.0,2.0,1.0,2.0,2.0,1.0,4.0,4.0,11.0,6.0,11.0,8.0,13.0,8.0,9.0,13.0,12.0,9.0,13.0,11.0,14.0,13.0,15.0,14.0,13.0,8.0,12.0,14.0,9.0,11.0,10.0,12.0,12.0,13.0,11.0,11.0,11.0,13.0,8.0,12.0,13.0,20.0,13.0,12.0,13.0,14.0,13.0,10.0,11.0,11.0,13.0,12.0,14.0,14.0,15.0,10.0,7.0,26.0,0.0,0.0,0.0,0.0,176.0,70.0,2.0,1.0,4.0,3.0,3.0,3.0,1.0,3.0,3.0,2.0,1.0,10.0,11.0,11.0,6.0,13.0,9.0,5.0,12.0,11.0,13.0,13.0,7.0,14.0,13.0,15.0,11.0,14.0,12.0,11.0,9.0,12.0,13.0,9.0,9.0,13.0,12.0,15.0,14.0,12.0,16.0,12.0,7.0,20.0,13.0,13.0,10.0,15.0,11.0,13.0,14.0,13.0,11.0,9.0,8.0,9.0,17.0,12.0,14.0,14.0,15.0,3.0,29.0,0.0,0.0,0.0,0.0,182.0,76.0,1.0,4.0,2.0,3.0,1.0,1.0,1.0,2.0,2.0,1.0,1.0,7.0,12.0,11.0,9.0,11.0,12.0,7.0,12.0,8.0,12.0,13.0,8.0,12.0,13.0,14.0,12.0,14.0,10.0,13.0,12.0,12.0,13.0,15.0,8.0,11.0,12.0,13.0,13.0,11.0,12.0,11.0,12.0,20.0,10.0,11.0,10.0,14.0,11.0,13.0,11.0,10.0,11.0,10.0,14.0,15.0,13.0,9.0,14.0,12.0,13.0,6.0,32.0,36.0,0.0,12.0,2.0,183.0,77.0,1.0,3.0,2.0,1.0,3.0,1.0,1.0,2.0,1.0,1.0,3.0,6.0,11.0,8.0,6.0,13.0,11.0,13.0,10.0,6.0,15.0,14.0,10.0,17.0,12.0,15.0,16.0,18.0,14.0,17.0,12.0,15.0,17.0,11.0,17.0,7.0,17.0,20.0,16.0,9.0,11.0,15.0,11.0,8.0,15.0,10.0,20.0,14.0,14.0,17.0,10.0,16.0,10.0,13.0,15.0,15.0,15.0,14.0,18.0,15.0,13.0,6.0,26.0,0.0,0.0,0.0,0.0,184.0,76.0,3.0,1.0,3.0,1.0,3.0,2.0,3.0,2.0,1.0,1.0,3.0,10.0,11.0,13.0,9.0,13.0,12.0,13.0,10.0,6.0,11.0,13.0,9.0,14.0,12.0,12.0,13.0,12.0,12.0,11.0,13.0,12.0,13.0,13.0,10.0,12.0,13.0,12.0,16.0,15.0,13.0,15.0,13.0,20.0,15.0,14.0,5.0,16.0,15.0,13.0,12.0,14.0,5.0,12.0,18.0,14.0,10.0,7.0,11.0,11.0,13.0,10.0,20.0,0.0,0.0,0.0,0.0,173.0,66.0,1.0,1.0,1.0,1.0,1.0,2.0,3.0,1.0,3.0,3.0,4.0,15.0,13.0,13.0,10.0,15.0,12.0,5.0,13.0,5.0,7.0,15.0,12.0,7.0,15.0,10.0,10.0,13.0,12.0,10.0,16.0,13.0,18.0,14.0,7.0,14.0,12.0,14.0,14.0,8.0,14.0,13.0,7.0,14.0,12.0,9.0,20.0,12.0,13.0,12.0,8.0,15.0,6.0,12.0,12.0,14.0,14.0,14.0,15.0,14.0,11.0,6.0,19.0,0.0,0.0,11.0,1.0,171.0,65.0,2.0,2.0,2.0,2.0,2.0,3.0,3.0,3.0,1.0,1.0,3.0,14.0,13.0,13.0,11.0,14.0,15.0,8.0,12.0,6.0,4.0,13.0,12.0,4.0,15.0,8.0,12.0,10.0,12.0,8.0,13.0,13.0,14.0,15.0,8.0,14.0,6.0,13.0,12.0,15.0,16.0,10.0,7.0,20.0,13.0,15.0,10.0,12.0,7.0,11.0,6.0,11.0,8.0,11.0,12.0,13.0,11.0,12.0,12.0,6.0,12.0,5.0,20.0,7.0,1.0,0.0,0.0,182.0,75.0,2.0,1.0,3.0,2.0,2.0,1.0,3.0,1.0,3.0,2.0,1.0,11.0,11.0,13.0,12.0,13.0,11.0,12.0,10.0,5.0,4.0,12.0,8.0,5.0,13.0,11.0,12.0,11.0,11.0,8.0,10.0,10.0,3.0,10.0,1.0,13.0,8.0,12.0,12.0,15.0,14.0,13.0,11.0,6.0,14.0,13.0,20.0,12.0,13.0,12.0,9.0,11.0,9.0,11.0,9.0,9.0,9.0,12.0,11.0,9.0,17.0,7.0,22.0,0.0,0.0,0.0,0.0,181.0,81.0,2.0,3.0,2.0,1.0,3.0,3.0,4.0,2.0,1.0,1.0,2.0,5.0,11.0,12.0,14.0,12.0,6.0,13.0,10.0,5.0,4.0,12.0,12.0,4.0,13.0,8.0,12.0,13.0,12.0,12.0,11.0,11.0,15.0,14.0,5.0,14.0,10.0,13.0,15.0,13.0,12.0,14.0,10.0,20.0,15.0,12.0,14.0,13.0,14.0,13.0,8.0,12.0,5.0,14.0,8.0,12.0,12.0,9.0,13.0,12.0,14.0,7.0,25.0,4.0,0.0,11.0,0.0,184.0,81.0,14.0,14.0,13.0,9.0,15.0,12.0,16.0,16.0,13.0,7.0,11.0,8.0,1.0,2.0,1.0,11.0,12.0,6.0,1.0,3.0,3.0,11.0,5.0,3.0,11.0,8.0,15.0,15.0,13.0,14.0,10.0,11.0,14.0,8.0,13.0,5.0,13.0,10.0,10.0,14.0,16.0,14.0,13.0,20.0,14.0,12.0,5.0,14.0,14.0,15.0,9.0,16.0,6.0,1.0,17.0,11.0,15.0,13.0,14.0,12.0,12.0,4.0,20.0,1.0,0.0,10.0,0.0,183.0,73.0,2.0,4.0,4.0,2.0,1.0,2.0,2.0,3.0,3.0,3.0,3.0,8.0,9.0,10.0,6.0,14.0,7.0,12.0,5.0,9.0,14.0,12.0,9.0,15.0,13.0,11.0,15.0,13.0,14.0,13.0,12.0,10.0,16.0,13.0,11.0,9.0,14.0,13.0,13.0,12.0,12.0,13.0,13.0,10.0,13.0,13.0,20.0,13.0,12.0,12.0,11.0,8.0,7.0,10.0,17.0,14.0,8.0,14.0,14.0,5.0,15.0,7.0,19.0,0.0,0.0,0.0,0.0,193.0,89.0,3.0,2.0,2.0,3.0,1.0,3.0,1.0,4.0,2.0,2.0,3.0,8.0,10.0,5.0,4.0,10.0,10.0,14.0,12.0,6.0,12.0,10.0,4.0,12.0,9.0,11.0,11.0,14.0,11.0,12.0,8.0,14.0,13.0,8.0,8.0,11.0,11.0,13.0,13.0,10.0,9.0,14.0,16.0,6.0,14.0,10.0,20.0,12.0,14.0,11.0,7.0,6.0,6.0,8.0,16.0,10.0,10.0,12.0,13.0,16.0,16.0,5.0,37.0,0.0,0.0,0.0,0.0,185.0,83.0,1.0,1.0,2.0,1.0,3.0,2.0,3.0,1.0,1.0,3.0,1.0,6.0,8.0,9.0,12.0,10.0,8.0,13.0,9.0,4.0,5.0,10.0,14.0,4.0,11.0,11.0,10.0,11.0,13.0,12.0,12.0,13.0,15.0,14.0,12.0,11.0,7.0,12.0,8.0,7.0,7.0,12.0,12.0,11.0,11.0,7.0,20.0,8.0,14.0,12.0,8.0,13.0,9.0,12.0,12.0,12.0,19.0,14.0,15.0,14.0,8.0,8.0,32.0,0.0,0.0,0.0,0.0,172.0,71.0,2.0,1.0,3.0,1.0,2.0,3.0,2.0,3.0,2.0,2.0,2.0,8.0,9.0,7.0,6.0,10.0,6.0,10.0,9.0,10.0,14.0,11.0,6.0,14.0,11.0,10.0,16.0,15.0,12.0,12.0,7.0,12.0,15.0,9.0,13.0,8.0,14.0,15.0,15.0,14.0,14.0,14.0,10.0,20.0,14.0,14.0,8.0,15.0,13.0,13.0,11.0,13.0,7.0,13.0,17.0,14.0,17.0,8.0,13.0,15.0,15.0,6.0,27.0,8.0,0.0,6.0,0.0,187.0,76.0,3.0,2.0,3.0,2.0,2.0,1.0,1.0,3.0,3.0,1.0,2.0,5.0,7.0,11.0,5.0,14.0,5.0,14.0,9.0,5.0,15.0,15.0,8.0,14.0,13.0,15.0,16.0,15.0,14.0,12.0,14.0,14.0,18.0,8.0,17.0,9.0,12.0,18.0,15.0,13.0,14.0,15.0,14.0,10.0,17.0,12.0,20.0,17.0,15.0,14.0,13.0,16.0,4.0,12.0,10.0,14.0,17.0,12.0,15.0,13.0,13.0,6.0,19.0,0.0,0.0,0.0,0.0,185.0,82.0,4.0,2.0,3.0,1.0,3.0,2.0,1.0,2.0,1.0,2.0,3.0,7.0,7.0,10.0,6.0,13.0,7.0,14.0,7.0,6.0,12.0,13.0,7.0,13.0,13.0,13.0,13.0,13.0,11.0,12.0,11.0,12.0,14.0,9.0,14.0,11.0,11.0,15.0,15.0,12.0,12.0,14.0,13.0,5.0,14.0,12.0,20.0,14.0,13.0,10.0,11.0,11.0,6.0,10.0,10.0,12.0,12.0,14.0,14.0,11.0,16.0,6.0,21.0,0.0,0.0,15.0,3.0,181.0,78.0,3.0,3.0,4.0,2.0,1.0,2.0,2.0,4.0,2.0,1.0,1.0,5.0,7.0,11.0,10.0,14.0,5.0,14.0,10.0,6.0,13.0,14.0,8.0,14.0,14.0,12.0,14.0,12.0,11.0,10.0,12.0,11.0,16.0,11.0,12.0,14.0,14.0,14.0,14.0,14.0,13.0,14.0,13.0,10.0,16.0,14.0,20.0,16.0,14.0,12.0,10.0,11.0,5.0,19.0,8.0,11.0,14.0,11.0,16.0,13.0,13.0,10.0,22.0,24.0,3.0,7.0,0.0,177.0,78.0,2.0,1.0,2.0,3.0,2.0,2.0,4.0,3.0,3.0,2.0,1.0,10.0,13.0,16.0,14.0,16.0,16.0,8.0,16.0,4.0,4.0,15.0,12.0,4.0,16.0,12.0,11.0,12.0,13.0,10.0,11.0,8.0,13.0,17.0,5.0,14.0,5.0,10.0,12.0,15.0,14.0,13.0,9.0,10.0,17.0,16.0,20.0,15.0,14.0,12.0,11.0,15.0,4.0,12.0,19.0,16.0,14.0,14.0,11.0,13.0,10.0,12.0,22.0,5.0,1.0,1.0,0.0,173.0,72.0,1.0,3.0,1.0,3.0,3.0,3.0,3.0,3.0,3.0,2.0,2.0,14.0,13.0,16.0,14.0,16.0,14.0,5.0,11.0,5.0,5.0,15.0,11.0,5.0,16.0,8.0,13.0,9.0,14.0,13.0,15.0,13.0,15.0,16.0,5.0,13.0,5.0,9.0,10.0,15.0,16.0,14.0,5.0,20.0,14.0,15.0,5.0,12.0,14.0,13.0,11.0,13.0,8.0,14.0,10.0,15.0,14.0,10.0,13.0,10.0,10.0,13.0,25.0,10.0,1.0,11.0,4.0,175.0,73.0,1.0,3.0,3.0,3.0,3.0,3.0,3.0,1.0,2.0,3.0,1.0,5.0,10.0,15.0,17.0,15.0,10.0,11.0,12.0,5.0,5.0,14.0,15.0,5.0,16.0,8.0,15.0,12.0,15.0,14.0,13.0,15.0,15.0,15.0,14.0,14.0,10.0,10.0,12.0,16.0,16.0,15.0,9.0,10.0,15.0,16.0,20.0,13.0,15.0,14.0,8.0,14.0,7.0,10.0,8.0,16.0,17.0,13.0,15.0,15.0,14.0,5.0
2,3,36.0,0.0,0.0,0.0,0.0,185.0,78.0,11.0,14.0,12.0,7.0,13.0,12.0,14.0,15.0,13.0,14.0,10.0,4.0,1.0,3.0,1.0,8.0,8.0,11.0,8.0,3.0,3.0,7.0,2.0,1.0,8.0,11.0,13.0,15.0,11.0,12.0,7.0,13.0,9.0,5.0,14.0,3.0,13.0,15.0,8.0,11.0,14.0,13.0,12.0,5.0,15.0,11.0,20.0,12.0,14.0,13.0,11.0,13.0,8.0,1.0,19.0,14.0,16.0,10.0,17.0,9.0,9.0,11.0,28.0,0.0,0.0,0.0,0.0,183.0,81.0,1.0,2.0,4.0,1.0,1.0,3.0,2.0,3.0,3.0,3.0,1.0,5.0,5.0,6.0,10.0,12.0,6.0,14.0,8.0,6.0,15.0,11.0,6.0,13.0,12.0,13.0,14.0,16.0,14.0,14.0,10.0,12.0,14.0,5.0,14.0,8.0,14.0,15.0,15.0,9.0,12.0,15.0,13.0,7.0,11.0,12.0,20.0,15.0,15.0,14.0,14.0,14.0,9.0,8.0,14.0,14.0,11.0,13.0,15.0,13.0,15.0,6.0,34.0,23.0,1.0,0.0,0.0,186.0,81.0,3.0,3.0,1.0,2.0,1.0,3.0,2.0,3.0,1.0,3.0,3.0,4.0,8.0,6.0,10.0,7.0,8.0,17.0,12.0,10.0,14.0,7.0,9.0,15.0,7.0,15.0,13.0,17.0,8.0,12.0,7.0,12.0,15.0,6.0,17.0,7.0,14.0,15.0,14.0,8.0,10.0,16.0,13.0,12.0,13.0,9.0,20.0,13.0,15.0,11.0,15.0,14.0,9.0,10.0,10.0,14.0,11.0,13.0,15.0,11.0,11.0,12.0,21.0,0.0,0.0,1.0,0.0,177.0,68.0,4.0,1.0,2.0,1.0,1.0,1.0,1.0,1.0,2.0,1.0,2.0,5.0,12.0,9.0,7.0,12.0,8.0,13.0,10.0,16.0,13.0,12.0,8.0,14.0,12.0,12.0,13.0,12.0,12.0,12.0,10.0,13.0,15.0,11.0,13.0,11.0,13.0,13.0,14.0,13.0,14.0,13.0,11.0,10.0,14.0,12.0,20.0,12.0,14.0,12.0,11.0,12.0,8.0,14.0,13.0,10.0,14.0,12.0,14.0,12.0,11.0,5.0,36.0,0.0,0.0,0.0,0.0,180.0,72.0,1.0,2.0,4.0,1.0,1.0,2.0,2.0,1.0,1.0,1.0,2.0,6.0,10.0,8.0,6.0,11.0,8.0,13.0,10.0,7.0,11.0,11.0,8.0,13.0,11.0,13.0,13.0,14.0,14.0,13.0,11.0,12.0,13.0,7.0,10.0,10.0,13.0,13.0,15.0,11.0,12.0,14.0,10.0,10.0,14.0,10.0,20.0,12.0,11.0,12.0,14.0,14.0,5.0,15.0,20.0,12.0,20.0,14.0,16.0,15.0,15.0,5.0,27.0,14.0,1.0,0.0,0.0,183.0,77.0,1.0,2.0,1.0,2.0,3.0,2.0,3.0,2.0,2.0,1.0,1.0,5.0,12.0,9.0,8.0,13.0,10.0,13.0,10.0,6.0,14.0,13.0,6.0,13.0,12.0,14.0,13.0,15.0,11.0,11.0,11.0,11.0,13.0,9.0,8.0,9.0,12.0,14.0,16.0,14.0,12.0,14.0,12.0,7.0,14.0,12.0,20.0,15.0,14.0,14.0,14.0,15.0,7.0,10.0,12.0,13.0,14.0,12.0,13.0,11.0,11.0,7.0,30.0,0.0,0.0,0.0,0.0,167.0,60.0,3.0,1.0,1.0,2.0,3.0,1.0,1.0,3.0,1.0,1.0,3.0,10.0,11.0,12.0,8.0,13.0,10.0,6.0,9.0,10.0,12.0,14.0,9.0,10.0,14.0,11.0,14.0,14.0,14.0,14.0,13.0,14.0,12.0,14.0,11.0,13.0,12.0,15.0,15.0,15.0,14.0,11.0,5.0,11.0,11.0,15.0,20.0,11.0,8.0,14.0,10.0,12.0,13.0,11.0,11.0,12.0,11.0,10.0,12.0,11.0,11.0,2.0,33.0,0.0,0.0,0.0,0.0,187.0,76.0,2.0,2.0,3.0,1.0,1.0,3.0,2.0,1.0,2.0,3.0,2.0,15.0,14.0,14.0,10.0,15.0,13.0,10.0,12.0,7.0,4.0,15.0,13.0,7.0,15.0,6.0,12.0,9.0,14.0,11.0,15.0,12.0,12.0,14.0,12.0,13.0,7.0,13.0,12.0,11.0,12.0,14.0,12.0,14.0,15.0,12.0,20.0,11.0,12.0,12.0,6.0,14.0,6.0,11.0,14.0,13.0,12.0,12.0,15.0,15.0,13.0,9.0,30.0,0.0,0.0,0.0,0.0,178.0,73.0,3.0,4.0,1.0,1.0,2.0,4.0,3.0,2.0,2.0,2.0,3.0,13.0,14.0,12.0,7.0,13.0,12.0,7.0,13.0,5.0,10.0,13.0,9.0,10.0,13.0,11.0,11.0,12.0,12.0,13.0,11.0,14.0,14.0,11.0,7.0,11.0,10.0,13.0,15.0,13.0,15.0,15.0,8.0,20.0,14.0,14.0,8.0,14.0,11.0,13.0,11.0,14.0,8.0,10.0,19.0,12.0,12.0,9.0,12.0,12.0,10.0,10.0,27.0,0.0,0.0,0.0,0.0,190.0,87.0,1.0,3.0,2.0,3.0,1.0,3.0,1.0,1.0,2.0,3.0,2.0,5.0,7.0,9.0,14.0,14.0,10.0,14.0,13.0,5.0,6.0,12.0,12.0,8.0,14.0,14.0,13.0,16.0,14.0,11.0,10.0,13.0,15.0,10.0,11.0,14.0,9.0,15.0,14.0,10.0,11.0,16.0,15.0,9.0,12.0,12.0,20.0,14.0,16.0,13.0,13.0,12.0,7.0,5.0,10.0,12.0,14.0,12.0,14.0,14.0,19.0,12.0,26.0,0.0,0.0,0.0,0.0,193.0,81.0,1.0,3.0,3.0,3.0,3.0,1.0,2.0,2.0,2.0,3.0,3.0,4.0,9.0,14.0,10.0,13.0,12.0,14.0,14.0,5.0,5.0,10.0,12.0,3.0,14.0,8.0,13.0,12.0,9.0,10.0,11.0,11.0,12.0,16.0,5.0,14.0,6.0,9.0,12.0,14.0,13.0,14.0,16.0,14.0,13.0,13.0,20.0,13.0,14.0,10.0,8.0,14.0,9.0,8.0,16.0,16.0,11.0,13.0,11.0,13.0,13.0,10.0,24.0,0.0,0.0,0.0,0.0,188.0,82.0,13.0,14.0,12.0,8.0,14.0,8.0,14.0,15.0,12.0,12.0,9.0,3.0,1.0,1.0,2.0,8.0,8.0,1.0,1.0,1.0,2.0,8.0,3.0,3.0,7.0,9.0,12.0,13.0,11.0,12.0,9.0,12.0,15.0,6.0,14.0,2.0,11.0,11.0,6.0,12.0,13.0,15.0,14.0,5.0,13.0,12.0,20.0,12.0,10.0,13.0,9.0,12.0,6.0,1.0,14.0,12.0,17.0,13.0,15.0,13.0,11.0,6.0,32.0,0.0,0.0,14.0,0.0,187.0,74.0,3.0,1.0,3.0,2.0,1.0,3.0,1.0,3.0,2.0,1.0,3.0,7.0,12.0,12.0,6.0,13.0,10.0,13.0,10.0,6.0,8.0,13.0,7.0,13.0,13.0,8.0,13.0,5.0,13.0,13.0,12.0,13.0,13.0,6.0,10.0,9.0,13.0,10.0,9.0,11.0,11.0,15.0,14.0,10.0,13.0,13.0,20.0,12.0,13.0,12.0,9.0,10.0,9.0,8.0,11.0,14.0,14.0,8.0,15.0,15.0,15.0,5.0,29.0,2.0,0.0,0.0,0.0,185.0,75.0,2.0,3.0,3.0,3.0,2.0,3.0,2.0,1.0,3.0,1.0,2.0,4.0,10.0,8.0,6.0,10.0,6.0,14.0,7.0,7.0,14.0,11.0,6.0,14.0,9.0,13.0,13.0,14.0,11.0,12.0,12.0,12.0,14.0,8.0,11.0,12.0,13.0,13.0,13.0,15.0,12.0,15.0,12.0,8.0,15.0,13.0,20.0,14.0,15.0,14.0,7.0,14.0,8.0,6.0,14.0,13.0,15.0,14.0,14.0,14.0,14.0,6.0,28.0,0.0,0.0,0.0,0.0,193.0,84.0,1.0,1.0,2.0,2.0,2.0,3.0,2.0,3.0,2.0,1.0,3.0,4.0,8.0,8.0,9.0,10.0,6.0,14.0,7.0,8.0,14.0,12.0,6.0,14.0,11.0,12.0,13.0,14.0,11.0,14.0,12.0,12.0,14.0,6.0,11.0,8.0,14.0,13.0,13.0,11.0,11.0,16.0,16.0,20.0,12.0,12.0,8.0,14.0,16.0,14.0,12.0,13.0,6.0,10.0,7.0,12.0,15.0,12.0,16.0,15.0,13.0,6.0,26.0,0.0,0.0,0.0,0.0,182.0,68.0,1.0,4.0,3.0,2.0,3.0,1.0,2.0,1.0,2.0,4.0,1.0,7.0,12.0,9.0,5.0,10.0,6.0,12.0,7.0,15.0,12.0,9.0,6.0,12.0,10.0,12.0,13.0,14.0,11.0,10.0,9.0,9.0,13.0,7.0,6.0,10.0,10.0,14.0,15.0,16.0,13.0,13.0,11.0,5.0,15.0,15.0,20.0,14.0,10.0,12.0,12.0,13.0,7.0,12.0,12.0,14.0,14.0,15.0,13.0,14.0,14.0,7.0,31.0,4.0,0.0,0.0,0.0,173.0,73.0,2.0,3.0,2.0,2.0,4.0,2.0,3.0,1.0,1.0,2.0,4.0,7.0,13.0,9.0,6.0,11.0,10.0,6.0,8.0,11.0,12.0,13.0,8.0,13.0,11.0,11.0,12.0,13.0,10.0,12.0,8.0,8.0,16.0,11.0,6.0,12.0,8.0,12.0,14.0,14.0,13.0,12.0,7.0,8.0,15.0,14.0,20.0,14.0,14.0,12.0,11.0,13.0,8.0,16.0,7.0,13.0,14.0,12.0,14.0,16.0,16.0,6.0,29.0,0.0,0.0,0.0,0.0,183.0,78.0,1.0,3.0,3.0,3.0,3.0,1.0,2.0,3.0,3.0,1.0,1.0,13.0,8.0,9.0,6.0,12.0,14.0,13.0,10.0,12.0,11.0,12.0,8.0,13.0,12.0,12.0,15.0,13.0,13.0,13.0,11.0,13.0,15.0,6.0,12.0,7.0,13.0,16.0,18.0,12.0,11.0,14.0,12.0,20.0,14.0,11.0,8.0,16.0,14.0,14.0,12.0,14.0,6.0,12.0,10.0,12.0,13.0,11.0,15.0,15.0,15.0,5.0,30.0,9.0,1.0,0.0,0.0,192.0,90.0,2.0,2.0,2.0,2.0,3.0,1.0,3.0,4.0,1.0,1.0,3.0,4.0,7.0,10.0,10.0,9.0,8.0,17.0,12.0,6.0,13.0,12.0,8.0,12.0,11.0,13.0,14.0,15.0,13.0,13.0,10.0,12.0,14.0,12.0,13.0,13.0,12.0,14.0,16.0,12.0,12.0,18.0,16.0,8.0,14.0,13.0,20.0,16.0,18.0,13.0,13.0,14.0,7.0,12.0,13.0,13.0,13.0,13.0,13.0,13.0,13.0,6.0,23.0,0.0,0.0,0.0,0.0,175.0,70.0,2.0,1.0,2.0,2.0,1.0,2.0,2.0,3.0,4.0,1.0,2.0,10.0,11.0,12.0,9.0,13.0,8.0,6.0,13.0,2.0,5.0,13.0,10.0,6.0,13.0,7.0,13.0,9.0,13.0,11.0,13.0,12.0,13.0,12.0,10.0,12.0,10.0,13.0,12.0,11.0,12.0,13.0,8.0,8.0,14.0,12.0,20.0,14.0,12.0,13.0,9.0,11.0,10.0,11.0,19.0,12.0,14.0,11.0,13.0,10.0,16.0,7.0,23.0,1.0,0.0,0.0,0.0,192.0,80.0,3.0,3.0,3.0,2.0,3.0,1.0,3.0,3.0,1.0,2.0,2.0,4.0,6.0,12.0,13.0,12.0,7.0,13.0,12.0,5.0,5.0,9.0,11.0,5.0,12.0,13.0,12.0,13.0,12.0,13.0,9.0,13.0,4.0,11.0,8.0,13.0,7.0,9.0,12.0,14.0,13.0,15.0,16.0,20.0,14.0,13.0,8.0,13.0,15.0,12.0,11.0,11.0,7.0,5.0,14.0,13.0,14.0,11.0,9.0,9.0,18.0,3.0,23.0,1.0,0.0,0.0,0.0,185.0,70.0,4.0,3.0,1.0,2.0,1.0,3.0,2.0,3.0,1.0,2.0,3.0,5.0,8.0,12.0,13.0,13.0,7.0,14.0,11.0,5.0,5.0,8.0,13.0,5.0,13.0,6.0,13.0,10.0,12.0,12.0,11.0,11.0,13.0,12.0,7.0,13.0,9.0,8.0,10.0,16.0,12.0,14.0,12.0,8.0,14.0,15.0,20.0,13.0,13.0,12.0,7.0,15.0,7.0,7.0,13.0,13.0,12.0,10.0,12.0,15.0,15.0,7.0
4,0,31.0,25.0,0.0,6.0,0.0,191.0,84.0,11.0,14.0,13.0,12.0,15.0,14.0,15.0,16.0,13.0,14.0,14.0,8.0,2.0,10.0,5.0,11.0,11.0,7.0,10.0,2.0,5.0,10.0,11.0,11.0,9.0,12.0,13.0,15.0,13.0,13.0,8.0,13.0,16.0,12.0,14.0,1.0,16.0,13.0,11.0,12.0,13.0,16.0,16.0,8.0,16.0,13.0,20.0,15.0,15.0,17.0,8.0,15.0,7.0,2.0,15.0,15.0,17.0,15.0,17.0,16.0,15.0,6.0,28.0,46.0,3.0,14.0,3.0,190.0,80.0,2.0,3.0,3.0,2.0,2.0,1.0,1.0,3.0,1.0,3.0,1.0,4.0,6.0,7.0,9.0,11.0,7.0,17.0,11.0,10.0,15.0,12.0,11.0,16.0,10.0,17.0,15.0,18.0,13.0,14.0,12.0,14.0,18.0,6.0,17.0,8.0,15.0,15.0,14.0,11.0,10.0,17.0,16.0,7.0,17.0,13.0,20.0,15.0,18.0,17.0,14.0,16.0,4.0,6.0,14.0,15.0,16.0,17.0,18.0,14.0,15.0,6.0,23.0,0.0,0.0,0.0,0.0,184.0,77.0,1.0,1.0,1.0,1.0,3.0,2.0,3.0,2.0,2.0,2.0,3.0,6.0,9.0,11.0,7.0,12.0,7.0,15.0,9.0,11.0,14.0,13.0,10.0,15.0,12.0,14.0,15.0,15.0,13.0,12.0,11.0,13.0,15.0,11.0,9.0,9.0,14.0,14.0,14.0,14.0,13.0,15.0,13.0,9.0,16.0,15.0,20.0,14.0,14.0,14.0,11.0,14.0,4.0,11.0,14.0,13.0,15.0,14.0,16.0,14.0,15.0,6.0,23.0,0.0,0.0,1.0,0.0,182.0,71.0,3.0,1.0,2.0,3.0,4.0,2.0,3.0,1.0,2.0,1.0,3.0,9.0,13.0,14.0,8.0,14.0,13.0,12.0,10.0,13.0,14.0,14.0,13.0,15.0,13.0,14.0,14.0,13.0,11.0,12.0,12.0,13.0,16.0,12.0,12.0,15.0,13.0,14.0,15.0,15.0,13.0,14.0,12.0,9.0,16.0,15.0,20.0,15.0,15.0,15.0,10.0,14.0,6.0,12.0,8.0,15.0,14.0,16.0,15.0,15.0,16.0,6.0,21.0,0.0,0.0,9.0,0.0,185.0,75.0,1.0,1.0,2.0,2.0,2.0,1.0,1.0,4.0,2.0,3.0,2.0,11.0,15.0,14.0,7.0,13.0,9.0,11.0,11.0,14.0,13.0,13.0,10.0,14.0,13.0,15.0,12.0,13.0,10.0,11.0,11.0,12.0,14.0,11.0,10.0,14.0,12.0,13.0,15.0,15.0,13.0,14.0,13.0,20.0,14.0,16.0,8.0,15.0,15.0,13.0,13.0,12.0,9.0,10.0,14.0,14.0,13.0,12.0,12.0,13.0,9.0,9.0,21.0,0.0,0.0,9.0,0.0,184.0,72.0,1.0,3.0,1.0,2.0,3.0,2.0,1.0,1.0,2.0,1.0,2.0,6.0,10.0,12.0,7.0,12.0,7.0,14.0,11.0,7.0,14.0,13.0,10.0,13.0,12.0,14.0,13.0,14.0,12.0,12.0,12.0,12.0,16.0,11.0,10.0,12.0,13.0,14.0,15.0,14.0,13.0,16.0,12.0,12.0,14.0,15.0,20.0,15.0,17.0,14.0,12.0,15.0,9.0,9.0,10.0,16.0,14.0,15.0,14.0,14.0,14.0,8.0,31.0,0.0,0.0,6.0,0.0,174.0,80.0,1.0,1.0,1.0,1.0,1.0,5.0,1.0,1.0,1.0,1.0,1.0,14.0,12.0,11.0,7.0,12.0,13.0,9.0,7.0,10.0,11.0,11.0,10.0,10.0,12.0,11.0,11.0,11.0,10.0,6.0,10.0,9.0,12.0,12.0,12.0,10.0,12.0,12.0,14.0,12.0,15.0,10.0,9.0,20.0,12.0,12.0,7.0,12.0,9.0,9.0,10.0,12.0,7.0,9.0,11.0,14.0,9.0,7.0,14.0,8.0,9.0,9.0,21.0,7.0,0.0,14.0,6.0,173.0,64.0,3.0,2.0,3.0,2.0,3.0,3.0,3.0,2.0,3.0,3.0,3.0,14.0,14.0,18.0,14.0,17.0,14.0,7.0,11.0,2.0,6.0,15.0,14.0,6.0,18.0,12.0,14.0,14.0,15.0,13.0,16.0,14.0,17.0,17.0,12.0,13.0,9.0,13.0,17.0,15.0,17.0,13.0,7.0,20.0,14.0,14.0,9.0,14.0,9.0,15.0,7.0,16.0,7.0,14.0,15.0,17.0,15.0,16.0,17.0,16.0,15.0,4.0,20.0,0.0,0.0,7.0,1.0,170.0,58.0,1.0,2.0,2.0,2.0,2.0,2.0,2.0,4.0,1.0,3.0,2.0,16.0,14.0,16.0,13.0,16.0,17.0,5.0,14.0,2.0,6.0,15.0,13.0,4.0,17.0,9.0,12.0,14.0,12.0,12.0,14.0,13.0,15.0,16.0,7.0,13.0,9.0,13.0,15.0,15.0,16.0,11.0,7.0,20.0,14.0,15.0,8.0,14.0,8.0,15.0,5.0,15.0,7.0,16.0,15.0,15.0,15.0,14.0,16.0,18.0,16.0,3.0,17.0,0.0,0.0,0.0,0.0,178.0,68.0,2.0,1.0,2.0,1.0,3.0,3.0,3.0,1.0,3.0,3.0,2.0,10.0,11.0,15.0,12.0,13.0,10.0,8.0,9.0,2.0,3.0,12.0,12.0,3.0,16.0,11.0,9.0,11.0,12.0,9.0,12.0,10.0,17.0,17.0,9.0,13.0,5.0,9.0,13.0,15.0,14.0,11.0,9.0,8.0,14.0,14.0,20.0,12.0,9.0,14.0,7.0,15.0,7.0,13.0,13.0,19.0,12.0,16.0,15.0,14.0,14.0,7.0,26.0,0.0,0.0,4.0,0.0,180.0,73.0,2.0,3.0,1.0,4.0,2.0,3.0,3.0,1.0,1.0,4.0,1.0,11.0,13.0,13.0,14.0,14.0,11.0,15.0,12.0,3.0,7.0,14.0,14.0,8.0,13.0,12.0,14.0,17.0,13.0,15.0,14.0,14.0,16.0,12.0,15.0,16.0,12.0,18.0,16.0,13.0,14.0,13.0,12.0,8.0,14.0,13.0,20.0,15.0,12.0,15.0,8.0,14.0,7.0,15.0,19.0,14.0,17.0,14.0,18.0,16.0,16.0,5.0,23.0,0.0,0.0,0.0,0.0,188.0,85.0,14.0,12.0,12.0,7.0,13.0,10.0,11.0,14.0,7.0,13.0,12.0,2.0,3.0,1.0,3.0,8.0,6.0,2.0,1.0,2.0,2.0,8.0,3.0,1.0,8.0,7.0,10.0,12.0,9.0,11.0,8.0,11.0,14.0,2.0,9.0,1.0,12.0,11.0,8.0,7.0,12.0,14.0,14.0,6.0,14.0,10.0,20.0,12.0,14.0,13.0,7.0,10.0,7.0,1.0,14.0,14.0,9.0,13.0,13.0,10.0,12.0,6.0,23.0,0.0,0.0,0.0,0.0,184.0,71.0,1.0,2.0,1.0,2.0,2.0,2.0,2.0,4.0,2.0,1.0,3.0,4.0,10.0,10.0,6.0,11.0,6.0,14.0,8.0,7.0,14.0,11.0,6.0,13.0,11.0,12.0,12.0,13.0,12.0,11.0,12.0,12.0,14.0,6.0,8.0,10.0,13.0,13.0,14.0,15.0,13.0,14.0,13.0,8.0,12.0,14.0,20.0,13.0,14.0,13.0,12.0,14.0,15.0,8.0,11.0,13.0,13.0,10.0,8.0,9.0,16.0,7.0,28.0,0.0,0.0,0.0,0.0,174.0,67.0,3.0,4.0,1.0,1.0,1.0,3.0,1.0,3.0,2.0,1.0,2.0,11.0,8.0,11.0,9.0,13.0,6.0,7.0,12.0,8.0,10.0,10.0,3.0,6.0,12.0,10.0,13.0,7.0,12.0,8.0,10.0,9.0,12.0,13.0,5.0,12.0,9.0,12.0,11.0,14.0,14.0,11.0,7.0,10.0,15.0,12.0,20.0,11.0,6.0,9.0,6.0,10.0,10.0,9.0,11.0,14.0,9.0,11.0,12.0,8.0,8.0,8.0,21.0,0.0,0.0,0.0,0.0,178.0,65.0,2.0,3.0,3.0,3.0,3.0,1.0,1.0,1.0,1.0,3.0,1.0,9.0,13.0,11.0,6.0,12.0,7.0,9.0,8.0,8.0,13.0,12.0,7.0,13.0,12.0,8.0,12.0,13.0,12.0,12.0,13.0,13.0,14.0,9.0,8.0,12.0,12.0,13.0,13.0,12.0,14.0,13.0,11.0,8.0,15.0,12.0,20.0,13.0,12.0,14.0,8.0,11.0,7.0,10.0,19.0,10.0,13.0,10.0,11.0,15.0,15.0,6.0,21.0,0.0,0.0,0.0,0.0,177.0,0.0,1.0,1.0,1.0,2.0,3.0,3.0,2.0,3.0,2.0,2.0,3.0,6.0,4.0,13.0,13.0,13.0,6.0,13.0,7.0,3.0,5.0,7.0,6.0,1.0,11.0,9.0,7.0,8.0,7.0,7.0,7.0,8.0,7.0,11.0,8.0,13.0,7.0,6.0,7.0,12.0,13.0,7.0,6.0,8.0,8.0,13.0,20.0,5.0,5.0,9.0,5.0,9.0,9.0,9.0,10.0,10.0,12.0,12.0,11.0,10.0,9.0,6.0,32.0,22.0,1.0,6.0,1.0,186.0,79.0,1.0,2.0,1.0,1.0,2.0,3.0,1.0,2.0,1.0,2.0,1.0,11.0,12.0,13.0,11.0,13.0,11.0,14.0,11.0,8.0,12.0,13.0,13.0,13.0,13.0,14.0,13.0,14.0,14.0,13.0,14.0,13.0,12.0,13.0,14.0,15.0,13.0,12.0,15.0,12.0,13.0,12.0,12.0,10.0,12.0,13.0,20.0,15.0,13.0,14.0,5.0,12.0,9.0,17.0,8.0,12.0,8.0,13.0,10.0,10.0,10.0,5.0,21.0,0.0,0.0,0.0,0.0,172.0,66.0,2.0,3.0,2.0,2.0,1.0,1.0,1.0,3.0,2.0,1.0,1.0,10.0,10.0,13.0,9.0,14.0,9.0,8.0,10.0,7.0,13.0,13.0,9.0,12.0,13.0,10.0,12.0,13.0,13.0,12.0,14.0,13.0,13.0,11.0,9.0,14.0,13.0,14.0,14.0,14.0,13.0,12.0,8.0,8.0,12.0,12.0,20.0,13.0,12.0,14.0,10.0,11.0,8.0,12.0,15.0,10.0,15.0,8.0,11.0,14.0,14.0,6.0,25.0,1.0,0.0,7.0,3.0,178.0,85.0,2.0,3.0,3.0,2.0,3.0,3.0,2.0,3.0,2.0,2.0,2.0,9.0,12.0,12.0,12.0,11.0,8.0,9.0,12.0,6.0,7.0,11.0,12.0,7.0,13.0,12.0,11.0,14.0,12.0,9.0,10.0,10.0,14.0,13.0,7.0,13.0,9.0,9.0,12.0,14.0,12.0,15.0,10.0,14.0,11.0,14.0,20.0,13.0,15.0,10.0,11.0,12.0,6.0,14.0,14.0,13.0,12.0,13.0,10.0,13.0,12.0,12.0,22.0,0.0,0.0,0.0,0.0,177.0,72.0,2.0,1.0,2.0,4.0,2.0,2.0,1.0,3.0,4.0,2.0,3.0,10.0,12.0,13.0,11.0,12.0,10.0,12.0,12.0,4.0,10.0,13.0,11.0,11.0,13.0,11.0,12.0,11.0,13.0,9.0,13.0,12.0,3.0,12.0,8.0,14.0,12.0,12.0,13.0,16.0,13.0,12.0,9.0,8.0,15.0,14.0,20.0,14.0,13.0,10.0,4.0,11.0,11.0,12.0,19.0,9.0,12.0,13.0,12.0,11.0,14.0,7.0,25.0,0.0,0.0,0.0,0.0,187.0,83.0,2.0,1.0,3.0,3.0,1.0,3.0,3.0,3.0,1.0,1.0,3.0,4.0,8.0,10.0,14.0,12.0,8.0,14.0,9.0,5.0,7.0,11.0,13.0,5.0,12.0,11.0,13.0,13.0,13.0,11.0,10.0,12.0,16.0,9.0,8.0,13.0,11.0,13.0,16.0,14.0,13.0,15.0,13.0,20.0,14.0,12.0,8.0,14.0,16.0,13.0,11.0,13.0,7.0,5.0,13.0,14.0,13.0,14.0,14.0,13.0,13.0,6.0,29.0,30.0,6.0,0.0,0.0,178.0,76.0,2.0,3.0,3.0,4.0,3.0,2.0,2.0,2.0,2.0,1.0,1.0,6.0,11.0,16.0,10.0,12.0,5.0,8.0,8.0,5.0,4.0,13.0,7.0,3.0,12.0,7.0,8.0,12.0,11.0,10.0,8.0,9.0,13.0,15.0,4.0,13.0,7.0,12.0,10.0,16.0,15.0,14.0,8.0,11.0,13.0,16.0,20.0,10.0,13.0,10.0,11.0,10.0,7.0,5.0,9.0,16.0,9.0,10.0,11.0,11.0,14.0,3.0
3,0,33.0,0.0,0.0,2.0,0.0,196.0,89.0,15.0,13.0,12.0,7.0,14.0,10.0,14.0,14.0,11.0,9.0,12.0,4.0,3.0,1.0,1.0,9.0,7.0,2.0,2.0,1.0,1.0,10.0,2.0,2.0,9.0,10.0,14.0,14.0,13.0,12.0,11.0,12.0,14.0,6.0,12.0,1.0,13.0,11.0,6.0,9.0,13.0,16.0,18.0,5.0,12.0,10.0,20.0,12.0,16.0,14.0,10.0,15.0,13.0,1.0,8.0,14.0,14.0,14.0,10.0,15.0,15.0,9.0,30.0,19.0,0.0,7.0,0.0,189.0,77.0,3.0,2.0,3.0,2.0,3.0,3.0,1.0,3.0,3.0,1.0,2.0,5.0,8.0,7.0,10.0,10.0,9.0,15.0,9.0,8.0,14.0,12.0,10.0,15.0,10.0,15.0,14.0,13.0,13.0,14.0,10.0,12.0,14.0,10.0,14.0,11.0,12.0,14.0,14.0,8.0,10.0,12.0,16.0,10.0,16.0,10.0,20.0,13.0,16.0,13.0,11.0,13.0,7.0,10.0,6.0,14.0,12.0,13.0,14.0,13.0,13.0,7.0,34.0,5.0,0.0,2.0,1.0,186.0,78.0,2.0,1.0,3.0,3.0,1.0,3.0,2.0,3.0,1.0,3.0,1.0,7.0,11.0,10.0,6.0,12.0,8.0,14.0,7.0,14.0,14.0,10.0,9.0,14.0,12.0,13.0,13.0,15.0,13.0,13.0,9.0,12.0,15.0,10.0,13.0,8.0,13.0,13.0,14.0,11.0,12.0,14.0,13.0,8.0,13.0,12.0,20.0,14.0,14.0,13.0,13.0,15.0,9.0,12.0,8.0,16.0,13.0,14.0,13.0,16.0,16.0,7.0,32.0,52.0,1.0,0.0,0.0,180.0,80.0,2.0,3.0,2.0,2.0,1.0,4.0,1.0,2.0,3.0,4.0,3.0,7.0,12.0,12.0,6.0,12.0,7.0,12.0,11.0,13.0,13.0,11.0,9.0,13.0,12.0,13.0,13.0,15.0,12.0,10.0,11.0,12.0,16.0,12.0,10.0,13.0,11.0,13.0,14.0,15.0,13.0,14.0,10.0,20.0,12.0,14.0,5.0,15.0,14.0,10.0,13.0,12.0,7.0,8.0,12.0,15.0,13.0,12.0,13.0,14.0,14.0,9.0,26.0,27.0,0.0,0.0,0.0,183.0,70.0,1.0,3.0,1.0,3.0,4.0,1.0,3.0,3.0,2.0,1.0,3.0,9.0,14.0,12.0,8.0,10.0,8.0,12.0,13.0,14.0,9.0,12.0,7.0,13.0,11.0,14.0,9.0,15.0,10.0,12.0,9.0,10.0,16.0,10.0,9.0,12.0,8.0,12.0,17.0,14.0,11.0,13.0,12.0,10.0,16.0,16.0,20.0,16.0,13.0,13.0,10.0,14.0,6.0,15.0,10.0,15.0,14.0,10.0,16.0,13.0,13.0,4.0,18.0,0.0,0.0,0.0,0.0,167.0,60.0,2.0,1.0,2.0,2.0,2.0,1.0,2.0,1.0,1.0,1.0,1.0,10.0,11.0,12.0,8.0,13.0,10.0,3.0,10.0,5.0,6.0,13.0,12.0,8.0,15.0,8.0,11.0,8.0,12.0,11.0,13.0,12.0,13.0,12.0,6.0,11.0,11.0,12.0,13.0,15.0,14.0,8.0,5.0,8.0,15.0,12.0,20.0,12.0,7.0,8.0,8.0,14.0,7.0,8.0,18.0,11.0,12.0,11.0,12.0,15.0,15.0,7.0,27.0,0.0,0.0,2.0,0.0,179.0,73.0,3.0,2.0,2.0,2.0,1.0,2.0,1.0,1.0,2.0,2.0,1.0,9.0,10.0,12.0,8.0,13.0,9.0,12.0,13.0,6.0,12.0,13.0,10.0,14.0,13.0,14.0,13.0,13.0,14.0,9.0,13.0,11.0,8.0,12.0,7.0,12.0,12.0,11.0,13.0,14.0,14.0,13.0,9.0,12.0,14.0,12.0,20.0,16.0,12.0,13.0,14.0,14.0,10.0,8.0,12.0,12.0,12.0,9.0,13.0,11.0,11.0,13.0,21.0,0.0,0.0,11.0,2.0,180.0,72.0,2.0,3.0,3.0,3.0,3.0,2.0,2.0,1.0,3.0,2.0,3.0,12.0,13.0,14.0,9.0,14.0,13.0,8.0,12.0,5.0,8.0,14.0,10.0,9.0,14.0,12.0,12.0,9.0,13.0,12.0,15.0,13.0,14.0,15.0,8.0,13.0,10.0,16.0,14.0,15.0,14.0,12.0,9.0,8.0,15.0,14.0,20.0,13.0,12.0,12.0,8.0,11.0,10.0,11.0,10.0,14.0,16.0,14.0,15.0,15.0,15.0,6.0,23.0,0.0,0.0,10.0,7.0,179.0,70.0,1.0,1.0,2.0,2.0,1.0,3.0,3.0,2.0,1.0,4.0,3.0,10.0,13.0,14.0,12.0,15.0,11.0,10.0,13.0,6.0,3.0,13.0,12.0,4.0,16.0,11.0,12.0,11.0,13.0,11.0,13.0,12.0,12.0,16.0,6.0,14.0,6.0,10.0,12.0,16.0,14.0,12.0,9.0,20.0,13.0,14.0,10.0,13.0,10.0,12.0,7.0,12.0,6.0,8.0,12.0,13.0,5.0,10.0,8.0,14.0,12.0,8.0,26.0,4.0,0.0,17.0,4.0,171.0,62.0,2.0,3.0,2.0,2.0,2.0,1.0,3.0,2.0,3.0,1.0,4.0,12.0,12.0,14.0,12.0,15.0,12.0,6.0,12.0,5.0,3.0,14.0,14.0,4.0,15.0,10.0,13.0,11.0,13.0,12.0,12.0,11.0,14.0,15.0,7.0,15.0,7.0,11.0,10.0,16.0,15.0,10.0,6.0,12.0,14.0,15.0,20.0,13.0,7.0,12.0,10.0,13.0,6.0,12.0,13.0,13.0,15.0,13.0,14.0,12.0,15.0,5.0,29.0,26.0,6.0,12.0,4.0,175.0,77.0,1.0,2.0,1.0,3.0,3.0,2.0,1.0,2.0,1.0,2.0,2.0,16.0,14.0,16.0,15.0,15.0,18.0,6.0,15.0,6.0,6.0,18.0,11.0,5.0,17.0,9.0,12.0,10.0,16.0,12.0,16.0,14.0,14.0,16.0,6.0,16.0,6.0,10.0,10.0,13.0,15.0,14.0,8.0,15.0,15.0,14.0,20.0,13.0,12.0,11.0,9.0,16.0,7.0,8.0,8.0,11.0,8.0,13.0,12.0,13.0,11.0,10.0,24.0,0.0,0.0,0.0,0.0,188.0,82.0,13.0,14.0,12.0,8.0,14.0,8.0,14.0,15.0,12.0,12.0,9.0,3.0,1.0,1.0,2.0,8.0,8.0,1.0,1.0,1.0,2.0,8.0,3.0,3.0,7.0,9.0,12.0,13.0,11.0,12.0,9.0,12.0,15.0,6.0,14.0,2.0,11.0,11.0,6.0,12.0,13.0,15.0,14.0,5.0,13.0,12.0,20.0,12.0,10.0,13.0,9.0,12.0,6.0,1.0,14.0,12.0,17.0,13.0,15.0,13.0,11.0,6.0,29.0,2.0,0.0,0.0,0.0,185.0,75.0,2.0,3.0,3.0,3.0,2.0,3.0,2.0,1.0,3.0,1.0,2.0,4.0,10.0,8.0,6.0,10.0,6.0,14.0,7.0,7.0,14.0,11.0,6.0,14.0,9.0,13.0,13.0,14.0,11.0,12.0,12.0,12.0,14.0,8.0,11.0,12.0,13.0,13.0,13.0,15.0,12.0,15.0,12.0,8.0,15.0,13.0,20.0,14.0,15.0,14.0,7.0,14.0,8.0,6.0,14.0,13.0,15.0,14.0,14.0,14.0,14.0,6.0,28.0,0.0,0.0,0.0,0.0,193.0,84.0,1.0,1.0,2.0,2.0,2.0,3.0,2.0,3.0,2.0,1.0,3.0,4.0,8.0,8.0,9.0,10.0,6.0,14.0,7.0,8.0,14.0,12.0,6.0,14.0,11.0,12.0,13.0,14.0,11.0,14.0,12.0,12.0,14.0,6.0,11.0,8.0,14.0,13.0,13.0,11.0,11.0,16.0,16.0,20.0,12.0,12.0,8.0,14.0,16.0,14.0,12.0,13.0,6.0,10.0,7.0,12.0,15.0,12.0,16.0,15.0,13.0,6.0,31.0,4.0,0.0,0.0,0.0,173.0,73.0,2.0,3.0,2.0,2.0,4.0,2.0,3.0,1.0,1.0,2.0,4.0,7.0,13.0,9.0,6.0,11.0,10.0,6.0,8.0,11.0,12.0,13.0,8.0,13.0,11.0,11.0,12.0,13.0,10.0,12.0,8.0,8.0,16.0,11.0,6.0,12.0,8.0,12.0,14.0,14.0,13.0,12.0,7.0,8.0,15.0,14.0,20.0,14.0,14.0,12.0,11.0,13.0,8.0,16.0,7.0,13.0,14.0,12.0,14.0,16.0,16.0,6.0,26.0,0.0,0.0,0.0,0.0,175.0,69.0,3.0,3.0,2.0,2.0,3.0,1.0,3.0,1.0,3.0,2.0,2.0,6.0,12.0,10.0,5.0,11.0,6.0,10.0,10.0,10.0,13.0,12.0,9.0,13.0,12.0,12.0,13.0,14.0,12.0,13.0,12.0,11.0,15.0,11.0,13.0,12.0,13.0,14.0,14.0,15.0,13.0,12.0,7.0,9.0,13.0,13.0,20.0,14.0,11.0,14.0,12.0,12.0,11.0,15.0,14.0,9.0,17.0,10.0,8.0,11.0,20.0,7.0,29.0,0.0,0.0,0.0,0.0,183.0,78.0,1.0,3.0,3.0,3.0,3.0,1.0,2.0,3.0,3.0,1.0,1.0,13.0,8.0,9.0,6.0,12.0,14.0,13.0,10.0,12.0,11.0,12.0,8.0,13.0,12.0,12.0,15.0,13.0,13.0,13.0,11.0,13.0,15.0,6.0,12.0,7.0,13.0,16.0,18.0,12.0,11.0,14.0,12.0,20.0,14.0,11.0,8.0,16.0,14.0,14.0,12.0,14.0,6.0,12.0,10.0,12.0,13.0,11.0,15.0,15.0,15.0,5.0,30.0,9.0,1.0,0.0,0.0,192.0,90.0,2.0,2.0,2.0,2.0,3.0,1.0,3.0,4.0,1.0,1.0,3.0,4.0,7.0,10.0,10.0,9.0,8.0,17.0,12.0,6.0,13.0,12.0,8.0,12.0,11.0,13.0,14.0,15.0,13.0,13.0,10.0,12.0,14.0,12.0,13.0,13.0,12.0,14.0,16.0,12.0,12.0,18.0,16.0,8.0,14.0,13.0,20.0,16.0,18.0,13.0,13.0,14.0,7.0,12.0,13.0,13.0,13.0,13.0,13.0,13.0,13.0,6.0,21.0,0.0,0.0,0.0,0.0,183.0,73.0,1.0,4.0,3.0,3.0,3.0,1.0,4.0,1.0,2.0,3.0,2.0,11.0,10.0,12.0,11.0,13.0,9.0,12.0,10.0,5.0,8.0,12.0,9.0,8.0,13.0,13.0,12.0,12.0,10.0,12.0,14.0,12.0,12.0,14.0,8.0,12.0,8.0,12.0,12.0,14.0,14.0,14.0,11.0,8.0,13.0,13.0,20.0,12.0,12.0,12.0,5.0,10.0,7.0,12.0,15.0,11.0,11.0,10.0,11.0,12.0,11.0,4.0,20.0,0.0,0.0,0.0,0.0,173.0,67.0,2.0,2.0,4.0,3.0,3.0,2.0,3.0,3.0,2.0,1.0,1.0,11.0,12.0,12.0,9.0,12.0,8.0,5.0,10.0,7.0,4.0,8.0,10.0,4.0,14.0,12.0,7.0,11.0,8.0,6.0,10.0,10.0,3.0,11.0,5.0,10.0,11.0,8.0,13.0,15.0,14.0,14.0,6.0,5.0,14.0,15.0,20.0,12.0,8.0,10.0,5.0,10.0,10.0,10.0,17.0,12.0,12.0,10.0,7.0,10.0,19.0,8.0,23.0,1.0,0.0,0.0,0.0,192.0,80.0,3.0,3.0,3.0,2.0,3.0,1.0,3.0,3.0,1.0,2.0,2.0,4.0,6.0,12.0,13.0,12.0,7.0,13.0,12.0,5.0,5.0,9.0,11.0,5.0,12.0,13.0,12.0,13.0,12.0,13.0,9.0,13.0,4.0,11.0,8.0,13.0,7.0,9.0,12.0,14.0,13.0,15.0,16.0,20.0,14.0,13.0,8.0,13.0,15.0,12.0,11.0,11.0,7.0,5.0,14.0,13.0,14.0,11.0,9.0,9.0,18.0,3.0,23.0,1.0,0.0,0.0,0.0,185.0,70.0,4.0,3.0,1.0,2.0,1.0,3.0,2.0,3.0,1.0,2.0,3.0,5.0,8.0,12.0,13.0,13.0,7.0,14.0,11.0,5.0,5.0,8.0,13.0,5.0,13.0,6.0,13.0,10.0,12.0,12.0,11.0,11.0,13.0,12.0,7.0,13.0,9.0,8.0,10.0,16.0,12.0,14.0,12.0,8.0,14.0,15.0,20.0,13.0,13.0,12.0,7.0,15.0,7.0,7.0,13.0,13.0,12.0,10.0,12.0,15.0,15.0,7.0
2,1,31.0,25.0,0.0,6.0,0.0,191.0,84.0,11.0,14.0,13.0,12.0,15.0,14.0,15.0,16.0,13.0,14.0,14.0,8.0,2.0,10.0,5.0,11.0,11.0,7.0,10.0,2.0,5.0,10.0,11.0,11.0,9.0,12.0,13.0,15.0,13.0,13.0,8.0,13.0,16.0,12.0,14.0,1.0,16.0,13.0,11.0,12.0,13.0,16.0,16.0,8.0,16.0,13.0,20.0,15.0,15.0,17.0,8.0,15.0,7.0,2.0,15.0,15.0,17.0,15.0,17.0,16.0,15.0,6.0,23.0,0.0,0.0,0.0,0.0,184.0,77.0,1.0,1.0,1.0,1.0,3.0,2.0,3.0,2.0,2.0,2.0,3.0,6.0,9.0,11.0,7.0,12.0,7.0,15.0,9.0,11.0,14.0,13.0,10.0,15.0,12.0,14.0,15.0,15.0,13.0,12.0,11.0,13.0,15.0,11.0,9.0,9.0,14.0,14.0,14.0,14.0,13.0,15.0,13.0,9.0,16.0,15.0,20.0,14.0,14.0,14.0,11.0,14.0,4.0,11.0,14.0,13.0,15.0,14.0,16.0,14.0,15.0,6.0,28.0,46.0,3.0,14.0,3.0,190.0,80.0,2.0,3.0,3.0,2.0,2.0,1.0,1.0,3.0,1.0,3.0,1.0,4.0,6.0,7.0,9.0,11.0,7.0,17.0,11.0,10.0,15.0,12.0,11.0,16.0,10.0,17.0,15.0,18.0,13.0,14.0,12.0,14.0,18.0,6.0,17.0,8.0,15.0,15.0,14.0,11.0,10.0,17.0,16.0,7.0,17.0,13.0,20.0,15.0,18.0,17.0,14.0,16.0,4.0,6.0,14.0,15.0,16.0,17.0,18.0,14.0,15.0,6.0,21.0,0.0,0.0,9.0,0.0,185.0,75.0,1.0,1.0,2.0,2.0,2.0,1.0,1.0,4.0,2.0,3.0,2.0,11.0,15.0,14.0,7.0,13.0,9.0,11.0,11.0,14.0,13.0,13.0,10.0,14.0,13.0,15.0,12.0,13.0,10.0,11.0,11.0,12.0,14.0,11.0,10.0,14.0,12.0,13.0,15.0,15.0,13.0,14.0,13.0,20.0,14.0,16.0,8.0,15.0,15.0,13.0,13.0,12.0,9.0,10.0,14.0,14.0,13.0,12.0,12.0,13.0,9.0,9.0,23.0,0.0,0.0,1.0,0.0,182.0,71.0,3.0,1.0,2.0,3.0,4.0,2.0,3.0,1.0,2.0,1.0,3.0,9.0,13.0,14.0,8.0,14.0,13.0,12.0,10.0,13.0,14.0,14.0,13.0,15.0,13.0,14.0,14.0,13.0,11.0,12.0,12.0,13.0,16.0,12.0,12.0,15.0,13.0,14.0,15.0,15.0,13.0,14.0,12.0,9.0,16.0,15.0,20.0,15.0,15.0,15.0,10.0,14.0,6.0,12.0,8.0,15.0,14.0,16.0,15.0,15.0,16.0,6.0,29.0,90.0,4.0,16.0,2.0,170.0,61.0,2.0,3.0,3.0,1.0,3.0,1.0,2.0,2.0,2.0,2.0,1.0,15.0,14.0,15.0,9.0,17.0,16.0,7.0,12.0,4.0,11.0,18.0,15.0,12.0,17.0,15.0,15.0,16.0,13.0,16.0,17.0,14.0,16.0,15.0,14.0,12.0,14.0,18.0,16.0,13.0,14.0,12.0,8.0,10.0,14.0,11.0,20.0,14.0,10.0,14.0,9.0,17.0,10.0,14.0,13.0,17.0,15.0,16.0,17.0,15.0,16.0,7.0,31.0,0.0,0.0,6.0,0.0,174.0,80.0,1.0,1.0,1.0,1.0,1.0,5.0,1.0,1.0,1.0,1.0,1.0,14.0,12.0,11.0,7.0,12.0,13.0,9.0,7.0,10.0,11.0,11.0,10.0,10.0,12.0,11.0,11.0,11.0,10.0,6.0,10.0,9.0,12.0,12.0,12.0,10.0,12.0,12.0,14.0,12.0,15.0,10.0,9.0,20.0,12.0,12.0,7.0,12.0,9.0,9.0,10.0,12.0,7.0,9.0,11.0,14.0,9.0,7.0,14.0,8.0,9.0,9.0,20.0,0.0,0.0,7.0,1.0,170.0,58.0,1.0,2.0,2.0,2.0,2.0,2.0,2.0,4.0,1.0,3.0,2.0,16.0,14.0,16.0,13.0,16.0,17.0,5.0,14.0,2.0,6.0,15.0,13.0,4.0,17.0,9.0,12.0,14.0,12.0,12.0,14.0,13.0,15.0,16.0,7.0,13.0,9.0,13.0,15.0,15.0,16.0,11.0,7.0,20.0,14.0,15.0,8.0,14.0,8.0,15.0,5.0,15.0,7.0,16.0,15.0,15.0,15.0,14.0,16.0,18.0,16.0,3.0,21.0,7.0,0.0,14.0,6.0,173.0,64.0,3.0,2.0,3.0,2.0,3.0,3.0,3.0,2.0,3.0,3.0,3.0,14.0,14.0,18.0,14.0,17.0,14.0,7.0,11.0,2.0,6.0,15.0,14.0,6.0,18.0,12.0,14.0,14.0,15.0,13.0,16.0,14.0,17.0,17.0,12.0,13.0,9.0,13.0,17.0,15.0,17.0,13.0,7.0,20.0,14.0,14.0,9.0,14.0,9.0,15.0,7.0,16.0,7.0,14.0,15.0,17.0,15.0,16.0,17.0,16.0,15.0,4.0,26.0,0.0,0.0,4.0,0.0,180.0,73.0,2.0,3.0,1.0,4.0,2.0,3.0,3.0,1.0,1.0,4.0,1.0,11.0,13.0,13.0,14.0,14.0,11.0,15.0,12.0,3.0,7.0,14.0,14.0,8.0,13.0,12.0,14.0,17.0,13.0,15.0,14.0,14.0,16.0,12.0,15.0,16.0,12.0,18.0,16.0,13.0,14.0,13.0,12.0,8.0,14.0,13.0,20.0,15.0,12.0,15.0,8.0,14.0,7.0,15.0,19.0,14.0,17.0,14.0,18.0,16.0,16.0,5.0,17.0,0.0,0.0,0.0,0.0,178.0,68.0,2.0,1.0,2.0,1.0,3.0,3.0,3.0,1.0,3.0,3.0,2.0,10.0,11.0,15.0,12.0,13.0,10.0,8.0,9.0,2.0,3.0,12.0,12.0,3.0,16.0,11.0,9.0,11.0,12.0,9.0,12.0,10.0,17.0,17.0,9.0,13.0,5.0,9.0,13.0,15.0,14.0,11.0,9.0,8.0,14.0,14.0,20.0,12.0,9.0,14.0,7.0,15.0,7.0,13.0,13.0,19.0,12.0,16.0,15.0,14.0,14.0,7.0,34.0,1.0,0.0,0.0,0.0,187.0,87.0,13.0,14.0,15.0,7.0,13.0,11.0,14.0,15.0,11.0,17.0,12.0,2.0,1.0,1.0,3.0,8.0,7.0,2.0,1.0,2.0,1.0,9.0,8.0,2.0,6.0,12.0,15.0,17.0,14.0,15.0,8.0,13.0,17.0,7.0,14.0,6.0,14.0,12.0,6.0,7.0,13.0,14.0,13.0,8.0,13.0,8.0,20.0,11.0,16.0,14.0,10.0,14.0,6.0,1.0,12.0,12.0,15.0,16.0,16.0,14.0,15.0,6.0,31.0,2.0,0.0,0.0,0.0,187.0,83.0,3.0,1.0,3.0,1.0,3.0,2.0,1.0,3.0,3.0,1.0,1.0,8.0,11.0,10.0,8.0,11.0,8.0,15.0,8.0,13.0,14.0,11.0,11.0,14.0,8.0,16.0,13.0,15.0,14.0,12.0,5.0,12.0,13.0,9.0,9.0,11.0,14.0,12.0,13.0,13.0,8.0,16.0,14.0,5.0,14.0,13.0,20.0,12.0,14.0,14.0,15.0,12.0,5.0,8.0,12.0,14.0,11.0,11.0,14.0,12.0,13.0,5.0,28.0,0.0,0.0,0.0,0.0,190.0,85.0,3.0,2.0,3.0,3.0,2.0,2.0,2.0,4.0,3.0,1.0,2.0,5.0,9.0,8.0,9.0,8.0,7.0,14.0,10.0,9.0,15.0,9.0,6.0,14.0,9.0,16.0,13.0,16.0,10.0,13.0,10.0,12.0,15.0,6.0,13.0,7.0,13.0,14.0,16.0,12.0,11.0,17.0,13.0,20.0,15.0,13.0,8.0,15.0,15.0,12.0,14.0,14.0,9.0,8.0,14.0,13.0,14.0,11.0,12.0,13.0,16.0,14.0,29.0,0.0,0.0,0.0,0.0,182.0,76.0,1.0,4.0,2.0,3.0,1.0,1.0,1.0,2.0,2.0,1.0,1.0,7.0,12.0,11.0,9.0,11.0,12.0,7.0,12.0,8.0,12.0,13.0,8.0,12.0,13.0,14.0,12.0,14.0,10.0,13.0,12.0,12.0,13.0,15.0,8.0,11.0,12.0,13.0,13.0,11.0,12.0,11.0,12.0,20.0,10.0,11.0,10.0,14.0,11.0,13.0,11.0,10.0,11.0,10.0,14.0,15.0,13.0,9.0,14.0,12.0,13.0,6.0,26.0,0.0,0.0,0.0,0.0,176.0,70.0,2.0,1.0,4.0,3.0,3.0,3.0,1.0,3.0,3.0,2.0,1.0,10.0,11.0,11.0,6.0,13.0,9.0,5.0,12.0,11.0,13.0,13.0,7.0,14.0,13.0,15.0,11.0,14.0,12.0,11.0,9.0,12.0,13.0,9.0,9.0,13.0,12.0,15.0,14.0,12.0,16.0,12.0,7.0,20.0,13.0,13.0,10.0,15.0,11.0,13.0,14.0,13.0,11.0,9.0,8.0,9.0,17.0,12.0,14.0,14.0,15.0,3.0,26.0,0.0,0.0,0.0,0.0,184.0,76.0,3.0,1.0,3.0,1.0,3.0,2.0,3.0,2.0,1.0,1.0,3.0,10.0,11.0,13.0,9.0,13.0,12.0,13.0,10.0,6.0,11.0,13.0,9.0,14.0,12.0,12.0,13.0,12.0,12.0,11.0,13.0,12.0,13.0,13.0,10.0,12.0,13.0,12.0,16.0,15.0,13.0,15.0,13.0,20.0,15.0,14.0,5.0,16.0,15.0,13.0,12.0,14.0,5.0,12.0,18.0,14.0,10.0,7.0,11.0,11.0,13.0,10.0,34.0,103.0,7.0,16.0,1.0,182.0,72.0,2.0,1.0,1.0,1.0,3.0,1.0,4.0,3.0,3.0,2.0,1.0,11.0,13.0,12.0,8.0,15.0,13.0,9.0,13.0,6.0,8.0,15.0,12.0,8.0,15.0,11.0,14.0,13.0,15.0,15.0,14.0,16.0,17.0,15.0,14.0,11.0,13.0,17.0,13.0,8.0,11.0,10.0,11.0,16.0,13.0,8.0,20.0,12.0,10.0,15.0,11.0,12.0,12.0,15.0,14.0,12.0,15.0,15.0,18.0,14.0,14.0,7.0,20.0,0.0,0.0,0.0,0.0,173.0,66.0,1.0,1.0,1.0,1.0,1.0,2.0,3.0,1.0,3.0,3.0,4.0,15.0,13.0,13.0,10.0,15.0,12.0,5.0,13.0,5.0,7.0,15.0,12.0,7.0,15.0,10.0,10.0,13.0,12.0,10.0,16.0,13.0,18.0,14.0,7.0,14.0,12.0,14.0,14.0,8.0,14.0,13.0,7.0,14.0,12.0,9.0,20.0,12.0,13.0,12.0,8.0,15.0,6.0,12.0,12.0,14.0,14.0,14.0,15.0,14.0,11.0,6.0,19.0,0.0,0.0,11.0,1.0,171.0,65.0,2.0,2.0,2.0,2.0,2.0,3.0,3.0,3.0,1.0,1.0,3.0,14.0,13.0,13.0,11.0,14.0,15.0,8.0,12.0,6.0,4.0,13.0,12.0,4.0,15.0,8.0,12.0,10.0,12.0,8.0,13.0,13.0,14.0,15.0,8.0,14.0,6.0,13.0,12.0,15.0,16.0,10.0,7.0,20.0,13.0,15.0,10.0,12.0,7.0,11.0,6.0,11.0,8.0,11.0,12.0,13.0,11.0,12.0,12.0,6.0,12.0,5.0,22.0,0.0,0.0,0.0,0.0,181.0,81.0,2.0,3.0,2.0,1.0,3.0,3.0,4.0,2.0,1.0,1.0,2.0,5.0,11.0,12.0,14.0,12.0,6.0,13.0,10.0,5.0,4.0,12.0,12.0,4.0,13.0,8.0,12.0,13.0,12.0,12.0,11.0,11.0,15.0,14.0,5.0,14.0,10.0,13.0,15.0,13.0,12.0,14.0,10.0,20.0,15.0,12.0,14.0,13.0,14.0,13.0,8.0,12.0,5.0,14.0,8.0,12.0,12.0,9.0,13.0,12.0,14.0,7.0,20.0,7.0,1.0,0.0,0.0,182.0,75.0,2.0,1.0,3.0,2.0,2.0,1.0,3.0,1.0,3.0,2.0,1.0,11.0,11.0,13.0,12.0,13.0,11.0,12.0,10.0,5.0,4.0,12.0,8.0,5.0,13.0,11.0,12.0,11.0,11.0,8.0,10.0,10.0,3.0,10.0,1.0,13.0,8.0,12.0,12.0,15.0,14.0,13.0,11.0,6.0,14.0,13.0,20.0,12.0,13.0,12.0,9.0,11.0,9.0,11.0,9.0,9.0,9.0,12.0,11.0,9.0,17.0,7.0
5,0,26.0,2.0,0.0,1.0,0.0,188.0,84.0,12.0,13.0,15.0,9.0,15.0,13.0,13.0,15.0,10.0,11.0,14.0,9.0,2.0,1.0,2.0,12.0,11.0,3.0,2.0,3.0,3.0,11.0,3.0,1.0,10.0,14.0,13.0,14.0,10.0,13.0,11.0,11.0,14.0,3.0,11.0,5.0,12.0,15.0,13.0,10.0,12.0,13.0,14.0,5.0,14.0,9.0,20.0,12.0,14.0,12.0,10.0,15.0,3.0,11.0,12.0,11.0,16.0,13.0,15.0,16.0,16.0,4.0,29.0,0.0,0.0,0.0,0.0,183.0,74.0,3.0,3.0,3.0,3.0,3.0,2.0,2.0,2.0,1.0,3.0,1.0,5.0,12.0,7.0,6.0,10.0,7.0,14.0,12.0,5.0,14.0,12.0,6.0,13.0,11.0,14.0,13.0,17.0,13.0,16.0,12.0,12.0,13.0,9.0,8.0,9.0,14.0,14.0,15.0,13.0,12.0,15.0,12.0,6.0,17.0,11.0,20.0,17.0,13.0,14.0,14.0,15.0,5.0,13.0,9.0,14.0,19.0,15.0,14.0,11.0,11.0,6.0,32.0,0.0,0.0,0.0,0.0,183.0,79.0,1.0,1.0,1.0,3.0,1.0,3.0,1.0,1.0,2.0,1.0,1.0,5.0,10.0,6.0,6.0,9.0,6.0,15.0,7.0,11.0,14.0,10.0,7.0,13.0,10.0,13.0,15.0,15.0,15.0,14.0,9.0,13.0,16.0,6.0,14.0,8.0,12.0,13.0,16.0,11.0,12.0,16.0,11.0,8.0,16.0,12.0,20.0,15.0,14.0,14.0,11.0,12.0,5.0,15.0,18.0,15.0,14.0,13.0,17.0,14.0,14.0,5.0,22.0,0.0,0.0,0.0,0.0,178.0,73.0,3.0,2.0,2.0,1.0,2.0,4.0,3.0,1.0,3.0,1.0,2.0,6.0,12.0,12.0,6.0,11.0,7.0,8.0,8.0,11.0,12.0,10.0,8.0,13.0,11.0,12.0,12.0,13.0,11.0,10.0,11.0,11.0,13.0,6.0,7.0,12.0,9.0,13.0,14.0,16.0,14.0,13.0,9.0,6.0,14.0,15.0,20.0,15.0,14.0,12.0,12.0,13.0,6.0,14.0,12.0,15.0,13.0,13.0,14.0,14.0,14.0,6.0,27.0,0.0,0.0,0.0,0.0,178.0,72.0,2.0,3.0,2.0,3.0,2.0,3.0,3.0,1.0,1.0,2.0,1.0,13.0,14.0,11.0,7.0,12.0,10.0,9.0,10.0,13.0,13.0,12.0,10.0,14.0,13.0,12.0,14.0,14.0,13.0,14.0,11.0,12.0,14.0,13.0,8.0,14.0,13.0,13.0,15.0,15.0,13.0,10.0,10.0,20.0,13.0,15.0,6.0,14.0,10.0,13.0,13.0,12.0,8.0,12.0,15.0,14.0,13.0,14.0,13.0,13.0,12.0,6.0,27.0,0.0,0.0,0.0,0.0,188.0,77.0,1.0,4.0,1.0,1.0,3.0,1.0,2.0,1.0,2.0,2.0,2.0,4.0,7.0,8.0,7.0,13.0,6.0,15.0,9.0,6.0,13.0,12.0,6.0,12.0,11.0,14.0,14.0,15.0,10.0,12.0,11.0,13.0,16.0,7.0,12.0,9.0,12.0,15.0,16.0,14.0,10.0,14.0,15.0,9.0,13.0,12.0,20.0,14.0,16.0,12.0,14.0,13.0,6.0,12.0,4.0,13.0,18.0,13.0,14.0,14.0,13.0,7.0,32.0,0.0,0.0,13.0,0.0,175.0,65.0,2.0,1.0,1.0,2.0,3.0,3.0,1.0,2.0,3.0,2.0,3.0,15.0,13.0,11.0,6.0,14.0,13.0,10.0,12.0,8.0,8.0,16.0,8.0,12.0,13.0,11.0,14.0,15.0,14.0,15.0,14.0,14.0,14.0,6.0,13.0,9.0,15.0,18.0,13.0,12.0,13.0,13.0,8.0,8.0,13.0,10.0,20.0,13.0,13.0,12.0,11.0,15.0,12.0,10.0,17.0,14.0,15.0,14.0,16.0,14.0,14.0,6.0,20.0,0.0,0.0,2.0,0.0,180.0,75.0,3.0,1.0,2.0,2.0,3.0,2.0,1.0,1.0,3.0,3.0,1.0,8.0,13.0,14.0,9.0,13.0,8.0,10.0,9.0,6.0,5.0,12.0,6.0,5.0,14.0,8.0,13.0,12.0,13.0,12.0,12.0,12.0,7.0,13.0,8.0,14.0,7.0,12.0,13.0,15.0,13.0,14.0,10.0,8.0,14.0,15.0,20.0,13.0,12.0,13.0,11.0,9.0,7.0,13.0,9.0,11.0,11.0,11.0,12.0,11.0,10.0,1.0,18.0,0.0,0.0,0.0,0.0,179.0,67.0,3.0,3.0,2.0,4.0,2.0,4.0,3.0,1.0,3.0,4.0,1.0,5.0,7.0,12.0,9.0,12.0,12.0,10.0,12.0,6.0,4.0,12.0,12.0,3.0,14.0,11.0,12.0,11.0,11.0,8.0,13.0,12.0,12.0,12.0,6.0,12.0,5.0,10.0,12.0,15.0,11.0,12.0,10.0,20.0,13.0,14.0,8.0,14.0,8.0,9.0,6.0,14.0,5.0,10.0,16.0,13.0,12.0,12.0,13.0,9.0,15.0,2.0,25.0,0.0,0.0,0.0,0.0,176.0,74.0,2.0,2.0,1.0,3.0,2.0,2.0,2.0,4.0,3.0,3.0,3.0,12.0,12.0,14.0,12.0,14.0,13.0,7.0,12.0,6.0,3.0,12.0,12.0,3.0,15.0,9.0,10.0,8.0,12.0,11.0,12.0,10.0,10.0,14.0,5.0,13.0,4.0,6.0,8.0,17.0,15.0,12.0,8.0,20.0,12.0,14.0,8.0,13.0,12.0,11.0,9.0,14.0,10.0,8.0,8.0,14.0,12.0,7.0,10.0,11.0,11.0,9.0,30.0,5.0,0.0,22.0,9.0,181.0,84.0,2.0,3.0,3.0,1.0,2.0,3.0,3.0,1.0,3.0,1.0,3.0,7.0,10.0,12.0,13.0,11.0,7.0,13.0,10.0,12.0,6.0,11.0,13.0,6.0,13.0,17.0,13.0,16.0,11.0,13.0,11.0,11.0,17.0,14.0,8.0,14.0,9.0,13.0,17.0,15.0,12.0,15.0,11.0,8.0,14.0,15.0,20.0,14.0,14.0,13.0,9.0,13.0,7.0,10.0,7.0,16.0,13.0,14.0,13.0,15.0,15.0,10.0,31.0,0.0,0.0,2.0,0.0,185.0,81.0,11.0,11.0,12.0,7.0,12.0,10.0,12.0,13.0,12.0,13.0,8.0,3.0,1.0,2.0,3.0,8.0,8.0,3.0,12.0,3.0,1.0,7.0,1.0,2.0,8.0,8.0,12.0,12.0,11.0,13.0,6.0,12.0,14.0,6.0,12.0,1.0,11.0,11.0,8.0,12.0,13.0,14.0,12.0,4.0,16.0,10.0,20.0,12.0,13.0,11.0,8.0,15.0,5.0,1.0,14.0,12.0,10.0,11.0,14.0,15.0,15.0,7.0,26.0,11.0,0.0,0.0,0.0,180.0,81.0,3.0,2.0,2.0,3.0,3.0,2.0,1.0,2.0,2.0,1.0,2.0,5.0,9.0,8.0,5.0,11.0,5.0,13.0,10.0,8.0,15.0,10.0,7.0,13.0,10.0,15.0,14.0,17.0,11.0,12.0,9.0,12.0,16.0,8.0,10.0,8.0,13.0,14.0,15.0,13.0,12.0,14.0,12.0,20.0,14.0,12.0,8.0,14.0,14.0,14.0,10.0,15.0,13.0,8.0,9.0,14.0,17.0,13.0,13.0,13.0,11.0,8.0,24.0,0.0,0.0,4.0,0.0,186.0,88.0,1.0,2.0,1.0,3.0,2.0,1.0,1.0,2.0,1.0,2.0,1.0,4.0,8.0,8.0,6.0,12.0,6.0,14.0,9.0,11.0,14.0,12.0,6.0,12.0,12.0,14.0,13.0,14.0,12.0,13.0,8.0,12.0,13.0,8.0,8.0,9.0,12.0,12.0,13.0,13.0,11.0,15.0,13.0,8.0,15.0,14.0,20.0,14.0,15.0,13.0,14.0,15.0,8.0,12.0,14.0,14.0,12.0,9.0,12.0,13.0,13.0,8.0,32.0,0.0,0.0,0.0,0.0,165.0,65.0,1.0,2.0,3.0,1.0,3.0,1.0,3.0,2.0,1.0,4.0,4.0,7.0,12.0,10.0,5.0,13.0,8.0,9.0,8.0,11.0,13.0,12.0,10.0,14.0,11.0,14.0,13.0,15.0,12.0,12.0,8.0,11.0,14.0,5.0,8.0,7.0,10.0,15.0,17.0,14.0,13.0,14.0,4.0,10.0,13.0,13.0,20.0,15.0,12.0,14.0,5.0,13.0,7.0,8.0,7.0,12.0,17.0,13.0,15.0,13.0,13.0,7.0,28.0,22.0,0.0,20.0,1.0,176.0,74.0,2.0,3.0,2.0,1.0,1.0,1.0,3.0,3.0,2.0,2.0,1.0,15.0,15.0,12.0,8.0,13.0,12.0,5.0,11.0,15.0,10.0,13.0,9.0,10.0,12.0,10.0,11.0,10.0,13.0,12.0,11.0,12.0,11.0,11.0,7.0,13.0,10.0,14.0,15.0,15.0,14.0,10.0,8.0,20.0,13.0,14.0,8.0,15.0,8.0,14.0,5.0,12.0,5.0,14.0,15.0,15.0,10.0,14.0,13.0,12.0,12.0,2.0,27.0,32.0,6.0,0.0,0.0,188.0,78.0,3.0,2.0,3.0,2.0,1.0,3.0,3.0,3.0,2.0,2.0,2.0,4.0,8.0,11.0,12.0,12.0,6.0,16.0,13.0,8.0,13.0,14.0,7.0,12.0,12.0,12.0,10.0,14.0,13.0,12.0,11.0,12.0,15.0,9.0,11.0,12.0,6.0,13.0,12.0,14.0,13.0,15.0,15.0,5.0,13.0,12.0,20.0,16.0,15.0,14.0,12.0,15.0,11.0,10.0,9.0,15.0,12.0,12.0,13.0,13.0,13.0,7.0,32.0,25.0,0.0,0.0,0.0,181.0,82.0,2.0,3.0,3.0,1.0,1.0,1.0,1.0,3.0,1.0,2.0,3.0,5.0,10.0,6.0,7.0,10.0,7.0,14.0,9.0,8.0,11.0,12.0,7.0,13.0,10.0,15.0,14.0,16.0,11.0,13.0,10.0,12.0,16.0,9.0,15.0,8.0,11.0,16.0,18.0,11.0,12.0,14.0,11.0,8.0,13.0,11.0,20.0,17.0,15.0,13.0,15.0,11.0,6.0,14.0,18.0,12.0,13.0,13.0,14.0,11.0,11.0,8.0,23.0,0.0,0.0,0.0,0.0,180.0,65.0,1.0,3.0,3.0,3.0,2.0,1.0,2.0,1.0,2.0,3.0,1.0,10.0,13.0,13.0,12.0,14.0,11.0,10.0,12.0,6.0,3.0,12.0,11.0,6.0,14.0,7.0,13.0,8.0,15.0,12.0,13.0,12.0,11.0,12.0,6.0,13.0,5.0,8.0,7.0,12.0,15.0,7.0,10.0,12.0,11.0,14.0,20.0,12.0,8.0,12.0,2.0,11.0,11.0,11.0,9.0,11.0,11.0,10.0,12.0,4.0,12.0,3.0,34.0,0.0,0.0,0.0,0.0,176.0,65.0,2.0,3.0,3.0,3.0,2.0,2.0,1.0,2.0,1.0,1.0,2.0,14.0,15.0,13.0,10.0,15.0,13.0,6.0,15.0,10.0,3.0,14.0,13.0,6.0,14.0,8.0,12.0,9.0,13.0,12.0,14.0,13.0,11.0,12.0,7.0,13.0,8.0,14.0,15.0,14.0,13.0,12.0,8.0,20.0,14.0,13.0,10.0,12.0,7.0,13.0,8.0,15.0,7.0,6.0,13.0,14.0,14.0,9.0,14.0,14.0,11.0,10.0,22.0,0.0,0.0,3.0,0.0,172.0,73.0,2.0,3.0,1.0,1.0,3.0,3.0,2.0,1.0,2.0,3.0,2.0,6.0,13.0,13.0,11.0,13.0,7.0,10.0,11.0,5.0,5.0,10.0,11.0,3.0,13.0,8.0,12.0,9.0,10.0,8.0,12.0,12.0,13.0,13.0,5.0,11.0,7.0,8.0,8.0,15.0,16.0,15.0,7.0,8.0,14.0,16.0,20.0,12.0,11.0,11.0,8.0,13.0,8.0,7.0,13.0,14.0,13.0,12.0,10.0,15.0,15.0,9.0,19.0,0.0,0.0,0.0,0.0,173.0,67.0,3.0,2.0,4.0,2.0,1.0,1.0,3.0,1.0,1.0,1.0,2.0,13.0,13.0,15.0,10.0,14.0,11.0,6.0,12.0,4.0,4.0,12.0,11.0,5.0,14.0,10.0,12.0,9.0,10.0,8.0,12.0,8.0,11.0,15.0,5.0,12.0,6.0,8.0,10.0,16.0,15.0,13.0,7.0,8.0,13.0,15.0,20.0,11.0,9.0,12.0,6.0,12.0,6.0,15.0,8.0,13.0,8.0,12.0,9.0,14.0,13.0,9.0
4,0,25.0,4.0,0.0,11.0,0.0,184.0,81.0,14.0,14.0,13.0,9.0,15.0,12.0,16.0,16.0,13.0,7.0,11.0,8.0,1.0,2.0,1.0,11.0,12.0,6.0,1.0,3.0,3.0,11.0,5.0,3.0,11.0,8.0,15.0,15.0,13.0,14.0,10.0,11.0,14.0,8.0,13.0,5.0,13.0,10.0,10.0,14.0,16.0,14.0,13.0,20.0,14.0,12.0,5.0,14.0,14.0,15.0,9.0,16.0,6.0,1.0,17.0,11.0,15.0,13.0,14.0,12.0,12.0,4.0,20.0,1.0,0.0,10.0,0.0,183.0,73.0,2.0,4.0,4.0,2.0,1.0,2.0,2.0,3.0,3.0,3.0,3.0,8.0,9.0,10.0,6.0,14.0,7.0,12.0,5.0,9.0,14.0,12.0,9.0,15.0,13.0,11.0,15.0,13.0,14.0,13.0,12.0,10.0,16.0,13.0,11.0,9.0,14.0,13.0,13.0,12.0,12.0,13.0,13.0,10.0,13.0,13.0,20.0,13.0,12.0,12.0,11.0,8.0,7.0,10.0,17.0,14.0,8.0,14.0,14.0,5.0,15.0,7.0,27.0,4.0,0.0,5.0,1.0,184.0,83.0,2.0,4.0,3.0,1.0,1.0,2.0,1.0,2.0,4.0,2.0,3.0,4.0,8.0,11.0,4.0,10.0,4.0,14.0,4.0,4.0,15.0,12.0,5.0,16.0,11.0,14.0,14.0,16.0,14.0,10.0,11.0,12.0,17.0,7.0,10.0,9.0,13.0,14.0,15.0,14.0,13.0,16.0,13.0,10.0,15.0,13.0,20.0,15.0,16.0,12.0,12.0,14.0,6.0,12.0,11.0,13.0,12.0,12.0,16.0,15.0,14.0,6.0,32.0,0.0,0.0,0.0,0.0,172.0,71.0,2.0,1.0,3.0,1.0,2.0,3.0,2.0,3.0,2.0,2.0,2.0,8.0,9.0,7.0,6.0,10.0,6.0,10.0,9.0,10.0,14.0,11.0,6.0,14.0,11.0,10.0,16.0,15.0,12.0,12.0,7.0,12.0,15.0,9.0,13.0,8.0,14.0,15.0,15.0,14.0,14.0,14.0,10.0,20.0,14.0,14.0,8.0,15.0,13.0,13.0,11.0,13.0,7.0,13.0,17.0,14.0,17.0,8.0,13.0,15.0,15.0,6.0,32.0,11.0,1.0,0.0,0.0,176.0,68.0,2.0,1.0,3.0,2.0,2.0,2.0,2.0,3.0,3.0,2.0,2.0,8.0,10.0,10.0,7.0,11.0,8.0,10.0,11.0,12.0,11.0,13.0,12.0,14.0,12.0,9.0,14.0,15.0,13.0,12.0,11.0,12.0,17.0,8.0,14.0,14.0,11.0,18.0,18.0,14.0,14.0,12.0,10.0,10.0,14.0,13.0,20.0,17.0,13.0,15.0,9.0,13.0,8.0,13.0,17.0,13.0,15.0,16.0,16.0,16.0,18.0,5.0,19.0,0.0,0.0,3.0,1.0,181.0,69.0,3.0,2.0,3.0,3.0,2.0,1.0,1.0,1.0,3.0,3.0,4.0,10.0,10.0,12.0,12.0,12.0,7.0,8.0,11.0,5.0,7.0,10.0,10.0,7.0,11.0,8.0,10.0,10.0,12.0,8.0,11.0,8.0,14.0,13.0,6.0,14.0,8.0,13.0,13.0,16.0,14.0,13.0,9.0,20.0,15.0,16.0,10.0,15.0,13.0,12.0,8.0,11.0,7.0,12.0,11.0,11.0,15.0,10.0,12.0,14.0,14.0,1.0,27.0,8.0,0.0,6.0,0.0,187.0,76.0,3.0,2.0,3.0,2.0,2.0,1.0,1.0,3.0,3.0,1.0,2.0,5.0,7.0,11.0,5.0,14.0,5.0,14.0,9.0,5.0,15.0,15.0,8.0,14.0,13.0,15.0,16.0,15.0,14.0,12.0,14.0,14.0,18.0,8.0,17.0,9.0,12.0,18.0,15.0,13.0,14.0,15.0,14.0,10.0,17.0,12.0,20.0,17.0,15.0,14.0,13.0,16.0,4.0,12.0,10.0,14.0,17.0,12.0,15.0,13.0,13.0,6.0,24.0,0.0,0.0,6.0,1.0,172.0,70.0,3.0,1.0,1.0,3.0,1.0,2.0,3.0,1.0,1.0,3.0,3.0,11.0,12.0,11.0,8.0,12.0,10.0,6.0,14.0,7.0,11.0,15.0,8.0,12.0,13.0,14.0,14.0,18.0,13.0,12.0,13.0,13.0,15.0,12.0,12.0,12.0,11.0,18.0,18.0,13.0,14.0,13.0,7.0,10.0,16.0,12.0,20.0,14.0,12.0,14.0,14.0,15.0,4.0,8.0,7.0,14.0,14.0,13.0,14.0,12.0,10.0,6.0,22.0,0.0,0.0,4.0,0.0,180.0,80.0,4.0,1.0,1.0,3.0,2.0,3.0,1.0,3.0,3.0,3.0,4.0,7.0,10.0,11.0,8.0,15.0,11.0,10.0,14.0,5.0,14.0,15.0,10.0,15.0,15.0,13.0,14.0,13.0,12.0,14.0,15.0,13.0,16.0,12.0,8.0,15.0,13.0,13.0,13.0,13.0,13.0,12.0,10.0,12.0,12.0,12.0,20.0,13.0,12.0,13.0,10.0,12.0,7.0,11.0,12.0,15.0,12.0,16.0,15.0,10.0,10.0,7.0,22.0,24.0,3.0,7.0,0.0,177.0,78.0,2.0,1.0,2.0,3.0,2.0,2.0,4.0,3.0,3.0,2.0,1.0,10.0,13.0,16.0,14.0,16.0,16.0,8.0,16.0,4.0,4.0,15.0,12.0,4.0,16.0,12.0,11.0,12.0,13.0,10.0,11.0,8.0,13.0,17.0,5.0,14.0,5.0,10.0,12.0,15.0,14.0,13.0,9.0,10.0,17.0,16.0,20.0,15.0,14.0,12.0,11.0,15.0,4.0,12.0,19.0,16.0,14.0,14.0,11.0,13.0,10.0,12.0,22.0,5.0,1.0,1.0,0.0,173.0,72.0,1.0,3.0,1.0,3.0,3.0,3.0,3.0,3.0,3.0,2.0,2.0,14.0,13.0,16.0,14.0,16.0,14.0,5.0,11.0,5.0,5.0,15.0,11.0,5.0,16.0,8.0,13.0,9.0,14.0,13.0,15.0,13.0,15.0,16.0,5.0,13.0,5.0,9.0,10.0,15.0,16.0,14.0,5.0,20.0,14.0,15.0,5.0,12.0,14.0,13.0,11.0,13.0,8.0,14.0,10.0,15.0,14.0,10.0,13.0,10.0,10.0,13.0,17.0,0.0,0.0,0.0,0.0,193.0,82.0,13.0,11.0,12.0,2.0,12.0,10.0,14.0,15.0,14.0,12.0,10.0,3.0,1.0,1.0,3.0,5.0,6.0,2.0,2.0,1.0,3.0,9.0,3.0,1.0,8.0,7.0,12.0,13.0,13.0,13.0,11.0,11.0,15.0,3.0,8.0,3.0,12.0,12.0,11.0,10.0,12.0,14.0,17.0,5.0,15.0,11.0,20.0,13.0,12.0,13.0,8.0,11.0,5.0,11.0,13.0,15.0,15.0,17.0,14.0,15.0,15.0,5.0,23.0,0.0,0.0,0.0,0.0,180.0,77.0,2.0,1.0,3.0,2.0,3.0,2.0,2.0,2.0,3.0,1.0,2.0,6.0,11.0,11.0,6.0,13.0,7.0,11.0,5.0,8.0,14.0,12.0,9.0,12.0,9.0,15.0,14.0,17.0,10.0,14.0,8.0,13.0,14.0,7.0,8.0,7.0,10.0,13.0,15.0,15.0,13.0,13.0,10.0,5.0,14.0,14.0,20.0,15.0,14.0,14.0,15.0,6.0,7.0,11.0,18.0,13.0,14.0,15.0,13.0,12.0,14.0,2.0,23.0,0.0,0.0,0.0,0.0,196.0,88.0,1.0,3.0,1.0,1.0,3.0,3.0,2.0,3.0,1.0,2.0,3.0,4.0,7.0,6.0,10.0,10.0,4.0,16.0,7.0,10.0,13.0,11.0,5.0,13.0,10.0,14.0,13.0,13.0,8.0,12.0,6.0,12.0,11.0,5.0,9.0,6.0,10.0,14.0,9.0,13.0,12.0,13.0,17.0,7.0,12.0,15.0,20.0,14.0,15.0,13.0,13.0,12.0,7.0,10.0,7.0,14.0,12.0,7.0,10.0,14.0,14.0,10.0,19.0,0.0,0.0,0.0,0.0,194.0,92.0,2.0,1.0,3.0,3.0,3.0,3.0,1.0,3.0,3.0,2.0,1.0,3.0,3.0,5.0,6.0,10.0,5.0,16.0,10.0,8.0,12.0,9.0,4.0,15.0,11.0,14.0,11.0,12.0,10.0,11.0,10.0,12.0,15.0,3.0,13.0,13.0,12.0,14.0,14.0,11.0,8.0,15.0,17.0,5.0,16.0,12.0,20.0,12.0,16.0,12.0,13.0,12.0,5.0,7.0,10.0,14.0,13.0,8.0,10.0,11.0,18.0,6.0,26.0,4.0,0.0,2.0,0.0,180.0,74.0,3.0,3.0,1.0,2.0,2.0,1.0,3.0,4.0,1.0,2.0,1.0,8.0,13.0,13.0,6.0,13.0,9.0,12.0,7.0,11.0,13.0,13.0,11.0,12.0,12.0,16.0,14.0,14.0,9.0,12.0,11.0,13.0,4.0,4.0,6.0,11.0,12.0,8.0,12.0,14.0,14.0,13.0,9.0,20.0,16.0,13.0,5.0,15.0,13.0,12.0,6.0,9.0,10.0,12.0,8.0,14.0,8.0,11.0,12.0,11.0,13.0,2.0,22.0,25.0,0.0,0.0,0.0,180.0,75.0,2.0,3.0,1.0,1.0,4.0,3.0,1.0,1.0,4.0,2.0,2.0,11.0,13.0,14.0,10.0,12.0,9.0,12.0,9.0,13.0,13.0,12.0,9.0,13.0,12.0,13.0,12.0,14.0,13.0,12.0,10.0,11.0,5.0,8.0,6.0,10.0,12.0,13.0,15.0,15.0,14.0,13.0,10.0,20.0,14.0,14.0,5.0,15.0,13.0,12.0,13.0,6.0,7.0,11.0,14.0,11.0,12.0,12.0,14.0,9.0,11.0,5.0,19.0,0.0,0.0,0.0,0.0,184.0,78.0,3.0,1.0,2.0,1.0,2.0,2.0,2.0,3.0,3.0,4.0,2.0,6.0,8.0,9.0,5.0,13.0,6.0,11.0,8.0,5.0,13.0,13.0,8.0,12.0,13.0,13.0,13.0,15.0,12.0,12.0,13.0,12.0,14.0,7.0,11.0,8.0,15.0,14.0,15.0,13.0,12.0,14.0,11.0,5.0,15.0,12.0,20.0,16.0,14.0,13.0,12.0,11.0,7.0,10.0,19.0,13.0,15.0,12.0,14.0,13.0,12.0,6.0,28.0,0.0,0.0,0.0,0.0,180.0,79.0,3.0,2.0,3.0,3.0,2.0,2.0,2.0,1.0,3.0,2.0,3.0,8.0,11.0,15.0,12.0,15.0,12.0,7.0,10.0,7.0,8.0,13.0,13.0,6.0,16.0,11.0,11.0,10.0,13.0,10.0,15.0,12.0,3.0,15.0,6.0,13.0,13.0,12.0,12.0,15.0,16.0,14.0,8.0,12.0,12.0,14.0,20.0,12.0,12.0,13.0,6.0,13.0,6.0,6.0,8.0,9.0,13.0,10.0,12.0,12.0,2.0,2.0,24.0,0.0,0.0,0.0,0.0,182.0,82.0,3.0,3.0,2.0,1.0,1.0,3.0,2.0,2.0,3.0,2.0,2.0,4.0,7.0,13.0,14.0,13.0,12.0,14.0,12.0,5.0,7.0,10.0,14.0,6.0,15.0,13.0,13.0,16.0,8.0,12.0,11.0,11.0,12.0,14.0,7.0,13.0,8.0,12.0,13.0,14.0,14.0,15.0,12.0,10.0,10.0,12.0,20.0,16.0,15.0,12.0,13.0,14.0,10.0,8.0,8.0,13.0,5.0,10.0,11.0,9.0,9.0,13.0,32.0,0.0,0.0,0.0,0.0,183.0,67.0,1.0,2.0,3.0,2.0,3.0,2.0,3.0,1.0,2.0,2.0,2.0,4.0,12.0,11.0,6.0,5.0,5.0,4.0,8.0,11.0,13.0,11.0,5.0,13.0,11.0,11.0,11.0,12.0,11.0,11.0,9.0,12.0,11.0,12.0,10.0,12.0,11.0,12.0,12.0,14.0,13.0,13.0,8.0,8.0,13.0,13.0,20.0,14.0,14.0,10.0,12.0,11.0,8.0,11.0,11.0,10.0,10.0,12.0,11.0,9.0,10.0,12.0,20.0,0.0,0.0,8.0,0.0,170.0,65.0,3.0,1.0,1.0,3.0,2.0,3.0,2.0,2.0,2.0,1.0,3.0,10.0,10.0,13.0,13.0,13.0,10.0,9.0,10.0,3.0,4.0,11.0,12.0,4.0,13.0,12.0,12.0,14.0,11.0,11.0,11.0,11.0,15.0,12.0,7.0,14.0,7.0,12.0,15.0,16.0,16.0,12.0,7.0,7.0,14.0,15.0,20.0,14.0,11.0,13.0,9.0,13.0,8.0,12.0,9.0,13.0,14.0,14.0,15.0,15.0,14.0,6.0
1,0,20.0,0.0,0.0,3.0,0.0,193.0,80.0,10.0,12.0,12.0,9.0,11.0,11.0,13.0,15.0,13.0,7.0,12.0,7.0,1.0,1.0,2.0,8.0,11.0,1.0,2.0,1.0,2.0,11.0,2.0,1.0,8.0,4.0,14.0,14.0,11.0,9.0,11.0,12.0,12.0,2.0,15.0,1.0,13.0,11.0,6.0,12.0,13.0,15.0,16.0,20.0,15.0,10.0,6.0,13.0,14.0,12.0,11.0,11.0,10.0,1.0,11.0,9.0,12.0,12.0,13.0,10.0,10.0,1.0,24.0,0.0,0.0,0.0,0.0,184.0,89.0,2.0,3.0,3.0,2.0,2.0,3.0,3.0,1.0,2.0,3.0,2.0,4.0,10.0,8.0,6.0,11.0,9.0,14.0,9.0,7.0,14.0,11.0,6.0,11.0,11.0,13.0,12.0,16.0,11.0,13.0,10.0,11.0,14.0,6.0,8.0,7.0,12.0,13.0,14.0,14.0,12.0,16.0,12.0,20.0,14.0,13.0,6.0,14.0,16.0,14.0,13.0,13.0,7.0,8.0,7.0,14.0,13.0,12.0,14.0,14.0,14.0,6.0,24.0,0.0,0.0,0.0,0.0,175.0,68.0,4.0,3.0,3.0,4.0,1.0,3.0,2.0,2.0,3.0,3.0,1.0,8.0,12.0,11.0,7.0,11.0,8.0,9.0,12.0,13.0,11.0,11.0,7.0,12.0,13.0,12.0,11.0,14.0,12.0,11.0,10.0,12.0,14.0,6.0,8.0,13.0,12.0,14.0,14.0,13.0,13.0,10.0,6.0,12.0,14.0,13.0,20.0,14.0,9.0,13.0,6.0,12.0,5.0,15.0,15.0,10.0,10.0,13.0,14.0,15.0,13.0,4.0,32.0,19.0,0.0,9.0,0.0,185.0,85.0,2.0,3.0,2.0,1.0,2.0,1.0,1.0,2.0,2.0,3.0,3.0,5.0,10.0,9.0,8.0,11.0,11.0,15.0,13.0,9.0,15.0,12.0,10.0,14.0,11.0,14.0,15.0,16.0,12.0,11.0,9.0,11.0,17.0,7.0,12.0,9.0,15.0,13.0,10.0,9.0,9.0,15.0,13.0,10.0,13.0,11.0,20.0,13.0,15.0,12.0,15.0,12.0,13.0,10.0,11.0,13.0,11.0,13.0,18.0,15.0,13.0,5.0,32.0,23.0,0.0,0.0,0.0,178.0,77.0,3.0,2.0,3.0,1.0,3.0,1.0,3.0,2.0,1.0,3.0,1.0,9.0,12.0,12.0,6.0,13.0,12.0,10.0,10.0,10.0,13.0,12.0,7.0,14.0,13.0,15.0,14.0,13.0,13.0,10.0,10.0,12.0,5.0,12.0,11.0,12.0,13.0,14.0,14.0,14.0,13.0,12.0,9.0,20.0,14.0,14.0,10.0,13.0,12.0,13.0,6.0,14.0,6.0,10.0,13.0,5.0,11.0,8.0,10.0,14.0,9.0,15.0,31.0,0.0,0.0,0.0,0.0,180.0,74.0,3.0,2.0,3.0,1.0,2.0,3.0,2.0,1.0,4.0,3.0,3.0,12.0,12.0,10.0,9.0,13.0,14.0,11.0,13.0,6.0,10.0,14.0,15.0,13.0,13.0,15.0,14.0,17.0,12.0,14.0,13.0,13.0,15.0,7.0,13.0,10.0,13.0,18.0,15.0,9.0,11.0,14.0,10.0,10.0,13.0,12.0,20.0,15.0,14.0,14.0,13.0,15.0,8.0,7.0,19.0,13.0,13.0,13.0,13.0,13.0,12.0,9.0,27.0,27.0,1.0,2.0,1.0,183.0,72.0,2.0,2.0,2.0,1.0,2.0,1.0,3.0,1.0,2.0,2.0,4.0,5.0,8.0,10.0,6.0,11.0,10.0,14.0,11.0,5.0,14.0,12.0,10.0,15.0,11.0,14.0,13.0,16.0,11.0,11.0,9.0,10.0,12.0,8.0,12.0,8.0,13.0,14.0,14.0,14.0,12.0,16.0,11.0,8.0,12.0,13.0,20.0,15.0,15.0,10.0,14.0,11.0,7.0,11.0,13.0,13.0,9.0,9.0,11.0,10.0,10.0,8.0,23.0,5.0,0.0,0.0,0.0,180.0,75.0,1.0,1.0,2.0,3.0,3.0,1.0,2.0,2.0,3.0,1.0,3.0,5.0,9.0,12.0,7.0,14.0,8.0,12.0,11.0,6.0,11.0,12.0,12.0,11.0,11.0,12.0,13.0,13.0,11.0,10.0,13.0,11.0,14.0,11.0,7.0,11.0,12.0,14.0,13.0,15.0,13.0,14.0,10.0,7.0,14.0,14.0,20.0,13.0,14.0,12.0,11.0,12.0,12.0,15.0,10.0,14.0,13.0,12.0,14.0,14.0,14.0,6.0,31.0,0.0,0.0,0.0,0.0,175.0,65.0,3.0,4.0,1.0,1.0,3.0,3.0,3.0,2.0,4.0,3.0,3.0,14.0,13.0,13.0,7.0,14.0,12.0,7.0,12.0,7.0,6.0,14.0,15.0,8.0,15.0,11.0,12.0,13.0,13.0,11.0,14.0,12.0,15.0,13.0,9.0,11.0,10.0,12.0,13.0,14.0,15.0,12.0,7.0,20.0,10.0,13.0,10.0,12.0,9.0,12.0,11.0,15.0,16.0,13.0,8.0,14.0,14.0,14.0,13.0,13.0,13.0,7.0,18.0,0.0,0.0,4.0,0.0,188.0,81.0,3.0,3.0,1.0,3.0,1.0,4.0,1.0,2.0,1.0,3.0,4.0,6.0,8.0,13.0,10.0,10.0,10.0,8.0,12.0,6.0,6.0,10.0,14.0,6.0,9.0,10.0,7.0,14.0,9.0,9.0,11.0,11.0,10.0,8.0,11.0,8.0,4.0,11.0,13.0,12.0,13.0,14.0,13.0,8.0,14.0,14.0,20.0,12.0,13.0,10.0,10.0,7.0,6.0,10.0,17.0,10.0,9.0,9.0,13.0,10.0,11.0,6.0,28.0,37.0,15.0,1.0,0.0,194.0,88.0,2.0,1.0,2.0,1.0,1.0,2.0,3.0,1.0,3.0,2.0,2.0,4.0,6.0,12.0,15.0,12.0,7.0,16.0,11.0,3.0,6.0,10.0,14.0,4.0,11.0,10.0,14.0,15.0,13.0,10.0,8.0,9.0,13.0,12.0,6.0,14.0,8.0,11.0,16.0,13.0,12.0,18.0,17.0,9.0,12.0,12.0,20.0,14.0,18.0,13.0,10.0,15.0,15.0,6.0,20.0,17.0,12.0,15.0,14.0,11.0,14.0,7.0,30.0,0.0,0.0,0.0,0.0,180.0,75.0,11.0,13.0,13.0,9.0,13.0,11.0,12.0,15.0,15.0,14.0,13.0,6.0,1.0,2.0,3.0,7.0,8.0,1.0,1.0,1.0,2.0,7.0,2.0,1.0,7.0,8.0,12.0,14.0,13.0,14.0,7.0,12.0,14.0,5.0,12.0,3.0,13.0,15.0,9.0,13.0,14.0,13.0,10.0,5.0,14.0,11.0,20.0,12.0,13.0,12.0,8.0,14.0,6.0,1.0,9.0,13.0,14.0,13.0,16.0,15.0,15.0,5.0,26.0,11.0,0.0,0.0,0.0,180.0,81.0,3.0,2.0,2.0,3.0,3.0,2.0,1.0,2.0,2.0,1.0,2.0,5.0,9.0,8.0,5.0,11.0,5.0,13.0,10.0,8.0,15.0,10.0,7.0,13.0,10.0,15.0,14.0,17.0,11.0,12.0,9.0,12.0,16.0,8.0,10.0,8.0,13.0,14.0,15.0,13.0,12.0,14.0,12.0,20.0,14.0,12.0,8.0,14.0,14.0,14.0,10.0,15.0,13.0,8.0,9.0,14.0,17.0,13.0,13.0,13.0,11.0,8.0,24.0,0.0,0.0,4.0,0.0,186.0,88.0,1.0,2.0,1.0,3.0,2.0,1.0,1.0,2.0,1.0,2.0,1.0,4.0,8.0,8.0,6.0,12.0,6.0,14.0,9.0,11.0,14.0,12.0,6.0,12.0,12.0,14.0,13.0,14.0,12.0,13.0,8.0,12.0,13.0,8.0,8.0,9.0,12.0,12.0,13.0,13.0,11.0,15.0,13.0,8.0,15.0,14.0,20.0,14.0,15.0,13.0,14.0,15.0,8.0,12.0,14.0,14.0,12.0,9.0,12.0,13.0,13.0,8.0,32.0,0.0,0.0,0.0,0.0,165.0,65.0,1.0,2.0,3.0,1.0,3.0,1.0,3.0,2.0,1.0,4.0,4.0,7.0,12.0,10.0,5.0,13.0,8.0,9.0,8.0,11.0,13.0,12.0,10.0,14.0,11.0,14.0,13.0,15.0,12.0,12.0,8.0,11.0,14.0,5.0,8.0,7.0,10.0,15.0,17.0,14.0,13.0,14.0,4.0,10.0,13.0,13.0,20.0,15.0,12.0,14.0,5.0,13.0,7.0,8.0,7.0,12.0,17.0,13.0,15.0,13.0,13.0,7.0,30.0,0.0,0.0,6.0,0.0,181.0,78.0,2.0,1.0,1.0,1.0,2.0,3.0,1.0,1.0,2.0,1.0,3.0,8.0,13.0,10.0,6.0,11.0,9.0,12.0,14.0,13.0,14.0,10.0,8.0,14.0,12.0,10.0,12.0,13.0,13.0,13.0,10.0,11.0,10.0,6.0,13.0,8.0,15.0,14.0,13.0,13.0,12.0,14.0,10.0,20.0,15.0,11.0,8.0,13.0,14.0,11.0,10.0,13.0,6.0,8.0,10.0,12.0,14.0,8.0,15.0,15.0,15.0,9.0,31.0,0.0,0.0,0.0,0.0,178.0,70.0,3.0,1.0,3.0,3.0,2.0,2.0,2.0,1.0,2.0,1.0,2.0,5.0,8.0,7.0,7.0,12.0,5.0,8.0,8.0,7.0,14.0,13.0,8.0,13.0,12.0,15.0,14.0,17.0,12.0,13.0,9.0,13.0,16.0,10.0,15.0,8.0,13.0,18.0,15.0,13.0,14.0,12.0,9.0,10.0,15.0,13.0,20.0,16.0,13.0,14.0,12.0,14.0,5.0,16.0,13.0,12.0,16.0,13.0,13.0,13.0,13.0,6.0,20.0,0.0,0.0,0.0,0.0,175.0,77.0,2.0,1.0,2.0,3.0,3.0,3.0,3.0,1.0,4.0,3.0,1.0,8.0,8.0,12.0,12.0,11.0,8.0,13.0,10.0,9.0,10.0,11.0,10.0,9.0,12.0,12.0,6.0,9.0,9.0,11.0,15.0,11.0,4.0,10.0,8.0,12.0,11.0,10.0,13.0,14.0,15.0,15.0,8.0,8.0,9.0,15.0,20.0,11.0,12.0,12.0,8.0,4.0,10.0,10.0,15.0,11.0,12.0,11.0,9.0,10.0,10.0,7.0,27.0,32.0,6.0,0.0,0.0,188.0,78.0,3.0,2.0,3.0,2.0,1.0,3.0,3.0,3.0,2.0,2.0,2.0,4.0,8.0,11.0,12.0,12.0,6.0,16.0,13.0,8.0,13.0,14.0,7.0,12.0,12.0,12.0,10.0,14.0,13.0,12.0,11.0,12.0,15.0,9.0,11.0,12.0,6.0,13.0,12.0,14.0,13.0,15.0,15.0,5.0,13.0,12.0,20.0,16.0,15.0,14.0,12.0,15.0,11.0,10.0,9.0,15.0,12.0,12.0,13.0,13.0,13.0,7.0,22.0,0.0,0.0,3.0,0.0,172.0,73.0,2.0,3.0,1.0,1.0,3.0,3.0,2.0,1.0,2.0,3.0,2.0,6.0,13.0,13.0,11.0,13.0,7.0,10.0,11.0,5.0,5.0,10.0,11.0,3.0,13.0,8.0,12.0,9.0,10.0,8.0,12.0,12.0,13.0,13.0,5.0,11.0,7.0,8.0,8.0,15.0,16.0,15.0,7.0,8.0,14.0,16.0,20.0,12.0,11.0,11.0,8.0,13.0,8.0,7.0,13.0,14.0,13.0,12.0,10.0,15.0,15.0,9.0,19.0,0.0,0.0,0.0,0.0,173.0,67.0,3.0,2.0,4.0,2.0,1.0,1.0,3.0,1.0,1.0,1.0,2.0,13.0,13.0,15.0,10.0,14.0,11.0,6.0,12.0,4.0,4.0,12.0,11.0,5.0,14.0,10.0,12.0,9.0,10.0,8.0,12.0,8.0,11.0,15.0,5.0,12.0,6.0,8.0,10.0,16.0,15.0,13.0,7.0,8.0,13.0,15.0,20.0,11.0,9.0,12.0,6.0,12.0,6.0,15.0,8.0,13.0,8.0,12.0,9.0,14.0,13.0,9.0,27.0,0.0,0.0,0.0,0.0,179.0,73.0,1.0,3.0,1.0,1.0,2.0,1.0,4.0,4.0,3.0,1.0,2.0,8.0,12.0,11.0,12.0,13.0,9.0,8.0,12.0,6.0,4.0,11.0,13.0,3.0,13.0,8.0,11.0,11.0,12.0,11.0,9.0,10.0,14.0,12.0,5.0,13.0,6.0,10.0,12.0,16.0,14.0,13.0,9.0,8.0,14.0,14.0,20.0,13.0,11.0,13.0,8.0,13.0,7.0,8.0,16.0,14.0,12.0,10.0,11.0,15.0,15.0,9.0
3,0,24.0,0.0,0.0,0.0,0.0,188.0,82.0,13.0,14.0,12.0,8.0,14.0,8.0,14.0,15.0,12.0,12.0,9.0,3.0,1.0,1.0,2.0,8.0,8.0,1.0,1.0,1.0,2.0,8.0,3.0,3.0,7.0,9.0,12.0,13.0,11.0,12.0,9.0,12.0,15.0,6.0,14.0,2.0,11.0,11.0,6.0,12.0,13.0,15.0,14.0,5.0,13.0,12.0,20.0,12.0,10.0,13.0,9.0,12.0,6.0,1.0,14.0,12.0,17.0,13.0,15.0,13.0,11.0,6.0,28.0,0.0,0.0,0.0,0.0,193.0,84.0,1.0,1.0,2.0,2.0,2.0,3.0,2.0,3.0,2.0,1.0,3.0,4.0,8.0,8.0,9.0,10.0,6.0,14.0,7.0,8.0,14.0,12.0,6.0,14.0,11.0,12.0,13.0,14.0,11.0,14.0,12.0,12.0,14.0,6.0,11.0,8.0,14.0,13.0,13.0,11.0,11.0,16.0,16.0,20.0,12.0,12.0,8.0,14.0,16.0,14.0,12.0,13.0,6.0,10.0,7.0,12.0,15.0,12.0,16.0,15.0,13.0,6.0,29.0,2.0,0.0,0.0,0.0,185.0,75.0,2.0,3.0,3.0,3.0,2.0,3.0,2.0,1.0,3.0,1.0,2.0,4.0,10.0,8.0,6.0,10.0,6.0,14.0,7.0,7.0,14.0,11.0,6.0,14.0,9.0,13.0,13.0,14.0,11.0,12.0,12.0,12.0,14.0,8.0,11.0,12.0,13.0,13.0,13.0,15.0,12.0,15.0,12.0,8.0,15.0,13.0,20.0,14.0,15.0,14.0,7.0,14.0,8.0,6.0,14.0,13.0,15.0,14.0,14.0,14.0,14.0,6.0,26.0,0.0,0.0,0.0,0.0,175.0,69.0,3.0,3.0,2.0,2.0,3.0,1.0,3.0,1.0,3.0,2.0,2.0,6.0,12.0,10.0,5.0,11.0,6.0,10.0,10.0,10.0,13.0,12.0,9.0,13.0,12.0,12.0,13.0,14.0,12.0,13.0,12.0,11.0,15.0,11.0,13.0,12.0,13.0,14.0,14.0,15.0,13.0,12.0,7.0,9.0,13.0,13.0,20.0,14.0,11.0,14.0,12.0,12.0,11.0,15.0,14.0,9.0,17.0,10.0,8.0,11.0,20.0,7.0,26.0,0.0,0.0,0.0,0.0,182.0,68.0,1.0,4.0,3.0,2.0,3.0,1.0,2.0,1.0,2.0,4.0,1.0,7.0,12.0,9.0,5.0,10.0,6.0,12.0,7.0,15.0,12.0,9.0,6.0,12.0,10.0,12.0,13.0,14.0,11.0,10.0,9.0,9.0,13.0,7.0,6.0,10.0,10.0,14.0,15.0,16.0,13.0,13.0,11.0,5.0,15.0,15.0,20.0,14.0,10.0,12.0,12.0,13.0,7.0,12.0,12.0,14.0,14.0,15.0,13.0,14.0,14.0,7.0,30.0,9.0,1.0,0.0,0.0,192.0,90.0,2.0,2.0,2.0,2.0,3.0,1.0,3.0,4.0,1.0,1.0,3.0,4.0,7.0,10.0,10.0,9.0,8.0,17.0,12.0,6.0,13.0,12.0,8.0,12.0,11.0,13.0,14.0,15.0,13.0,13.0,10.0,12.0,14.0,12.0,13.0,13.0,12.0,14.0,16.0,12.0,12.0,18.0,16.0,8.0,14.0,13.0,20.0,16.0,18.0,13.0,13.0,14.0,7.0,12.0,13.0,13.0,13.0,13.0,13.0,13.0,13.0,6.0,21.0,0.0,0.0,0.0,0.0,183.0,73.0,1.0,4.0,3.0,3.0,3.0,1.0,4.0,1.0,2.0,3.0,2.0,11.0,10.0,12.0,11.0,13.0,9.0,12.0,10.0,5.0,8.0,12.0,9.0,8.0,13.0,13.0,12.0,12.0,10.0,12.0,14.0,12.0,12.0,14.0,8.0,12.0,8.0,12.0,12.0,14.0,14.0,14.0,11.0,8.0,13.0,13.0,20.0,12.0,12.0,12.0,5.0,10.0,7.0,12.0,15.0,11.0,11.0,10.0,11.0,12.0,11.0,4.0,29.0,0.0,0.0,0.0,0.0,183.0,78.0,1.0,3.0,3.0,3.0,3.0,1.0,2.0,3.0,3.0,1.0,1.0,13.0,8.0,9.0,6.0,12.0,14.0,13.0,10.0,12.0,11.0,12.0,8.0,13.0,12.0,12.0,15.0,13.0,13.0,13.0,11.0,13.0,15.0,6.0,12.0,7.0,13.0,16.0,18.0,12.0,11.0,14.0,12.0,20.0,14.0,11.0,8.0,16.0,14.0,14.0,12.0,14.0,6.0,12.0,10.0,12.0,13.0,11.0,15.0,15.0,15.0,5.0,29.0,0.0,0.0,0.0,0.0,180.0,71.0,1.0,3.0,1.0,1.0,1.0,4.0,4.0,1.0,1.0,2.0,3.0,10.0,11.0,12.0,9.0,13.0,11.0,8.0,14.0,6.0,8.0,11.0,10.0,8.0,12.0,10.0,11.0,12.0,12.0,9.0,12.0,11.0,14.0,12.0,7.0,12.0,10.0,12.0,14.0,15.0,14.0,12.0,10.0,20.0,16.0,13.0,12.0,15.0,10.0,13.0,10.0,15.0,7.0,8.0,16.0,12.0,12.0,13.0,14.0,15.0,15.0,6.0,20.0,0.0,0.0,0.0,0.0,173.0,67.0,2.0,2.0,4.0,3.0,3.0,2.0,3.0,3.0,2.0,1.0,1.0,11.0,12.0,12.0,9.0,12.0,8.0,5.0,10.0,7.0,4.0,8.0,10.0,4.0,14.0,12.0,7.0,11.0,8.0,6.0,10.0,10.0,3.0,11.0,5.0,10.0,11.0,8.0,13.0,15.0,14.0,14.0,6.0,5.0,14.0,15.0,20.0,12.0,8.0,10.0,5.0,10.0,10.0,10.0,17.0,12.0,12.0,10.0,7.0,10.0,19.0,8.0,23.0,1.0,0.0,0.0,0.0,185.0,70.0,4.0,3.0,1.0,2.0,1.0,3.0,2.0,3.0,1.0,2.0,3.0,5.0,8.0,12.0,13.0,13.0,7.0,14.0,11.0,5.0,5.0,8.0,13.0,5.0,13.0,6.0,13.0,10.0,12.0,12.0,11.0,11.0,13.0,12.0,7.0,13.0,9.0,8.0,10.0,16.0,12.0,14.0,12.0,8.0,14.0,15.0,20.0,13.0,13.0,12.0,7.0,15.0,7.0,7.0,13.0,13.0,12.0,10.0,12.0,15.0,15.0,7.0,26.0,2.0,0.0,1.0,0.0,188.0,84.0,12.0,13.0,15.0,9.0,15.0,13.0,13.0,15.0,10.0,11.0,14.0,9.0,2.0,1.0,2.0,12.0,11.0,3.0,2.0,3.0,3.0,11.0,3.0,1.0,10.0,14.0,13.0,14.0,10.0,13.0,11.0,11.0,14.0,3.0,11.0,5.0,12.0,15.0,13.0,10.0,12.0,13.0,14.0,5.0,14.0,9.0,20.0,12.0,14.0,12.0,10.0,15.0,3.0,11.0,12.0,11.0,16.0,13.0,15.0,16.0,16.0,4.0,29.0,0.0,0.0,0.0,0.0,183.0,74.0,3.0,3.0,3.0,3.0,3.0,2.0,2.0,2.0,1.0,3.0,1.0,5.0,12.0,7.0,6.0,10.0,7.0,14.0,12.0,5.0,14.0,12.0,6.0,13.0,11.0,14.0,13.0,17.0,13.0,16.0,12.0,12.0,13.0,9.0,8.0,9.0,14.0,14.0,15.0,13.0,12.0,15.0,12.0,6.0,17.0,11.0,20.0,17.0,13.0,14.0,14.0,15.0,5.0,13.0,9.0,14.0,19.0,15.0,14.0,11.0,11.0,6.0,32.0,0.0,0.0,0.0,0.0,183.0,79.0,1.0,1.0,1.0,3.0,1.0,3.0,1.0,1.0,2.0,1.0,1.0,5.0,10.0,6.0,6.0,9.0,6.0,15.0,7.0,11.0,14.0,10.0,7.0,13.0,10.0,13.0,15.0,15.0,15.0,14.0,9.0,13.0,16.0,6.0,14.0,8.0,12.0,13.0,16.0,11.0,12.0,16.0,11.0,8.0,16.0,12.0,20.0,15.0,14.0,14.0,11.0,12.0,5.0,15.0,18.0,15.0,14.0,13.0,17.0,14.0,14.0,5.0,22.0,0.0,0.0,0.0,0.0,178.0,73.0,3.0,2.0,2.0,1.0,2.0,4.0,3.0,1.0,3.0,1.0,2.0,6.0,12.0,12.0,6.0,11.0,7.0,8.0,8.0,11.0,12.0,10.0,8.0,13.0,11.0,12.0,12.0,13.0,11.0,10.0,11.0,11.0,13.0,6.0,7.0,12.0,9.0,13.0,14.0,16.0,14.0,13.0,9.0,6.0,14.0,15.0,20.0,15.0,14.0,12.0,12.0,13.0,6.0,14.0,12.0,15.0,13.0,13.0,14.0,14.0,14.0,6.0,27.0,0.0,0.0,0.0,0.0,178.0,72.0,2.0,3.0,2.0,3.0,2.0,3.0,3.0,1.0,1.0,2.0,1.0,13.0,14.0,11.0,7.0,12.0,10.0,9.0,10.0,13.0,13.0,12.0,10.0,14.0,13.0,12.0,14.0,14.0,13.0,14.0,11.0,12.0,14.0,13.0,8.0,14.0,13.0,13.0,15.0,15.0,13.0,10.0,10.0,20.0,13.0,15.0,6.0,14.0,10.0,13.0,13.0,12.0,8.0,12.0,15.0,14.0,13.0,14.0,13.0,13.0,12.0,6.0,32.0,0.0,0.0,13.0,0.0,175.0,65.0,2.0,1.0,1.0,2.0,3.0,3.0,1.0,2.0,3.0,2.0,3.0,15.0,13.0,11.0,6.0,14.0,13.0,10.0,12.0,8.0,8.0,16.0,8.0,12.0,13.0,11.0,14.0,15.0,14.0,15.0,14.0,14.0,14.0,6.0,13.0,9.0,15.0,18.0,13.0,12.0,13.0,13.0,8.0,8.0,13.0,10.0,20.0,13.0,13.0,12.0,11.0,15.0,12.0,10.0,17.0,14.0,15.0,14.0,16.0,14.0,14.0,6.0,27.0,0.0,0.0,0.0,0.0,188.0,77.0,1.0,4.0,1.0,1.0,3.0,1.0,2.0,1.0,2.0,2.0,2.0,4.0,7.0,8.0,7.0,13.0,6.0,15.0,9.0,6.0,13.0,12.0,6.0,12.0,11.0,14.0,14.0,15.0,10.0,12.0,11.0,13.0,16.0,7.0,12.0,9.0,12.0,15.0,16.0,14.0,10.0,14.0,15.0,9.0,13.0,12.0,20.0,14.0,16.0,12.0,14.0,13.0,6.0,12.0,4.0,13.0,18.0,13.0,14.0,14.0,13.0,7.0,18.0,0.0,0.0,0.0,0.0,179.0,67.0,3.0,3.0,2.0,4.0,2.0,4.0,3.0,1.0,3.0,4.0,1.0,5.0,7.0,12.0,9.0,12.0,12.0,10.0,12.0,6.0,4.0,12.0,12.0,3.0,14.0,11.0,12.0,11.0,11.0,8.0,13.0,12.0,12.0,12.0,6.0,12.0,5.0,10.0,12.0,15.0,11.0,12.0,10.0,20.0,13.0,14.0,8.0,14.0,8.0,9.0,6.0,14.0,5.0,10.0,16.0,13.0,12.0,12.0,13.0,9.0,15.0,2.0,20.0,0.0,0.0,2.0,0.0,180.0,75.0,3.0,1.0,2.0,2.0,3.0,2.0,1.0,1.0,3.0,3.0,1.0,8.0,13.0,14.0,9.0,13.0,8.0,10.0,9.0,6.0,5.0,12.0,6.0,5.0,14.0,8.0,13.0,12.0,13.0,12.0,12.0,12.0,7.0,13.0,8.0,14.0,7.0,12.0,13.0,15.0,13.0,14.0,10.0,8.0,14.0,15.0,20.0,13.0,12.0,13.0,11.0,9.0,7.0,13.0,9.0,11.0,11.0,11.0,12.0,11.0,10.0,1.0,25.0,0.0,0.0,0.0,0.0,176.0,74.0,2.0,2.0,1.0,3.0,2.0,2.0,2.0,4.0,3.0,3.0,3.0,12.0,12.0,14.0,12.0,14.0,13.0,7.0,12.0,6.0,3.0,12.0,12.0,3.0,15.0,9.0,10.0,8.0,12.0,11.0,12.0,10.0,10.0,14.0,5.0,13.0,4.0,6.0,8.0,17.0,15.0,12.0,8.0,20.0,12.0,14.0,8.0,13.0,12.0,11.0,9.0,14.0,10.0,8.0,8.0,14.0,12.0,7.0,10.0,11.0,11.0,9.0,30.0,5.0,0.0,22.0,9.0,181.0,84.0,2.0,3.0,3.0,1.0,2.0,3.0,3.0,1.0,3.0,1.0,3.0,7.0,10.0,12.0,13.0,11.0,7.0,13.0,10.0,12.0,6.0,11.0,13.0,6.0,13.0,17.0,13.0,16.0,11.0,13.0,11.0,11.0,17.0,14.0,8.0,14.0,9.0,13.0,17.0,15.0,12.0,15.0,11.0,8.0,14.0,15.0,20.0,14.0,14.0,13.0,9.0,13.0,7.0,10.0,7.0,16.0,13.0,14.0,13.0,15.0,15.0,10.0
0,3,36.0,0.0,0.0,0.0,0.0,185.0,78.0,11.0,14.0,12.0,7.0,13.0,12.0,14.0,15.0,13.0,14.0,10.0,4.0,1.0,3.0,1.0,8.0,8.0,11.0,8.0,3.0,3.0,7.0,2.0,1.0,8.0,11.0,13.0,15.0,11.0,12.0,7.0,13.0,9.0,5.0,14.0,3.0,13.0,15.0,8.0,11.0,14.0,13.0,12.0,5.0,15.0,11.0,20.0,12.0,14.0,13.0,11.0,13.0,8.0,1.0,19.0,14.0,16.0,10.0,17.0,9.0,9.0,11.0,28.0,0.0,0.0,0.0,0.0,183.0,81.0,1.0,2.0,4.0,1.0,1.0,3.0,2.0,3.0,3.0,3.0,1.0,5.0,5.0,6.0,10.0,12.0,6.0,14.0,8.0,6.0,15.0,11.0,6.0,13.0,12.0,13.0,14.0,16.0,14.0,14.0,10.0,12.0,14.0,5.0,14.0,8.0,14.0,15.0,15.0,9.0,12.0,15.0,13.0,7.0,11.0,12.0,20.0,15.0,15.0,14.0,14.0,14.0,9.0,8.0,14.0,14.0,11.0,13.0,15.0,13.0,15.0,6.0,34.0,23.0,1.0,0.0,0.0,186.0,81.0,3.0,3.0,1.0,2.0,1.0,3.0,2.0,3.0,1.0,3.0,3.0,4.0,8.0,6.0,10.0,7.0,8.0,17.0,12.0,10.0,14.0,7.0,9.0,15.0,7.0,15.0,13.0,17.0,8.0,12.0,7.0,12.0,15.0,6.0,17.0,7.0,14.0,15.0,14.0,8.0,10.0,16.0,13.0,12.0,13.0,9.0,20.0,13.0,15.0,11.0,15.0,14.0,9.0,10.0,10.0,14.0,11.0,13.0,15.0,11.0,11.0,12.0,27.0,25.0,1.0,0.0,0.0,189.0,82.0,3.0,1.0,3.0,4.0,3.0,1.0,3.0,3.0,1.0,2.0,3.0,6.0,7.0,5.0,8.0,9.0,8.0,12.0,8.0,6.0,14.0,13.0,11.0,14.0,5.0,12.0,14.0,15.0,13.0,13.0,8.0,13.0,12.0,5.0,11.0,5.0,13.0,15.0,14.0,12.0,12.0,14.0,15.0,6.0,16.0,12.0,20.0,13.0,14.0,11.0,10.0,12.0,5.0,8.0,11.0,13.0,14.0,17.0,8.0,6.0,8.0,13.0,21.0,0.0,0.0,1.0,0.0,177.0,68.0,4.0,1.0,2.0,1.0,1.0,1.0,1.0,1.0,2.0,1.0,2.0,5.0,12.0,9.0,7.0,12.0,8.0,13.0,10.0,16.0,13.0,12.0,8.0,14.0,12.0,12.0,13.0,12.0,12.0,12.0,10.0,13.0,15.0,11.0,13.0,11.0,13.0,13.0,14.0,13.0,14.0,13.0,11.0,10.0,14.0,12.0,20.0,12.0,14.0,12.0,11.0,12.0,8.0,14.0,13.0,10.0,14.0,12.0,14.0,12.0,11.0,5.0,27.0,14.0,1.0,0.0,0.0,183.0,77.0,1.0,2.0,1.0,2.0,3.0,2.0,3.0,2.0,2.0,1.0,1.0,5.0,12.0,9.0,8.0,13.0,10.0,13.0,10.0,6.0,14.0,13.0,6.0,13.0,12.0,14.0,13.0,15.0,11.0,11.0,11.0,11.0,13.0,9.0,8.0,9.0,12.0,14.0,16.0,14.0,12.0,14.0,12.0,7.0,14.0,12.0,20.0,15.0,14.0,14.0,14.0,15.0,7.0,10.0,12.0,13.0,14.0,12.0,13.0,11.0,11.0,7.0,33.0,0.0,0.0,0.0,0.0,187.0,76.0,2.0,2.0,3.0,1.0,1.0,3.0,2.0,1.0,2.0,3.0,2.0,15.0,14.0,14.0,10.0,15.0,13.0,10.0,12.0,7.0,4.0,15.0,13.0,7.0,15.0,6.0,12.0,9.0,14.0,11.0,15.0,12.0,12.0,14.0,12.0,13.0,7.0,13.0,12.0,11.0,12.0,14.0,12.0,14.0,15.0,12.0,20.0,11.0,12.0,12.0,6.0,14.0,6.0,11.0,14.0,13.0,12.0,12.0,15.0,15.0,13.0,9.0,17.0,0.0,0.0,0.0,0.0,181.0,68.0,1.0,2.0,1.0,1.0,2.0,2.0,3.0,3.0,3.0,2.0,1.0,8.0,11.0,14.0,11.0,13.0,8.0,11.0,9.0,5.0,3.0,11.0,5.0,5.0,14.0,5.0,11.0,6.0,10.0,10.0,11.0,12.0,14.0,13.0,6.0,13.0,9.0,10.0,8.0,14.0,14.0,14.0,10.0,5.0,12.0,14.0,20.0,12.0,11.0,10.0,6.0,5.0,10.0,12.0,20.0,12.0,11.0,12.0,12.0,11.0,14.0,5.0,26.0,0.0,0.0,0.0,0.0,193.0,81.0,1.0,3.0,3.0,3.0,3.0,1.0,2.0,2.0,2.0,3.0,3.0,4.0,9.0,14.0,10.0,13.0,12.0,14.0,14.0,5.0,5.0,10.0,12.0,3.0,14.0,8.0,13.0,12.0,9.0,10.0,11.0,11.0,12.0,16.0,5.0,14.0,6.0,9.0,12.0,14.0,13.0,14.0,16.0,14.0,13.0,13.0,20.0,13.0,14.0,10.0,8.0,14.0,9.0,8.0,16.0,16.0,11.0,13.0,11.0,13.0,13.0,10.0,27.0,0.0,0.0,0.0,0.0,190.0,87.0,1.0,3.0,2.0,3.0,1.0,3.0,1.0,1.0,2.0,3.0,2.0,5.0,7.0,9.0,14.0,14.0,10.0,14.0,13.0,5.0,6.0,12.0,12.0,8.0,14.0,14.0,13.0,16.0,14.0,11.0,10.0,13.0,15.0,10.0,11.0,14.0,9.0,15.0,14.0,10.0,11.0,16.0,15.0,9.0,12.0,12.0,20.0,14.0,16.0,13.0,13.0,12.0,7.0,5.0,10.0,12.0,14.0,12.0,14.0,14.0,19.0,12.0,30.0,0.0,0.0,0.0,0.0,178.0,73.0,3.0,4.0,1.0,1.0,2.0,4.0,3.0,2.0,2.0,2.0,3.0,13.0,14.0,12.0,7.0,13.0,12.0,7.0,13.0,5.0,10.0,13.0,9.0,10.0,13.0,11.0,11.0,12.0,12.0,13.0,11.0,14.0,14.0,11.0,7.0,11.0,10.0,13.0,15.0,13.0,15.0,15.0,8.0,20.0,14.0,14.0,8.0,14.0,11.0,13.0,11.0,14.0,8.0,10.0,19.0,12.0,12.0,9.0,12.0,12.0,10.0,10.0,31.0,25.0,0.0,6.0,0.0,191.0,84.0,11.0,14.0,13.0,12.0,15.0,14.0,15.0,16.0,13.0,14.0,14.0,8.0,2.0,10.0,5.0,11.0,11.0,7.0,10.0,2.0,5.0,10.0,11.0,11.0,9.0,12.0,13.0,15.0,13.0,13.0,8.0,13.0,16.0,12.0,14.0,1.0,16.0,13.0,11.0,12.0,13.0,16.0,16.0,8.0,16.0,13.0,20.0,15.0,15.0,17.0,8.0,15.0,7.0,2.0,15.0,15.0,17.0,15.0,17.0,16.0,15.0,6.0,28.0,46.0,3.0,14.0,3.0,190.0,80.0,2.0,3.0,3.0,2.0,2.0,1.0,1.0,3.0,1.0,3.0,1.0,4.0,6.0,7.0,9.0,11.0,7.0,17.0,11.0,10.0,15.0,12.0,11.0,16.0,10.0,17.0,15.0,18.0,13.0,14.0,12.0,14.0,18.0,6.0,17.0,8.0,15.0,15.0,14.0,11.0,10.0,17.0,16.0,7.0,17.0,13.0,20.0,15.0,18.0,17.0,14.0,16.0,4.0,6.0,14.0,15.0,16.0,17.0,18.0,14.0,15.0,6.0,23.0,0.0,0.0,0.0,0.0,184.0,77.0,1.0,1.0,1.0,1.0,3.0,2.0,3.0,2.0,2.0,2.0,3.0,6.0,9.0,11.0,7.0,12.0,7.0,15.0,9.0,11.0,14.0,13.0,10.0,15.0,12.0,14.0,15.0,15.0,13.0,12.0,11.0,13.0,15.0,11.0,9.0,9.0,14.0,14.0,14.0,14.0,13.0,15.0,13.0,9.0,16.0,15.0,20.0,14.0,14.0,14.0,11.0,14.0,4.0,11.0,14.0,13.0,15.0,14.0,16.0,14.0,15.0,6.0,20.0,0.0,0.0,0.0,0.0,184.0,80.0,1.0,4.0,4.0,1.0,3.0,1.0,4.0,3.0,3.0,3.0,2.0,7.0,14.0,13.0,8.0,12.0,7.0,16.0,7.0,12.0,13.0,13.0,11.0,12.0,13.0,12.0,13.0,14.0,13.0,12.0,12.0,12.0,15.0,12.0,10.0,14.0,13.0,14.0,13.0,14.0,12.0,14.0,12.0,6.0,13.0,14.0,20.0,13.0,14.0,14.0,8.0,15.0,10.0,13.0,9.0,16.0,15.0,14.0,16.0,16.0,17.0,5.0,21.0,0.0,0.0,9.0,0.0,185.0,75.0,1.0,1.0,2.0,2.0,2.0,1.0,1.0,4.0,2.0,3.0,2.0,11.0,15.0,14.0,7.0,13.0,9.0,11.0,11.0,14.0,13.0,13.0,10.0,14.0,13.0,15.0,12.0,13.0,10.0,11.0,11.0,12.0,14.0,11.0,10.0,14.0,12.0,13.0,15.0,15.0,13.0,14.0,13.0,20.0,14.0,16.0,8.0,15.0,15.0,13.0,13.0,12.0,9.0,10.0,14.0,14.0,13.0,12.0,12.0,13.0,9.0,9.0,29.0,90.0,4.0,16.0,2.0,170.0,61.0,2.0,3.0,3.0,1.0,3.0,1.0,2.0,2.0,2.0,2.0,1.0,15.0,14.0,15.0,9.0,17.0,16.0,7.0,12.0,4.0,11.0,18.0,15.0,12.0,17.0,15.0,15.0,16.0,13.0,16.0,17.0,14.0,16.0,15.0,14.0,12.0,14.0,18.0,16.0,13.0,14.0,12.0,8.0,10.0,14.0,11.0,20.0,14.0,10.0,14.0,9.0,17.0,10.0,14.0,13.0,17.0,15.0,16.0,17.0,15.0,16.0,7.0,31.0,0.0,0.0,6.0,0.0,174.0,80.0,1.0,1.0,1.0,1.0,1.0,5.0,1.0,1.0,1.0,1.0,1.0,14.0,12.0,11.0,7.0,12.0,13.0,9.0,7.0,10.0,11.0,11.0,10.0,10.0,12.0,11.0,11.0,11.0,10.0,6.0,10.0,9.0,12.0,12.0,12.0,10.0,12.0,12.0,14.0,12.0,15.0,10.0,9.0,20.0,12.0,12.0,7.0,12.0,9.0,9.0,10.0,12.0,7.0,9.0,11.0,14.0,9.0,7.0,14.0,8.0,9.0,9.0,20.0,0.0,0.0,7.0,1.0,170.0,58.0,1.0,2.0,2.0,2.0,2.0,2.0,2.0,4.0,1.0,3.0,2.0,16.0,14.0,16.0,13.0,16.0,17.0,5.0,14.0,2.0,6.0,15.0,13.0,4.0,17.0,9.0,12.0,14.0,12.0,12.0,14.0,13.0,15.0,16.0,7.0,13.0,9.0,13.0,15.0,15.0,16.0,11.0,7.0,20.0,14.0,15.0,8.0,14.0,8.0,15.0,5.0,15.0,7.0,16.0,15.0,15.0,15.0,14.0,16.0,18.0,16.0,3.0,30.0,18.0,2.0,0.0,0.0,184.0,79.0,2.0,2.0,2.0,1.0,2.0,2.0,3.0,1.0,3.0,1.0,1.0,13.0,16.0,15.0,10.0,13.0,12.0,9.0,11.0,11.0,10.0,14.0,12.0,8.0,14.0,14.0,10.0,15.0,10.0,12.0,12.0,11.0,15.0,12.0,14.0,14.0,11.0,13.0,14.0,15.0,14.0,15.0,11.0,7.0,15.0,15.0,20.0,15.0,14.0,13.0,13.0,13.0,11.0,14.0,12.0,14.0,14.0,10.0,13.0,14.0,11.0,9.0,17.0,0.0,0.0,0.0,0.0,178.0,68.0,2.0,1.0,2.0,1.0,3.0,3.0,3.0,1.0,3.0,3.0,2.0,10.0,11.0,15.0,12.0,13.0,10.0,8.0,9.0,2.0,3.0,12.0,12.0,3.0,16.0,11.0,9.0,11.0,12.0,9.0,12.0,10.0,17.0,17.0,9.0,13.0,5.0,9.0,13.0,15.0,14.0,11.0,9.0,8.0,14.0,14.0,20.0,12.0,9.0,14.0,7.0,15.0,7.0,13.0,13.0,19.0,12.0,16.0,15.0,14.0,14.0,7.0,26.0,0.0,0.0,4.0,0.0,180.0,73.0,2.0,3.0,1.0,4.0,2.0,3.0,3.0,1.0,1.0,4.0,1.0,11.0,13.0,13.0,14.0,14.0,11.0,15.0,12.0,3.0,7.0,14.0,14.0,8.0,13.0,12.0,14.0,17.0,13.0,15.0,14.0,14.0,16.0,12.0,15.0,16.0,12.0,18.0,16.0,13.0,14.0,13.0,12.0,8.0,14.0,13.0,20.0,15.0,12.0,15.0,8.0,14.0,7.0,15.0,19.0,14.0,17.0,14.0,18.0,16.0,16.0,5.0
2,1,25.0,0.0,0.0,11.0,0.0,189.0,83.0,12.0,12.0,11.0,7.0,13.0,12.0,17.0,17.0,16.0,12.0,13.0,6.0,2.0,1.0,1.0,10.0,10.0,7.0,1.0,1.0,1.0,9.0,5.0,1.0,10.0,8.0,15.0,14.0,14.0,12.0,7.0,13.0,12.0,6.0,9.0,3.0,16.0,17.0,10.0,13.0,16.0,14.0,12.0,8.0,15.0,10.0,20.0,13.0,14.0,14.0,5.0,14.0,4.0,12.0,15.0,15.0,13.0,13.0,17.0,15.0,17.0,4.0,31.0,0.0,0.0,0.0,0.0,171.0,65.0,1.0,3.0,1.0,3.0,2.0,2.0,3.0,1.0,2.0,2.0,3.0,8.0,9.0,11.0,7.0,5.0,6.0,5.0,6.0,7.0,14.0,14.0,6.0,14.0,13.0,14.0,12.0,13.0,12.0,11.0,11.0,12.0,12.0,11.0,7.0,12.0,12.0,12.0,10.0,15.0,15.0,7.0,9.0,9.0,12.0,14.0,20.0,12.0,13.0,11.0,13.0,11.0,9.0,10.0,15.0,14.0,12.0,11.0,14.0,13.0,12.0,7.0,29.0,0.0,0.0,0.0,0.0,170.0,65.0,2.0,1.0,3.0,3.0,1.0,3.0,2.0,1.0,2.0,3.0,2.0,5.0,11.0,4.0,6.0,7.0,4.0,7.0,5.0,6.0,6.0,6.0,2.0,6.0,7.0,9.0,10.0,13.0,8.0,12.0,8.0,13.0,15.0,2.0,7.0,5.0,9.0,8.0,8.0,12.0,12.0,14.0,4.0,9.0,12.0,11.0,20.0,12.0,5.0,9.0,9.0,9.0,9.0,9.0,10.0,12.0,12.0,12.0,12.0,7.0,5.0,8.0,28.0,0.0,0.0,0.0,0.0,169.0,0.0,3.0,3.0,2.0,3.0,3.0,1.0,1.0,3.0,2.0,1.0,3.0,5.0,8.0,11.0,9.0,8.0,8.0,7.0,8.0,4.0,2.0,9.0,5.0,3.0,11.0,11.0,11.0,13.0,9.0,11.0,8.0,15.0,14.0,11.0,7.0,10.0,8.0,8.0,10.0,11.0,11.0,6.0,5.0,14.0,11.0,12.0,20.0,14.0,5.0,9.0,12.0,9.0,5.0,6.0,9.0,12.0,11.0,9.0,9.0,10.0,12.0,11.0,23.0,25.0,0.0,0.0,0.0,174.0,74.0,2.0,1.0,1.0,1.0,3.0,3.0,3.0,3.0,3.0,1.0,2.0,8.0,13.0,12.0,8.0,12.0,8.0,14.0,9.0,13.0,14.0,12.0,6.0,16.0,13.0,13.0,14.0,15.0,13.0,11.0,10.0,12.0,15.0,9.0,10.0,14.0,11.0,14.0,17.0,16.0,13.0,14.0,10.0,8.0,17.0,15.0,20.0,18.0,15.0,14.0,13.0,14.0,8.0,12.0,12.0,14.0,13.0,13.0,12.0,12.0,15.0,13.0,23.0,15.0,1.0,7.0,0.0,165.0,60.0,2.0,3.0,2.0,1.0,1.0,1.0,3.0,3.0,2.0,1.0,3.0,14.0,14.0,16.0,8.0,16.0,13.0,6.0,10.0,6.0,11.0,18.0,15.0,12.0,18.0,16.0,15.0,15.0,17.0,13.0,17.0,15.0,14.0,18.0,12.0,10.0,12.0,15.0,16.0,14.0,16.0,16.0,6.0,12.0,13.0,14.0,20.0,15.0,11.0,16.0,14.0,15.0,10.0,12.0,14.0,15.0,16.0,14.0,14.0,13.0,10.0,6.0,21.0,0.0,0.0,15.0,1.0,189.0,75.0,3.0,3.0,3.0,3.0,1.0,1.0,3.0,3.0,3.0,2.0,3.0,10.0,12.0,13.0,7.0,14.0,8.0,14.0,12.0,5.0,13.0,15.0,8.0,15.0,14.0,14.0,14.0,15.0,14.0,14.0,13.0,14.0,15.0,12.0,10.0,12.0,14.0,15.0,16.0,12.0,13.0,15.0,14.0,20.0,14.0,13.0,10.0,16.0,13.0,14.0,11.0,14.0,7.0,10.0,8.0,16.0,10.0,12.0,13.0,13.0,11.0,14.0,22.0,24.0,2.0,1.0,1.0,187.0,75.0,1.0,2.0,1.0,1.0,2.0,1.0,2.0,1.0,2.0,3.0,3.0,13.0,13.0,16.0,13.0,17.0,10.0,9.0,17.0,8.0,6.0,14.0,10.0,8.0,16.0,10.0,12.0,9.0,12.0,10.0,15.0,11.0,10.0,15.0,7.0,13.0,8.0,12.0,11.0,15.0,14.0,10.0,16.0,18.0,12.0,13.0,20.0,14.0,11.0,8.0,5.0,15.0,12.0,13.0,11.0,17.0,8.0,10.0,16.0,12.0,14.0,13.0,27.0,10.0,0.0,0.0,0.0,187.0,75.0,2.0,2.0,4.0,3.0,3.0,3.0,2.0,3.0,4.0,2.0,1.0,13.0,13.0,15.0,11.0,18.0,13.0,8.0,13.0,4.0,3.0,17.0,14.0,4.0,17.0,10.0,13.0,9.0,14.0,12.0,17.0,13.0,12.0,18.0,8.0,14.0,6.0,14.0,9.0,15.0,16.0,12.0,12.0,14.0,12.0,14.0,20.0,12.0,11.0,13.0,8.0,13.0,13.0,10.0,11.0,17.0,13.0,12.0,14.0,15.0,15.0,8.0,28.0,66.0,15.0,13.0,3.0,180.0,70.0,2.0,2.0,1.0,2.0,1.0,1.0,3.0,2.0,3.0,3.0,1.0,14.0,15.0,16.0,13.0,17.0,15.0,6.0,15.0,4.0,5.0,16.0,14.0,8.0,17.0,13.0,16.0,11.0,15.0,13.0,16.0,14.0,13.0,17.0,10.0,14.0,9.0,13.0,13.0,16.0,18.0,12.0,10.0,20.0,14.0,15.0,8.0,16.0,9.0,13.0,14.0,12.0,10.0,15.0,14.0,15.0,10.0,16.0,14.0,6.0,12.0,10.0,29.0,76.0,27.0,13.0,9.0,188.0,72.0,2.0,3.0,1.0,2.0,3.0,3.0,1.0,3.0,3.0,3.0,3.0,5.0,10.0,13.0,16.0,13.0,11.0,17.0,13.0,5.0,10.0,13.0,14.0,10.0,13.0,15.0,16.0,18.0,14.0,15.0,10.0,13.0,14.0,13.0,10.0,18.0,12.0,14.0,19.0,15.0,14.0,16.0,14.0,10.0,18.0,16.0,20.0,18.0,14.0,14.0,8.0,15.0,5.0,16.0,10.0,16.0,12.0,14.0,16.0,14.0,10.0,10.0,25.0,4.0,0.0,11.0,0.0,184.0,81.0,14.0,14.0,13.0,9.0,15.0,12.0,16.0,16.0,13.0,7.0,11.0,8.0,1.0,2.0,1.0,11.0,12.0,6.0,1.0,3.0,3.0,11.0,5.0,3.0,11.0,8.0,15.0,15.0,13.0,14.0,10.0,11.0,14.0,8.0,13.0,5.0,13.0,10.0,10.0,14.0,16.0,14.0,13.0,20.0,14.0,12.0,5.0,14.0,14.0,15.0,9.0,16.0,6.0,1.0,17.0,11.0,15.0,13.0,14.0,12.0,12.0,4.0,27.0,4.0,0.0,5.0,1.0,184.0,83.0,2.0,4.0,3.0,1.0,1.0,2.0,1.0,2.0,4.0,2.0,3.0,4.0,8.0,11.0,4.0,10.0,4.0,14.0,4.0,4.0,15.0,12.0,5.0,16.0,11.0,14.0,14.0,16.0,14.0,10.0,11.0,12.0,17.0,7.0,10.0,9.0,13.0,14.0,15.0,14.0,13.0,16.0,13.0,10.0,15.0,13.0,20.0,15.0,16.0,12.0,12.0,14.0,6.0,12.0,11.0,13.0,12.0,12.0,16.0,15.0,14.0,6.0,19.0,0.0,0.0,0.0,0.0,193.0,89.0,3.0,2.0,2.0,3.0,1.0,3.0,1.0,4.0,2.0,2.0,3.0,8.0,10.0,5.0,4.0,10.0,10.0,14.0,12.0,6.0,12.0,10.0,4.0,12.0,9.0,11.0,11.0,14.0,11.0,12.0,8.0,14.0,13.0,8.0,8.0,11.0,11.0,13.0,13.0,10.0,9.0,14.0,16.0,6.0,14.0,10.0,20.0,12.0,14.0,11.0,7.0,6.0,6.0,8.0,16.0,10.0,10.0,12.0,13.0,16.0,16.0,5.0,32.0,0.0,0.0,0.0,0.0,172.0,71.0,2.0,1.0,3.0,1.0,2.0,3.0,2.0,3.0,2.0,2.0,2.0,8.0,9.0,7.0,6.0,10.0,6.0,10.0,9.0,10.0,14.0,11.0,6.0,14.0,11.0,10.0,16.0,15.0,12.0,12.0,7.0,12.0,15.0,9.0,13.0,8.0,14.0,15.0,15.0,14.0,14.0,14.0,10.0,20.0,14.0,14.0,8.0,15.0,13.0,13.0,11.0,13.0,7.0,13.0,17.0,14.0,17.0,8.0,13.0,15.0,15.0,6.0,37.0,0.0,0.0,0.0,0.0,185.0,83.0,1.0,1.0,2.0,1.0,3.0,2.0,3.0,1.0,1.0,3.0,1.0,6.0,8.0,9.0,12.0,10.0,8.0,13.0,9.0,4.0,5.0,10.0,14.0,4.0,11.0,11.0,10.0,11.0,13.0,12.0,12.0,13.0,15.0,14.0,12.0,11.0,7.0,12.0,8.0,7.0,7.0,12.0,12.0,11.0,11.0,7.0,20.0,8.0,14.0,12.0,8.0,13.0,9.0,12.0,12.0,12.0,19.0,14.0,15.0,14.0,8.0,8.0,27.0,8.0,0.0,6.0,0.0,187.0,76.0,3.0,2.0,3.0,2.0,2.0,1.0,1.0,3.0,3.0,1.0,2.0,5.0,7.0,11.0,5.0,14.0,5.0,14.0,9.0,5.0,15.0,15.0,8.0,14.0,13.0,15.0,16.0,15.0,14.0,12.0,14.0,14.0,18.0,8.0,17.0,9.0,12.0,18.0,15.0,13.0,14.0,15.0,14.0,10.0,17.0,12.0,20.0,17.0,15.0,14.0,13.0,16.0,4.0,12.0,10.0,14.0,17.0,12.0,15.0,13.0,13.0,6.0,21.0,0.0,0.0,15.0,3.0,181.0,78.0,3.0,3.0,4.0,2.0,1.0,2.0,2.0,4.0,2.0,1.0,1.0,5.0,7.0,11.0,10.0,14.0,5.0,14.0,10.0,6.0,13.0,14.0,8.0,14.0,14.0,12.0,14.0,12.0,11.0,10.0,12.0,11.0,16.0,11.0,12.0,14.0,14.0,14.0,14.0,14.0,13.0,14.0,13.0,10.0,16.0,14.0,20.0,16.0,14.0,12.0,10.0,11.0,5.0,19.0,8.0,11.0,14.0,11.0,16.0,13.0,13.0,10.0,31.0,52.0,8.0,0.0,0.0,167.0,58.0,1.0,2.0,2.0,1.0,3.0,2.0,4.0,2.0,1.0,2.0,3.0,15.0,15.0,14.0,7.0,15.0,15.0,6.0,11.0,3.0,4.0,15.0,14.0,7.0,15.0,13.0,12.0,15.0,13.0,14.0,16.0,11.0,17.0,14.0,11.0,12.0,10.0,12.0,14.0,15.0,18.0,10.0,5.0,10.0,16.0,14.0,20.0,13.0,7.0,14.0,13.0,16.0,8.0,12.0,13.0,16.0,14.0,15.0,13.0,9.0,11.0,14.0,25.0,10.0,1.0,11.0,4.0,175.0,73.0,1.0,3.0,3.0,3.0,3.0,3.0,3.0,1.0,2.0,3.0,1.0,5.0,10.0,15.0,17.0,15.0,10.0,11.0,12.0,5.0,5.0,14.0,15.0,5.0,16.0,8.0,15.0,12.0,15.0,14.0,13.0,15.0,15.0,15.0,14.0,14.0,10.0,10.0,12.0,16.0,16.0,15.0,9.0,10.0,15.0,16.0,20.0,13.0,15.0,14.0,8.0,14.0,7.0,10.0,8.0,16.0,17.0,13.0,15.0,15.0,14.0,5.0,22.0,24.0,3.0,7.0,0.0,177.0,78.0,2.0,1.0,2.0,3.0,2.0,2.0,4.0,3.0,3.0,2.0,1.0,10.0,13.0,16.0,14.0,16.0,16.0,8.0,16.0,4.0,4.0,15.0,12.0,4.0,16.0,12.0,11.0,12.0,13.0,10.0,11.0,8.0,13.0,17.0,5.0,14.0,5.0,10.0,12.0,15.0,14.0,13.0,9.0,10.0,17.0,16.0,20.0,15.0,14.0,12.0,11.0,15.0,4.0,12.0,19.0,16.0,14.0,14.0,11.0,13.0,10.0,12.0,22.0,5.0,1.0,1.0,0.0,173.0,72.0,1.0,3.0,1.0,3.0,3.0,3.0,3.0,3.0,3.0,2.0,2.0,14.0,13.0,16.0,14.0,16.0,14.0,5.0,11.0,5.0,5.0,15.0,11.0,5.0,16.0,8.0,13.0,9.0,14.0,13.0,15.0,13.0,15.0,16.0,5.0,13.0,5.0,9.0,10.0,15.0,16.0,14.0,5.0,20.0,14.0,15.0,5.0,12.0,14.0,13.0,11.0,13.0,8.0,14.0,10.0,15.0,14.0,10.0,13.0,10.0,10.0,13.0
1,0,25.0,0.0,0.0,0.0,0.0,187.0,83.0,11.0,14.0,12.0,8.0,13.0,11.0,14.0,15.0,13.0,13.0,9.0,8.0,1.0,1.0,1.0,11.0,11.0,1.0,2.0,2.0,1.0,10.0,3.0,2.0,11.0,8.0,12.0,14.0,12.0,12.0,10.0,12.0,14.0,6.0,14.0,2.0,12.0,12.0,8.0,13.0,15.0,14.0,13.0,20.0,15.0,11.0,5.0,14.0,13.0,13.0,8.0,8.0,10.0,1.0,9.0,13.0,14.0,12.0,15.0,15.0,15.0,5.0,32.0,1.0,0.0,5.0,0.0,189.0,93.0,1.0,1.0,3.0,4.0,2.0,2.0,3.0,2.0,3.0,3.0,3.0,3.0,8.0,8.0,7.0,9.0,8.0,16.0,8.0,7.0,14.0,10.0,9.0,14.0,9.0,15.0,14.0,16.0,12.0,10.0,10.0,12.0,14.0,9.0,9.0,7.0,13.0,14.0,15.0,9.0,8.0,10.0,14.0,8.0,16.0,11.0,20.0,14.0,19.0,12.0,14.0,12.0,8.0,6.0,13.0,16.0,14.0,11.0,15.0,14.0,12.0,10.0,25.0,0.0,0.0,3.0,0.0,184.0,80.0,2.0,2.0,4.0,2.0,1.0,3.0,2.0,1.0,1.0,2.0,1.0,5.0,8.0,7.0,6.0,9.0,6.0,14.0,6.0,6.0,14.0,7.0,6.0,13.0,9.0,12.0,14.0,13.0,11.0,13.0,7.0,12.0,14.0,8.0,10.0,7.0,14.0,13.0,14.0,15.0,12.0,14.0,12.0,8.0,15.0,15.0,20.0,14.0,14.0,13.0,12.0,14.0,5.0,10.0,16.0,13.0,15.0,15.0,12.0,14.0,14.0,8.0,26.0,0.0,0.0,0.0,0.0,177.0,68.0,4.0,2.0,1.0,2.0,3.0,1.0,1.0,2.0,3.0,3.0,3.0,12.0,13.0,11.0,8.0,13.0,11.0,8.0,10.0,8.0,10.0,13.0,10.0,12.0,13.0,7.0,12.0,10.0,13.0,11.0,15.0,13.0,14.0,11.0,7.0,14.0,10.0,14.0,14.0,13.0,15.0,12.0,9.0,20.0,15.0,14.0,5.0,15.0,8.0,13.0,7.0,14.0,6.0,12.0,11.0,12.0,14.0,13.0,16.0,16.0,16.0,5.0,21.0,0.0,0.0,0.0,0.0,174.0,68.0,1.0,3.0,1.0,3.0,1.0,1.0,2.0,1.0,3.0,1.0,2.0,6.0,9.0,11.0,7.0,11.0,8.0,10.0,9.0,8.0,10.0,12.0,6.0,12.0,12.0,14.0,12.0,12.0,5.0,9.0,11.0,12.0,11.0,12.0,5.0,11.0,5.0,10.0,12.0,14.0,14.0,13.0,7.0,5.0,13.0,14.0,20.0,13.0,13.0,10.0,3.0,6.0,10.0,10.0,7.0,11.0,12.0,13.0,9.0,13.0,17.0,5.0,29.0,0.0,0.0,0.0,0.0,188.0,74.0,1.0,2.0,3.0,3.0,2.0,3.0,1.0,3.0,2.0,1.0,1.0,4.0,8.0,10.0,6.0,13.0,7.0,14.0,9.0,6.0,13.0,12.0,8.0,13.0,13.0,12.0,14.0,13.0,14.0,11.0,13.0,12.0,14.0,6.0,13.0,8.0,14.0,15.0,15.0,9.0,12.0,14.0,14.0,10.0,13.0,10.0,20.0,16.0,12.0,13.0,12.0,15.0,9.0,11.0,11.0,14.0,14.0,12.0,15.0,13.0,13.0,6.0,31.0,0.0,0.0,4.0,0.0,174.0,72.0,2.0,1.0,4.0,2.0,2.0,3.0,1.0,1.0,3.0,3.0,4.0,12.0,9.0,11.0,6.0,14.0,11.0,7.0,10.0,6.0,8.0,16.0,12.0,9.0,14.0,9.0,14.0,10.0,13.0,12.0,12.0,11.0,14.0,8.0,8.0,11.0,12.0,14.0,12.0,13.0,14.0,12.0,7.0,12.0,14.0,12.0,20.0,15.0,11.0,11.0,9.0,12.0,8.0,10.0,10.0,14.0,13.0,10.0,12.0,14.0,14.0,9.0,28.0,0.0,0.0,0.0,0.0,170.0,67.0,2.0,3.0,3.0,4.0,3.0,2.0,1.0,1.0,2.0,2.0,3.0,8.0,12.0,12.0,10.0,14.0,7.0,5.0,10.0,6.0,5.0,12.0,5.0,4.0,13.0,7.0,16.0,12.0,9.0,11.0,12.0,10.0,3.0,12.0,6.0,13.0,6.0,8.0,13.0,16.0,13.0,10.0,5.0,5.0,13.0,16.0,20.0,15.0,7.0,12.0,4.0,9.0,7.0,10.0,20.0,13.0,12.0,10.0,13.0,11.0,10.0,2.0,30.0,0.0,0.0,11.0,4.0,172.0,69.0,4.0,2.0,2.0,3.0,3.0,3.0,3.0,3.0,4.0,4.0,3.0,13.0,13.0,13.0,11.0,13.0,13.0,7.0,12.0,9.0,4.0,13.0,12.0,4.0,15.0,7.0,12.0,10.0,12.0,12.0,15.0,12.0,13.0,17.0,8.0,14.0,7.0,12.0,12.0,14.0,15.0,12.0,6.0,20.0,10.0,14.0,10.0,13.0,7.0,12.0,6.0,12.0,15.0,13.0,10.0,11.0,13.0,12.0,11.0,14.0,14.0,6.0,27.0,33.0,4.0,3.0,0.0,180.0,75.0,2.0,1.0,2.0,1.0,4.0,2.0,1.0,3.0,1.0,1.0,2.0,12.0,11.0,13.0,13.0,11.0,11.0,11.0,10.0,7.0,5.0,10.0,14.0,5.0,14.0,9.0,11.0,12.0,10.0,11.0,12.0,12.0,14.0,13.0,8.0,14.0,8.0,11.0,14.0,16.0,14.0,13.0,10.0,7.0,12.0,15.0,20.0,14.0,12.0,12.0,9.0,13.0,10.0,10.0,9.0,15.0,8.0,9.0,13.0,14.0,14.0,7.0,24.0,24.0,4.0,0.0,0.0,172.0,74.0,2.0,4.0,3.0,2.0,2.0,1.0,2.0,2.0,3.0,2.0,4.0,8.0,9.0,14.0,13.0,14.0,9.0,11.0,10.0,7.0,5.0,12.0,12.0,3.0,13.0,10.0,12.0,12.0,13.0,12.0,11.0,10.0,14.0,13.0,7.0,14.0,9.0,9.0,13.0,16.0,15.0,13.0,6.0,8.0,13.0,16.0,20.0,14.0,12.0,11.0,11.0,13.0,9.0,8.0,9.0,13.0,9.0,11.0,12.0,13.0,10.0,9.0,36.0,0.0,0.0,0.0,0.0,185.0,78.0,11.0,14.0,12.0,7.0,13.0,12.0,14.0,15.0,13.0,14.0,10.0,4.0,1.0,3.0,1.0,8.0,8.0,11.0,8.0,3.0,3.0,7.0,2.0,1.0,8.0,11.0,13.0,15.0,11.0,12.0,7.0,13.0,9.0,5.0,14.0,3.0,13.0,15.0,8.0,11.0,14.0,13.0,12.0,5.0,15.0,11.0,20.0,12.0,14.0,13.0,11.0,13.0,8.0,1.0,19.0,14.0,16.0,10.0,17.0,9.0,9.0,11.0,34.0,23.0,1.0,0.0,0.0,186.0,81.0,3.0,3.0,1.0,2.0,1.0,3.0,2.0,3.0,1.0,3.0,3.0,4.0,8.0,6.0,10.0,7.0,8.0,17.0,12.0,10.0,14.0,7.0,9.0,15.0,7.0,15.0,13.0,17.0,8.0,12.0,7.0,12.0,15.0,6.0,17.0,7.0,14.0,15.0,14.0,8.0,10.0,16.0,13.0,12.0,13.0,9.0,20.0,13.0,15.0,11.0,15.0,14.0,9.0,10.0,10.0,14.0,11.0,13.0,15.0,11.0,11.0,12.0,28.0,0.0,0.0,0.0,0.0,183.0,81.0,1.0,2.0,4.0,1.0,1.0,3.0,2.0,3.0,3.0,3.0,1.0,5.0,5.0,6.0,10.0,12.0,6.0,14.0,8.0,6.0,15.0,11.0,6.0,13.0,12.0,13.0,14.0,16.0,14.0,14.0,10.0,12.0,14.0,5.0,14.0,8.0,14.0,15.0,15.0,9.0,12.0,15.0,13.0,7.0,11.0,12.0,20.0,15.0,15.0,14.0,14.0,14.0,9.0,8.0,14.0,14.0,11.0,13.0,15.0,13.0,15.0,6.0,21.0,0.0,0.0,1.0,0.0,177.0,68.0,4.0,1.0,2.0,1.0,1.0,1.0,1.0,1.0,2.0,1.0,2.0,5.0,12.0,9.0,7.0,12.0,8.0,13.0,10.0,16.0,13.0,12.0,8.0,14.0,12.0,12.0,13.0,12.0,12.0,12.0,10.0,13.0,15.0,11.0,13.0,11.0,13.0,13.0,14.0,13.0,14.0,13.0,11.0,10.0,14.0,12.0,20.0,12.0,14.0,12.0,11.0,12.0,8.0,14.0,13.0,10.0,14.0,12.0,14.0,12.0,11.0,5.0,27.0,14.0,1.0,0.0,0.0,183.0,77.0,1.0,2.0,1.0,2.0,3.0,2.0,3.0,2.0,2.0,1.0,1.0,5.0,12.0,9.0,8.0,13.0,10.0,13.0,10.0,6.0,14.0,13.0,6.0,13.0,12.0,14.0,13.0,15.0,11.0,11.0,11.0,11.0,13.0,9.0,8.0,9.0,12.0,14.0,16.0,14.0,12.0,14.0,12.0,7.0,14.0,12.0,20.0,15.0,14.0,14.0,14.0,15.0,7.0,10.0,12.0,13.0,14.0,12.0,13.0,11.0,11.0,7.0,30.0,0.0,0.0,0.0,0.0,167.0,60.0,3.0,1.0,1.0,2.0,3.0,1.0,1.0,3.0,1.0,1.0,3.0,10.0,11.0,12.0,8.0,13.0,10.0,6.0,9.0,10.0,12.0,14.0,9.0,10.0,14.0,11.0,14.0,14.0,14.0,14.0,13.0,14.0,12.0,14.0,11.0,13.0,12.0,15.0,15.0,15.0,14.0,11.0,5.0,11.0,11.0,15.0,20.0,11.0,8.0,14.0,10.0,12.0,13.0,11.0,11.0,12.0,11.0,10.0,12.0,11.0,11.0,2.0,33.0,0.0,0.0,0.0,0.0,187.0,76.0,2.0,2.0,3.0,1.0,1.0,3.0,2.0,1.0,2.0,3.0,2.0,15.0,14.0,14.0,10.0,15.0,13.0,10.0,12.0,7.0,4.0,15.0,13.0,7.0,15.0,6.0,12.0,9.0,14.0,11.0,15.0,12.0,12.0,14.0,12.0,13.0,7.0,13.0,12.0,11.0,12.0,14.0,12.0,14.0,15.0,12.0,20.0,11.0,12.0,12.0,6.0,14.0,6.0,11.0,14.0,13.0,12.0,12.0,15.0,15.0,13.0,9.0,27.0,0.0,0.0,0.0,0.0,190.0,87.0,1.0,3.0,2.0,3.0,1.0,3.0,1.0,1.0,2.0,3.0,2.0,5.0,7.0,9.0,14.0,14.0,10.0,14.0,13.0,5.0,6.0,12.0,12.0,8.0,14.0,14.0,13.0,16.0,14.0,11.0,10.0,13.0,15.0,10.0,11.0,14.0,9.0,15.0,14.0,10.0,11.0,16.0,15.0,9.0,12.0,12.0,20.0,14.0,16.0,13.0,13.0,12.0,7.0,5.0,10.0,12.0,14.0,12.0,14.0,14.0,19.0,12.0,30.0,0.0,0.0,0.0,0.0,178.0,73.0,3.0,4.0,1.0,1.0,2.0,4.0,3.0,2.0,2.0,2.0,3.0,13.0,14.0,12.0,7.0,13.0,12.0,7.0,13.0,5.0,10.0,13.0,9.0,10.0,13.0,11.0,11.0,12.0,12.0,13.0,11.0,14.0,14.0,11.0,7.0,11.0,10.0,13.0,15.0,13.0,15.0,15.0,8.0,20.0,14.0,14.0,8.0,14.0,11.0,13.0,11.0,14.0,8.0,10.0,19.0,12.0,12.0,9.0,12.0,12.0,10.0,10.0,26.0,0.0,0.0,0.0,0.0,193.0,81.0,1.0,3.0,3.0,3.0,3.0,1.0,2.0,2.0,2.0,3.0,3.0,4.0,9.0,14.0,10.0,13.0,12.0,14.0,14.0,5.0,5.0,10.0,12.0,3.0,14.0,8.0,13.0,12.0,9.0,10.0,11.0,11.0,12.0,16.0,5.0,14.0,6.0,9.0,12.0,14.0,13.0,14.0,16.0,14.0,13.0,13.0,20.0,13.0,14.0,10.0,8.0,14.0,9.0,8.0,16.0,16.0,11.0,13.0,11.0,13.0,13.0,10.0,17.0,0.0,0.0,0.0,0.0,181.0,68.0,1.0,2.0,1.0,1.0,2.0,2.0,3.0,3.0,3.0,2.0,1.0,8.0,11.0,14.0,11.0,13.0,8.0,11.0,9.0,5.0,3.0,11.0,5.0,5.0,14.0,5.0,11.0,6.0,10.0,10.0,11.0,12.0,14.0,13.0,6.0,13.0,9.0,10.0,8.0,14.0,14.0,14.0,10.0,5.0,12.0,14.0,20.0,12.0,11.0,10.0,6.0,5.0,10.0,12.0,20.0,12.0,11.0,12.0,12.0,11.0,14.0,5.0
0,1,25.0,0.0,0.0,0.0,0.0,192.0,87.0,12.0,13.0,12.0,6.0,14.0,11.0,12.0,13.0,9.0,12.0,11.0,5.0,1.0,3.0,1.0,10.0,8.0,3.0,3.0,3.0,3.0,8.0,2.0,1.0,8.0,7.0,13.0,14.0,12.0,13.0,12.0,11.0,13.0,7.0,11.0,3.0,13.0,11.0,12.0,11.0,12.0,16.0,16.0,8.0,14.0,12.0,20.0,13.0,16.0,13.0,7.0,9.0,7.0,10.0,14.0,12.0,17.0,13.0,14.0,14.0,14.0,5.0,29.0,2.0,0.0,0.0,0.0,185.0,75.0,2.0,3.0,3.0,3.0,2.0,3.0,2.0,1.0,3.0,1.0,2.0,4.0,10.0,8.0,6.0,10.0,6.0,14.0,7.0,7.0,14.0,11.0,6.0,14.0,9.0,13.0,13.0,14.0,11.0,12.0,12.0,12.0,14.0,8.0,11.0,12.0,13.0,13.0,13.0,15.0,12.0,15.0,12.0,8.0,15.0,13.0,20.0,14.0,15.0,14.0,7.0,14.0,8.0,6.0,14.0,13.0,15.0,14.0,14.0,14.0,14.0,6.0,28.0,0.0,0.0,0.0,0.0,193.0,84.0,1.0,1.0,2.0,2.0,2.0,3.0,2.0,3.0,2.0,1.0,3.0,4.0,8.0,8.0,9.0,10.0,6.0,14.0,7.0,8.0,14.0,12.0,6.0,14.0,11.0,12.0,13.0,14.0,11.0,14.0,12.0,12.0,14.0,6.0,11.0,8.0,14.0,13.0,13.0,11.0,11.0,16.0,16.0,20.0,12.0,12.0,8.0,14.0,16.0,14.0,12.0,13.0,6.0,10.0,7.0,12.0,15.0,12.0,16.0,15.0,13.0,6.0,26.0,0.0,0.0,0.0,0.0,175.0,69.0,3.0,3.0,2.0,2.0,3.0,1.0,3.0,1.0,3.0,2.0,2.0,6.0,12.0,10.0,5.0,11.0,6.0,10.0,10.0,10.0,13.0,12.0,9.0,13.0,12.0,12.0,13.0,14.0,12.0,13.0,12.0,11.0,15.0,11.0,13.0,12.0,13.0,14.0,14.0,15.0,13.0,12.0,7.0,9.0,13.0,13.0,20.0,14.0,11.0,14.0,12.0,12.0,11.0,15.0,14.0,9.0,17.0,10.0,8.0,11.0,20.0,7.0,21.0,0.0,0.0,0.0,0.0,183.0,73.0,1.0,4.0,3.0,3.0,3.0,1.0,4.0,1.0,2.0,3.0,2.0,11.0,10.0,12.0,11.0,13.0,9.0,12.0,10.0,5.0,8.0,12.0,9.0,8.0,13.0,13.0,12.0,12.0,10.0,12.0,14.0,12.0,12.0,14.0,8.0,12.0,8.0,12.0,12.0,14.0,14.0,14.0,11.0,8.0,13.0,13.0,20.0,12.0,12.0,12.0,5.0,10.0,7.0,12.0,15.0,11.0,11.0,10.0,11.0,12.0,11.0,4.0,29.0,0.0,0.0,0.0,0.0,183.0,78.0,1.0,3.0,3.0,3.0,3.0,1.0,2.0,3.0,3.0,1.0,1.0,13.0,8.0,9.0,6.0,12.0,14.0,13.0,10.0,12.0,11.0,12.0,8.0,13.0,12.0,12.0,15.0,13.0,13.0,13.0,11.0,13.0,15.0,6.0,12.0,7.0,13.0,16.0,18.0,12.0,11.0,14.0,12.0,20.0,14.0,11.0,8.0,16.0,14.0,14.0,12.0,14.0,6.0,12.0,10.0,12.0,13.0,11.0,15.0,15.0,15.0,5.0,30.0,9.0,1.0,0.0,0.0,192.0,90.0,2.0,2.0,2.0,2.0,3.0,1.0,3.0,4.0,1.0,1.0,3.0,4.0,7.0,10.0,10.0,9.0,8.0,17.0,12.0,6.0,13.0,12.0,8.0,12.0,11.0,13.0,14.0,15.0,13.0,13.0,10.0,12.0,14.0,12.0,13.0,13.0,12.0,14.0,16.0,12.0,12.0,18.0,16.0,8.0,14.0,13.0,20.0,16.0,18.0,13.0,13.0,14.0,7.0,12.0,13.0,13.0,13.0,13.0,13.0,13.0,13.0,6.0,29.0,0.0,0.0,0.0,0.0,180.0,71.0,1.0,3.0,1.0,1.0,1.0,4.0,4.0,1.0,1.0,2.0,3.0,10.0,11.0,12.0,9.0,13.0,11.0,8.0,14.0,6.0,8.0,11.0,10.0,8.0,12.0,10.0,11.0,12.0,12.0,9.0,12.0,11.0,14.0,12.0,7.0,12.0,10.0,12.0,14.0,15.0,14.0,12.0,10.0,20.0,16.0,13.0,12.0,15.0,10.0,13.0,10.0,15.0,7.0,8.0,16.0,12.0,12.0,13.0,14.0,15.0,15.0,6.0,28.0,0.0,0.0,0.0,0.0,176.0,72.0,2.0,1.0,2.0,2.0,3.0,3.0,2.0,2.0,3.0,2.0,1.0,6.0,11.0,13.0,10.0,13.0,9.0,12.0,12.0,5.0,5.0,11.0,13.0,5.0,13.0,10.0,13.0,11.0,12.0,13.0,10.0,12.0,13.0,12.0,6.0,14.0,8.0,12.0,14.0,15.0,14.0,14.0,10.0,8.0,12.0,13.0,20.0,14.0,13.0,11.0,10.0,9.0,8.0,5.0,10.0,13.0,15.0,12.0,13.0,11.0,11.0,8.0,23.0,1.0,0.0,0.0,0.0,185.0,70.0,4.0,3.0,1.0,2.0,1.0,3.0,2.0,3.0,1.0,2.0,3.0,5.0,8.0,12.0,13.0,13.0,7.0,14.0,11.0,5.0,5.0,8.0,13.0,5.0,13.0,6.0,13.0,10.0,12.0,12.0,11.0,11.0,13.0,12.0,7.0,13.0,9.0,8.0,10.0,16.0,12.0,14.0,12.0,8.0,14.0,15.0,20.0,13.0,13.0,12.0,7.0,15.0,7.0,7.0,13.0,13.0,12.0,10.0,12.0,15.0,15.0,7.0,23.0,1.0,0.0,0.0,0.0,192.0,80.0,3.0,3.0,3.0,2.0,3.0,1.0,3.0,3.0,1.0,2.0,2.0,4.0,6.0,12.0,13.0,12.0,7.0,13.0,12.0,5.0,5.0,9.0,11.0,5.0,12.0,13.0,12.0,13.0,12.0,13.0,9.0,13.0,4.0,11.0,8.0,13.0,7.0,9.0,12.0,14.0,13.0,15.0,16.0,20.0,14.0,13.0,8.0,13.0,15.0,12.0,11.0,11.0,7.0,5.0,14.0,13.0,14.0,11.0,9.0,9.0,18.0,3.0,31.0,25.0,0.0,6.0,0.0,191.0,84.0,11.0,14.0,13.0,12.0,15.0,14.0,15.0,16.0,13.0,14.0,14.0,8.0,2.0,10.0,5.0,11.0,11.0,7.0,10.0,2.0,5.0,10.0,11.0,11.0,9.0,12.0,13.0,15.0,13.0,13.0,8.0,13.0,16.0,12.0,14.0,1.0,16.0,13.0,11.0,12.0,13.0,16.0,16.0,8.0,16.0,13.0,20.0,15.0,15.0,17.0,8.0,15.0,7.0,2.0,15.0,15.0,17.0,15.0,17.0,16.0,15.0,6.0,28.0,46.0,3.0,14.0,3.0,190.0,80.0,2.0,3.0,3.0,2.0,2.0,1.0,1.0,3.0,1.0,3.0,1.0,4.0,6.0,7.0,9.0,11.0,7.0,17.0,11.0,10.0,15.0,12.0,11.0,16.0,10.0,17.0,15.0,18.0,13.0,14.0,12.0,14.0,18.0,6.0,17.0,8.0,15.0,15.0,14.0,11.0,10.0,17.0,16.0,7.0,17.0,13.0,20.0,15.0,18.0,17.0,14.0,16.0,4.0,6.0,14.0,15.0,16.0,17.0,18.0,14.0,15.0,6.0,23.0,0.0,0.0,0.0,0.0,184.0,77.0,1.0,1.0,1.0,1.0,3.0,2.0,3.0,2.0,2.0,2.0,3.0,6.0,9.0,11.0,7.0,12.0,7.0,15.0,9.0,11.0,14.0,13.0,10.0,15.0,12.0,14.0,15.0,15.0,13.0,12.0,11.0,13.0,15.0,11.0,9.0,9.0,14.0,14.0,14.0,14.0,13.0,15.0,13.0,9.0,16.0,15.0,20.0,14.0,14.0,14.0,11.0,14.0,4.0,11.0,14.0,13.0,15.0,14.0,16.0,14.0,15.0,6.0,20.0,0.0,0.0,0.0,0.0,184.0,80.0,1.0,4.0,4.0,1.0,3.0,1.0,4.0,3.0,3.0,3.0,2.0,7.0,14.0,13.0,8.0,12.0,7.0,16.0,7.0,12.0,13.0,13.0,11.0,12.0,13.0,12.0,13.0,14.0,13.0,12.0,12.0,12.0,15.0,12.0,10.0,14.0,13.0,14.0,13.0,14.0,12.0,14.0,12.0,6.0,13.0,14.0,20.0,13.0,14.0,14.0,8.0,15.0,10.0,13.0,9.0,16.0,15.0,14.0,16.0,16.0,17.0,5.0,21.0,0.0,0.0,9.0,0.0,185.0,75.0,1.0,1.0,2.0,2.0,2.0,1.0,1.0,4.0,2.0,3.0,2.0,11.0,15.0,14.0,7.0,13.0,9.0,11.0,11.0,14.0,13.0,13.0,10.0,14.0,13.0,15.0,12.0,13.0,10.0,11.0,11.0,12.0,14.0,11.0,10.0,14.0,12.0,13.0,15.0,15.0,13.0,14.0,13.0,20.0,14.0,16.0,8.0,15.0,15.0,13.0,13.0,12.0,9.0,10.0,14.0,14.0,13.0,12.0,12.0,13.0,9.0,9.0,21.0,0.0,0.0,9.0,0.0,184.0,72.0,1.0,3.0,1.0,2.0,3.0,2.0,1.0,1.0,2.0,1.0,2.0,6.0,10.0,12.0,7.0,12.0,7.0,14.0,11.0,7.0,14.0,13.0,10.0,13.0,12.0,14.0,13.0,14.0,12.0,12.0,12.0,12.0,16.0,11.0,10.0,12.0,13.0,14.0,15.0,14.0,13.0,16.0,12.0,12.0,14.0,15.0,20.0,15.0,17.0,14.0,12.0,15.0,9.0,9.0,10.0,16.0,14.0,15.0,14.0,14.0,14.0,8.0,31.0,0.0,0.0,6.0,0.0,174.0,80.0,1.0,1.0,1.0,1.0,1.0,5.0,1.0,1.0,1.0,1.0,1.0,14.0,12.0,11.0,7.0,12.0,13.0,9.0,7.0,10.0,11.0,11.0,10.0,10.0,12.0,11.0,11.0,11.0,10.0,6.0,10.0,9.0,12.0,12.0,12.0,10.0,12.0,12.0,14.0,12.0,15.0,10.0,9.0,20.0,12.0,12.0,7.0,12.0,9.0,9.0,10.0,12.0,7.0,9.0,11.0,14.0,9.0,7.0,14.0,8.0,9.0,9.0,21.0,7.0,0.0,14.0,6.0,173.0,64.0,3.0,2.0,3.0,2.0,3.0,3.0,3.0,2.0,3.0,3.0,3.0,14.0,14.0,18.0,14.0,17.0,14.0,7.0,11.0,2.0,6.0,15.0,14.0,6.0,18.0,12.0,14.0,14.0,15.0,13.0,16.0,14.0,17.0,17.0,12.0,13.0,9.0,13.0,17.0,15.0,17.0,13.0,7.0,20.0,14.0,14.0,9.0,14.0,9.0,15.0,7.0,16.0,7.0,14.0,15.0,17.0,15.0,16.0,17.0,16.0,15.0,4.0,30.0,18.0,2.0,0.0,0.0,184.0,79.0,2.0,2.0,2.0,1.0,2.0,2.0,3.0,1.0,3.0,1.0,1.0,13.0,16.0,15.0,10.0,13.0,12.0,9.0,11.0,11.0,10.0,14.0,12.0,8.0,14.0,14.0,10.0,15.0,10.0,12.0,12.0,11.0,15.0,12.0,14.0,14.0,11.0,13.0,14.0,15.0,14.0,15.0,11.0,7.0,15.0,15.0,20.0,15.0,14.0,13.0,13.0,13.0,11.0,14.0,12.0,14.0,14.0,10.0,13.0,14.0,11.0,9.0,30.0,62.0,25.0,13.0,8.0,177.0,72.0,1.0,3.0,3.0,1.0,3.0,2.0,1.0,3.0,1.0,4.0,1.0,8.0,11.0,12.0,17.0,14.0,12.0,18.0,14.0,3.0,4.0,13.0,18.0,5.0,16.0,14.0,15.0,16.0,17.0,13.0,14.0,16.0,16.0,16.0,16.0,16.0,6.0,13.0,13.0,13.0,14.0,13.0,11.0,14.0,13.0,12.0,20.0,12.0,12.0,15.0,8.0,19.0,10.0,6.0,13.0,18.0,14.0,19.0,15.0,16.0,17.0,10.0,26.0,0.0,0.0,4.0,0.0,180.0,73.0,2.0,3.0,1.0,4.0,2.0,3.0,3.0,1.0,1.0,4.0,1.0,11.0,13.0,13.0,14.0,14.0,11.0,15.0,12.0,3.0,7.0,14.0,14.0,8.0,13.0,12.0,14.0,17.0,13.0,15.0,14.0,14.0,16.0,12.0,15.0,16.0,12.0,18.0,16.0,13.0,14.0,13.0,12.0,8.0,14.0,13.0,20.0,15.0,12.0,15.0,8.0,14.0,7.0,15.0,19.0,14.0,17.0,14.0,18.0,16.0,16.0,5.0
3,0,34.0,1.0,0.0,0.0,0.0,187.0,87.0,13.0,14.0,15.0,7.0,13.0,11.0,14.0,15.0,11.0,17.0,12.0,2.0,1.0,1.0,3.0,8.0,7.0,2.0,1.0,2.0,1.0,9.0,8.0,2.0,6.0,12.0,15.0,17.0,14.0,15.0,8.0,13.0,17.0,7.0,14.0,6.0,14.0,12.0,6.0,7.0,13.0,14.0,13.0,8.0,13.0,8.0,20.0,11.0,16.0,14.0,10.0,14.0,6.0,1.0,12.0,12.0,15.0,16.0,16.0,14.0,15.0,6.0,31.0,2.0,0.0,0.0,0.0,187.0,83.0,3.0,1.0,3.0,1.0,3.0,2.0,1.0,3.0,3.0,1.0,1.0,8.0,11.0,10.0,8.0,11.0,8.0,15.0,8.0,13.0,14.0,11.0,11.0,14.0,8.0,16.0,13.0,15.0,14.0,12.0,5.0,12.0,13.0,9.0,9.0,11.0,14.0,12.0,13.0,13.0,8.0,16.0,14.0,5.0,14.0,13.0,20.0,12.0,14.0,14.0,15.0,12.0,5.0,8.0,12.0,14.0,11.0,11.0,14.0,12.0,13.0,5.0,28.0,0.0,0.0,0.0,0.0,190.0,85.0,3.0,2.0,3.0,3.0,2.0,2.0,2.0,4.0,3.0,1.0,2.0,5.0,9.0,8.0,9.0,8.0,7.0,14.0,10.0,9.0,15.0,9.0,6.0,14.0,9.0,16.0,13.0,16.0,10.0,13.0,10.0,12.0,15.0,6.0,13.0,7.0,13.0,14.0,16.0,12.0,11.0,17.0,13.0,20.0,15.0,13.0,8.0,15.0,15.0,12.0,14.0,14.0,9.0,8.0,14.0,13.0,14.0,11.0,12.0,13.0,16.0,14.0,23.0,0.0,0.0,0.0,0.0,174.0,64.0,4.0,3.0,1.0,1.0,3.0,3.0,2.0,3.0,3.0,2.0,3.0,8.0,12.0,10.0,8.0,11.0,7.0,10.0,9.0,12.0,14.0,9.0,10.0,13.0,12.0,12.0,12.0,12.0,11.0,12.0,10.0,12.0,13.0,8.0,9.0,12.0,11.0,13.0,14.0,15.0,14.0,11.0,10.0,10.0,14.0,14.0,20.0,15.0,10.0,14.0,12.0,12.0,8.0,13.0,10.0,12.0,15.0,12.0,13.0,10.0,17.0,6.0,26.0,0.0,0.0,0.0,0.0,176.0,70.0,2.0,1.0,4.0,3.0,3.0,3.0,1.0,3.0,3.0,2.0,1.0,10.0,11.0,11.0,6.0,13.0,9.0,5.0,12.0,11.0,13.0,13.0,7.0,14.0,13.0,15.0,11.0,14.0,12.0,11.0,9.0,12.0,13.0,9.0,9.0,13.0,12.0,15.0,14.0,12.0,16.0,12.0,7.0,20.0,13.0,13.0,10.0,15.0,11.0,13.0,14.0,13.0,11.0,9.0,8.0,9.0,17.0,12.0,14.0,14.0,15.0,3.0,32.0,36.0,0.0,12.0,2.0,183.0,77.0,1.0,3.0,2.0,1.0,3.0,1.0,1.0,2.0,1.0,1.0,3.0,6.0,11.0,8.0,6.0,13.0,11.0,13.0,10.0,6.0,15.0,14.0,10.0,17.0,12.0,15.0,16.0,18.0,14.0,17.0,12.0,15.0,17.0,11.0,17.0,7.0,17.0,20.0,16.0,9.0,11.0,15.0,11.0,8.0,15.0,10.0,20.0,14.0,14.0,17.0,10.0,16.0,10.0,13.0,15.0,15.0,15.0,14.0,18.0,15.0,13.0,6.0,26.0,0.0,0.0,0.0,0.0,184.0,76.0,3.0,1.0,3.0,1.0,3.0,2.0,3.0,2.0,1.0,1.0,3.0,10.0,11.0,13.0,9.0,13.0,12.0,13.0,10.0,6.0,11.0,13.0,9.0,14.0,12.0,12.0,13.0,12.0,12.0,11.0,13.0,12.0,13.0,13.0,10.0,12.0,13.0,12.0,16.0,15.0,13.0,15.0,13.0,20.0,15.0,14.0,5.0,16.0,15.0,13.0,12.0,14.0,5.0,12.0,18.0,14.0,10.0,7.0,11.0,11.0,13.0,10.0,20.0,0.0,0.0,0.0,0.0,173.0,66.0,1.0,1.0,1.0,1.0,1.0,2.0,3.0,1.0,3.0,3.0,4.0,15.0,13.0,13.0,10.0,15.0,12.0,5.0,13.0,5.0,7.0,15.0,12.0,7.0,15.0,10.0,10.0,13.0,12.0,10.0,16.0,13.0,18.0,14.0,7.0,14.0,12.0,14.0,14.0,8.0,14.0,13.0,7.0,14.0,12.0,9.0,20.0,12.0,13.0,12.0,8.0,15.0,6.0,12.0,12.0,14.0,14.0,14.0,15.0,14.0,11.0,6.0,19.0,0.0,0.0,11.0,1.0,171.0,65.0,2.0,2.0,2.0,2.0,2.0,3.0,3.0,3.0,1.0,1.0,3.0,14.0,13.0,13.0,11.0,14.0,15.0,8.0,12.0,6.0,4.0,13.0,12.0,4.0,15.0,8.0,12.0,10.0,12.0,8.0,13.0,13.0,14.0,15.0,8.0,14.0,6.0,13.0,12.0,15.0,16.0,10.0,7.0,20.0,13.0,15.0,10.0,12.0,7.0,11.0,6.0,11.0,8.0,11.0,12.0,13.0,11.0,12.0,12.0,6.0,12.0,5.0,22.0,0.0,0.0,0.0,0.0,181.0,81.0,2.0,3.0,2.0,1.0,3.0,3.0,4.0,2.0,1.0,1.0,2.0,5.0,11.0,12.0,14.0,12.0,6.0,13.0,10.0,5.0,4.0,12.0,12.0,4.0,13.0,8.0,12.0,13.0,12.0,12.0,11.0,11.0,15.0,14.0,5.0,14.0,10.0,13.0,15.0,13.0,12.0,14.0,10.0,20.0,15.0,12.0,14.0,13.0,14.0,13.0,8.0,12.0,5.0,14.0,8.0,12.0,12.0,9.0,13.0,12.0,14.0,7.0,20.0,7.0,1.0,0.0,0.0,182.0,75.0,2.0,1.0,3.0,2.0,2.0,1.0,3.0,1.0,3.0,2.0,1.0,11.0,11.0,13.0,12.0,13.0,11.0,12.0,10.0,5.0,4.0,12.0,8.0,5.0,13.0,11.0,12.0,11.0,11.0,8.0,10.0,10.0,3.0,10.0,1.0,13.0,8.0,12.0,12.0,15.0,14.0,13.0,11.0,6.0,14.0,13.0,20.0,12.0,13.0,12.0,9.0,11.0,9.0,11.0,9.0,9.0,9.0,12.0,11.0,9.0,17.0,7.0,20.0,0.0,0.0,3.0,0.0,193.0,80.0,10.0,12.0,12.0,9.0,11.0,11.0,13.0,15.0,13.0,7.0,12.0,7.0,1.0,1.0,2.0,8.0,11.0,1.0,2.0,1.0,2.0,11.0,2.0,1.0,8.0,4.0,14.0,14.0,11.0,9.0,11.0,12.0,12.0,2.0,15.0,1.0,13.0,11.0,6.0,12.0,13.0,15.0,16.0,20.0,15.0,10.0,6.0,13.0,14.0,12.0,11.0,11.0,10.0,1.0,11.0,9.0,12.0,12.0,13.0,10.0,10.0,1.0,24.0,0.0,0.0,0.0,0.0,184.0,89.0,2.0,3.0,3.0,2.0,2.0,3.0,3.0,1.0,2.0,3.0,2.0,4.0,10.0,8.0,6.0,11.0,9.0,14.0,9.0,7.0,14.0,11.0,6.0,11.0,11.0,13.0,12.0,16.0,11.0,13.0,10.0,11.0,14.0,6.0,8.0,7.0,12.0,13.0,14.0,14.0,12.0,16.0,12.0,20.0,14.0,13.0,6.0,14.0,16.0,14.0,13.0,13.0,7.0,8.0,7.0,14.0,13.0,12.0,14.0,14.0,14.0,6.0,24.0,0.0,0.0,0.0,0.0,175.0,68.0,4.0,3.0,3.0,4.0,1.0,3.0,2.0,2.0,3.0,3.0,1.0,8.0,12.0,11.0,7.0,11.0,8.0,9.0,12.0,13.0,11.0,11.0,7.0,12.0,13.0,12.0,11.0,14.0,12.0,11.0,10.0,12.0,14.0,6.0,8.0,13.0,12.0,14.0,14.0,13.0,13.0,10.0,6.0,12.0,14.0,13.0,20.0,14.0,9.0,13.0,6.0,12.0,5.0,15.0,15.0,10.0,10.0,13.0,14.0,15.0,13.0,4.0,26.0,1.0,0.0,0.0,0.0,185.0,80.0,3.0,1.0,3.0,3.0,3.0,3.0,2.0,3.0,4.0,2.0,1.0,5.0,9.0,11.0,8.0,11.0,6.0,12.0,8.0,10.0,15.0,11.0,12.0,14.0,12.0,16.0,12.0,17.0,14.0,9.0,9.0,10.0,15.0,13.0,9.0,7.0,10.0,8.0,12.0,15.0,13.0,17.0,14.0,8.0,13.0,18.0,20.0,13.0,14.0,11.0,12.0,11.0,4.0,10.0,12.0,12.0,13.0,10.0,10.0,8.0,7.0,14.0,32.0,23.0,0.0,0.0,0.0,178.0,77.0,3.0,2.0,3.0,1.0,3.0,1.0,3.0,2.0,1.0,3.0,1.0,9.0,12.0,12.0,6.0,13.0,12.0,10.0,10.0,10.0,13.0,12.0,7.0,14.0,13.0,15.0,14.0,13.0,13.0,10.0,10.0,12.0,5.0,12.0,11.0,12.0,13.0,14.0,14.0,14.0,13.0,12.0,9.0,20.0,14.0,14.0,10.0,13.0,12.0,13.0,6.0,14.0,6.0,10.0,13.0,5.0,11.0,8.0,10.0,14.0,9.0,15.0,31.0,0.0,0.0,0.0,0.0,180.0,74.0,3.0,2.0,3.0,1.0,2.0,3.0,2.0,1.0,4.0,3.0,3.0,12.0,12.0,10.0,9.0,13.0,14.0,11.0,13.0,6.0,10.0,14.0,15.0,13.0,13.0,15.0,14.0,17.0,12.0,14.0,13.0,13.0,15.0,7.0,13.0,10.0,13.0,18.0,15.0,9.0,11.0,14.0,10.0,10.0,13.0,12.0,20.0,15.0,14.0,14.0,13.0,15.0,8.0,7.0,19.0,13.0,13.0,13.0,13.0,13.0,12.0,9.0,23.0,5.0,0.0,0.0,0.0,180.0,75.0,1.0,1.0,2.0,3.0,3.0,1.0,2.0,2.0,3.0,1.0,3.0,5.0,9.0,12.0,7.0,14.0,8.0,12.0,11.0,6.0,11.0,12.0,12.0,11.0,11.0,12.0,13.0,13.0,11.0,10.0,13.0,11.0,14.0,11.0,7.0,11.0,12.0,14.0,13.0,15.0,13.0,14.0,10.0,7.0,14.0,14.0,20.0,13.0,14.0,12.0,11.0,12.0,12.0,15.0,10.0,14.0,13.0,12.0,14.0,14.0,14.0,6.0,27.0,27.0,1.0,2.0,1.0,183.0,72.0,2.0,2.0,2.0,1.0,2.0,1.0,3.0,1.0,2.0,2.0,4.0,5.0,8.0,10.0,6.0,11.0,10.0,14.0,11.0,5.0,14.0,12.0,10.0,15.0,11.0,14.0,13.0,16.0,11.0,11.0,9.0,10.0,12.0,8.0,12.0,8.0,13.0,14.0,14.0,14.0,12.0,16.0,11.0,8.0,12.0,13.0,20.0,15.0,15.0,10.0,14.0,11.0,7.0,11.0,13.0,13.0,9.0,9.0,11.0,10.0,10.0,8.0,31.0,0.0,0.0,0.0,0.0,175.0,65.0,3.0,4.0,1.0,1.0,3.0,3.0,3.0,2.0,4.0,3.0,3.0,14.0,13.0,13.0,7.0,14.0,12.0,7.0,12.0,7.0,6.0,14.0,15.0,8.0,15.0,11.0,12.0,13.0,13.0,11.0,14.0,12.0,15.0,13.0,9.0,11.0,10.0,12.0,13.0,14.0,15.0,12.0,7.0,20.0,10.0,13.0,10.0,12.0,9.0,12.0,11.0,15.0,16.0,13.0,8.0,14.0,14.0,14.0,13.0,13.0,13.0,7.0,21.0,0.0,0.0,0.0,0.0,181.0,73.0,2.0,3.0,2.0,2.0,1.0,2.0,1.0,2.0,1.0,3.0,1.0,6.0,9.0,12.0,11.0,11.0,8.0,9.0,11.0,6.0,4.0,9.0,12.0,3.0,13.0,10.0,11.0,12.0,11.0,9.0,9.0,9.0,14.0,13.0,6.0,13.0,6.0,10.0,12.0,15.0,14.0,13.0,10.0,8.0,12.0,14.0,20.0,11.0,12.0,12.0,10.0,14.0,10.0,8.0,16.0,13.0,13.0,14.0,12.0,15.0,15.0,8.0,28.0,37.0,15.0,1.0,0.0,194.0,88.0,2.0,1.0,2.0,1.0,1.0,2.0,3.0,1.0,3.0,2.0,2.0,4.0,6.0,12.0,15.0,12.0,7.0,16.0,11.0,3.0,6.0,10.0,14.0,4.0,11.0,10.0,14.0,15.0,13.0,10.0,8.0,9.0,13.0,12.0,6.0,14.0,8.0,11.0,16.0,13.0,12.0,18.0,17.0,9.0,12.0,12.0,20.0,14.0,18.0,13.0,10.0,15.0,15.0,6.0,20.0,17.0,12.0,15.0,14.0,11.0,14.0,7.0
1,4,25.0,4.0,0.0,11.0,0.0,184.0,81.0,14.0,14.0,13.0,9.0,15.0,12.0,16.0,16.0,13.0,7.0,11.0,8.0,1.0,2.0,1.0,11.0,12.0,6.0,1.0,3.0,3.0,11.0,5.0,3.0,11.0,8.0,15.0,15.0,13.0,14.0,10.0,11.0,14.0,8.0,13.0,5.0,13.0,10.0,10.0,14.0,16.0,14.0,13.0,20.0,14.0,12.0,5.0,14.0,14.0,15.0,9.0,16.0,6.0,1.0,17.0,11.0,15.0,13.0,14.0,12.0,12.0,4.0,20.0,1.0,0.0,10.0,0.0,183.0,73.0,2.0,4.0,4.0,2.0,1.0,2.0,2.0,3.0,3.0,3.0,3.0,8.0,9.0,10.0,6.0,14.0,7.0,12.0,5.0,9.0,14.0,12.0,9.0,15.0,13.0,11.0,15.0,13.0,14.0,13.0,12.0,10.0,16.0,13.0,11.0,9.0,14.0,13.0,13.0,12.0,12.0,13.0,13.0,10.0,13.0,13.0,20.0,13.0,12.0,12.0,11.0,8.0,7.0,10.0,17.0,14.0,8.0,14.0,14.0,5.0,15.0,7.0,27.0,4.0,0.0,5.0,1.0,184.0,83.0,2.0,4.0,3.0,1.0,1.0,2.0,1.0,2.0,4.0,2.0,3.0,4.0,8.0,11.0,4.0,10.0,4.0,14.0,4.0,4.0,15.0,12.0,5.0,16.0,11.0,14.0,14.0,16.0,14.0,10.0,11.0,12.0,17.0,7.0,10.0,9.0,13.0,14.0,15.0,14.0,13.0,16.0,13.0,10.0,15.0,13.0,20.0,15.0,16.0,12.0,12.0,14.0,6.0,12.0,11.0,13.0,12.0,12.0,16.0,15.0,14.0,6.0,19.0,0.0,0.0,3.0,1.0,181.0,69.0,3.0,2.0,3.0,3.0,2.0,1.0,1.0,1.0,3.0,3.0,4.0,10.0,10.0,12.0,12.0,12.0,7.0,8.0,11.0,5.0,7.0,10.0,10.0,7.0,11.0,8.0,10.0,10.0,12.0,8.0,11.0,8.0,14.0,13.0,6.0,14.0,8.0,13.0,13.0,16.0,14.0,13.0,9.0,20.0,15.0,16.0,10.0,15.0,13.0,12.0,8.0,11.0,7.0,12.0,11.0,11.0,15.0,10.0,12.0,14.0,14.0,1.0,37.0,0.0,0.0,0.0,0.0,185.0,83.0,1.0,1.0,2.0,1.0,3.0,2.0,3.0,1.0,1.0,3.0,1.0,6.0,8.0,9.0,12.0,10.0,8.0,13.0,9.0,4.0,5.0,10.0,14.0,4.0,11.0,11.0,10.0,11.0,13.0,12.0,12.0,13.0,15.0,14.0,12.0,11.0,7.0,12.0,8.0,7.0,7.0,12.0,12.0,11.0,11.0,7.0,20.0,8.0,14.0,12.0,8.0,13.0,9.0,12.0,12.0,12.0,19.0,14.0,15.0,14.0,8.0,8.0,32.0,11.0,1.0,0.0,0.0,176.0,68.0,2.0,1.0,3.0,2.0,2.0,2.0,2.0,3.0,3.0,2.0,2.0,8.0,10.0,10.0,7.0,11.0,8.0,10.0,11.0,12.0,11.0,13.0,12.0,14.0,12.0,9.0,14.0,15.0,13.0,12.0,11.0,12.0,17.0,8.0,14.0,14.0,11.0,18.0,18.0,14.0,14.0,12.0,10.0,10.0,14.0,13.0,20.0,17.0,13.0,15.0,9.0,13.0,8.0,13.0,17.0,13.0,15.0,16.0,16.0,16.0,18.0,5.0,27.0,8.0,0.0,6.0,0.0,187.0,76.0,3.0,2.0,3.0,2.0,2.0,1.0,1.0,3.0,3.0,1.0,2.0,5.0,7.0,11.0,5.0,14.0,5.0,14.0,9.0,5.0,15.0,15.0,8.0,14.0,13.0,15.0,16.0,15.0,14.0,12.0,14.0,14.0,18.0,8.0,17.0,9.0,12.0,18.0,15.0,13.0,14.0,15.0,14.0,10.0,17.0,12.0,20.0,17.0,15.0,14.0,13.0,16.0,4.0,12.0,10.0,14.0,17.0,12.0,15.0,13.0,13.0,6.0,24.0,0.0,0.0,6.0,1.0,172.0,70.0,3.0,1.0,1.0,3.0,1.0,2.0,3.0,1.0,1.0,3.0,3.0,11.0,12.0,11.0,8.0,12.0,10.0,6.0,14.0,7.0,11.0,15.0,8.0,12.0,13.0,14.0,14.0,18.0,13.0,12.0,13.0,13.0,15.0,12.0,12.0,12.0,11.0,18.0,18.0,13.0,14.0,13.0,7.0,10.0,16.0,12.0,20.0,14.0,12.0,14.0,14.0,15.0,4.0,8.0,7.0,14.0,14.0,13.0,14.0,12.0,10.0,6.0,21.0,0.0,0.0,15.0,3.0,181.0,78.0,3.0,3.0,4.0,2.0,1.0,2.0,2.0,4.0,2.0,1.0,1.0,5.0,7.0,11.0,10.0,14.0,5.0,14.0,10.0,6.0,13.0,14.0,8.0,14.0,14.0,12.0,14.0,12.0,11.0,10.0,12.0,11.0,16.0,11.0,12.0,14.0,14.0,14.0,14.0,14.0,13.0,14.0,13.0,10.0,16.0,14.0,20.0,16.0,14.0,12.0,10.0,11.0,5.0,19.0,8.0,11.0,14.0,11.0,16.0,13.0,13.0,10.0,22.0,24.0,3.0,7.0,0.0,177.0,78.0,2.0,1.0,2.0,3.0,2.0,2.0,4.0,3.0,3.0,2.0,1.0,10.0,13.0,16.0,14.0,16.0,16.0,8.0,16.0,4.0,4.0,15.0,12.0,4.0,16.0,12.0,11.0,12.0,13.0,10.0,11.0,8.0,13.0,17.0,5.0,14.0,5.0,10.0,12.0,15.0,14.0,13.0,9.0,10.0,17.0,16.0,20.0,15.0,14.0,12.0,11.0,15.0,4.0,12.0,19.0,16.0,14.0,14.0,11.0,13.0,10.0,12.0,22.0,5.0,1.0,1.0,0.0,173.0,72.0,1.0,3.0,1.0,3.0,3.0,3.0,3.0,3.0,3.0,2.0,2.0,14.0,13.0,16.0,14.0,16.0,14.0,5.0,11.0,5.0,5.0,15.0,11.0,5.0,16.0,8.0,13.0,9.0,14.0,13.0,15.0,13.0,15.0,16.0,5.0,13.0,5.0,9.0,10.0,15.0,16.0,14.0,5.0,20.0,14.0,15.0,5.0,12.0,14.0,13.0,11.0,13.0,8.0,14.0,10.0,15.0,14.0,10.0,13.0,10.0,10.0,13.0,25.0,0.0,0.0,0.0,0.0,187.0,83.0,11.0,14.0,12.0,8.0,13.0,11.0,14.0,15.0,13.0,13.0,9.0,8.0,1.0,1.0,1.0,11.0,11.0,1.0,2.0,2.0,1.0,10.0,3.0,2.0,11.0,8.0,12.0,14.0,12.0,12.0,10.0,12.0,14.0,6.0,14.0,2.0,12.0,12.0,8.0,13.0,15.0,14.0,13.0,20.0,15.0,11.0,5.0,14.0,13.0,13.0,8.0,8.0,10.0,1.0,9.0,13.0,14.0,12.0,15.0,15.0,15.0,5.0,28.0,0.0,0.0,0.0,0.0,184.0,85.0,2.0,3.0,2.0,1.0,1.0,3.0,2.0,2.0,3.0,1.0,3.0,4.0,8.0,8.0,6.0,12.0,6.0,14.0,8.0,5.0,13.0,12.0,6.0,14.0,12.0,11.0,13.0,14.0,13.0,12.0,11.0,11.0,13.0,7.0,14.0,10.0,15.0,16.0,12.0,12.0,11.0,15.0,12.0,20.0,13.0,11.0,7.0,14.0,16.0,13.0,11.0,13.0,13.0,12.0,15.0,13.0,13.0,14.0,15.0,14.0,14.0,6.0,25.0,0.0,0.0,3.0,0.0,184.0,80.0,2.0,2.0,4.0,2.0,1.0,3.0,2.0,1.0,1.0,2.0,1.0,5.0,8.0,7.0,6.0,9.0,6.0,14.0,6.0,6.0,14.0,7.0,6.0,13.0,9.0,12.0,14.0,13.0,11.0,13.0,7.0,12.0,14.0,8.0,10.0,7.0,14.0,13.0,14.0,15.0,12.0,14.0,12.0,8.0,15.0,15.0,20.0,14.0,14.0,13.0,12.0,14.0,5.0,10.0,16.0,13.0,15.0,15.0,12.0,14.0,14.0,8.0,32.0,1.0,0.0,5.0,0.0,189.0,93.0,1.0,1.0,3.0,4.0,2.0,2.0,3.0,2.0,3.0,3.0,3.0,3.0,8.0,8.0,7.0,9.0,8.0,16.0,8.0,7.0,14.0,10.0,9.0,14.0,9.0,15.0,14.0,16.0,12.0,10.0,10.0,12.0,14.0,9.0,9.0,7.0,13.0,14.0,15.0,9.0,8.0,10.0,14.0,8.0,16.0,11.0,20.0,14.0,19.0,12.0,14.0,12.0,8.0,6.0,13.0,16.0,14.0,11.0,15.0,14.0,12.0,10.0,21.0,0.0,0.0,4.0,0.0,178.0,72.0,2.0,3.0,1.0,2.0,2.0,3.0,3.0,1.0,2.0,2.0,3.0,6.0,12.0,10.0,7.0,11.0,7.0,9.0,8.0,11.0,12.0,11.0,8.0,13.0,11.0,10.0,12.0,11.0,12.0,13.0,11.0,11.0,13.0,8.0,11.0,12.0,12.0,13.0,14.0,15.0,13.0,13.0,9.0,7.0,14.0,14.0,20.0,14.0,12.0,13.0,10.0,12.0,9.0,14.0,16.0,15.0,8.0,10.0,12.0,16.0,17.0,10.0,26.0,0.0,0.0,0.0,0.0,177.0,68.0,4.0,2.0,1.0,2.0,3.0,1.0,1.0,2.0,3.0,3.0,3.0,12.0,13.0,11.0,8.0,13.0,11.0,8.0,10.0,8.0,10.0,13.0,10.0,12.0,13.0,7.0,12.0,10.0,13.0,11.0,15.0,13.0,14.0,11.0,7.0,14.0,10.0,14.0,14.0,13.0,15.0,12.0,9.0,20.0,15.0,14.0,5.0,15.0,8.0,13.0,7.0,14.0,6.0,12.0,11.0,12.0,14.0,13.0,16.0,16.0,16.0,5.0,31.0,0.0,0.0,4.0,0.0,174.0,72.0,2.0,1.0,4.0,2.0,2.0,3.0,1.0,1.0,3.0,3.0,4.0,12.0,9.0,11.0,6.0,14.0,11.0,7.0,10.0,6.0,8.0,16.0,12.0,9.0,14.0,9.0,14.0,10.0,13.0,12.0,12.0,11.0,14.0,8.0,8.0,11.0,12.0,14.0,12.0,13.0,14.0,12.0,7.0,12.0,14.0,12.0,20.0,15.0,11.0,11.0,9.0,12.0,8.0,10.0,10.0,14.0,13.0,10.0,12.0,14.0,14.0,9.0,30.0,0.0,0.0,11.0,4.0,172.0,69.0,4.0,2.0,2.0,3.0,3.0,3.0,3.0,3.0,4.0,4.0,3.0,13.0,13.0,13.0,11.0,13.0,13.0,7.0,12.0,9.0,4.0,13.0,12.0,4.0,15.0,7.0,12.0,10.0,12.0,12.0,15.0,12.0,13.0,17.0,8.0,14.0,7.0,12.0,12.0,14.0,15.0,12.0,6.0,20.0,10.0,14.0,10.0,13.0,7.0,12.0,6.0,12.0,15.0,13.0,10.0,11.0,13.0,12.0,11.0,14.0,14.0,6.0,33.0,0.0,0.0,5.0,1.0,181.0,80.0,3.0,1.0,2.0,2.0,3.0,2.0,1.0,1.0,4.0,3.0,1.0,7.0,8.0,13.0,13.0,13.0,11.0,12.0,10.0,5.0,5.0,12.0,13.0,4.0,14.0,11.0,13.0,14.0,11.0,13.0,13.0,12.0,13.0,14.0,11.0,14.0,8.0,11.0,12.0,13.0,12.0,13.0,10.0,9.0,11.0,12.0,20.0,13.0,12.0,12.0,11.0,14.0,13.0,8.0,12.0,13.0,10.0,10.0,13.0,15.0,14.0,8.0,27.0,33.0,4.0,3.0,0.0,180.0,75.0,2.0,1.0,2.0,1.0,4.0,2.0,1.0,3.0,1.0,1.0,2.0,12.0,11.0,13.0,13.0,11.0,11.0,11.0,10.0,7.0,5.0,10.0,14.0,5.0,14.0,9.0,11.0,12.0,10.0,11.0,12.0,12.0,14.0,13.0,8.0,14.0,8.0,11.0,14.0,16.0,14.0,13.0,10.0,7.0,12.0,15.0,20.0,14.0,12.0,12.0,9.0,13.0,10.0,10.0,9.0,15.0,8.0,9.0,13.0,14.0,14.0,7.0,24.0,24.0,4.0,0.0,0.0,172.0,74.0,2.0,4.0,3.0,2.0,2.0,1.0,2.0,2.0,3.0,2.0,4.0,8.0,9.0,14.0,13.0,14.0,9.0,11.0,10.0,7.0,5.0,12.0,12.0,3.0,13.0,10.0,12.0,12.0,13.0,12.0,11.0,10.0,14.0,13.0,7.0,14.0,9.0,9.0,13.0,16.0,15.0,13.0,6.0,8.0,13.0,16.0,20.0,14.0,12.0,11.0,11.0,13.0,9.0,8.0,9.0,13.0,9.0,11.0,12.0,13.0,10.0,9.0
1,2,25.0,0.0,0.0,0.0,0.0,185.0,85.0,14.0,11.0,14.0,10.0,12.0,14.0,13.0,14.0,11.0,15.0,9.0,4.0,1.0,3.0,1.0,9.0,8.0,3.0,11.0,1.0,2.0,8.0,2.0,7.0,9.0,8.0,13.0,13.0,12.0,12.0,8.0,11.0,16.0,6.0,14.0,1.0,12.0,12.0,7.0,10.0,13.0,15.0,12.0,5.0,17.0,9.0,20.0,13.0,15.0,14.0,8.0,13.0,3.0,1.0,17.0,13.0,13.0,13.0,14.0,14.0,14.0,5.0,36.0,0.0,0.0,0.0,0.0,182.0,70.0,2.0,1.0,3.0,3.0,1.0,2.0,1.0,1.0,1.0,1.0,3.0,8.0,11.0,8.0,6.0,11.0,7.0,10.0,8.0,12.0,13.0,10.0,6.0,14.0,11.0,15.0,13.0,15.0,11.0,12.0,7.0,10.0,12.0,6.0,13.0,7.0,14.0,14.0,14.0,12.0,11.0,14.0,11.0,12.0,12.0,10.0,20.0,13.0,12.0,12.0,15.0,13.0,9.0,10.0,6.0,12.0,14.0,11.0,15.0,12.0,12.0,6.0,31.0,0.0,0.0,0.0,0.0,190.0,82.0,1.0,1.0,2.0,2.0,2.0,1.0,3.0,1.0,1.0,1.0,2.0,4.0,8.0,8.0,6.0,12.0,10.0,15.0,13.0,8.0,14.0,13.0,7.0,14.0,13.0,14.0,14.0,15.0,11.0,11.0,12.0,12.0,13.0,7.0,11.0,10.0,13.0,14.0,16.0,12.0,10.0,9.0,15.0,5.0,13.0,13.0,20.0,13.0,15.0,12.0,14.0,14.0,13.0,12.0,10.0,13.0,14.0,11.0,14.0,13.0,13.0,9.0,24.0,2.0,0.0,0.0,0.0,188.0,83.0,2.0,2.0,2.0,1.0,3.0,2.0,3.0,3.0,1.0,2.0,1.0,11.0,12.0,11.0,6.0,12.0,11.0,11.0,9.0,13.0,11.0,11.0,10.0,12.0,12.0,13.0,13.0,12.0,12.0,9.0,11.0,11.0,2.0,12.0,11.0,12.0,8.0,12.0,12.0,11.0,10.0,13.0,13.0,20.0,12.0,12.0,4.0,12.0,13.0,12.0,9.0,5.0,7.0,11.0,8.0,10.0,14.0,12.0,12.0,1.0,18.0,8.0,29.0,6.0,0.0,0.0,0.0,183.0,72.0,3.0,3.0,3.0,4.0,1.0,3.0,3.0,3.0,1.0,3.0,3.0,2.0,13.0,13.0,8.0,14.0,8.0,10.0,12.0,10.0,12.0,13.0,8.0,14.0,10.0,14.0,13.0,10.0,12.0,12.0,10.0,12.0,4.0,12.0,4.0,14.0,12.0,13.0,14.0,14.0,13.0,13.0,11.0,5.0,14.0,15.0,20.0,14.0,11.0,13.0,2.0,12.0,7.0,8.0,16.0,10.0,11.0,13.0,10.0,3.0,19.0,8.0,26.0,0.0,0.0,0.0,0.0,175.0,70.0,2.0,1.0,1.0,2.0,2.0,2.0,3.0,2.0,2.0,1.0,1.0,13.0,12.0,11.0,8.0,14.0,11.0,7.0,11.0,6.0,5.0,14.0,11.0,6.0,15.0,11.0,12.0,12.0,15.0,10.0,13.0,12.0,14.0,13.0,7.0,12.0,12.0,16.0,12.0,12.0,14.0,12.0,8.0,8.0,11.0,13.0,20.0,11.0,9.0,8.0,8.0,12.0,15.0,14.0,12.0,13.0,11.0,13.0,12.0,15.0,15.0,7.0,23.0,2.0,0.0,5.0,0.0,180.0,77.0,3.0,2.0,2.0,3.0,2.0,3.0,2.0,2.0,3.0,3.0,4.0,14.0,12.0,12.0,10.0,13.0,14.0,6.0,14.0,8.0,8.0,13.0,12.0,9.0,14.0,13.0,12.0,12.0,11.0,10.0,12.0,13.0,13.0,10.0,6.0,13.0,10.0,12.0,14.0,13.0,14.0,13.0,10.0,8.0,13.0,14.0,20.0,14.0,14.0,9.0,8.0,14.0,6.0,16.0,13.0,12.0,13.0,12.0,13.0,13.0,14.0,6.0,23.0,0.0,0.0,0.0,0.0,185.0,67.0,3.0,1.0,3.0,1.0,2.0,2.0,3.0,1.0,2.0,2.0,1.0,13.0,11.0,14.0,13.0,13.0,12.0,3.0,14.0,5.0,5.0,15.0,11.0,5.0,14.0,6.0,12.0,11.0,13.0,13.0,12.0,12.0,15.0,11.0,2.0,12.0,12.0,14.0,13.0,11.0,13.0,12.0,7.0,10.0,7.0,13.0,20.0,14.0,8.0,13.0,10.0,13.0,10.0,9.0,9.0,11.0,12.0,10.0,12.0,10.0,17.0,3.0,30.0,0.0,0.0,0.0,0.0,162.0,65.0,1.0,1.0,1.0,1.0,3.0,3.0,3.0,4.0,2.0,2.0,1.0,13.0,12.0,14.0,10.0,14.0,15.0,5.0,12.0,6.0,4.0,11.0,12.0,3.0,15.0,11.0,12.0,8.0,10.0,13.0,13.0,12.0,17.0,15.0,9.0,13.0,7.0,11.0,14.0,15.0,14.0,7.0,3.0,14.0,11.0,13.0,20.0,11.0,7.0,13.0,11.0,15.0,11.0,8.0,10.0,14.0,13.0,14.0,14.0,13.0,10.0,6.0,23.0,0.0,0.0,0.0,0.0,183.0,80.0,3.0,2.0,1.0,3.0,1.0,3.0,2.0,3.0,1.0,2.0,3.0,4.0,12.0,13.0,14.0,12.0,9.0,10.0,14.0,5.0,5.0,12.0,11.0,7.0,12.0,11.0,12.0,12.0,10.0,12.0,10.0,11.0,5.0,11.0,9.0,14.0,10.0,13.0,12.0,15.0,14.0,13.0,11.0,8.0,12.0,14.0,20.0,13.0,14.0,10.0,8.0,13.0,7.0,7.0,16.0,14.0,11.0,10.0,12.0,9.0,9.0,2.0,27.0,11.0,1.0,0.0,0.0,187.0,86.0,3.0,1.0,2.0,2.0,4.0,3.0,2.0,1.0,1.0,3.0,1.0,3.0,9.0,13.0,15.0,12.0,10.0,17.0,11.0,5.0,5.0,9.0,14.0,4.0,11.0,9.0,12.0,13.0,12.0,11.0,9.0,10.0,13.0,11.0,10.0,13.0,10.0,15.0,15.0,14.0,12.0,15.0,13.0,7.0,15.0,13.0,20.0,13.0,15.0,14.0,9.0,13.0,7.0,5.0,15.0,13.0,13.0,11.0,10.0,12.0,18.0,6.0,30.0,0.0,0.0,0.0,0.0,180.0,75.0,11.0,13.0,13.0,9.0,13.0,11.0,12.0,15.0,15.0,14.0,13.0,6.0,1.0,2.0,3.0,7.0,8.0,1.0,1.0,1.0,2.0,7.0,2.0,1.0,7.0,8.0,12.0,14.0,13.0,14.0,7.0,12.0,14.0,5.0,12.0,3.0,13.0,15.0,9.0,13.0,14.0,13.0,10.0,5.0,14.0,11.0,20.0,12.0,13.0,12.0,8.0,14.0,6.0,1.0,9.0,13.0,14.0,13.0,16.0,15.0,15.0,5.0,21.0,0.0,0.0,0.0,0.0,182.0,74.0,2.0,2.0,2.0,2.0,2.0,1.0,1.0,1.0,3.0,2.0,2.0,9.0,11.0,12.0,7.0,9.0,8.0,12.0,7.0,11.0,12.0,7.0,8.0,13.0,11.0,12.0,12.0,14.0,12.0,13.0,7.0,12.0,11.0,1.0,9.0,11.0,9.0,10.0,12.0,14.0,10.0,13.0,11.0,9.0,8.0,12.0,20.0,13.0,11.0,10.0,13.0,8.0,10.0,10.0,15.0,11.0,13.0,10.0,10.0,8.0,13.0,7.0,26.0,11.0,0.0,0.0,0.0,180.0,81.0,3.0,2.0,2.0,3.0,3.0,2.0,1.0,2.0,2.0,1.0,2.0,5.0,9.0,8.0,5.0,11.0,5.0,13.0,10.0,8.0,15.0,10.0,7.0,13.0,10.0,15.0,14.0,17.0,11.0,12.0,9.0,12.0,16.0,8.0,10.0,8.0,13.0,14.0,15.0,13.0,12.0,14.0,12.0,20.0,14.0,12.0,8.0,14.0,14.0,14.0,10.0,15.0,13.0,8.0,9.0,14.0,17.0,13.0,13.0,13.0,11.0,8.0,32.0,0.0,0.0,0.0,0.0,165.0,65.0,1.0,2.0,3.0,1.0,3.0,1.0,3.0,2.0,1.0,4.0,4.0,7.0,12.0,10.0,5.0,13.0,8.0,9.0,8.0,11.0,13.0,12.0,10.0,14.0,11.0,14.0,13.0,15.0,12.0,12.0,8.0,11.0,14.0,5.0,8.0,7.0,10.0,15.0,17.0,14.0,13.0,14.0,4.0,10.0,13.0,13.0,20.0,15.0,12.0,14.0,5.0,13.0,7.0,8.0,7.0,12.0,17.0,13.0,15.0,13.0,13.0,7.0,28.0,22.0,0.0,20.0,1.0,176.0,74.0,2.0,3.0,2.0,1.0,1.0,1.0,3.0,3.0,2.0,2.0,1.0,15.0,15.0,12.0,8.0,13.0,12.0,5.0,11.0,15.0,10.0,13.0,9.0,10.0,12.0,10.0,11.0,10.0,13.0,12.0,11.0,12.0,11.0,11.0,7.0,13.0,10.0,14.0,15.0,15.0,14.0,10.0,8.0,20.0,13.0,14.0,8.0,15.0,8.0,14.0,5.0,12.0,5.0,14.0,15.0,15.0,10.0,14.0,13.0,12.0,12.0,2.0,31.0,0.0,0.0,0.0,0.0,178.0,70.0,3.0,1.0,3.0,3.0,2.0,2.0,2.0,1.0,2.0,1.0,2.0,5.0,8.0,7.0,7.0,12.0,5.0,8.0,8.0,7.0,14.0,13.0,8.0,13.0,12.0,15.0,14.0,17.0,12.0,13.0,9.0,13.0,16.0,10.0,15.0,8.0,13.0,18.0,15.0,13.0,14.0,12.0,9.0,10.0,15.0,13.0,20.0,16.0,13.0,14.0,12.0,14.0,5.0,16.0,13.0,12.0,16.0,13.0,13.0,13.0,13.0,6.0,20.0,0.0,0.0,0.0,0.0,175.0,77.0,2.0,1.0,2.0,3.0,3.0,3.0,3.0,1.0,4.0,3.0,1.0,8.0,8.0,12.0,12.0,11.0,8.0,13.0,10.0,9.0,10.0,11.0,10.0,9.0,12.0,12.0,6.0,9.0,9.0,11.0,15.0,11.0,4.0,10.0,8.0,12.0,11.0,10.0,13.0,14.0,15.0,15.0,8.0,8.0,9.0,15.0,20.0,11.0,12.0,12.0,8.0,4.0,10.0,10.0,15.0,11.0,12.0,11.0,9.0,10.0,10.0,7.0,22.0,0.0,0.0,4.0,0.0,179.0,71.0,1.0,3.0,1.0,3.0,2.0,1.0,3.0,2.0,1.0,2.0,4.0,11.0,13.0,12.0,8.0,15.0,11.0,6.0,11.0,6.0,4.0,14.0,12.0,6.0,16.0,7.0,12.0,10.0,12.0,11.0,13.0,13.0,13.0,9.0,6.0,12.0,9.0,15.0,12.0,13.0,14.0,12.0,9.0,20.0,14.0,12.0,10.0,13.0,10.0,13.0,7.0,14.0,7.0,8.0,18.0,13.0,14.0,14.0,16.0,15.0,15.0,5.0,32.0,25.0,0.0,0.0,0.0,181.0,82.0,2.0,3.0,3.0,1.0,1.0,1.0,1.0,3.0,1.0,2.0,3.0,5.0,10.0,6.0,7.0,10.0,7.0,14.0,9.0,8.0,11.0,12.0,7.0,13.0,10.0,15.0,14.0,16.0,11.0,13.0,10.0,12.0,16.0,9.0,15.0,8.0,11.0,16.0,18.0,11.0,12.0,14.0,11.0,8.0,13.0,11.0,20.0,17.0,15.0,13.0,15.0,11.0,6.0,14.0,18.0,12.0,13.0,13.0,14.0,11.0,11.0,8.0,21.0,0.0,0.0,4.0,1.0,184.0,79.0,1.0,2.0,3.0,1.0,2.0,1.0,3.0,2.0,2.0,1.0,3.0,3.0,6.0,10.0,12.0,12.0,7.0,15.0,8.0,4.0,5.0,13.0,10.0,8.0,12.0,18.0,12.0,19.0,13.0,10.0,13.0,12.0,14.0,13.0,10.0,12.0,9.0,16.0,15.0,12.0,14.0,14.0,14.0,12.0,13.0,10.0,20.0,14.0,14.0,11.0,14.0,14.0,11.0,5.0,10.0,13.0,14.0,15.0,10.0,8.0,4.0,15.0,19.0,0.0,0.0,0.0,0.0,173.0,67.0,3.0,2.0,4.0,2.0,1.0,1.0,3.0,1.0,1.0,1.0,2.0,13.0,13.0,15.0,10.0,14.0,11.0,6.0,12.0,4.0,4.0,12.0,11.0,5.0,14.0,10.0,12.0,9.0,10.0,8.0,12.0,8.0,11.0,15.0,5.0,12.0,6.0,8.0,10.0,16.0,15.0,13.0,7.0,8.0,13.0,15.0,20.0,11.0,9.0,12.0,6.0,12.0,6.0,15.0,8.0,13.0,8.0,12.0,9.0,14.0,13.0,9.0
4,0,25.0,0.0,0.0,11.0,0.0,189.0,83.0,12.0,12.0,11.0,7.0,13.0,12.0,17.0,17.0,16.0,12.0,13.0,6.0,2.0,1.0,1.0,10.0,10.0,7.0,1.0,1.0,1.0,9.0,5.0,1.0,10.0,8.0,15.0,14.0,14.0,12.0,7.0,13.0,12.0,6.0,9.0,3.0,16.0,17.0,10.0,13.0,16.0,14.0,12.0,8.0,15.0,10.0,20.0,13.0,14.0,14.0,5.0,14.0,4.0,12.0,15.0,15.0,13.0,13.0,17.0,15.0,17.0,4.0,20.0,0.0,0.0,7.0,0.0,186.0,72.0,3.0,3.0,2.0,3.0,3.0,4.0,3.0,3.0,2.0,2.0,2.0,4.0,9.0,8.0,6.0,13.0,6.0,14.0,6.0,7.0,14.0,12.0,8.0,13.0,13.0,11.0,13.0,14.0,14.0,14.0,9.0,13.0,13.0,8.0,8.0,8.0,13.0,14.0,14.0,13.0,13.0,15.0,13.0,20.0,15.0,14.0,8.0,14.0,13.0,12.0,8.0,12.0,4.0,10.0,8.0,15.0,14.0,12.0,14.0,15.0,14.0,7.0,23.0,2.0,0.0,5.0,3.0,182.0,73.0,3.0,1.0,1.0,1.0,2.0,1.0,2.0,1.0,3.0,4.0,2.0,12.0,14.0,14.0,10.0,13.0,12.0,16.0,11.0,13.0,12.0,13.0,13.0,14.0,14.0,12.0,11.0,14.0,13.0,11.0,13.0,11.0,15.0,15.0,9.0,15.0,10.0,14.0,15.0,16.0,15.0,13.0,13.0,20.0,14.0,15.0,6.0,15.0,12.0,13.0,9.0,13.0,14.0,15.0,17.0,15.0,13.0,12.0,12.0,15.0,13.0,9.0,24.0,9.0,0.0,7.0,1.0,190.0,82.0,2.0,2.0,3.0,3.0,1.0,2.0,2.0,1.0,1.0,3.0,1.0,8.0,14.0,13.0,11.0,12.0,10.0,12.0,11.0,9.0,11.0,13.0,8.0,13.0,13.0,10.0,14.0,14.0,13.0,13.0,14.0,14.0,16.0,11.0,6.0,12.0,12.0,16.0,16.0,12.0,11.0,11.0,14.0,8.0,14.0,14.0,20.0,15.0,13.0,14.0,9.0,13.0,8.0,14.0,13.0,14.0,12.0,14.0,16.0,12.0,15.0,2.0,23.0,25.0,0.0,0.0,0.0,174.0,74.0,2.0,1.0,1.0,1.0,3.0,3.0,3.0,3.0,3.0,1.0,2.0,8.0,13.0,12.0,8.0,12.0,8.0,14.0,9.0,13.0,14.0,12.0,6.0,16.0,13.0,13.0,14.0,15.0,13.0,11.0,10.0,12.0,15.0,9.0,10.0,14.0,11.0,14.0,17.0,16.0,13.0,14.0,10.0,8.0,17.0,15.0,20.0,18.0,15.0,14.0,13.0,14.0,8.0,12.0,12.0,14.0,13.0,13.0,12.0,12.0,15.0,13.0,23.0,15.0,1.0,7.0,0.0,165.0,60.0,2.0,3.0,2.0,1.0,1.0,1.0,3.0,3.0,2.0,1.0,3.0,14.0,14.0,16.0,8.0,16.0,13.0,6.0,10.0,6.0,11.0,18.0,15.0,12.0,18.0,16.0,15.0,15.0,17.0,13.0,17.0,15.0,14.0,18.0,12.0,10.0,12.0,15.0,16.0,14.0,16.0,16.0,6.0,12.0,13.0,14.0,20.0,15.0,11.0,16.0,14.0,15.0,10.0,12.0,14.0,15.0,16.0,14.0,14.0,13.0,10.0,6.0,21.0,0.0,0.0,15.0,1.0,189.0,75.0,3.0,3.0,3.0,3.0,1.0,1.0,3.0,3.0,3.0,2.0,3.0,10.0,12.0,13.0,7.0,14.0,8.0,14.0,12.0,5.0,13.0,15.0,8.0,15.0,14.0,14.0,14.0,15.0,14.0,14.0,13.0,14.0,15.0,12.0,10.0,12.0,14.0,15.0,16.0,12.0,13.0,15.0,14.0,20.0,14.0,13.0,10.0,16.0,13.0,14.0,11.0,14.0,7.0,10.0,8.0,16.0,10.0,12.0,13.0,13.0,11.0,14.0,29.0,51.0,8.0,24.0,0.0,175.0,70.0,3.0,4.0,2.0,3.0,2.0,3.0,2.0,2.0,2.0,1.0,3.0,6.0,12.0,12.0,10.0,13.0,7.0,12.0,12.0,8.0,14.0,13.0,9.0,16.0,13.0,14.0,16.0,16.0,15.0,16.0,11.0,14.0,16.0,8.0,14.0,14.0,15.0,18.0,18.0,15.0,14.0,16.0,8.0,20.0,16.0,14.0,8.0,18.0,14.0,16.0,13.0,14.0,7.0,14.0,15.0,14.0,14.0,14.0,16.0,16.0,16.0,5.0,28.0,66.0,15.0,13.0,3.0,180.0,70.0,2.0,2.0,1.0,2.0,1.0,1.0,3.0,2.0,3.0,3.0,1.0,14.0,15.0,16.0,13.0,17.0,15.0,6.0,15.0,4.0,5.0,16.0,14.0,8.0,17.0,13.0,16.0,11.0,15.0,13.0,16.0,14.0,13.0,17.0,10.0,14.0,9.0,13.0,13.0,16.0,18.0,12.0,10.0,20.0,14.0,15.0,8.0,16.0,9.0,13.0,14.0,12.0,10.0,15.0,14.0,15.0,10.0,16.0,14.0,6.0,12.0,10.0,22.0,24.0,2.0,1.0,1.0,187.0,75.0,1.0,2.0,1.0,1.0,2.0,1.0,2.0,1.0,2.0,3.0,3.0,13.0,13.0,16.0,13.0,17.0,10.0,9.0,17.0,8.0,6.0,14.0,10.0,8.0,16.0,10.0,12.0,9.0,12.0,10.0,15.0,11.0,10.0,15.0,7.0,13.0,8.0,12.0,11.0,15.0,14.0,10.0,16.0,18.0,12.0,13.0,20.0,14.0,11.0,8.0,5.0,15.0,12.0,13.0,11.0,17.0,8.0,10.0,16.0,12.0,14.0,13.0,29.0,76.0,27.0,13.0,9.0,188.0,72.0,2.0,3.0,1.0,2.0,3.0,3.0,1.0,3.0,3.0,3.0,3.0,5.0,10.0,13.0,16.0,13.0,11.0,17.0,13.0,5.0,10.0,13.0,14.0,10.0,13.0,15.0,16.0,18.0,14.0,15.0,10.0,13.0,14.0,13.0,10.0,18.0,12.0,14.0,19.0,15.0,14.0,16.0,14.0,10.0,18.0,16.0,20.0,18.0,14.0,14.0,8.0,15.0,5.0,16.0,10.0,16.0,12.0,14.0,16.0,14.0,10.0,10.0,26.0,2.0,0.0,1.0,0.0,188.0,84.0,12.0,13.0,15.0,9.0,15.0,13.0,13.0,15.0,10.0,11.0,14.0,9.0,2.0,1.0,2.0,12.0,11.0,3.0,2.0,3.0,3.0,11.0,3.0,1.0,10.0,14.0,13.0,14.0,10.0,13.0,11.0,11.0,14.0,3.0,11.0,5.0,12.0,15.0,13.0,10.0,12.0,13.0,14.0,5.0,14.0,9.0,20.0,12.0,14.0,12.0,10.0,15.0,3.0,11.0,12.0,11.0,16.0,13.0,15.0,16.0,16.0,4.0,29.0,0.0,0.0,0.0,0.0,183.0,74.0,3.0,3.0,3.0,3.0,3.0,2.0,2.0,2.0,1.0,3.0,1.0,5.0,12.0,7.0,6.0,10.0,7.0,14.0,12.0,5.0,14.0,12.0,6.0,13.0,11.0,14.0,13.0,17.0,13.0,16.0,12.0,12.0,13.0,9.0,8.0,9.0,14.0,14.0,15.0,13.0,12.0,15.0,12.0,6.0,17.0,11.0,20.0,17.0,13.0,14.0,14.0,15.0,5.0,13.0,9.0,14.0,19.0,15.0,14.0,11.0,11.0,6.0,32.0,0.0,0.0,0.0,0.0,183.0,79.0,1.0,1.0,1.0,3.0,1.0,3.0,1.0,1.0,2.0,1.0,1.0,5.0,10.0,6.0,6.0,9.0,6.0,15.0,7.0,11.0,14.0,10.0,7.0,13.0,10.0,13.0,15.0,15.0,15.0,14.0,9.0,13.0,16.0,6.0,14.0,8.0,12.0,13.0,16.0,11.0,12.0,16.0,11.0,8.0,16.0,12.0,20.0,15.0,14.0,14.0,11.0,12.0,5.0,15.0,18.0,15.0,14.0,13.0,17.0,14.0,14.0,5.0,22.0,0.0,0.0,0.0,0.0,178.0,73.0,3.0,2.0,2.0,1.0,2.0,4.0,3.0,1.0,3.0,1.0,2.0,6.0,12.0,12.0,6.0,11.0,7.0,8.0,8.0,11.0,12.0,10.0,8.0,13.0,11.0,12.0,12.0,13.0,11.0,10.0,11.0,11.0,13.0,6.0,7.0,12.0,9.0,13.0,14.0,16.0,14.0,13.0,9.0,6.0,14.0,15.0,20.0,15.0,14.0,12.0,12.0,13.0,6.0,14.0,12.0,15.0,13.0,13.0,14.0,14.0,14.0,6.0,27.0,0.0,0.0,0.0,0.0,178.0,72.0,2.0,3.0,2.0,3.0,2.0,3.0,3.0,1.0,1.0,2.0,1.0,13.0,14.0,11.0,7.0,12.0,10.0,9.0,10.0,13.0,13.0,12.0,10.0,14.0,13.0,12.0,14.0,14.0,13.0,14.0,11.0,12.0,14.0,13.0,8.0,14.0,13.0,13.0,15.0,15.0,13.0,10.0,10.0,20.0,13.0,15.0,6.0,14.0,10.0,13.0,13.0,12.0,8.0,12.0,15.0,14.0,13.0,14.0,13.0,13.0,12.0,6.0,24.0,10.0,0.0,0.0,0.0,180.0,73.0,3.0,2.0,3.0,1.0,1.0,1.0,1.0,3.0,3.0,3.0,2.0,5.0,10.0,8.0,5.0,8.0,6.0,13.0,8.0,6.0,14.0,12.0,6.0,13.0,10.0,12.0,13.0,13.0,11.0,12.0,9.0,12.0,14.0,1.0,7.0,7.0,12.0,12.0,13.0,15.0,11.0,13.0,10.0,5.0,15.0,14.0,20.0,12.0,14.0,12.0,12.0,11.0,8.0,11.0,8.0,11.0,9.0,15.0,12.0,11.0,19.0,6.0,27.0,0.0,0.0,0.0,0.0,188.0,77.0,1.0,4.0,1.0,1.0,3.0,1.0,2.0,1.0,2.0,2.0,2.0,4.0,7.0,8.0,7.0,13.0,6.0,15.0,9.0,6.0,13.0,12.0,6.0,12.0,11.0,14.0,14.0,15.0,10.0,12.0,11.0,13.0,16.0,7.0,12.0,9.0,12.0,15.0,16.0,14.0,10.0,14.0,15.0,9.0,13.0,12.0,20.0,14.0,16.0,12.0,14.0,13.0,6.0,12.0,4.0,13.0,18.0,13.0,14.0,14.0,13.0,7.0,32.0,0.0,0.0,13.0,0.0,175.0,65.0,2.0,1.0,1.0,2.0,3.0,3.0,1.0,2.0,3.0,2.0,3.0,15.0,13.0,11.0,6.0,14.0,13.0,10.0,12.0,8.0,8.0,16.0,8.0,12.0,13.0,11.0,14.0,15.0,14.0,15.0,14.0,14.0,14.0,6.0,13.0,9.0,15.0,18.0,13.0,12.0,13.0,13.0,8.0,8.0,13.0,10.0,20.0,13.0,13.0,12.0,11.0,15.0,12.0,10.0,17.0,14.0,15.0,14.0,16.0,14.0,14.0,6.0,20.0,0.0,0.0,2.0,0.0,180.0,75.0,3.0,1.0,2.0,2.0,3.0,2.0,1.0,1.0,3.0,3.0,1.0,8.0,13.0,14.0,9.0,13.0,8.0,10.0,9.0,6.0,5.0,12.0,6.0,5.0,14.0,8.0,13.0,12.0,13.0,12.0,12.0,12.0,7.0,13.0,8.0,14.0,7.0,12.0,13.0,15.0,13.0,14.0,10.0,8.0,14.0,15.0,20.0,13.0,12.0,13.0,11.0,9.0,7.0,13.0,9.0,11.0,11.0,11.0,12.0,11.0,10.0,1.0,26.0,1.0,2.0,0.0,0.0,187.0,88.0,2.0,4.0,2.0,3.0,3.0,2.0,2.0,3.0,1.0,2.0,3.0,4.0,8.0,12.0,12.0,10.0,11.0,15.0,13.0,5.0,6.0,11.0,15.0,4.0,12.0,9.0,13.0,14.0,13.0,14.0,10.0,12.0,15.0,9.0,7.0,13.0,8.0,13.0,14.0,12.0,14.0,16.0,14.0,20.0,13.0,12.0,8.0,13.0,17.0,13.0,9.0,14.0,8.0,5.0,14.0,14.0,14.0,12.0,13.0,14.0,14.0,7.0,30.0,5.0,0.0,22.0,9.0,181.0,84.0,2.0,3.0,3.0,1.0,2.0,3.0,3.0,1.0,3.0,1.0,3.0,7.0,10.0,12.0,13.0,11.0,7.0,13.0,10.0,12.0,6.0,11.0,13.0,6.0,13.0,17.0,13.0,16.0,11.0,13.0,11.0,11.0,17.0,14.0,8.0,14.0,9.0,13.0,17.0,15.0,12.0,15.0,11.0,8.0,14.0,15.0,20.0,14.0,14.0,13.0,9.0,13.0,7.0,10.0,7.0,16.0,13.0,14.0,13.0,15.0,15.0,10.0
5,1,25.0,0.0,0.0,0.0,0.0,187.0,83.0,11.0,14.0,12.0,8.0,13.0,11.0,14.0,15.0,13.0,13.0,9.0,8.0,1.0,1.0,1.0,11.0,11.0,1.0,2.0,2.0,1.0,10.0,3.0,2.0,11.0,8.0,12.0,14.0,12.0,12.0,10.0,12.0,14.0,6.0,14.0,2.0,12.0,12.0,8.0,13.0,15.0,14.0,13.0,20.0,15.0,11.0,5.0,14.0,13.0,13.0,8.0,8.0,10.0,1.0,9.0,13.0,14.0,12.0,15.0,15.0,15.0,5.0,32.0,1.0,0.0,5.0,0.0,189.0,93.0,1.0,1.0,3.0,4.0,2.0,2.0,3.0,2.0,3.0,3.0,3.0,3.0,8.0,8.0,7.0,9.0,8.0,16.0,8.0,7.0,14.0,10.0,9.0,14.0,9.0,15.0,14.0,16.0,12.0,10.0,10.0,12.0,14.0,9.0,9.0,7.0,13.0,14.0,15.0,9.0,8.0,10.0,14.0,8.0,16.0,11.0,20.0,14.0,19.0,12.0,14.0,12.0,8.0,6.0,13.0,16.0,14.0,11.0,15.0,14.0,12.0,10.0,28.0,0.0,0.0,0.0,0.0,184.0,85.0,2.0,3.0,2.0,1.0,1.0,3.0,2.0,2.0,3.0,1.0,3.0,4.0,8.0,8.0,6.0,12.0,6.0,14.0,8.0,5.0,13.0,12.0,6.0,14.0,12.0,11.0,13.0,14.0,13.0,12.0,11.0,11.0,13.0,7.0,14.0,10.0,15.0,16.0,12.0,12.0,11.0,15.0,12.0,20.0,13.0,11.0,7.0,14.0,16.0,13.0,11.0,13.0,13.0,12.0,15.0,13.0,13.0,14.0,15.0,14.0,14.0,6.0,25.0,0.0,0.0,3.0,0.0,184.0,80.0,2.0,2.0,4.0,2.0,1.0,3.0,2.0,1.0,1.0,2.0,1.0,5.0,8.0,7.0,6.0,9.0,6.0,14.0,6.0,6.0,14.0,7.0,6.0,13.0,9.0,12.0,14.0,13.0,11.0,13.0,7.0,12.0,14.0,8.0,10.0,7.0,14.0,13.0,14.0,15.0,12.0,14.0,12.0,8.0,15.0,15.0,20.0,14.0,14.0,13.0,12.0,14.0,5.0,10.0,16.0,13.0,15.0,15.0,12.0,14.0,14.0,8.0,26.0,0.0,0.0,0.0,0.0,177.0,68.0,4.0,2.0,1.0,2.0,3.0,1.0,1.0,2.0,3.0,3.0,3.0,12.0,13.0,11.0,8.0,13.0,11.0,8.0,10.0,8.0,10.0,13.0,10.0,12.0,13.0,7.0,12.0,10.0,13.0,11.0,15.0,13.0,14.0,11.0,7.0,14.0,10.0,14.0,14.0,13.0,15.0,12.0,9.0,20.0,15.0,14.0,5.0,15.0,8.0,13.0,7.0,14.0,6.0,12.0,11.0,12.0,14.0,13.0,16.0,16.0,16.0,5.0,21.0,0.0,0.0,4.0,0.0,178.0,72.0,2.0,3.0,1.0,2.0,2.0,3.0,3.0,1.0,2.0,2.0,3.0,6.0,12.0,10.0,7.0,11.0,7.0,9.0,8.0,11.0,12.0,11.0,8.0,13.0,11.0,10.0,12.0,11.0,12.0,13.0,11.0,11.0,13.0,8.0,11.0,12.0,12.0,13.0,14.0,15.0,13.0,13.0,9.0,7.0,14.0,14.0,20.0,14.0,12.0,13.0,10.0,12.0,9.0,14.0,16.0,15.0,8.0,10.0,12.0,16.0,17.0,10.0,31.0,0.0,0.0,4.0,0.0,174.0,72.0,2.0,1.0,4.0,2.0,2.0,3.0,1.0,1.0,3.0,3.0,4.0,12.0,9.0,11.0,6.0,14.0,11.0,7.0,10.0,6.0,8.0,16.0,12.0,9.0,14.0,9.0,14.0,10.0,13.0,12.0,12.0,11.0,14.0,8.0,8.0,11.0,12.0,14.0,12.0,13.0,14.0,12.0,7.0,12.0,14.0,12.0,20.0,15.0,11.0,11.0,9.0,12.0,8.0,10.0,10.0,14.0,13.0,10.0,12.0,14.0,14.0,9.0,22.0,0.0,0.0,0.0,0.0,164.0,65.0,1.0,2.0,3.0,1.0,2.0,2.0,3.0,2.0,2.0,1.0,2.0,10.0,12.0,13.0,11.0,13.0,10.0,5.0,10.0,7.0,5.0,12.0,10.0,3.0,13.0,7.0,11.0,11.0,11.0,13.0,13.0,11.0,13.0,13.0,6.0,14.0,7.0,12.0,12.0,15.0,15.0,8.0,2.0,9.0,13.0,14.0,20.0,13.0,8.0,13.0,7.0,10.0,8.0,12.0,10.0,12.0,11.0,12.0,11.0,10.0,10.0,8.0,28.0,0.0,0.0,0.0,0.0,170.0,67.0,2.0,3.0,3.0,4.0,3.0,2.0,1.0,1.0,2.0,2.0,3.0,8.0,12.0,12.0,10.0,14.0,7.0,5.0,10.0,6.0,5.0,12.0,5.0,4.0,13.0,7.0,16.0,12.0,9.0,11.0,12.0,10.0,3.0,12.0,6.0,13.0,6.0,8.0,13.0,16.0,13.0,10.0,5.0,5.0,13.0,16.0,20.0,15.0,7.0,12.0,4.0,9.0,7.0,10.0,20.0,13.0,12.0,10.0,13.0,11.0,10.0,2.0,27.0,33.0,4.0,3.0,0.0,180.0,75.0,2.0,1.0,2.0,1.0,4.0,2.0,1.0,3.0,1.0,1.0,2.0,12.0,11.0,13.0,13.0,11.0,11.0,11.0,10.0,7.0,5.0,10.0,14.0,5.0,14.0,9.0,11.0,12.0,10.0,11.0,12.0,12.0,14.0,13.0,8.0,14.0,8.0,11.0,14.0,16.0,14.0,13.0,10.0,7.0,12.0,15.0,20.0,14.0,12.0,12.0,9.0,13.0,10.0,10.0,9.0,15.0,8.0,9.0,13.0,14.0,14.0,7.0,24.0,24.0,4.0,0.0,0.0,172.0,74.0,2.0,4.0,3.0,2.0,2.0,1.0,2.0,2.0,3.0,2.0,4.0,8.0,9.0,14.0,13.0,14.0,9.0,11.0,10.0,7.0,5.0,12.0,12.0,3.0,13.0,10.0,12.0,12.0,13.0,12.0,11.0,10.0,14.0,13.0,7.0,14.0,9.0,9.0,13.0,16.0,15.0,13.0,6.0,8.0,13.0,16.0,20.0,14.0,12.0,11.0,11.0,13.0,9.0,8.0,9.0,13.0,9.0,11.0,12.0,13.0,10.0,9.0,20.0,0.0,0.0,3.0,0.0,193.0,80.0,10.0,12.0,12.0,9.0,11.0,11.0,13.0,15.0,13.0,7.0,12.0,7.0,1.0,1.0,2.0,8.0,11.0,1.0,2.0,1.0,2.0,11.0,2.0,1.0,8.0,4.0,14.0,14.0,11.0,9.0,11.0,12.0,12.0,2.0,15.0,1.0,13.0,11.0,6.0,12.0,13.0,15.0,16.0,20.0,15.0,10.0,6.0,13.0,14.0,12.0,11.0,11.0,10.0,1.0,11.0,9.0,12.0,12.0,13.0,10.0,10.0,1.0,24.0,0.0,0.0,0.0,0.0,175.0,68.0,4.0,3.0,3.0,4.0,1.0,3.0,2.0,2.0,3.0,3.0,1.0,8.0,12.0,11.0,7.0,11.0,8.0,9.0,12.0,13.0,11.0,11.0,7.0,12.0,13.0,12.0,11.0,14.0,12.0,11.0,10.0,12.0,14.0,6.0,8.0,13.0,12.0,14.0,14.0,13.0,13.0,10.0,6.0,12.0,14.0,13.0,20.0,14.0,9.0,13.0,6.0,12.0,5.0,15.0,15.0,10.0,10.0,13.0,14.0,15.0,13.0,4.0,32.0,19.0,0.0,9.0,0.0,185.0,85.0,2.0,3.0,2.0,1.0,2.0,1.0,1.0,2.0,2.0,3.0,3.0,5.0,10.0,9.0,8.0,11.0,11.0,15.0,13.0,9.0,15.0,12.0,10.0,14.0,11.0,14.0,15.0,16.0,12.0,11.0,9.0,11.0,17.0,7.0,12.0,9.0,15.0,13.0,10.0,9.0,9.0,15.0,13.0,10.0,13.0,11.0,20.0,13.0,15.0,12.0,15.0,12.0,13.0,10.0,11.0,13.0,11.0,13.0,18.0,15.0,13.0,5.0,24.0,0.0,0.0,0.0,0.0,184.0,89.0,2.0,3.0,3.0,2.0,2.0,3.0,3.0,1.0,2.0,3.0,2.0,4.0,10.0,8.0,6.0,11.0,9.0,14.0,9.0,7.0,14.0,11.0,6.0,11.0,11.0,13.0,12.0,16.0,11.0,13.0,10.0,11.0,14.0,6.0,8.0,7.0,12.0,13.0,14.0,14.0,12.0,16.0,12.0,20.0,14.0,13.0,6.0,14.0,16.0,14.0,13.0,13.0,7.0,8.0,7.0,14.0,13.0,12.0,14.0,14.0,14.0,6.0,34.0,0.0,0.0,2.0,0.0,175.0,69.0,1.0,1.0,1.0,3.0,2.0,2.0,1.0,1.0,2.0,2.0,2.0,7.0,13.0,9.0,5.0,12.0,8.0,11.0,10.0,13.0,13.0,12.0,8.0,13.0,10.0,15.0,15.0,18.0,13.0,14.0,13.0,13.0,16.0,8.0,14.0,10.0,14.0,15.0,15.0,12.0,13.0,15.0,8.0,20.0,12.0,13.0,5.0,14.0,12.0,16.0,10.0,15.0,10.0,14.0,13.0,14.0,15.0,15.0,18.0,13.0,8.0,10.0,23.0,5.0,0.0,0.0,0.0,180.0,75.0,1.0,1.0,2.0,3.0,3.0,1.0,2.0,2.0,3.0,1.0,3.0,5.0,9.0,12.0,7.0,14.0,8.0,12.0,11.0,6.0,11.0,12.0,12.0,11.0,11.0,12.0,13.0,13.0,11.0,10.0,13.0,11.0,14.0,11.0,7.0,11.0,12.0,14.0,13.0,15.0,13.0,14.0,10.0,7.0,14.0,14.0,20.0,13.0,14.0,12.0,11.0,12.0,12.0,15.0,10.0,14.0,13.0,12.0,14.0,14.0,14.0,6.0,27.0,27.0,1.0,2.0,1.0,183.0,72.0,2.0,2.0,2.0,1.0,2.0,1.0,3.0,1.0,2.0,2.0,4.0,5.0,8.0,10.0,6.0,11.0,10.0,14.0,11.0,5.0,14.0,12.0,10.0,15.0,11.0,14.0,13.0,16.0,11.0,11.0,9.0,10.0,12.0,8.0,12.0,8.0,13.0,14.0,14.0,14.0,12.0,16.0,11.0,8.0,12.0,13.0,20.0,15.0,15.0,10.0,14.0,11.0,7.0,11.0,13.0,13.0,9.0,9.0,11.0,10.0,10.0,8.0,31.0,0.0,0.0,0.0,0.0,180.0,74.0,3.0,2.0,3.0,1.0,2.0,3.0,2.0,1.0,4.0,3.0,3.0,12.0,12.0,10.0,9.0,13.0,14.0,11.0,13.0,6.0,10.0,14.0,15.0,13.0,13.0,15.0,14.0,17.0,12.0,14.0,13.0,13.0,15.0,7.0,13.0,10.0,13.0,18.0,15.0,9.0,11.0,14.0,10.0,10.0,13.0,12.0,20.0,15.0,14.0,14.0,13.0,15.0,8.0,7.0,19.0,13.0,13.0,13.0,13.0,13.0,12.0,9.0,21.0,0.0,0.0,0.0,0.0,181.0,73.0,2.0,3.0,2.0,2.0,1.0,2.0,1.0,2.0,1.0,3.0,1.0,6.0,9.0,12.0,11.0,11.0,8.0,9.0,11.0,6.0,4.0,9.0,12.0,3.0,13.0,10.0,11.0,12.0,11.0,9.0,9.0,9.0,14.0,13.0,6.0,13.0,6.0,10.0,12.0,15.0,14.0,13.0,10.0,8.0,12.0,14.0,20.0,11.0,12.0,12.0,10.0,14.0,10.0,8.0,16.0,13.0,13.0,14.0,12.0,15.0,15.0,8.0,18.0,0.0,0.0,4.0,0.0,188.0,81.0,3.0,3.0,1.0,3.0,1.0,4.0,1.0,2.0,1.0,3.0,4.0,6.0,8.0,13.0,10.0,10.0,10.0,8.0,12.0,6.0,6.0,10.0,14.0,6.0,9.0,10.0,7.0,14.0,9.0,9.0,11.0,11.0,10.0,8.0,11.0,8.0,4.0,11.0,13.0,12.0,13.0,14.0,13.0,8.0,14.0,14.0,20.0,12.0,13.0,10.0,10.0,7.0,6.0,10.0,17.0,10.0,9.0,9.0,13.0,10.0,11.0,6.0,28.0,37.0,15.0,1.0,0.0,194.0,88.0,2.0,1.0,2.0,1.0,1.0,2.0,3.0,1.0,3.0,2.0,2.0,4.0,6.0,12.0,15.0,12.0,7.0,16.0,11.0,3.0,6.0,10.0,14.0,4.0,11.0,10.0,14.0,15.0,13.0,10.0,8.0,9.0,13.0,12.0,6.0,14.0,8.0,11.0,16.0,13.0,12.0,18.0,17.0,9.0,12.0,12.0,20.0,14.0,18.0,13.0,10.0,15.0,15.0,6.0,20.0,17.0,12.0,15.0,14.0,11.0,14.0,7.0
2,0,34.0,1.0,0.0,0.0,0.0,187.0,87.0,13.0,14.0,15.0,7.0,13.0,11.0,14.0,15.0,11.0,17.0,12.0,2.0,1.0,1.0,3.0,8.0,7.0,2.0,1.0,2.0,1.0,9.0,8.0,2.0,6.0,12.0,15.0,17.0,14.0,15.0,8.0,13.0,17.0,7.0,14.0,6.0,14.0,12.0,6.0,7.0,13.0,14.0,13.0,8.0,13.0,8.0,20.0,11.0,16.0,14.0,10.0,14.0,6.0,1.0,12.0,12.0,15.0,16.0,16.0,14.0,15.0,6.0,31.0,2.0,0.0,0.0,0.0,187.0,83.0,3.0,1.0,3.0,1.0,3.0,2.0,1.0,3.0,3.0,1.0,1.0,8.0,11.0,10.0,8.0,11.0,8.0,15.0,8.0,13.0,14.0,11.0,11.0,14.0,8.0,16.0,13.0,15.0,14.0,12.0,5.0,12.0,13.0,9.0,9.0,11.0,14.0,12.0,13.0,13.0,8.0,16.0,14.0,5.0,14.0,13.0,20.0,12.0,14.0,14.0,15.0,12.0,5.0,8.0,12.0,14.0,11.0,11.0,14.0,12.0,13.0,5.0,28.0,0.0,0.0,0.0,0.0,190.0,85.0,3.0,2.0,3.0,3.0,2.0,2.0,2.0,4.0,3.0,1.0,2.0,5.0,9.0,8.0,9.0,8.0,7.0,14.0,10.0,9.0,15.0,9.0,6.0,14.0,9.0,16.0,13.0,16.0,10.0,13.0,10.0,12.0,15.0,6.0,13.0,7.0,13.0,14.0,16.0,12.0,11.0,17.0,13.0,20.0,15.0,13.0,8.0,15.0,15.0,12.0,14.0,14.0,9.0,8.0,14.0,13.0,14.0,11.0,12.0,13.0,16.0,14.0,23.0,0.0,0.0,0.0,0.0,174.0,64.0,4.0,3.0,1.0,1.0,3.0,3.0,2.0,3.0,3.0,2.0,3.0,8.0,12.0,10.0,8.0,11.0,7.0,10.0,9.0,12.0,14.0,9.0,10.0,13.0,12.0,12.0,12.0,12.0,11.0,12.0,10.0,12.0,13.0,8.0,9.0,12.0,11.0,13.0,14.0,15.0,14.0,11.0,10.0,10.0,14.0,14.0,20.0,15.0,10.0,14.0,12.0,12.0,8.0,13.0,10.0,12.0,15.0,12.0,13.0,10.0,17.0,6.0,29.0,0.0,0.0,0.0,0.0,182.0,76.0,1.0,4.0,2.0,3.0,1.0,1.0,1.0,2.0,2.0,1.0,1.0,7.0,12.0,11.0,9.0,11.0,12.0,7.0,12.0,8.0,12.0,13.0,8.0,12.0,13.0,14.0,12.0,14.0,10.0,13.0,12.0,12.0,13.0,15.0,8.0,11.0,12.0,13.0,13.0,11.0,12.0,11.0,12.0,20.0,10.0,11.0,10.0,14.0,11.0,13.0,11.0,10.0,11.0,10.0,14.0,15.0,13.0,9.0,14.0,12.0,13.0,6.0,32.0,36.0,0.0,12.0,2.0,183.0,77.0,1.0,3.0,2.0,1.0,3.0,1.0,1.0,2.0,1.0,1.0,3.0,6.0,11.0,8.0,6.0,13.0,11.0,13.0,10.0,6.0,15.0,14.0,10.0,17.0,12.0,15.0,16.0,18.0,14.0,17.0,12.0,15.0,17.0,11.0,17.0,7.0,17.0,20.0,16.0,9.0,11.0,15.0,11.0,8.0,15.0,10.0,20.0,14.0,14.0,17.0,10.0,16.0,10.0,13.0,15.0,15.0,15.0,14.0,18.0,15.0,13.0,6.0,26.0,0.0,0.0,0.0,0.0,184.0,76.0,3.0,1.0,3.0,1.0,3.0,2.0,3.0,2.0,1.0,1.0,3.0,10.0,11.0,13.0,9.0,13.0,12.0,13.0,10.0,6.0,11.0,13.0,9.0,14.0,12.0,12.0,13.0,12.0,12.0,11.0,13.0,12.0,13.0,13.0,10.0,12.0,13.0,12.0,16.0,15.0,13.0,15.0,13.0,20.0,15.0,14.0,5.0,16.0,15.0,13.0,12.0,14.0,5.0,12.0,18.0,14.0,10.0,7.0,11.0,11.0,13.0,10.0,20.0,0.0,0.0,0.0,0.0,173.0,66.0,1.0,1.0,1.0,1.0,1.0,2.0,3.0,1.0,3.0,3.0,4.0,15.0,13.0,13.0,10.0,15.0,12.0,5.0,13.0,5.0,7.0,15.0,12.0,7.0,15.0,10.0,10.0,13.0,12.0,10.0,16.0,13.0,18.0,14.0,7.0,14.0,12.0,14.0,14.0,8.0,14.0,13.0,7.0,14.0,12.0,9.0,20.0,12.0,13.0,12.0,8.0,15.0,6.0,12.0,12.0,14.0,14.0,14.0,15.0,14.0,11.0,6.0,19.0,0.0,0.0,11.0,1.0,171.0,65.0,2.0,2.0,2.0,2.0,2.0,3.0,3.0,3.0,1.0,1.0,3.0,14.0,13.0,13.0,11.0,14.0,15.0,8.0,12.0,6.0,4.0,13.0,12.0,4.0,15.0,8.0,12.0,10.0,12.0,8.0,13.0,13.0,14.0,15.0,8.0,14.0,6.0,13.0,12.0,15.0,16.0,10.0,7.0,20.0,13.0,15.0,10.0,12.0,7.0,11.0,6.0,11.0,8.0,11.0,12.0,13.0,11.0,12.0,12.0,6.0,12.0,5.0,22.0,0.0,0.0,0.0,0.0,181.0,81.0,2.0,3.0,2.0,1.0,3.0,3.0,4.0,2.0,1.0,1.0,2.0,5.0,11.0,12.0,14.0,12.0,6.0,13.0,10.0,5.0,4.0,12.0,12.0,4.0,13.0,8.0,12.0,13.0,12.0,12.0,11.0,11.0,15.0,14.0,5.0,14.0,10.0,13.0,15.0,13.0,12.0,14.0,10.0,20.0,15.0,12.0,14.0,13.0,14.0,13.0,8.0,12.0,5.0,14.0,8.0,12.0,12.0,9.0,13.0,12.0,14.0,7.0,20.0,7.0,1.0,0.0,0.0,182.0,75.0,2.0,1.0,3.0,2.0,2.0,1.0,3.0,1.0,3.0,2.0,1.0,11.0,11.0,13.0,12.0,13.0,11.0,12.0,10.0,5.0,4.0,12.0,8.0,5.0,13.0,11.0,12.0,11.0,11.0,8.0,10.0,10.0,3.0,10.0,1.0,13.0,8.0,12.0,12.0,15.0,14.0,13.0,11.0,6.0,14.0,13.0,20.0,12.0,13.0,12.0,9.0,11.0,9.0,11.0,9.0,9.0,9.0,12.0,11.0,9.0,17.0,7.0,30.0,0.0,0.0,0.0,0.0,180.0,75.0,11.0,13.0,13.0,9.0,13.0,11.0,12.0,15.0,15.0,14.0,13.0,6.0,1.0,2.0,3.0,7.0,8.0,1.0,1.0,1.0,2.0,7.0,2.0,1.0,7.0,8.0,12.0,14.0,13.0,14.0,7.0,12.0,14.0,5.0,12.0,3.0,13.0,15.0,9.0,13.0,14.0,13.0,10.0,5.0,14.0,11.0,20.0,12.0,13.0,12.0,8.0,14.0,6.0,1.0,9.0,13.0,14.0,13.0,16.0,15.0,15.0,5.0,26.0,11.0,0.0,0.0,0.0,180.0,81.0,3.0,2.0,2.0,3.0,3.0,2.0,1.0,2.0,2.0,1.0,2.0,5.0,9.0,8.0,5.0,11.0,5.0,13.0,10.0,8.0,15.0,10.0,7.0,13.0,10.0,15.0,14.0,17.0,11.0,12.0,9.0,12.0,16.0,8.0,10.0,8.0,13.0,14.0,15.0,13.0,12.0,14.0,12.0,20.0,14.0,12.0,8.0,14.0,14.0,14.0,10.0,15.0,13.0,8.0,9.0,14.0,17.0,13.0,13.0,13.0,11.0,8.0,21.0,0.0,0.0,0.0,0.0,182.0,74.0,2.0,2.0,2.0,2.0,2.0,1.0,1.0,1.0,3.0,2.0,2.0,9.0,11.0,12.0,7.0,9.0,8.0,12.0,7.0,11.0,12.0,7.0,8.0,13.0,11.0,12.0,12.0,14.0,12.0,13.0,7.0,12.0,11.0,1.0,9.0,11.0,9.0,10.0,12.0,14.0,10.0,13.0,11.0,9.0,8.0,12.0,20.0,13.0,11.0,10.0,13.0,8.0,10.0,10.0,15.0,11.0,13.0,10.0,10.0,8.0,13.0,7.0,32.0,0.0,0.0,0.0,0.0,165.0,65.0,1.0,2.0,3.0,1.0,3.0,1.0,3.0,2.0,1.0,4.0,4.0,7.0,12.0,10.0,5.0,13.0,8.0,9.0,8.0,11.0,13.0,12.0,10.0,14.0,11.0,14.0,13.0,15.0,12.0,12.0,8.0,11.0,14.0,5.0,8.0,7.0,10.0,15.0,17.0,14.0,13.0,14.0,4.0,10.0,13.0,13.0,20.0,15.0,12.0,14.0,5.0,13.0,7.0,8.0,7.0,12.0,17.0,13.0,15.0,13.0,13.0,7.0,28.0,22.0,0.0,20.0,1.0,176.0,74.0,2.0,3.0,2.0,1.0,1.0,1.0,3.0,3.0,2.0,2.0,1.0,15.0,15.0,12.0,8.0,13.0,12.0,5.0,11.0,15.0,10.0,13.0,9.0,10.0,12.0,10.0,11.0,10.0,13.0,12.0,11.0,12.0,11.0,11.0,7.0,13.0,10.0,14.0,15.0,15.0,14.0,10.0,8.0,20.0,13.0,14.0,8.0,15.0,8.0,14.0,5.0,12.0,5.0,14.0,15.0,15.0,10.0,14.0,13.0,12.0,12.0,2.0,31.0,0.0,0.0,0.0,0.0,178.0,70.0,3.0,1.0,3.0,3.0,2.0,2.0,2.0,1.0,2.0,1.0,2.0,5.0,8.0,7.0,7.0,12.0,5.0,8.0,8.0,7.0,14.0,13.0,8.0,13.0,12.0,15.0,14.0,17.0,12.0,13.0,9.0,13.0,16.0,10.0,15.0,8.0,13.0,18.0,15.0,13.0,14.0,12.0,9.0,10.0,15.0,13.0,20.0,16.0,13.0,14.0,12.0,14.0,5.0,16.0,13.0,12.0,16.0,13.0,13.0,13.0,13.0,6.0,32.0,25.0,0.0,0.0,0.0,181.0,82.0,2.0,3.0,3.0,1.0,1.0,1.0,1.0,3.0,1.0,2.0,3.0,5.0,10.0,6.0,7.0,10.0,7.0,14.0,9.0,8.0,11.0,12.0,7.0,13.0,10.0,15.0,14.0,16.0,11.0,13.0,10.0,12.0,16.0,9.0,15.0,8.0,11.0,16.0,18.0,11.0,12.0,14.0,11.0,8.0,13.0,11.0,20.0,17.0,15.0,13.0,15.0,11.0,6.0,14.0,18.0,12.0,13.0,13.0,14.0,11.0,11.0,8.0,22.0,0.0,0.0,4.0,0.0,179.0,71.0,1.0,3.0,1.0,3.0,2.0,1.0,3.0,2.0,1.0,2.0,4.0,11.0,13.0,12.0,8.0,15.0,11.0,6.0,11.0,6.0,4.0,14.0,12.0,6.0,16.0,7.0,12.0,10.0,12.0,11.0,13.0,13.0,13.0,9.0,6.0,12.0,9.0,15.0,12.0,13.0,14.0,12.0,9.0,20.0,14.0,12.0,10.0,13.0,10.0,13.0,7.0,14.0,7.0,8.0,18.0,13.0,14.0,14.0,16.0,15.0,15.0,5.0,20.0,0.0,0.0,0.0,0.0,175.0,77.0,2.0,1.0,2.0,3.0,3.0,3.0,3.0,1.0,4.0,3.0,1.0,8.0,8.0,12.0,12.0,11.0,8.0,13.0,10.0,9.0,10.0,11.0,10.0,9.0,12.0,12.0,6.0,9.0,9.0,11.0,15.0,11.0,4.0,10.0,8.0,12.0,11.0,10.0,13.0,14.0,15.0,15.0,8.0,8.0,9.0,15.0,20.0,11.0,12.0,12.0,8.0,4.0,10.0,10.0,15.0,11.0,12.0,11.0,9.0,10.0,10.0,7.0,27.0,0.0,0.0,0.0,0.0,179.0,73.0,1.0,3.0,1.0,1.0,2.0,1.0,4.0,4.0,3.0,1.0,2.0,8.0,12.0,11.0,12.0,13.0,9.0,8.0,12.0,6.0,4.0,11.0,13.0,3.0,13.0,8.0,11.0,11.0,12.0,11.0,9.0,10.0,14.0,12.0,5.0,13.0,6.0,10.0,12.0,16.0,14.0,13.0,9.0,8.0,14.0,14.0,20.0,13.0,11.0,13.0,8.0,13.0,7.0,8.0,16.0,14.0,12.0,10.0,11.0,15.0,15.0,9.0,22.0,0.0,0.0,3.0,0.0,172.0,73.0,2.0,3.0,1.0,1.0,3.0,3.0,2.0,1.0,2.0,3.0,2.0,6.0,13.0,13.0,11.0,13.0,7.0,10.0,11.0,5.0,5.0,10.0,11.0,3.0,13.0,8.0,12.0,9.0,10.0,8.0,12.0,12.0,13.0,13.0,5.0,11.0,7.0,8.0,8.0,15.0,16.0,15.0,7.0,8.0,14.0,16.0,20.0,12.0,11.0,11.0,8.0,13.0,8.0,7.0,13.0,14.0,13.0,12.0,10.0,15.0,15.0,9.0
3,2,25.0,0.0,0.0,0.0,0.0,185.0,85.0,14.0,11.0,14.0,10.0,12.0,14.0,13.0,14.0,11.0,15.0,9.0,4.0,1.0,3.0,1.0,9.0,8.0,3.0,11.0,1.0,2.0,8.0,2.0,7.0,9.0,8.0,13.0,13.0,12.0,12.0,8.0,11.0,16.0,6.0,14.0,1.0,12.0,12.0,7.0,10.0,13.0,15.0,12.0,5.0,17.0,9.0,20.0,13.0,15.0,14.0,8.0,13.0,3.0,1.0,17.0,13.0,13.0,13.0,14.0,14.0,14.0,5.0,36.0,0.0,0.0,0.0,0.0,182.0,70.0,2.0,1.0,3.0,3.0,1.0,2.0,1.0,1.0,1.0,1.0,3.0,8.0,11.0,8.0,6.0,11.0,7.0,10.0,8.0,12.0,13.0,10.0,6.0,14.0,11.0,15.0,13.0,15.0,11.0,12.0,7.0,10.0,12.0,6.0,13.0,7.0,14.0,14.0,14.0,12.0,11.0,14.0,11.0,12.0,12.0,10.0,20.0,13.0,12.0,12.0,15.0,13.0,9.0,10.0,6.0,12.0,14.0,11.0,15.0,12.0,12.0,6.0,24.0,2.0,0.0,0.0,0.0,188.0,83.0,2.0,2.0,2.0,1.0,3.0,2.0,3.0,3.0,1.0,2.0,1.0,11.0,12.0,11.0,6.0,12.0,11.0,11.0,9.0,13.0,11.0,11.0,10.0,12.0,12.0,13.0,13.0,12.0,12.0,9.0,11.0,11.0,2.0,12.0,11.0,12.0,8.0,12.0,12.0,11.0,10.0,13.0,13.0,20.0,12.0,12.0,4.0,12.0,13.0,12.0,9.0,5.0,7.0,11.0,8.0,10.0,14.0,12.0,12.0,1.0,18.0,8.0,31.0,0.0,0.0,0.0,0.0,190.0,82.0,1.0,1.0,2.0,2.0,2.0,1.0,3.0,1.0,1.0,1.0,2.0,4.0,8.0,8.0,6.0,12.0,10.0,15.0,13.0,8.0,14.0,13.0,7.0,14.0,13.0,14.0,14.0,15.0,11.0,11.0,12.0,12.0,13.0,7.0,11.0,10.0,13.0,14.0,16.0,12.0,10.0,9.0,15.0,5.0,13.0,13.0,20.0,13.0,15.0,12.0,14.0,14.0,13.0,12.0,10.0,13.0,14.0,11.0,14.0,13.0,13.0,9.0,29.0,6.0,0.0,0.0,0.0,183.0,72.0,3.0,3.0,3.0,4.0,1.0,3.0,3.0,3.0,1.0,3.0,3.0,2.0,13.0,13.0,8.0,14.0,8.0,10.0,12.0,10.0,12.0,13.0,8.0,14.0,10.0,14.0,13.0,10.0,12.0,12.0,10.0,12.0,4.0,12.0,4.0,14.0,12.0,13.0,14.0,14.0,13.0,13.0,11.0,5.0,14.0,15.0,20.0,14.0,11.0,13.0,2.0,12.0,7.0,8.0,16.0,10.0,11.0,13.0,10.0,3.0,19.0,8.0,36.0,0.0,0.0,3.0,0.0,168.0,72.0,3.0,2.0,1.0,3.0,1.0,3.0,3.0,1.0,3.0,3.0,1.0,11.0,8.0,12.0,5.0,13.0,11.0,8.0,13.0,6.0,12.0,13.0,8.0,14.0,13.0,17.0,14.0,17.0,14.0,15.0,13.0,14.0,17.0,12.0,16.0,10.0,15.0,16.0,14.0,10.0,13.0,14.0,4.0,8.0,16.0,8.0,20.0,12.0,13.0,17.0,14.0,14.0,7.0,10.0,19.0,15.0,14.0,16.0,15.0,9.0,9.0,7.0,23.0,2.0,0.0,5.0,0.0,180.0,77.0,3.0,2.0,2.0,3.0,2.0,3.0,2.0,2.0,3.0,3.0,4.0,14.0,12.0,12.0,10.0,13.0,14.0,6.0,14.0,8.0,8.0,13.0,12.0,9.0,14.0,13.0,12.0,12.0,11.0,10.0,12.0,13.0,13.0,10.0,6.0,13.0,10.0,12.0,14.0,13.0,14.0,13.0,10.0,8.0,13.0,14.0,20.0,14.0,14.0,9.0,8.0,14.0,6.0,16.0,13.0,12.0,13.0,12.0,13.0,13.0,14.0,6.0,23.0,0.0,0.0,0.0,0.0,185.0,67.0,3.0,1.0,3.0,1.0,2.0,2.0,3.0,1.0,2.0,2.0,1.0,13.0,11.0,14.0,13.0,13.0,12.0,3.0,14.0,5.0,5.0,15.0,11.0,5.0,14.0,6.0,12.0,11.0,13.0,13.0,12.0,12.0,15.0,11.0,2.0,12.0,12.0,14.0,13.0,11.0,13.0,12.0,7.0,10.0,7.0,13.0,20.0,14.0,8.0,13.0,10.0,13.0,10.0,9.0,9.0,11.0,12.0,10.0,12.0,10.0,17.0,3.0,30.0,0.0,0.0,0.0,0.0,162.0,65.0,1.0,1.0,1.0,1.0,3.0,3.0,3.0,4.0,2.0,2.0,1.0,13.0,12.0,14.0,10.0,14.0,15.0,5.0,12.0,6.0,4.0,11.0,12.0,3.0,15.0,11.0,12.0,8.0,10.0,13.0,13.0,12.0,17.0,15.0,9.0,13.0,7.0,11.0,14.0,15.0,14.0,7.0,3.0,14.0,11.0,13.0,20.0,11.0,7.0,13.0,11.0,15.0,11.0,8.0,10.0,14.0,13.0,14.0,14.0,13.0,10.0,6.0,23.0,0.0,0.0,0.0,0.0,183.0,80.0,3.0,2.0,1.0,3.0,1.0,3.0,2.0,3.0,1.0,2.0,3.0,4.0,12.0,13.0,14.0,12.0,9.0,10.0,14.0,5.0,5.0,12.0,11.0,7.0,12.0,11.0,12.0,12.0,10.0,12.0,10.0,11.0,5.0,11.0,9.0,14.0,10.0,13.0,12.0,15.0,14.0,13.0,11.0,8.0,12.0,14.0,20.0,13.0,14.0,10.0,8.0,13.0,7.0,7.0,16.0,14.0,11.0,10.0,12.0,9.0,9.0,2.0,27.0,11.0,1.0,0.0,0.0,187.0,86.0,3.0,1.0,2.0,2.0,4.0,3.0,2.0,1.0,1.0,3.0,1.0,3.0,9.0,13.0,15.0,12.0,10.0,17.0,11.0,5.0,5.0,9.0,14.0,4.0,11.0,9.0,12.0,13.0,12.0,11.0,9.0,10.0,13.0,11.0,10.0,13.0,10.0,15.0,15.0,14.0,12.0,15.0,13.0,7.0,15.0,13.0,20.0,13.0,15.0,14.0,9.0,13.0,7.0,5.0,15.0,13.0,13.0,11.0,10.0,12.0,18.0,6.0,25.0,0.0,0.0,0.0,0.0,192.0,87.0,12.0,13.0,12.0,6.0,14.0,11.0,12.0,13.0,9.0,12.0,11.0,5.0,1.0,3.0,1.0,10.0,8.0,3.0,3.0,3.0,3.0,8.0,2.0,1.0,8.0,7.0,13.0,14.0,12.0,13.0,12.0,11.0,13.0,7.0,11.0,3.0,13.0,11.0,12.0,11.0,12.0,16.0,16.0,8.0,14.0,12.0,20.0,13.0,16.0,13.0,7.0,9.0,7.0,10.0,14.0,12.0,17.0,13.0,14.0,14.0,14.0,5.0,29.0,2.0,0.0,0.0,0.0,185.0,75.0,2.0,3.0,3.0,3.0,2.0,3.0,2.0,1.0,3.0,1.0,2.0,4.0,10.0,8.0,6.0,10.0,6.0,14.0,7.0,7.0,14.0,11.0,6.0,14.0,9.0,13.0,13.0,14.0,11.0,12.0,12.0,12.0,14.0,8.0,11.0,12.0,13.0,13.0,13.0,15.0,12.0,15.0,12.0,8.0,15.0,13.0,20.0,14.0,15.0,14.0,7.0,14.0,8.0,6.0,14.0,13.0,15.0,14.0,14.0,14.0,14.0,6.0,28.0,0.0,0.0,0.0,0.0,193.0,84.0,1.0,1.0,2.0,2.0,2.0,3.0,2.0,3.0,2.0,1.0,3.0,4.0,8.0,8.0,9.0,10.0,6.0,14.0,7.0,8.0,14.0,12.0,6.0,14.0,11.0,12.0,13.0,14.0,11.0,14.0,12.0,12.0,14.0,6.0,11.0,8.0,14.0,13.0,13.0,11.0,11.0,16.0,16.0,20.0,12.0,12.0,8.0,14.0,16.0,14.0,12.0,13.0,6.0,10.0,7.0,12.0,15.0,12.0,16.0,15.0,13.0,6.0,26.0,0.0,0.0,0.0,0.0,175.0,69.0,3.0,3.0,2.0,2.0,3.0,1.0,3.0,1.0,3.0,2.0,2.0,6.0,12.0,10.0,5.0,11.0,6.0,10.0,10.0,10.0,13.0,12.0,9.0,13.0,12.0,12.0,13.0,14.0,12.0,13.0,12.0,11.0,15.0,11.0,13.0,12.0,13.0,14.0,14.0,15.0,13.0,12.0,7.0,9.0,13.0,13.0,20.0,14.0,11.0,14.0,12.0,12.0,11.0,15.0,14.0,9.0,17.0,10.0,8.0,11.0,20.0,7.0,26.0,0.0,0.0,0.0,0.0,182.0,68.0,1.0,4.0,3.0,2.0,3.0,1.0,2.0,1.0,2.0,4.0,1.0,7.0,12.0,9.0,5.0,10.0,6.0,12.0,7.0,15.0,12.0,9.0,6.0,12.0,10.0,12.0,13.0,14.0,11.0,10.0,9.0,9.0,13.0,7.0,6.0,10.0,10.0,14.0,15.0,16.0,13.0,13.0,11.0,5.0,15.0,15.0,20.0,14.0,10.0,12.0,12.0,13.0,7.0,12.0,12.0,14.0,14.0,15.0,13.0,14.0,14.0,7.0,21.0,0.0,0.0,0.0,0.0,183.0,73.0,1.0,4.0,3.0,3.0,3.0,1.0,4.0,1.0,2.0,3.0,2.0,11.0,10.0,12.0,11.0,13.0,9.0,12.0,10.0,5.0,8.0,12.0,9.0,8.0,13.0,13.0,12.0,12.0,10.0,12.0,14.0,12.0,12.0,14.0,8.0,12.0,8.0,12.0,12.0,14.0,14.0,14.0,11.0,8.0,13.0,13.0,20.0,12.0,12.0,12.0,5.0,10.0,7.0,12.0,15.0,11.0,11.0,10.0,11.0,12.0,11.0,4.0,29.0,0.0,0.0,0.0,0.0,183.0,78.0,1.0,3.0,3.0,3.0,3.0,1.0,2.0,3.0,3.0,1.0,1.0,13.0,8.0,9.0,6.0,12.0,14.0,13.0,10.0,12.0,11.0,12.0,8.0,13.0,12.0,12.0,15.0,13.0,13.0,13.0,11.0,13.0,15.0,6.0,12.0,7.0,13.0,16.0,18.0,12.0,11.0,14.0,12.0,20.0,14.0,11.0,8.0,16.0,14.0,14.0,12.0,14.0,6.0,12.0,10.0,12.0,13.0,11.0,15.0,15.0,15.0,5.0,29.0,0.0,0.0,0.0,0.0,180.0,71.0,1.0,3.0,1.0,1.0,1.0,4.0,4.0,1.0,1.0,2.0,3.0,10.0,11.0,12.0,9.0,13.0,11.0,8.0,14.0,6.0,8.0,11.0,10.0,8.0,12.0,10.0,11.0,12.0,12.0,9.0,12.0,11.0,14.0,12.0,7.0,12.0,10.0,12.0,14.0,15.0,14.0,12.0,10.0,20.0,16.0,13.0,12.0,15.0,10.0,13.0,10.0,15.0,7.0,8.0,16.0,12.0,12.0,13.0,14.0,15.0,15.0,6.0,23.0,1.0,0.0,0.0,0.0,192.0,80.0,3.0,3.0,3.0,2.0,3.0,1.0,3.0,3.0,1.0,2.0,2.0,4.0,6.0,12.0,13.0,12.0,7.0,13.0,12.0,5.0,5.0,9.0,11.0,5.0,12.0,13.0,12.0,13.0,12.0,13.0,9.0,13.0,4.0,11.0,8.0,13.0,7.0,9.0,12.0,14.0,13.0,15.0,16.0,20.0,14.0,13.0,8.0,13.0,15.0,12.0,11.0,11.0,7.0,5.0,14.0,13.0,14.0,11.0,9.0,9.0,18.0,3.0,21.0,0.0,0.0,0.0,0.0,178.0,68.0,1.0,1.0,1.0,2.0,3.0,2.0,1.0,1.0,1.0,1.0,3.0,10.0,10.0,14.0,12.0,13.0,7.0,11.0,12.0,5.0,5.0,10.0,10.0,4.0,13.0,6.0,12.0,11.0,12.0,11.0,11.0,12.0,11.0,14.0,6.0,14.0,9.0,10.0,13.0,15.0,14.0,12.0,9.0,20.0,12.0,14.0,8.0,13.0,9.0,12.0,6.0,10.0,8.0,11.0,13.0,11.0,10.0,12.0,12.0,9.0,16.0,8.0,23.0,1.0,0.0,0.0,0.0,185.0,70.0,4.0,3.0,1.0,2.0,1.0,3.0,2.0,3.0,1.0,2.0,3.0,5.0,8.0,12.0,13.0,13.0,7.0,14.0,11.0,5.0,5.0,8.0,13.0,5.0,13.0,6.0,13.0,10.0,12.0,12.0,11.0,11.0,13.0,12.0,7.0,13.0,9.0,8.0,10.0,16.0,12.0,14.0,12.0,8.0,14.0,15.0,20.0,13.0,13.0,12.0,7.0,15.0,7.0,7.0,13.0,13.0,12.0,10.0,12.0,15.0,15.0,7.0
0,2,36.0,0.0,0.0,0.0,0.0,185.0,78.0,11.0,14.0,12.0,7.0,13.0,12.0,14.0,15.0,13.0,14.0,10.0,4.0,1.0,3.0,1.0,8.0,8.0,11.0,8.0,3.0,3.0,7.0,2.0,1.0,8.0,11.0,13.0,15.0,11.0,12.0,7.0,13.0,9.0,5.0,14.0,3.0,13.0,15.0,8.0,11.0,14.0,13.0,12.0,5.0,15.0,11.0,20.0,12.0,14.0,13.0,11.0,13.0,8.0,1.0,19.0,14.0,16.0,10.0,17.0,9.0,9.0,11.0,28.0,0.0,0.0,0.0,0.0,183.0,81.0,1.0,2.0,4.0,1.0,1.0,3.0,2.0,3.0,3.0,3.0,1.0,5.0,5.0,6.0,10.0,12.0,6.0,14.0,8.0,6.0,15.0,11.0,6.0,13.0,12.0,13.0,14.0,16.0,14.0,14.0,10.0,12.0,14.0,5.0,14.0,8.0,14.0,15.0,15.0,9.0,12.0,15.0,13.0,7.0,11.0,12.0,20.0,15.0,15.0,14.0,14.0,14.0,9.0,8.0,14.0,14.0,11.0,13.0,15.0,13.0,15.0,6.0,34.0,23.0,1.0,0.0,0.0,186.0,81.0,3.0,3.0,1.0,2.0,1.0,3.0,2.0,3.0,1.0,3.0,3.0,4.0,8.0,6.0,10.0,7.0,8.0,17.0,12.0,10.0,14.0,7.0,9.0,15.0,7.0,15.0,13.0,17.0,8.0,12.0,7.0,12.0,15.0,6.0,17.0,7.0,14.0,15.0,14.0,8.0,10.0,16.0,13.0,12.0,13.0,9.0,20.0,13.0,15.0,11.0,15.0,14.0,9.0,10.0,10.0,14.0,11.0,13.0,15.0,11.0,11.0,12.0,27.0,25.0,1.0,0.0,0.0,189.0,82.0,3.0,1.0,3.0,4.0,3.0,1.0,3.0,3.0,1.0,2.0,3.0,6.0,7.0,5.0,8.0,9.0,8.0,12.0,8.0,6.0,14.0,13.0,11.0,14.0,5.0,12.0,14.0,15.0,13.0,13.0,8.0,13.0,12.0,5.0,11.0,5.0,13.0,15.0,14.0,12.0,12.0,14.0,15.0,6.0,16.0,12.0,20.0,13.0,14.0,11.0,10.0,12.0,5.0,8.0,11.0,13.0,14.0,17.0,8.0,6.0,8.0,13.0,23.0,14.0,1.0,0.0,0.0,180.0,75.0,1.0,3.0,2.0,4.0,1.0,3.0,2.0,2.0,4.0,1.0,2.0,5.0,12.0,12.0,6.0,11.0,7.0,13.0,12.0,6.0,12.0,12.0,6.0,12.0,11.0,13.0,13.0,15.0,11.0,11.0,12.0,9.0,16.0,7.0,12.0,8.0,12.0,14.0,16.0,14.0,13.0,15.0,10.0,8.0,15.0,13.0,20.0,15.0,14.0,14.0,13.0,12.0,7.0,11.0,12.0,13.0,14.0,14.0,14.0,13.0,13.0,6.0,30.0,0.0,0.0,0.0,0.0,167.0,60.0,3.0,1.0,1.0,2.0,3.0,1.0,1.0,3.0,1.0,1.0,3.0,10.0,11.0,12.0,8.0,13.0,10.0,6.0,9.0,10.0,12.0,14.0,9.0,10.0,14.0,11.0,14.0,14.0,14.0,14.0,13.0,14.0,12.0,14.0,11.0,13.0,12.0,15.0,15.0,15.0,14.0,11.0,5.0,11.0,11.0,15.0,20.0,11.0,8.0,14.0,10.0,12.0,13.0,11.0,11.0,12.0,11.0,10.0,12.0,11.0,11.0,2.0,33.0,0.0,0.0,0.0,0.0,187.0,76.0,2.0,2.0,3.0,1.0,1.0,3.0,2.0,1.0,2.0,3.0,2.0,15.0,14.0,14.0,10.0,15.0,13.0,10.0,12.0,7.0,4.0,15.0,13.0,7.0,15.0,6.0,12.0,9.0,14.0,11.0,15.0,12.0,12.0,14.0,12.0,13.0,7.0,13.0,12.0,11.0,12.0,14.0,12.0,14.0,15.0,12.0,20.0,11.0,12.0,12.0,6.0,14.0,6.0,11.0,14.0,13.0,12.0,12.0,15.0,15.0,13.0,9.0,26.0,0.0,0.0,0.0,0.0,193.0,81.0,1.0,3.0,3.0,3.0,3.0,1.0,2.0,2.0,2.0,3.0,3.0,4.0,9.0,14.0,10.0,13.0,12.0,14.0,14.0,5.0,5.0,10.0,12.0,3.0,14.0,8.0,13.0,12.0,9.0,10.0,11.0,11.0,12.0,16.0,5.0,14.0,6.0,9.0,12.0,14.0,13.0,14.0,16.0,14.0,13.0,13.0,20.0,13.0,14.0,10.0,8.0,14.0,9.0,8.0,16.0,16.0,11.0,13.0,11.0,13.0,13.0,10.0,30.0,0.0,0.0,0.0,0.0,178.0,73.0,3.0,4.0,1.0,1.0,2.0,4.0,3.0,2.0,2.0,2.0,3.0,13.0,14.0,12.0,7.0,13.0,12.0,7.0,13.0,5.0,10.0,13.0,9.0,10.0,13.0,11.0,11.0,12.0,12.0,13.0,11.0,14.0,14.0,11.0,7.0,11.0,10.0,13.0,15.0,13.0,15.0,15.0,8.0,20.0,14.0,14.0,8.0,14.0,11.0,13.0,11.0,14.0,8.0,10.0,19.0,12.0,12.0,9.0,12.0,12.0,10.0,10.0,27.0,0.0,0.0,0.0,0.0,190.0,87.0,1.0,3.0,2.0,3.0,1.0,3.0,1.0,1.0,2.0,3.0,2.0,5.0,7.0,9.0,14.0,14.0,10.0,14.0,13.0,5.0,6.0,12.0,12.0,8.0,14.0,14.0,13.0,16.0,14.0,11.0,10.0,13.0,15.0,10.0,11.0,14.0,9.0,15.0,14.0,10.0,11.0,16.0,15.0,9.0,12.0,12.0,20.0,14.0,16.0,13.0,13.0,12.0,7.0,5.0,10.0,12.0,14.0,12.0,14.0,14.0,19.0,12.0,17.0,0.0,0.0,0.0,0.0,181.0,68.0,1.0,2.0,1.0,1.0,2.0,2.0,3.0,3.0,3.0,2.0,1.0,8.0,11.0,14.0,11.0,13.0,8.0,11.0,9.0,5.0,3.0,11.0,5.0,5.0,14.0,5.0,11.0,6.0,10.0,10.0,11.0,12.0,14.0,13.0,6.0,13.0,9.0,10.0,8.0,14.0,14.0,14.0,10.0,5.0,12.0,14.0,20.0,12.0,11.0,10.0,6.0,5.0,10.0,12.0,20.0,12.0,11.0,12.0,12.0,11.0,14.0,5.0,23.0,0.0,0.0,0.0,0.0,188.0,85.0,14.0,12.0,12.0,7.0,13.0,10.0,11.0,14.0,7.0,13.0,12.0,2.0,3.0,1.0,3.0,8.0,6.0,2.0,1.0,2.0,2.0,8.0,3.0,1.0,8.0,7.0,10.0,12.0,9.0,11.0,8.0,11.0,14.0,2.0,9.0,1.0,12.0,11.0,8.0,7.0,12.0,14.0,14.0,6.0,14.0,10.0,20.0,12.0,14.0,13.0,7.0,10.0,7.0,1.0,14.0,14.0,9.0,13.0,13.0,10.0,12.0,6.0,28.0,0.0,0.0,0.0,0.0,174.0,67.0,3.0,4.0,1.0,1.0,1.0,3.0,1.0,3.0,2.0,1.0,2.0,11.0,8.0,11.0,9.0,13.0,6.0,7.0,12.0,8.0,10.0,10.0,3.0,6.0,12.0,10.0,13.0,7.0,12.0,8.0,10.0,9.0,12.0,13.0,5.0,12.0,9.0,12.0,11.0,14.0,14.0,11.0,7.0,10.0,15.0,12.0,20.0,11.0,6.0,9.0,6.0,10.0,10.0,9.0,11.0,14.0,9.0,11.0,12.0,8.0,8.0,8.0,23.0,0.0,0.0,0.0,0.0,184.0,71.0,1.0,2.0,1.0,2.0,2.0,2.0,2.0,4.0,2.0,1.0,3.0,4.0,10.0,10.0,6.0,11.0,6.0,14.0,8.0,7.0,14.0,11.0,6.0,13.0,11.0,12.0,12.0,13.0,12.0,11.0,12.0,12.0,14.0,6.0,8.0,10.0,13.0,13.0,14.0,15.0,13.0,14.0,13.0,8.0,12.0,14.0,20.0,13.0,14.0,13.0,12.0,14.0,15.0,8.0,11.0,13.0,13.0,10.0,8.0,9.0,16.0,7.0,21.0,0.0,0.0,0.0,0.0,177.0,0.0,1.0,1.0,1.0,2.0,3.0,3.0,2.0,3.0,2.0,2.0,3.0,6.0,4.0,13.0,13.0,13.0,6.0,13.0,7.0,3.0,5.0,7.0,6.0,1.0,11.0,9.0,7.0,8.0,7.0,7.0,7.0,8.0,7.0,11.0,8.0,13.0,7.0,6.0,7.0,12.0,13.0,7.0,6.0,8.0,8.0,13.0,20.0,5.0,5.0,9.0,5.0,9.0,9.0,9.0,10.0,10.0,12.0,12.0,11.0,10.0,9.0,6.0,21.0,0.0,0.0,0.0,0.0,178.0,65.0,2.0,3.0,3.0,3.0,3.0,1.0,1.0,1.0,1.0,3.0,1.0,9.0,13.0,11.0,6.0,12.0,7.0,9.0,8.0,8.0,13.0,12.0,7.0,13.0,12.0,8.0,12.0,13.0,12.0,12.0,13.0,13.0,14.0,9.0,8.0,12.0,12.0,13.0,13.0,12.0,14.0,13.0,11.0,8.0,15.0,12.0,20.0,13.0,12.0,14.0,8.0,11.0,7.0,10.0,19.0,10.0,13.0,10.0,11.0,15.0,15.0,6.0,21.0,0.0,0.0,0.0,0.0,172.0,66.0,2.0,3.0,2.0,2.0,1.0,1.0,1.0,3.0,2.0,1.0,1.0,10.0,10.0,13.0,9.0,14.0,9.0,8.0,10.0,7.0,13.0,13.0,9.0,12.0,13.0,10.0,12.0,13.0,13.0,12.0,14.0,13.0,13.0,11.0,9.0,14.0,13.0,14.0,14.0,14.0,13.0,12.0,8.0,8.0,12.0,12.0,20.0,13.0,12.0,14.0,10.0,11.0,8.0,12.0,15.0,10.0,15.0,8.0,11.0,14.0,14.0,6.0,32.0,22.0,1.0,6.0,1.0,186.0,79.0,1.0,2.0,1.0,1.0,2.0,3.0,1.0,2.0,1.0,2.0,1.0,11.0,12.0,13.0,11.0,13.0,11.0,14.0,11.0,8.0,12.0,13.0,13.0,13.0,13.0,14.0,13.0,14.0,14.0,13.0,14.0,13.0,12.0,13.0,14.0,15.0,13.0,12.0,15.0,12.0,13.0,12.0,12.0,10.0,12.0,13.0,20.0,15.0,13.0,14.0,5.0,12.0,9.0,17.0,8.0,12.0,8.0,13.0,10.0,10.0,10.0,5.0,25.0,1.0,0.0,7.0,3.0,178.0,85.0,2.0,3.0,3.0,2.0,3.0,3.0,2.0,3.0,2.0,2.0,2.0,9.0,12.0,12.0,12.0,11.0,8.0,9.0,12.0,6.0,7.0,11.0,12.0,7.0,13.0,12.0,11.0,14.0,12.0,9.0,10.0,10.0,14.0,13.0,7.0,13.0,9.0,9.0,12.0,14.0,12.0,15.0,10.0,14.0,11.0,14.0,20.0,13.0,15.0,10.0,11.0,12.0,6.0,14.0,14.0,13.0,12.0,13.0,10.0,13.0,12.0,12.0,19.0,0.0,0.0,0.0,0.0,179.0,66.0,1.0,3.0,3.0,1.0,1.0,3.0,3.0,1.0,2.0,3.0,2.0,13.0,11.0,14.0,10.0,14.0,13.0,9.0,10.0,4.0,7.0,13.0,11.0,9.0,15.0,10.0,12.0,10.0,13.0,10.0,13.0,12.0,14.0,13.0,10.0,13.0,12.0,11.0,11.0,12.0,14.0,12.0,6.0,10.0,12.0,13.0,20.0,12.0,10.0,12.0,11.0,11.0,11.0,11.0,11.0,14.0,12.0,11.0,13.0,11.0,13.0,10.0,22.0,0.0,0.0,0.0,0.0,177.0,72.0,2.0,1.0,2.0,4.0,2.0,2.0,1.0,3.0,4.0,2.0,3.0,10.0,12.0,13.0,11.0,12.0,10.0,12.0,12.0,4.0,10.0,13.0,11.0,11.0,13.0,11.0,12.0,11.0,13.0,9.0,13.0,12.0,3.0,12.0,8.0,14.0,12.0,12.0,13.0,16.0,13.0,12.0,9.0,8.0,15.0,14.0,20.0,14.0,13.0,10.0,4.0,11.0,11.0,12.0,19.0,9.0,12.0,13.0,12.0,11.0,14.0,7.0,24.0,4.0,1.0,0.0,0.0,188.0,79.0,2.0,3.0,2.0,1.0,2.0,1.0,1.0,2.0,1.0,2.0,2.0,10.0,11.0,13.0,12.0,11.0,9.0,13.0,9.0,5.0,8.0,11.0,11.0,7.0,13.0,10.0,12.0,11.0,11.0,12.0,13.0,11.0,14.0,12.0,9.0,12.0,12.0,14.0,14.0,12.0,13.0,15.0,14.0,8.0,13.0,12.0,20.0,13.0,14.0,11.0,9.0,10.0,5.0,10.0,14.0,12.0,13.0,10.0,14.0,13.0,12.0,10.0
1,0,23.0,0.0,0.0,0.0,0.0,188.0,85.0,14.0,12.0,12.0,7.0,13.0,10.0,11.0,14.0,7.0,13.0,12.0,2.0,3.0,1.0,3.0,8.0,6.0,2.0,1.0,2.0,2.0,8.0,3.0,1.0,8.0,7.0,10.0,12.0,9.0,11.0,8.0,11.0,14.0,2.0,9.0,1.0,12.0,11.0,8.0,7.0,12.0,14.0,14.0,6.0,14.0,10.0,20.0,12.0,14.0,13.0,7.0,10.0,7.0,1.0,14.0,14.0,9.0,13.0,13.0,10.0,12.0,6.0,23.0,0.0,0.0,0.0,0.0,184.0,71.0,1.0,2.0,1.0,2.0,2.0,2.0,2.0,4.0,2.0,1.0,3.0,4.0,10.0,10.0,6.0,11.0,6.0,14.0,8.0,7.0,14.0,11.0,6.0,13.0,11.0,12.0,12.0,13.0,12.0,11.0,12.0,12.0,14.0,6.0,8.0,10.0,13.0,13.0,14.0,15.0,13.0,14.0,13.0,8.0,12.0,14.0,20.0,13.0,14.0,13.0,12.0,14.0,15.0,8.0,11.0,13.0,13.0,10.0,8.0,9.0,16.0,7.0,28.0,0.0,0.0,0.0,0.0,174.0,67.0,3.0,4.0,1.0,1.0,1.0,3.0,1.0,3.0,2.0,1.0,2.0,11.0,8.0,11.0,9.0,13.0,6.0,7.0,12.0,8.0,10.0,10.0,3.0,6.0,12.0,10.0,13.0,7.0,12.0,8.0,10.0,9.0,12.0,13.0,5.0,12.0,9.0,12.0,11.0,14.0,14.0,11.0,7.0,10.0,15.0,12.0,20.0,11.0,6.0,9.0,6.0,10.0,10.0,9.0,11.0,14.0,9.0,11.0,12.0,8.0,8.0,8.0,21.0,0.0,0.0,0.0,0.0,177.0,0.0,1.0,1.0,1.0,2.0,3.0,3.0,2.0,3.0,2.0,2.0,3.0,6.0,4.0,13.0,13.0,13.0,6.0,13.0,7.0,3.0,5.0,7.0,6.0,1.0,11.0,9.0,7.0,8.0,7.0,7.0,7.0,8.0,7.0,11.0,8.0,13.0,7.0,6.0,7.0,12.0,13.0,7.0,6.0,8.0,8.0,13.0,20.0,5.0,5.0,9.0,5.0,9.0,9.0,9.0,10.0,10.0,12.0,12.0,11.0,10.0,9.0,6.0,21.0,0.0,0.0,0.0,0.0,178.0,65.0,2.0,3.0,3.0,3.0,3.0,1.0,1.0,1.0,1.0,3.0,1.0,9.0,13.0,11.0,6.0,12.0,7.0,9.0,8.0,8.0,13.0,12.0,7.0,13.0,12.0,8.0,12.0,13.0,12.0,12.0,13.0,13.0,14.0,9.0,8.0,12.0,12.0,13.0,13.0,12.0,14.0,13.0,11.0,8.0,15.0,12.0,20.0,13.0,12.0,14.0,8.0,11.0,7.0,10.0,19.0,10.0,13.0,10.0,11.0,15.0,15.0,6.0,32.0,22.0,1.0,6.0,1.0,186.0,79.0,1.0,2.0,1.0,1.0,2.0,3.0,1.0,2.0,1.0,2.0,1.0,11.0,12.0,13.0,11.0,13.0,11.0,14.0,11.0,8.0,12.0,13.0,13.0,13.0,13.0,14.0,13.0,14.0,14.0,13.0,14.0,13.0,12.0,13.0,14.0,15.0,13.0,12.0,15.0,12.0,13.0,12.0,12.0,10.0,12.0,13.0,20.0,15.0,13.0,14.0,5.0,12.0,9.0,17.0,8.0,12.0,8.0,13.0,10.0,10.0,10.0,5.0,21.0,0.0,0.0,0.0,0.0,172.0,66.0,2.0,3.0,2.0,2.0,1.0,1.0,1.0,3.0,2.0,1.0,1.0,10.0,10.0,13.0,9.0,14.0,9.0,8.0,10.0,7.0,13.0,13.0,9.0,12.0,13.0,10.0,12.0,13.0,13.0,12.0,14.0,13.0,13.0,11.0,9.0,14.0,13.0,14.0,14.0,14.0,13.0,12.0,8.0,8.0,12.0,12.0,20.0,13.0,12.0,14.0,10.0,11.0,8.0,12.0,15.0,10.0,15.0,8.0,11.0,14.0,14.0,6.0,22.0,0.0,0.0,0.0,0.0,177.0,72.0,2.0,1.0,2.0,4.0,2.0,2.0,1.0,3.0,4.0,2.0,3.0,10.0,12.0,13.0,11.0,12.0,10.0,12.0,12.0,4.0,10.0,13.0,11.0,11.0,13.0,11.0,12.0,11.0,13.0,9.0,13.0,12.0,3.0,12.0,8.0,14.0,12.0,12.0,13.0,16.0,13.0,12.0,9.0,8.0,15.0,14.0,20.0,14.0,13.0,10.0,4.0,11.0,11.0,12.0,19.0,9.0,12.0,13.0,12.0,11.0,14.0,7.0,25.0,1.0,0.0,7.0,3.0,178.0,85.0,2.0,3.0,3.0,2.0,3.0,3.0,2.0,3.0,2.0,2.0,2.0,9.0,12.0,12.0,12.0,11.0,8.0,9.0,12.0,6.0,7.0,11.0,12.0,7.0,13.0,12.0,11.0,14.0,12.0,9.0,10.0,10.0,14.0,13.0,7.0,13.0,9.0,9.0,12.0,14.0,12.0,15.0,10.0,14.0,11.0,14.0,20.0,13.0,15.0,10.0,11.0,12.0,6.0,14.0,14.0,13.0,12.0,13.0,10.0,13.0,12.0,12.0,24.0,4.0,1.0,0.0,0.0,188.0,79.0,2.0,3.0,2.0,1.0,2.0,1.0,1.0,2.0,1.0,2.0,2.0,10.0,11.0,13.0,12.0,11.0,9.0,13.0,9.0,5.0,8.0,11.0,11.0,7.0,13.0,10.0,12.0,11.0,11.0,12.0,13.0,11.0,14.0,12.0,9.0,12.0,12.0,14.0,14.0,12.0,13.0,15.0,14.0,8.0,13.0,12.0,20.0,13.0,14.0,11.0,9.0,10.0,5.0,10.0,14.0,12.0,13.0,10.0,14.0,13.0,12.0,10.0,29.0,30.0,6.0,0.0,0.0,178.0,76.0,2.0,3.0,3.0,4.0,3.0,2.0,2.0,2.0,2.0,1.0,1.0,6.0,11.0,16.0,10.0,12.0,5.0,8.0,8.0,5.0,4.0,13.0,7.0,3.0,12.0,7.0,8.0,12.0,11.0,10.0,8.0,9.0,13.0,15.0,4.0,13.0,7.0,12.0,10.0,16.0,15.0,14.0,8.0,11.0,13.0,16.0,20.0,10.0,13.0,10.0,11.0,10.0,7.0,5.0,9.0,16.0,9.0,10.0,11.0,11.0,14.0,3.0,25.0,0.0,0.0,0.0,0.0,187.0,83.0,11.0,14.0,12.0,8.0,13.0,11.0,14.0,15.0,13.0,13.0,9.0,8.0,1.0,1.0,1.0,11.0,11.0,1.0,2.0,2.0,1.0,10.0,3.0,2.0,11.0,8.0,12.0,14.0,12.0,12.0,10.0,12.0,14.0,6.0,14.0,2.0,12.0,12.0,8.0,13.0,15.0,14.0,13.0,20.0,15.0,11.0,5.0,14.0,13.0,13.0,8.0,8.0,10.0,1.0,9.0,13.0,14.0,12.0,15.0,15.0,15.0,5.0,28.0,0.0,0.0,0.0,0.0,184.0,85.0,2.0,3.0,2.0,1.0,1.0,3.0,2.0,2.0,3.0,1.0,3.0,4.0,8.0,8.0,6.0,12.0,6.0,14.0,8.0,5.0,13.0,12.0,6.0,14.0,12.0,11.0,13.0,14.0,13.0,12.0,11.0,11.0,13.0,7.0,14.0,10.0,15.0,16.0,12.0,12.0,11.0,15.0,12.0,20.0,13.0,11.0,7.0,14.0,16.0,13.0,11.0,13.0,13.0,12.0,15.0,13.0,13.0,14.0,15.0,14.0,14.0,6.0,32.0,1.0,0.0,5.0,0.0,189.0,93.0,1.0,1.0,3.0,4.0,2.0,2.0,3.0,2.0,3.0,3.0,3.0,3.0,8.0,8.0,7.0,9.0,8.0,16.0,8.0,7.0,14.0,10.0,9.0,14.0,9.0,15.0,14.0,16.0,12.0,10.0,10.0,12.0,14.0,9.0,9.0,7.0,13.0,14.0,15.0,9.0,8.0,10.0,14.0,8.0,16.0,11.0,20.0,14.0,19.0,12.0,14.0,12.0,8.0,6.0,13.0,16.0,14.0,11.0,15.0,14.0,12.0,10.0,25.0,0.0,0.0,3.0,0.0,184.0,80.0,2.0,2.0,4.0,2.0,1.0,3.0,2.0,1.0,1.0,2.0,1.0,5.0,8.0,7.0,6.0,9.0,6.0,14.0,6.0,6.0,14.0,7.0,6.0,13.0,9.0,12.0,14.0,13.0,11.0,13.0,7.0,12.0,14.0,8.0,10.0,7.0,14.0,13.0,14.0,15.0,12.0,14.0,12.0,8.0,15.0,15.0,20.0,14.0,14.0,13.0,12.0,14.0,5.0,10.0,16.0,13.0,15.0,15.0,12.0,14.0,14.0,8.0,21.0,0.0,0.0,4.0,0.0,178.0,72.0,2.0,3.0,1.0,2.0,2.0,3.0,3.0,1.0,2.0,2.0,3.0,6.0,12.0,10.0,7.0,11.0,7.0,9.0,8.0,11.0,12.0,11.0,8.0,13.0,11.0,10.0,12.0,11.0,12.0,13.0,11.0,11.0,13.0,8.0,11.0,12.0,12.0,13.0,14.0,15.0,13.0,13.0,9.0,7.0,14.0,14.0,20.0,14.0,12.0,13.0,10.0,12.0,9.0,14.0,16.0,15.0,8.0,10.0,12.0,16.0,17.0,10.0,26.0,0.0,0.0,0.0,0.0,177.0,68.0,4.0,2.0,1.0,2.0,3.0,1.0,1.0,2.0,3.0,3.0,3.0,12.0,13.0,11.0,8.0,13.0,11.0,8.0,10.0,8.0,10.0,13.0,10.0,12.0,13.0,7.0,12.0,10.0,13.0,11.0,15.0,13.0,14.0,11.0,7.0,14.0,10.0,14.0,14.0,13.0,15.0,12.0,9.0,20.0,15.0,14.0,5.0,15.0,8.0,13.0,7.0,14.0,6.0,12.0,11.0,12.0,14.0,13.0,16.0,16.0,16.0,5.0,31.0,0.0,0.0,4.0,0.0,174.0,72.0,2.0,1.0,4.0,2.0,2.0,3.0,1.0,1.0,3.0,3.0,4.0,12.0,9.0,11.0,6.0,14.0,11.0,7.0,10.0,6.0,8.0,16.0,12.0,9.0,14.0,9.0,14.0,10.0,13.0,12.0,12.0,11.0,14.0,8.0,8.0,11.0,12.0,14.0,12.0,13.0,14.0,12.0,7.0,12.0,14.0,12.0,20.0,15.0,11.0,11.0,9.0,12.0,8.0,10.0,10.0,14.0,13.0,10.0,12.0,14.0,14.0,9.0,22.0,0.0,0.0,0.0,0.0,164.0,65.0,1.0,2.0,3.0,1.0,2.0,2.0,3.0,2.0,2.0,1.0,2.0,10.0,12.0,13.0,11.0,13.0,10.0,5.0,10.0,7.0,5.0,12.0,10.0,3.0,13.0,7.0,11.0,11.0,11.0,13.0,13.0,11.0,13.0,13.0,6.0,14.0,7.0,12.0,12.0,15.0,15.0,8.0,2.0,9.0,13.0,14.0,20.0,13.0,8.0,13.0,7.0,10.0,8.0,12.0,10.0,12.0,11.0,12.0,11.0,10.0,10.0,8.0,28.0,0.0,0.0,0.0,0.0,170.0,67.0,2.0,3.0,3.0,4.0,3.0,2.0,1.0,1.0,2.0,2.0,3.0,8.0,12.0,12.0,10.0,14.0,7.0,5.0,10.0,6.0,5.0,12.0,5.0,4.0,13.0,7.0,16.0,12.0,9.0,11.0,12.0,10.0,3.0,12.0,6.0,13.0,6.0,8.0,13.0,16.0,13.0,10.0,5.0,5.0,13.0,16.0,20.0,15.0,7.0,12.0,4.0,9.0,7.0,10.0,20.0,13.0,12.0,10.0,13.0,11.0,10.0,2.0,27.0,33.0,4.0,3.0,0.0,180.0,75.0,2.0,1.0,2.0,1.0,4.0,2.0,1.0,3.0,1.0,1.0,2.0,12.0,11.0,13.0,13.0,11.0,11.0,11.0,10.0,7.0,5.0,10.0,14.0,5.0,14.0,9.0,11.0,12.0,10.0,11.0,12.0,12.0,14.0,13.0,8.0,14.0,8.0,11.0,14.0,16.0,14.0,13.0,10.0,7.0,12.0,15.0,20.0,14.0,12.0,12.0,9.0,13.0,10.0,10.0,9.0,15.0,8.0,9.0,13.0,14.0,14.0,7.0,24.0,24.0,4.0,0.0,0.0,172.0,74.0,2.0,4.0,3.0,2.0,2.0,1.0,2.0,2.0,3.0,2.0,4.0,8.0,9.0,14.0,13.0,14.0,9.0,11.0,10.0,7.0,5.0,12.0,12.0,3.0,13.0,10.0,12.0,12.0,13.0,12.0,11.0,10.0,14.0,13.0,7.0,14.0,9.0,9.0,13.0,16.0,15.0,13.0,6.0,8.0,13.0,16.0,20.0,14.0,12.0,11.0,11.0,13.0,9.0,8.0,9.0,13.0,9.0,11.0,12.0,13.0,10.0,9.0
1,5,36.0,0.0,0.0,0.0,0.0,185.0,78.0,11.0,14.0,12.0,7.0,13.0,12.0,14.0,15.0,13.0,14.0,10.0,4.0,1.0,3.0,1.0,8.0,8.0,11.0,8.0,3.0,3.0,7.0,2.0,1.0,8.0,11.0,13.0,15.0,11.0,12.0,7.0,13.0,9.0,5.0,14.0,3.0,13.0,15.0,8.0,11.0,14.0,13.0,12.0,5.0,15.0,11.0,20.0,12.0,14.0,13.0,11.0,13.0,8.0,1.0,19.0,14.0,16.0,10.0,17.0,9.0,9.0,11.0,28.0,0.0,0.0,0.0,0.0,183.0,81.0,1.0,2.0,4.0,1.0,1.0,3.0,2.0,3.0,3.0,3.0,1.0,5.0,5.0,6.0,10.0,12.0,6.0,14.0,8.0,6.0,15.0,11.0,6.0,13.0,12.0,13.0,14.0,16.0,14.0,14.0,10.0,12.0,14.0,5.0,14.0,8.0,14.0,15.0,15.0,9.0,12.0,15.0,13.0,7.0,11.0,12.0,20.0,15.0,15.0,14.0,14.0,14.0,9.0,8.0,14.0,14.0,11.0,13.0,15.0,13.0,15.0,6.0,34.0,23.0,1.0,0.0,0.0,186.0,81.0,3.0,3.0,1.0,2.0,1.0,3.0,2.0,3.0,1.0,3.0,3.0,4.0,8.0,6.0,10.0,7.0,8.0,17.0,12.0,10.0,14.0,7.0,9.0,15.0,7.0,15.0,13.0,17.0,8.0,12.0,7.0,12.0,15.0,6.0,17.0,7.0,14.0,15.0,14.0,8.0,10.0,16.0,13.0,12.0,13.0,9.0,20.0,13.0,15.0,11.0,15.0,14.0,9.0,10.0,10.0,14.0,11.0,13.0,15.0,11.0,11.0,12.0,27.0,10.0,0.0,0.0,0.0,181.0,69.0,1.0,1.0,3.0,3.0,3.0,3.0,2.0,3.0,3.0,3.0,1.0,5.0,13.0,10.0,7.0,13.0,9.0,10.0,10.0,12.0,12.0,11.0,7.0,12.0,11.0,11.0,13.0,12.0,11.0,13.0,9.0,9.0,12.0,8.0,7.0,12.0,11.0,11.0,13.0,15.0,13.0,13.0,10.0,20.0,12.0,15.0,8.0,15.0,12.0,13.0,11.0,14.0,13.0,12.0,10.0,14.0,12.0,10.0,11.0,15.0,15.0,7.0,36.0,0.0,0.0,0.0,0.0,180.0,72.0,1.0,2.0,4.0,1.0,1.0,2.0,2.0,1.0,1.0,1.0,2.0,6.0,10.0,8.0,6.0,11.0,8.0,13.0,10.0,7.0,11.0,11.0,8.0,13.0,11.0,13.0,13.0,14.0,14.0,13.0,11.0,12.0,13.0,7.0,10.0,10.0,13.0,13.0,15.0,11.0,12.0,14.0,10.0,10.0,14.0,10.0,20.0,12.0,11.0,12.0,14.0,14.0,5.0,15.0,20.0,12.0,20.0,14.0,16.0,15.0,15.0,5.0,27.0,14.0,1.0,0.0,0.0,183.0,77.0,1.0,2.0,1.0,2.0,3.0,2.0,3.0,2.0,2.0,1.0,1.0,5.0,12.0,9.0,8.0,13.0,10.0,13.0,10.0,6.0,14.0,13.0,6.0,13.0,12.0,14.0,13.0,15.0,11.0,11.0,11.0,11.0,13.0,9.0,8.0,9.0,12.0,14.0,16.0,14.0,12.0,14.0,12.0,7.0,14.0,12.0,20.0,15.0,14.0,14.0,14.0,15.0,7.0,10.0,12.0,13.0,14.0,12.0,13.0,11.0,11.0,7.0,30.0,0.0,0.0,0.0,0.0,167.0,60.0,3.0,1.0,1.0,2.0,3.0,1.0,1.0,3.0,1.0,1.0,3.0,10.0,11.0,12.0,8.0,13.0,10.0,6.0,9.0,10.0,12.0,14.0,9.0,10.0,14.0,11.0,14.0,14.0,14.0,14.0,13.0,14.0,12.0,14.0,11.0,13.0,12.0,15.0,15.0,15.0,14.0,11.0,5.0,11.0,11.0,15.0,20.0,11.0,8.0,14.0,10.0,12.0,13.0,11.0,11.0,12.0,11.0,10.0,12.0,11.0,11.0,2.0,33.0,0.0,0.0,0.0,0.0,187.0,76.0,2.0,2.0,3.0,1.0,1.0,3.0,2.0,1.0,2.0,3.0,2.0,15.0,14.0,14.0,10.0,15.0,13.0,10.0,12.0,7.0,4.0,15.0,13.0,7.0,15.0,6.0,12.0,9.0,14.0,11.0,15.0,12.0,12.0,14.0,12.0,13.0,7.0,13.0,12.0,11.0,12.0,14.0,12.0,14.0,15.0,12.0,20.0,11.0,12.0,12.0,6.0,14.0,6.0,11.0,14.0,13.0,12.0,12.0,15.0,15.0,13.0,9.0,27.0,0.0,0.0,0.0,0.0,190.0,87.0,1.0,3.0,2.0,3.0,1.0,3.0,1.0,1.0,2.0,3.0,2.0,5.0,7.0,9.0,14.0,14.0,10.0,14.0,13.0,5.0,6.0,12.0,12.0,8.0,14.0,14.0,13.0,16.0,14.0,11.0,10.0,13.0,15.0,10.0,11.0,14.0,9.0,15.0,14.0,10.0,11.0,16.0,15.0,9.0,12.0,12.0,20.0,14.0,16.0,13.0,13.0,12.0,7.0,5.0,10.0,12.0,14.0,12.0,14.0,14.0,19.0,12.0,17.0,0.0,0.0,0.0,0.0,181.0,68.0,1.0,2.0,1.0,1.0,2.0,2.0,3.0,3.0,3.0,2.0,1.0,8.0,11.0,14.0,11.0,13.0,8.0,11.0,9.0,5.0,3.0,11.0,5.0,5.0,14.0,5.0,11.0,6.0,10.0,10.0,11.0,12.0,14.0,13.0,6.0,13.0,9.0,10.0,8.0,14.0,14.0,14.0,10.0,5.0,12.0,14.0,20.0,12.0,11.0,10.0,6.0,5.0,10.0,12.0,20.0,12.0,11.0,12.0,12.0,11.0,14.0,5.0,26.0,0.0,0.0,0.0,0.0,193.0,81.0,1.0,3.0,3.0,3.0,3.0,1.0,2.0,2.0,2.0,3.0,3.0,4.0,9.0,14.0,10.0,13.0,12.0,14.0,14.0,5.0,5.0,10.0,12.0,3.0,14.0,8.0,13.0,12.0,9.0,10.0,11.0,11.0,12.0,16.0,5.0,14.0,6.0,9.0,12.0,14.0,13.0,14.0,16.0,14.0,13.0,13.0,20.0,13.0,14.0,10.0,8.0,14.0,9.0,8.0,16.0,16.0,11.0,13.0,11.0,13.0,13.0,10.0,33.0,0.0,0.0,2.0,0.0,196.0,89.0,15.0,13.0,12.0,7.0,14.0,10.0,14.0,14.0,11.0,9.0,12.0,4.0,3.0,1.0,1.0,9.0,7.0,2.0,2.0,1.0,1.0,10.0,2.0,2.0,9.0,10.0,14.0,14.0,13.0,12.0,11.0,12.0,14.0,6.0,12.0,1.0,13.0,11.0,6.0,9.0,13.0,16.0,18.0,5.0,12.0,10.0,20.0,12.0,16.0,14.0,10.0,15.0,13.0,1.0,8.0,14.0,14.0,14.0,10.0,15.0,15.0,9.0,30.0,19.0,0.0,7.0,0.0,189.0,77.0,3.0,2.0,3.0,2.0,3.0,3.0,1.0,3.0,3.0,1.0,2.0,5.0,8.0,7.0,10.0,10.0,9.0,15.0,9.0,8.0,14.0,12.0,10.0,15.0,10.0,15.0,14.0,13.0,13.0,14.0,10.0,12.0,14.0,10.0,14.0,11.0,12.0,14.0,14.0,8.0,10.0,12.0,16.0,10.0,16.0,10.0,20.0,13.0,16.0,13.0,11.0,13.0,7.0,10.0,6.0,14.0,12.0,13.0,14.0,13.0,13.0,7.0,34.0,5.0,0.0,2.0,1.0,186.0,78.0,2.0,1.0,3.0,3.0,1.0,3.0,2.0,3.0,1.0,3.0,1.0,7.0,11.0,10.0,6.0,12.0,8.0,14.0,7.0,14.0,14.0,10.0,9.0,14.0,12.0,13.0,13.0,15.0,13.0,13.0,9.0,12.0,15.0,10.0,13.0,8.0,13.0,13.0,14.0,11.0,12.0,14.0,13.0,8.0,13.0,12.0,20.0,14.0,14.0,13.0,13.0,15.0,9.0,12.0,8.0,16.0,13.0,14.0,13.0,16.0,16.0,7.0,35.0,80.0,0.0,11.0,0.0,174.0,74.0,3.0,4.0,2.0,2.0,2.0,2.0,1.0,2.0,2.0,3.0,2.0,8.0,14.0,13.0,7.0,15.0,8.0,14.0,4.0,14.0,14.0,13.0,9.0,16.0,15.0,15.0,15.0,16.0,17.0,13.0,11.0,15.0,19.0,14.0,18.0,14.0,17.0,16.0,14.0,12.0,13.0,15.0,9.0,20.0,17.0,12.0,9.0,13.0,11.0,16.0,14.0,16.0,4.0,10.0,18.0,14.0,17.0,17.0,14.0,14.0,14.0,12.0,26.0,27.0,0.0,0.0,0.0,183.0,70.0,1.0,3.0,1.0,3.0,4.0,1.0,3.0,3.0,2.0,1.0,3.0,9.0,14.0,12.0,8.0,10.0,8.0,12.0,13.0,14.0,9.0,12.0,7.0,13.0,11.0,14.0,9.0,15.0,10.0,12.0,9.0,10.0,16.0,10.0,9.0,12.0,8.0,12.0,17.0,14.0,11.0,13.0,12.0,10.0,16.0,16.0,20.0,16.0,13.0,13.0,10.0,14.0,6.0,15.0,10.0,15.0,14.0,10.0,16.0,13.0,13.0,4.0,18.0,0.0,0.0,0.0,0.0,167.0,60.0,2.0,1.0,2.0,2.0,2.0,1.0,2.0,1.0,1.0,1.0,1.0,10.0,11.0,12.0,8.0,13.0,10.0,3.0,10.0,5.0,6.0,13.0,12.0,8.0,15.0,8.0,11.0,8.0,12.0,11.0,13.0,12.0,13.0,12.0,6.0,11.0,11.0,12.0,13.0,15.0,14.0,8.0,5.0,8.0,15.0,12.0,20.0,12.0,7.0,8.0,8.0,14.0,7.0,8.0,18.0,11.0,12.0,11.0,12.0,15.0,15.0,7.0,27.0,0.0,0.0,2.0,0.0,179.0,73.0,3.0,2.0,2.0,2.0,1.0,2.0,1.0,1.0,2.0,2.0,1.0,9.0,10.0,12.0,8.0,13.0,9.0,12.0,13.0,6.0,12.0,13.0,10.0,14.0,13.0,14.0,13.0,13.0,14.0,9.0,13.0,11.0,8.0,12.0,7.0,12.0,12.0,11.0,13.0,14.0,14.0,13.0,9.0,12.0,14.0,12.0,20.0,16.0,12.0,13.0,14.0,14.0,10.0,8.0,12.0,12.0,12.0,9.0,13.0,11.0,11.0,13.0,21.0,0.0,0.0,11.0,2.0,180.0,72.0,2.0,3.0,3.0,3.0,3.0,2.0,2.0,1.0,3.0,2.0,3.0,12.0,13.0,14.0,9.0,14.0,13.0,8.0,12.0,5.0,8.0,14.0,10.0,9.0,14.0,12.0,12.0,9.0,13.0,12.0,15.0,13.0,14.0,15.0,8.0,13.0,10.0,16.0,14.0,15.0,14.0,12.0,9.0,8.0,15.0,14.0,20.0,13.0,12.0,12.0,8.0,11.0,10.0,11.0,10.0,14.0,16.0,14.0,15.0,15.0,15.0,6.0,29.0,26.0,6.0,12.0,4.0,175.0,77.0,1.0,2.0,1.0,3.0,3.0,2.0,1.0,2.0,1.0,2.0,2.0,16.0,14.0,16.0,15.0,15.0,18.0,6.0,15.0,6.0,6.0,18.0,11.0,5.0,17.0,9.0,12.0,10.0,16.0,12.0,16.0,14.0,14.0,16.0,6.0,16.0,6.0,10.0,10.0,13.0,15.0,14.0,8.0,15.0,15.0,14.0,20.0,13.0,12.0,11.0,9.0,16.0,7.0,8.0,8.0,11.0,8.0,13.0,12.0,13.0,11.0,10.0,23.0,0.0,0.0,10.0,7.0,179.0,70.0,1.0,1.0,2.0,2.0,1.0,3.0,3.0,2.0,1.0,4.0,3.0,10.0,13.0,14.0,12.0,15.0,11.0,10.0,13.0,6.0,3.0,13.0,12.0,4.0,16.0,11.0,12.0,11.0,13.0,11.0,13.0,12.0,12.0,16.0,6.0,14.0,6.0,10.0,12.0,16.0,14.0,12.0,9.0,20.0,13.0,14.0,10.0,13.0,10.0,12.0,7.0,12.0,6.0,8.0,12.0,13.0,5.0,10.0,8.0,14.0,12.0,8.0,30.0,12.0,3.0,0.0,0.0,184.0,77.0,1.0,2.0,1.0,1.0,1.0,4.0,2.0,1.0,1.0,2.0,3.0,4.0,8.0,12.0,15.0,12.0,9.0,16.0,11.0,5.0,6.0,11.0,16.0,4.0,13.0,9.0,14.0,15.0,13.0,13.0,9.0,12.0,12.0,15.0,10.0,14.0,5.0,12.0,10.0,12.0,13.0,14.0,13.0,10.0,11.0,13.0,20.0,15.0,16.0,11.0,9.0,14.0,6.0,5.0,10.0,17.0,11.0,14.0,14.0,15.0,17.0,10.0
0,0,25.0,0.0,0.0,0.0,0.0,185.0,85.0,14.0,11.0,14.0,10.0,12.0,14.0,13.0,14.0,11.0,15.0,9.0,4.0,1.0,3.0,1.0,9.0,8.0,3.0,11.0,1.0,2.0,8.0,2.0,7.0,9.0,8.0,13.0,13.0,12.0,12.0,8.0,11.0,16.0,6.0,14.0,1.0,12.0,12.0,7.0,10.0,13.0,15.0,12.0,5.0,17.0,9.0,20.0,13.0,15.0,14.0,8.0,13.0,3.0,1.0,17.0,13.0,13.0,13.0,14.0,14.0,14.0,5.0,24.0,2.0,0.0,0.0,0.0,188.0,83.0,2.0,2.0,2.0,1.0,3.0,2.0,3.0,3.0,1.0,2.0,1.0,11.0,12.0,11.0,6.0,12.0,11.0,11.0,9.0,13.0,11.0,11.0,10.0,12.0,12.0,13.0,13.0,12.0,12.0,9.0,11.0,11.0,2.0,12.0,11.0,12.0,8.0,12.0,12.0,11.0,10.0,13.0,13.0,20.0,12.0,12.0,4.0,12.0,13.0,12.0,9.0,5.0,7.0,11.0,8.0,10.0,14.0,12.0,12.0,1.0,18.0,8.0,36.0,0.0,0.0,0.0,0.0,182.0,70.0,2.0,1.0,3.0,3.0,1.0,2.0,1.0,1.0,1.0,1.0,3.0,8.0,11.0,8.0,6.0,11.0,7.0,10.0,8.0,12.0,13.0,10.0,6.0,14.0,11.0,15.0,13.0,15.0,11.0,12.0,7.0,10.0,12.0,6.0,13.0,7.0,14.0,14.0,14.0,12.0,11.0,14.0,11.0,12.0,12.0,10.0,20.0,13.0,12.0,12.0,15.0,13.0,9.0,10.0,6.0,12.0,14.0,11.0,15.0,12.0,12.0,6.0,31.0,0.0,0.0,0.0,0.0,190.0,82.0,1.0,1.0,2.0,2.0,2.0,1.0,3.0,1.0,1.0,1.0,2.0,4.0,8.0,8.0,6.0,12.0,10.0,15.0,13.0,8.0,14.0,13.0,7.0,14.0,13.0,14.0,14.0,15.0,11.0,11.0,12.0,12.0,13.0,7.0,11.0,10.0,13.0,14.0,16.0,12.0,10.0,9.0,15.0,5.0,13.0,13.0,20.0,13.0,15.0,12.0,14.0,14.0,13.0,12.0,10.0,13.0,14.0,11.0,14.0,13.0,13.0,9.0,19.0,0.0,0.0,0.0,0.0,175.0,70.0,1.0,3.0,3.0,1.0,1.0,3.0,1.0,1.0,2.0,2.0,2.0,6.0,10.0,6.0,7.0,10.0,2.0,10.0,6.0,9.0,10.0,11.0,2.0,15.0,9.0,9.0,12.0,9.0,10.0,8.0,10.0,13.0,2.0,9.0,1.0,9.0,9.0,10.0,11.0,14.0,12.0,7.0,7.0,4.0,13.0,13.0,20.0,9.0,8.0,9.0,9.0,8.0,9.0,14.0,12.0,7.0,9.0,9.0,9.0,10.0,19.0,3.0,36.0,0.0,0.0,3.0,0.0,168.0,72.0,3.0,2.0,1.0,3.0,1.0,3.0,3.0,1.0,3.0,3.0,1.0,11.0,8.0,12.0,5.0,13.0,11.0,8.0,13.0,6.0,12.0,13.0,8.0,14.0,13.0,17.0,14.0,17.0,14.0,15.0,13.0,14.0,17.0,12.0,16.0,10.0,15.0,16.0,14.0,10.0,13.0,14.0,4.0,8.0,16.0,8.0,20.0,12.0,13.0,17.0,14.0,14.0,7.0,10.0,19.0,15.0,14.0,16.0,15.0,9.0,9.0,7.0,23.0,2.0,0.0,5.0,0.0,180.0,77.0,3.0,2.0,2.0,3.0,2.0,3.0,2.0,2.0,3.0,3.0,4.0,14.0,12.0,12.0,10.0,13.0,14.0,6.0,14.0,8.0,8.0,13.0,12.0,9.0,14.0,13.0,12.0,12.0,11.0,10.0,12.0,13.0,13.0,10.0,6.0,13.0,10.0,12.0,14.0,13.0,14.0,13.0,10.0,8.0,13.0,14.0,20.0,14.0,14.0,9.0,8.0,14.0,6.0,16.0,13.0,12.0,13.0,12.0,13.0,13.0,14.0,6.0,30.0,0.0,0.0,0.0,0.0,162.0,65.0,1.0,1.0,1.0,1.0,3.0,3.0,3.0,4.0,2.0,2.0,1.0,13.0,12.0,14.0,10.0,14.0,15.0,5.0,12.0,6.0,4.0,11.0,12.0,3.0,15.0,11.0,12.0,8.0,10.0,13.0,13.0,12.0,17.0,15.0,9.0,13.0,7.0,11.0,14.0,15.0,14.0,7.0,3.0,14.0,11.0,13.0,20.0,11.0,7.0,13.0,11.0,15.0,11.0,8.0,10.0,14.0,13.0,14.0,14.0,13.0,10.0,6.0,23.0,0.0,0.0,0.0,0.0,185.0,67.0,3.0,1.0,3.0,1.0,2.0,2.0,3.0,1.0,2.0,2.0,1.0,13.0,11.0,14.0,13.0,13.0,12.0,3.0,14.0,5.0,5.0,15.0,11.0,5.0,14.0,6.0,12.0,11.0,13.0,13.0,12.0,12.0,15.0,11.0,2.0,12.0,12.0,14.0,13.0,11.0,13.0,12.0,7.0,10.0,7.0,13.0,20.0,14.0,8.0,13.0,10.0,13.0,10.0,9.0,9.0,11.0,12.0,10.0,12.0,10.0,17.0,3.0,27.0,11.0,1.0,0.0,0.0,187.0,86.0,3.0,1.0,2.0,2.0,4.0,3.0,2.0,1.0,1.0,3.0,1.0,3.0,9.0,13.0,15.0,12.0,10.0,17.0,11.0,5.0,5.0,9.0,14.0,4.0,11.0,9.0,12.0,13.0,12.0,11.0,9.0,10.0,13.0,11.0,10.0,13.0,10.0,15.0,15.0,14.0,12.0,15.0,13.0,7.0,15.0,13.0,20.0,13.0,15.0,14.0,9.0,13.0,7.0,5.0,15.0,13.0,13.0,11.0,10.0,12.0,18.0,6.0,23.0,0.0,0.0,0.0,0.0,183.0,80.0,3.0,2.0,1.0,3.0,1.0,3.0,2.0,3.0,1.0,2.0,3.0,4.0,12.0,13.0,14.0,12.0,9.0,10.0,14.0,5.0,5.0,12.0,11.0,7.0,12.0,11.0,12.0,12.0,10.0,12.0,10.0,11.0,5.0,11.0,9.0,14.0,10.0,13.0,12.0,15.0,14.0,13.0,11.0,8.0,12.0,14.0,20.0,13.0,14.0,10.0,8.0,13.0,7.0,7.0,16.0,14.0,11.0,10.0,12.0,9.0,9.0,2.0,34.0,1.0,0.0,0.0,0.0,187.0,87.0,13.0,14.0,15.0,7.0,13.0,11.0,14.0,15.0,11.0,17.0,12.0,2.0,1.0,1.0,3.0,8.0,7.0,2.0,1.0,2.0,1.0,9.0,8.0,2.0,6.0,12.0,15.0,17.0,14.0,15.0,8.0,13.0,17.0,7.0,14.0,6.0,14.0,12.0,6.0,7.0,13.0,14.0,13.0,8.0,13.0,8.0,20.0,11.0,16.0,14.0,10.0,14.0,6.0,1.0,12.0,12.0,15.0,16.0,16.0,14.0,15.0,6.0,28.0,0.0,0.0,0.0,0.0,190.0,85.0,3.0,2.0,3.0,3.0,2.0,2.0,2.0,4.0,3.0,1.0,2.0,5.0,9.0,8.0,9.0,8.0,7.0,14.0,10.0,9.0,15.0,9.0,6.0,14.0,9.0,16.0,13.0,16.0,10.0,13.0,10.0,12.0,15.0,6.0,13.0,7.0,13.0,14.0,16.0,12.0,11.0,17.0,13.0,20.0,15.0,13.0,8.0,15.0,15.0,12.0,14.0,14.0,9.0,8.0,14.0,13.0,14.0,11.0,12.0,13.0,16.0,14.0,31.0,2.0,0.0,0.0,0.0,187.0,83.0,3.0,1.0,3.0,1.0,3.0,2.0,1.0,3.0,3.0,1.0,1.0,8.0,11.0,10.0,8.0,11.0,8.0,15.0,8.0,13.0,14.0,11.0,11.0,14.0,8.0,16.0,13.0,15.0,14.0,12.0,5.0,12.0,13.0,9.0,9.0,11.0,14.0,12.0,13.0,13.0,8.0,16.0,14.0,5.0,14.0,13.0,20.0,12.0,14.0,14.0,15.0,12.0,5.0,8.0,12.0,14.0,11.0,11.0,14.0,12.0,13.0,5.0,26.0,0.0,0.0,0.0,0.0,176.0,70.0,2.0,1.0,4.0,3.0,3.0,3.0,1.0,3.0,3.0,2.0,1.0,10.0,11.0,11.0,6.0,13.0,9.0,5.0,12.0,11.0,13.0,13.0,7.0,14.0,13.0,15.0,11.0,14.0,12.0,11.0,9.0,12.0,13.0,9.0,9.0,13.0,12.0,15.0,14.0,12.0,16.0,12.0,7.0,20.0,13.0,13.0,10.0,15.0,11.0,13.0,14.0,13.0,11.0,9.0,8.0,9.0,17.0,12.0,14.0,14.0,15.0,3.0,23.0,0.0,0.0,0.0,0.0,174.0,64.0,4.0,3.0,1.0,1.0,3.0,3.0,2.0,3.0,3.0,2.0,3.0,8.0,12.0,10.0,8.0,11.0,7.0,10.0,9.0,12.0,14.0,9.0,10.0,13.0,12.0,12.0,12.0,12.0,11.0,12.0,10.0,12.0,13.0,8.0,9.0,12.0,11.0,13.0,14.0,15.0,14.0,11.0,10.0,10.0,14.0,14.0,20.0,15.0,10.0,14.0,12.0,12.0,8.0,13.0,10.0,12.0,15.0,12.0,13.0,10.0,17.0,6.0,32.0,36.0,0.0,12.0,2.0,183.0,77.0,1.0,3.0,2.0,1.0,3.0,1.0,1.0,2.0,1.0,1.0,3.0,6.0,11.0,8.0,6.0,13.0,11.0,13.0,10.0,6.0,15.0,14.0,10.0,17.0,12.0,15.0,16.0,18.0,14.0,17.0,12.0,15.0,17.0,11.0,17.0,7.0,17.0,20.0,16.0,9.0,11.0,15.0,11.0,8.0,15.0,10.0,20.0,14.0,14.0,17.0,10.0,16.0,10.0,13.0,15.0,15.0,15.0,14.0,18.0,15.0,13.0,6.0,26.0,0.0,0.0,0.0,0.0,184.0,76.0,3.0,1.0,3.0,1.0,3.0,2.0,3.0,2.0,1.0,1.0,3.0,10.0,11.0,13.0,9.0,13.0,12.0,13.0,10.0,6.0,11.0,13.0,9.0,14.0,12.0,12.0,13.0,12.0,12.0,11.0,13.0,12.0,13.0,13.0,10.0,12.0,13.0,12.0,16.0,15.0,13.0,15.0,13.0,20.0,15.0,14.0,5.0,16.0,15.0,13.0,12.0,14.0,5.0,12.0,18.0,14.0,10.0,7.0,11.0,11.0,13.0,10.0,20.0,0.0,0.0,0.0,0.0,173.0,66.0,1.0,1.0,1.0,1.0,1.0,2.0,3.0,1.0,3.0,3.0,4.0,15.0,13.0,13.0,10.0,15.0,12.0,5.0,13.0,5.0,7.0,15.0,12.0,7.0,15.0,10.0,10.0,13.0,12.0,10.0,16.0,13.0,18.0,14.0,7.0,14.0,12.0,14.0,14.0,8.0,14.0,13.0,7.0,14.0,12.0,9.0,20.0,12.0,13.0,12.0,8.0,15.0,6.0,12.0,12.0,14.0,14.0,14.0,15.0,14.0,11.0,6.0,19.0,0.0,0.0,11.0,1.0,171.0,65.0,2.0,2.0,2.0,2.0,2.0,3.0,3.0,3.0,1.0,1.0,3.0,14.0,13.0,13.0,11.0,14.0,15.0,8.0,12.0,6.0,4.0,13.0,12.0,4.0,15.0,8.0,12.0,10.0,12.0,8.0,13.0,13.0,14.0,15.0,8.0,14.0,6.0,13.0,12.0,15.0,16.0,10.0,7.0,20.0,13.0,15.0,10.0,12.0,7.0,11.0,6.0,11.0,8.0,11.0,12.0,13.0,11.0,12.0,12.0,6.0,12.0,5.0,20.0,7.0,1.0,0.0,0.0,182.0,75.0,2.0,1.0,3.0,2.0,2.0,1.0,3.0,1.0,3.0,2.0,1.0,11.0,11.0,13.0,12.0,13.0,11.0,12.0,10.0,5.0,4.0,12.0,8.0,5.0,13.0,11.0,12.0,11.0,11.0,8.0,10.0,10.0,3.0,10.0,1.0,13.0,8.0,12.0,12.0,15.0,14.0,13.0,11.0,6.0,14.0,13.0,20.0,12.0,13.0,12.0,9.0,11.0,9.0,11.0,9.0,9.0,9.0,12.0,11.0,9.0,17.0,7.0,22.0,0.0,0.0,0.0,0.0,181.0,81.0,2.0,3.0,2.0,1.0,3.0,3.0,4.0,2.0,1.0,1.0,2.0,5.0,11.0,12.0,14.0,12.0,6.0,13.0,10.0,5.0,4.0,12.0,12.0,4.0,13.0,8.0,12.0,13.0,12.0,12.0,11.0,11.0,15.0,14.0,5.0,14.0,10.0,13.0,15.0,13.0,12.0,14.0,10.0,20.0,15.0,12.0,14.0,13.0,14.0,13.0,8.0,12.0,5.0,14.0,8.0,12.0,12.0,9.0,13.0,12.0,14.0,7.0
5,0,25.0,0.0,0.0,11.0,0.0,189.0,83.0,12.0,12.0,11.0,7.0,13.0,12.0,17.0,17.0,16.0,12.0,13.0,6.0,2.0,1.0,1.0,10.0,10.0,7.0,1.0,1.0,1.0,9.0,5.0,1.0,10.0,8.0,15.0,14.0,14.0,12.0,7.0,13.0,12.0,6.0,9.0,3.0,16.0,17.0,10.0,13.0,16.0,14.0,12.0,8.0,15.0,10.0,20.0,13.0,14.0,14.0,5.0,14.0,4.0,12.0,15.0,15.0,13.0,13.0,17.0,15.0,17.0,4.0,31.0,0.0,0.0,0.0,0.0,171.0,65.0,1.0,3.0,1.0,3.0,2.0,2.0,3.0,1.0,2.0,2.0,3.0,8.0,9.0,11.0,7.0,5.0,6.0,5.0,6.0,7.0,14.0,14.0,6.0,14.0,13.0,14.0,12.0,13.0,12.0,11.0,11.0,12.0,12.0,11.0,7.0,12.0,12.0,12.0,10.0,15.0,15.0,7.0,9.0,9.0,12.0,14.0,20.0,12.0,13.0,11.0,13.0,11.0,9.0,10.0,15.0,14.0,12.0,11.0,14.0,13.0,12.0,7.0,29.0,0.0,0.0,0.0,0.0,170.0,65.0,2.0,1.0,3.0,3.0,1.0,3.0,2.0,1.0,2.0,3.0,2.0,5.0,11.0,4.0,6.0,7.0,4.0,7.0,5.0,6.0,6.0,6.0,2.0,6.0,7.0,9.0,10.0,13.0,8.0,12.0,8.0,13.0,15.0,2.0,7.0,5.0,9.0,8.0,8.0,12.0,12.0,14.0,4.0,9.0,12.0,11.0,20.0,12.0,5.0,9.0,9.0,9.0,9.0,9.0,10.0,12.0,12.0,12.0,12.0,7.0,5.0,8.0,24.0,9.0,0.0,7.0,1.0,190.0,82.0,2.0,2.0,3.0,3.0,1.0,2.0,2.0,1.0,1.0,3.0,1.0,8.0,14.0,13.0,11.0,12.0,10.0,12.0,11.0,9.0,11.0,13.0,8.0,13.0,13.0,10.0,14.0,14.0,13.0,13.0,14.0,14.0,16.0,11.0,6.0,12.0,12.0,16.0,16.0,12.0,11.0,11.0,14.0,8.0,14.0,14.0,20.0,15.0,13.0,14.0,9.0,13.0,8.0,14.0,13.0,14.0,12.0,14.0,16.0,12.0,15.0,2.0,28.0,0.0,0.0,0.0,0.0,169.0,0.0,3.0,3.0,2.0,3.0,3.0,1.0,1.0,3.0,2.0,1.0,3.0,5.0,8.0,11.0,9.0,8.0,8.0,7.0,8.0,4.0,2.0,9.0,5.0,3.0,11.0,11.0,11.0,13.0,9.0,11.0,8.0,15.0,14.0,11.0,7.0,10.0,8.0,8.0,10.0,11.0,11.0,6.0,5.0,14.0,11.0,12.0,20.0,14.0,5.0,9.0,12.0,9.0,5.0,6.0,9.0,12.0,11.0,9.0,9.0,10.0,12.0,11.0,23.0,15.0,1.0,7.0,0.0,165.0,60.0,2.0,3.0,2.0,1.0,1.0,1.0,3.0,3.0,2.0,1.0,3.0,14.0,14.0,16.0,8.0,16.0,13.0,6.0,10.0,6.0,11.0,18.0,15.0,12.0,18.0,16.0,15.0,15.0,17.0,13.0,17.0,15.0,14.0,18.0,12.0,10.0,12.0,15.0,16.0,14.0,16.0,16.0,6.0,12.0,13.0,14.0,20.0,15.0,11.0,16.0,14.0,15.0,10.0,12.0,14.0,15.0,16.0,14.0,14.0,13.0,10.0,6.0,29.0,51.0,8.0,24.0,0.0,175.0,70.0,3.0,4.0,2.0,3.0,2.0,3.0,2.0,2.0,2.0,1.0,3.0,6.0,12.0,12.0,10.0,13.0,7.0,12.0,12.0,8.0,14.0,13.0,9.0,16.0,13.0,14.0,16.0,16.0,15.0,16.0,11.0,14.0,16.0,8.0,14.0,14.0,15.0,18.0,18.0,15.0,14.0,16.0,8.0,20.0,16.0,14.0,8.0,18.0,14.0,16.0,13.0,14.0,7.0,14.0,15.0,14.0,14.0,14.0,16.0,16.0,16.0,5.0,21.0,0.0,0.0,15.0,1.0,189.0,75.0,3.0,3.0,3.0,3.0,1.0,1.0,3.0,3.0,3.0,2.0,3.0,10.0,12.0,13.0,7.0,14.0,8.0,14.0,12.0,5.0,13.0,15.0,8.0,15.0,14.0,14.0,14.0,15.0,14.0,14.0,13.0,14.0,15.0,12.0,10.0,12.0,14.0,15.0,16.0,12.0,13.0,15.0,14.0,20.0,14.0,13.0,10.0,16.0,13.0,14.0,11.0,14.0,7.0,10.0,8.0,16.0,10.0,12.0,13.0,13.0,11.0,14.0,16.0,0.0,0.0,0.0,0.0,173.0,0.0,3.0,1.0,1.0,1.0,2.0,1.0,4.0,1.0,2.0,3.0,1.0,1.0,1.0,4.0,4.0,5.0,4.0,4.0,4.0,1.0,5.0,6.0,5.0,8.0,9.0,10.0,6.0,6.0,3.0,5.0,4.0,10.0,7.0,8.0,8.0,3.0,11.0,13.0,9.0,7.0,5.0,14.0,4.0,20.0,6.0,5.0,8.0,6.0,9.0,5.0,7.0,8.0,5.0,7.0,6.0,11.0,7.0,10.0,18.0,19.0,15.0,9.0,22.0,24.0,2.0,1.0,1.0,187.0,75.0,1.0,2.0,1.0,1.0,2.0,1.0,2.0,1.0,2.0,3.0,3.0,13.0,13.0,16.0,13.0,17.0,10.0,9.0,17.0,8.0,6.0,14.0,10.0,8.0,16.0,10.0,12.0,9.0,12.0,10.0,15.0,11.0,10.0,15.0,7.0,13.0,8.0,12.0,11.0,15.0,14.0,10.0,16.0,18.0,12.0,13.0,20.0,14.0,11.0,8.0,5.0,15.0,12.0,13.0,11.0,17.0,8.0,10.0,16.0,12.0,14.0,13.0,29.0,76.0,27.0,13.0,9.0,188.0,72.0,2.0,3.0,1.0,2.0,3.0,3.0,1.0,3.0,3.0,3.0,3.0,5.0,10.0,13.0,16.0,13.0,11.0,17.0,13.0,5.0,10.0,13.0,14.0,10.0,13.0,15.0,16.0,18.0,14.0,15.0,10.0,13.0,14.0,13.0,10.0,18.0,12.0,14.0,19.0,15.0,14.0,16.0,14.0,10.0,18.0,16.0,20.0,18.0,14.0,14.0,8.0,15.0,5.0,16.0,10.0,16.0,12.0,14.0,16.0,14.0,10.0,10.0,30.0,0.0,0.0,0.0,0.0,180.0,75.0,11.0,13.0,13.0,9.0,13.0,11.0,12.0,15.0,15.0,14.0,13.0,6.0,1.0,2.0,3.0,7.0,8.0,1.0,1.0,1.0,2.0,7.0,2.0,1.0,7.0,8.0,12.0,14.0,13.0,14.0,7.0,12.0,14.0,5.0,12.0,3.0,13.0,15.0,9.0,13.0,14.0,13.0,10.0,5.0,14.0,11.0,20.0,12.0,13.0,12.0,8.0,14.0,6.0,1.0,9.0,13.0,14.0,13.0,16.0,15.0,15.0,5.0,26.0,11.0,0.0,0.0,0.0,180.0,81.0,3.0,2.0,2.0,3.0,3.0,2.0,1.0,2.0,2.0,1.0,2.0,5.0,9.0,8.0,5.0,11.0,5.0,13.0,10.0,8.0,15.0,10.0,7.0,13.0,10.0,15.0,14.0,17.0,11.0,12.0,9.0,12.0,16.0,8.0,10.0,8.0,13.0,14.0,15.0,13.0,12.0,14.0,12.0,20.0,14.0,12.0,8.0,14.0,14.0,14.0,10.0,15.0,13.0,8.0,9.0,14.0,17.0,13.0,13.0,13.0,11.0,8.0,21.0,0.0,0.0,0.0,0.0,182.0,74.0,2.0,2.0,2.0,2.0,2.0,1.0,1.0,1.0,3.0,2.0,2.0,9.0,11.0,12.0,7.0,9.0,8.0,12.0,7.0,11.0,12.0,7.0,8.0,13.0,11.0,12.0,12.0,14.0,12.0,13.0,7.0,12.0,11.0,1.0,9.0,11.0,9.0,10.0,12.0,14.0,10.0,13.0,11.0,9.0,8.0,12.0,20.0,13.0,11.0,10.0,13.0,8.0,10.0,10.0,15.0,11.0,13.0,10.0,10.0,8.0,13.0,7.0,28.0,22.0,0.0,20.0,1.0,176.0,74.0,2.0,3.0,2.0,1.0,1.0,1.0,3.0,3.0,2.0,2.0,1.0,15.0,15.0,12.0,8.0,13.0,12.0,5.0,11.0,15.0,10.0,13.0,9.0,10.0,12.0,10.0,11.0,10.0,13.0,12.0,11.0,12.0,11.0,11.0,7.0,13.0,10.0,14.0,15.0,15.0,14.0,10.0,8.0,20.0,13.0,14.0,8.0,15.0,8.0,14.0,5.0,12.0,5.0,14.0,15.0,15.0,10.0,14.0,13.0,12.0,12.0,2.0,22.0,0.0,0.0,6.0,1.0,175.0,75.0,3.0,3.0,2.0,1.0,1.0,2.0,3.0,2.0,2.0,1.0,1.0,10.0,9.0,12.0,6.0,11.0,7.0,10.0,11.0,7.0,9.0,11.0,6.0,10.0,14.0,12.0,10.0,12.0,10.0,10.0,12.0,11.0,10.0,13.0,6.0,11.0,8.0,11.0,13.0,12.0,14.0,12.0,8.0,5.0,14.0,13.0,20.0,11.0,12.0,10.0,10.0,10.0,8.0,10.0,8.0,11.0,10.0,9.0,12.0,12.0,15.0,6.0,22.0,0.0,0.0,4.0,0.0,179.0,71.0,1.0,3.0,1.0,3.0,2.0,1.0,3.0,2.0,1.0,2.0,4.0,11.0,13.0,12.0,8.0,15.0,11.0,6.0,11.0,6.0,4.0,14.0,12.0,6.0,16.0,7.0,12.0,10.0,12.0,11.0,13.0,13.0,13.0,9.0,6.0,12.0,9.0,15.0,12.0,13.0,14.0,12.0,9.0,20.0,14.0,12.0,10.0,13.0,10.0,13.0,7.0,14.0,7.0,8.0,18.0,13.0,14.0,14.0,16.0,15.0,15.0,5.0,27.0,32.0,6.0,0.0,0.0,188.0,78.0,3.0,2.0,3.0,2.0,1.0,3.0,3.0,3.0,2.0,2.0,2.0,4.0,8.0,11.0,12.0,12.0,6.0,16.0,13.0,8.0,13.0,14.0,7.0,12.0,12.0,12.0,10.0,14.0,13.0,12.0,11.0,12.0,15.0,9.0,11.0,12.0,6.0,13.0,12.0,14.0,13.0,15.0,15.0,5.0,13.0,12.0,20.0,16.0,15.0,14.0,12.0,15.0,11.0,10.0,9.0,15.0,12.0,12.0,13.0,13.0,13.0,7.0,32.0,25.0,0.0,0.0,0.0,181.0,82.0,2.0,3.0,3.0,1.0,1.0,1.0,1.0,3.0,1.0,2.0,3.0,5.0,10.0,6.0,7.0,10.0,7.0,14.0,9.0,8.0,11.0,12.0,7.0,13.0,10.0,15.0,14.0,16.0,11.0,13.0,10.0,12.0,16.0,9.0,15.0,8.0,11.0,16.0,18.0,11.0,12.0,14.0,11.0,8.0,13.0,11.0,20.0,17.0,15.0,13.0,15.0,11.0,6.0,14.0,18.0,12.0,13.0,13.0,14.0,11.0,11.0,8.0,20.0,0.0,0.0,0.0,0.0,175.0,77.0,2.0,1.0,2.0,3.0,3.0,3.0,3.0,1.0,4.0,3.0,1.0,8.0,8.0,12.0,12.0,11.0,8.0,13.0,10.0,9.0,10.0,11.0,10.0,9.0,12.0,12.0,6.0,9.0,9.0,11.0,15.0,11.0,4.0,10.0,8.0,12.0,11.0,10.0,13.0,14.0,15.0,15.0,8.0,8.0,9.0,15.0,20.0,11.0,12.0,12.0,8.0,4.0,10.0,10.0,15.0,11.0,12.0,11.0,9.0,10.0,10.0,7.0,19.0,0.0,0.0,0.0,0.0,173.0,67.0,3.0,2.0,4.0,2.0,1.0,1.0,3.0,1.0,1.0,1.0,2.0,13.0,13.0,15.0,10.0,14.0,11.0,6.0,12.0,4.0,4.0,12.0,11.0,5.0,14.0,10.0,12.0,9.0,10.0,8.0,12.0,8.0,11.0,15.0,5.0,12.0,6.0,8.0,10.0,16.0,15.0,13.0,7.0,8.0,13.0,15.0,20.0,11.0,9.0,12.0,6.0,12.0,6.0,15.0,8.0,13.0,8.0,12.0,9.0,14.0,13.0,9.0,21.0,0.0,0.0,4.0,1.0,184.0,79.0,1.0,2.0,3.0,1.0,2.0,1.0,3.0,2.0,2.0,1.0,3.0,3.0,6.0,10.0,12.0,12.0,7.0,15.0,8.0,4.0,5.0,13.0,10.0,8.0,12.0,18.0,12.0,19.0,13.0,10.0,13.0,12.0,14.0,13.0,10.0,12.0,9.0,16.0,15.0,12.0,14.0,14.0,14.0,12.0,13.0,10.0,20.0,14.0,14.0,11.0,14.0,14.0,11.0,5.0,10.0,13.0,14.0,15.0,10.0,8.0,4.0,15.0
1,1,25.0,0.0,0.0,0.0,0.0,187.0,83.0,11.0,14.0,12.0,8.0,13.0,11.0,14.0,15.0,13.0,13.0,9.0,8.0,1.0,1.0,1.0,11.0,11.0,1.0,2.0,2.0,1.0,10.0,3.0,2.0,11.0,8.0,12.0,14.0,12.0,12.0,10.0,12.0,14.0,6.0,14.0,2.0,12.0,12.0,8.0,13.0,15.0,14.0,13.0,20.0,15.0,11.0,5.0,14.0,13.0,13.0,8.0,8.0,10.0,1.0,9.0,13.0,14.0,12.0,15.0,15.0,15.0,5.0,28.0,0.0,0.0,0.0,0.0,184.0,85.0,2.0,3.0,2.0,1.0,1.0,3.0,2.0,2.0,3.0,1.0,3.0,4.0,8.0,8.0,6.0,12.0,6.0,14.0,8.0,5.0,13.0,12.0,6.0,14.0,12.0,11.0,13.0,14.0,13.0,12.0,11.0,11.0,13.0,7.0,14.0,10.0,15.0,16.0,12.0,12.0,11.0,15.0,12.0,20.0,13.0,11.0,7.0,14.0,16.0,13.0,11.0,13.0,13.0,12.0,15.0,13.0,13.0,14.0,15.0,14.0,14.0,6.0,32.0,1.0,0.0,5.0,0.0,189.0,93.0,1.0,1.0,3.0,4.0,2.0,2.0,3.0,2.0,3.0,3.0,3.0,3.0,8.0,8.0,7.0,9.0,8.0,16.0,8.0,7.0,14.0,10.0,9.0,14.0,9.0,15.0,14.0,16.0,12.0,10.0,10.0,12.0,14.0,9.0,9.0,7.0,13.0,14.0,15.0,9.0,8.0,10.0,14.0,8.0,16.0,11.0,20.0,14.0,19.0,12.0,14.0,12.0,8.0,6.0,13.0,16.0,14.0,11.0,15.0,14.0,12.0,10.0,25.0,0.0,0.0,3.0,0.0,184.0,80.0,2.0,2.0,4.0,2.0,1.0,3.0,2.0,1.0,1.0,2.0,1.0,5.0,8.0,7.0,6.0,9.0,6.0,14.0,6.0,6.0,14.0,7.0,6.0,13.0,9.0,12.0,14.0,13.0,11.0,13.0,7.0,12.0,14.0,8.0,10.0,7.0,14.0,13.0,14.0,15.0,12.0,14.0,12.0,8.0,15.0,15.0,20.0,14.0,14.0,13.0,12.0,14.0,5.0,10.0,16.0,13.0,15.0,15.0,12.0,14.0,14.0,8.0,21.0,0.0,0.0,4.0,0.0,178.0,72.0,2.0,3.0,1.0,2.0,2.0,3.0,3.0,1.0,2.0,2.0,3.0,6.0,12.0,10.0,7.0,11.0,7.0,9.0,8.0,11.0,12.0,11.0,8.0,13.0,11.0,10.0,12.0,11.0,12.0,13.0,11.0,11.0,13.0,8.0,11.0,12.0,12.0,13.0,14.0,15.0,13.0,13.0,9.0,7.0,14.0,14.0,20.0,14.0,12.0,13.0,10.0,12.0,9.0,14.0,16.0,15.0,8.0,10.0,12.0,16.0,17.0,10.0,26.0,0.0,0.0,0.0,0.0,177.0,68.0,4.0,2.0,1.0,2.0,3.0,1.0,1.0,2.0,3.0,3.0,3.0,12.0,13.0,11.0,8.0,13.0,11.0,8.0,10.0,8.0,10.0,13.0,10.0,12.0,13.0,7.0,12.0,10.0,13.0,11.0,15.0,13.0,14.0,11.0,7.0,14.0,10.0,14.0,14.0,13.0,15.0,12.0,9.0,20.0,15.0,14.0,5.0,15.0,8.0,13.0,7.0,14.0,6.0,12.0,11.0,12.0,14.0,13.0,16.0,16.0,16.0,5.0,31.0,0.0,0.0,4.0,0.0,174.0,72.0,2.0,1.0,4.0,2.0,2.0,3.0,1.0,1.0,3.0,3.0,4.0,12.0,9.0,11.0,6.0,14.0,11.0,7.0,10.0,6.0,8.0,16.0,12.0,9.0,14.0,9.0,14.0,10.0,13.0,12.0,12.0,11.0,14.0,8.0,8.0,11.0,12.0,14.0,12.0,13.0,14.0,12.0,7.0,12.0,14.0,12.0,20.0,15.0,11.0,11.0,9.0,12.0,8.0,10.0,10.0,14.0,13.0,10.0,12.0,14.0,14.0,9.0,30.0,0.0,0.0,11.0,4.0,172.0,69.0,4.0,2.0,2.0,3.0,3.0,3.0,3.0,3.0,4.0,4.0,3.0,13.0,13.0,13.0,11.0,13.0,13.0,7.0,12.0,9.0,4.0,13.0,12.0,4.0,15.0,7.0,12.0,10.0,12.0,12.0,15.0,12.0,13.0,17.0,8.0,14.0,7.0,12.0,12.0,14.0,15.0,12.0,6.0,20.0,10.0,14.0,10.0,13.0,7.0,12.0,6.0,12.0,15.0,13.0,10.0,11.0,13.0,12.0,11.0,14.0,14.0,6.0,28.0,0.0,0.0,0.0,0.0,170.0,67.0,2.0,3.0,3.0,4.0,3.0,2.0,1.0,1.0,2.0,2.0,3.0,8.0,12.0,12.0,10.0,14.0,7.0,5.0,10.0,6.0,5.0,12.0,5.0,4.0,13.0,7.0,16.0,12.0,9.0,11.0,12.0,10.0,3.0,12.0,6.0,13.0,6.0,8.0,13.0,16.0,13.0,10.0,5.0,5.0,13.0,16.0,20.0,15.0,7.0,12.0,4.0,9.0,7.0,10.0,20.0,13.0,12.0,10.0,13.0,11.0,10.0,2.0,24.0,0.0,0.0,5.0,0.0,183.0,79.0,4.0,4.0,3.0,3.0,1.0,3.0,2.0,1.0,3.0,2.0,3.0,4.0,7.0,12.0,13.0,12.0,8.0,13.0,12.0,5.0,6.0,11.0,12.0,4.0,13.0,11.0,12.0,14.0,9.0,12.0,10.0,10.0,13.0,12.0,6.0,14.0,12.0,13.0,14.0,15.0,14.0,14.0,11.0,10.0,13.0,14.0,20.0,14.0,14.0,12.0,12.0,14.0,9.0,5.0,7.0,13.0,15.0,11.0,14.0,14.0,14.0,6.0,24.0,24.0,4.0,0.0,0.0,172.0,74.0,2.0,4.0,3.0,2.0,2.0,1.0,2.0,2.0,3.0,2.0,4.0,8.0,9.0,14.0,13.0,14.0,9.0,11.0,10.0,7.0,5.0,12.0,12.0,3.0,13.0,10.0,12.0,12.0,13.0,12.0,11.0,10.0,14.0,13.0,7.0,14.0,9.0,9.0,13.0,16.0,15.0,13.0,6.0,8.0,13.0,16.0,20.0,14.0,12.0,11.0,11.0,13.0,9.0,8.0,9.0,13.0,9.0,11.0,12.0,13.0,10.0,9.0,25.0,0.0,0.0,0.0,0.0,192.0,87.0,12.0,13.0,12.0,6.0,14.0,11.0,12.0,13.0,9.0,12.0,11.0,5.0,1.0,3.0,1.0,10.0,8.0,3.0,3.0,3.0,3.0,8.0,2.0,1.0,8.0,7.0,13.0,14.0,12.0,13.0,12.0,11.0,13.0,7.0,11.0,3.0,13.0,11.0,12.0,11.0,12.0,16.0,16.0,8.0,14.0,12.0,20.0,13.0,16.0,13.0,7.0,9.0,7.0,10.0,14.0,12.0,17.0,13.0,14.0,14.0,14.0,5.0,28.0,0.0,0.0,0.0,0.0,193.0,84.0,1.0,1.0,2.0,2.0,2.0,3.0,2.0,3.0,2.0,1.0,3.0,4.0,8.0,8.0,9.0,10.0,6.0,14.0,7.0,8.0,14.0,12.0,6.0,14.0,11.0,12.0,13.0,14.0,11.0,14.0,12.0,12.0,14.0,6.0,11.0,8.0,14.0,13.0,13.0,11.0,11.0,16.0,16.0,20.0,12.0,12.0,8.0,14.0,16.0,14.0,12.0,13.0,6.0,10.0,7.0,12.0,15.0,12.0,16.0,15.0,13.0,6.0,29.0,2.0,0.0,0.0,0.0,185.0,75.0,2.0,3.0,3.0,3.0,2.0,3.0,2.0,1.0,3.0,1.0,2.0,4.0,10.0,8.0,6.0,10.0,6.0,14.0,7.0,7.0,14.0,11.0,6.0,14.0,9.0,13.0,13.0,14.0,11.0,12.0,12.0,12.0,14.0,8.0,11.0,12.0,13.0,13.0,13.0,15.0,12.0,15.0,12.0,8.0,15.0,13.0,20.0,14.0,15.0,14.0,7.0,14.0,8.0,6.0,14.0,13.0,15.0,14.0,14.0,14.0,14.0,6.0,31.0,4.0,0.0,0.0,0.0,173.0,73.0,2.0,3.0,2.0,2.0,4.0,2.0,3.0,1.0,1.0,2.0,4.0,7.0,13.0,9.0,6.0,11.0,10.0,6.0,8.0,11.0,12.0,13.0,8.0,13.0,11.0,11.0,12.0,13.0,10.0,12.0,8.0,8.0,16.0,11.0,6.0,12.0,8.0,12.0,14.0,14.0,13.0,12.0,7.0,8.0,15.0,14.0,20.0,14.0,14.0,12.0,11.0,13.0,8.0,16.0,7.0,13.0,14.0,12.0,14.0,16.0,16.0,6.0,26.0,0.0,0.0,0.0,0.0,175.0,69.0,3.0,3.0,2.0,2.0,3.0,1.0,3.0,1.0,3.0,2.0,2.0,6.0,12.0,10.0,5.0,11.0,6.0,10.0,10.0,10.0,13.0,12.0,9.0,13.0,12.0,12.0,13.0,14.0,12.0,13.0,12.0,11.0,15.0,11.0,13.0,12.0,13.0,14.0,14.0,15.0,13.0,12.0,7.0,9.0,13.0,13.0,20.0,14.0,11.0,14.0,12.0,12.0,11.0,15.0,14.0,9.0,17.0,10.0,8.0,11.0,20.0,7.0,29.0,0.0,0.0,0.0,0.0,183.0,78.0,1.0,3.0,3.0,3.0,3.0,1.0,2.0,3.0,3.0,1.0,1.0,13.0,8.0,9.0,6.0,12.0,14.0,13.0,10.0,12.0,11.0,12.0,8.0,13.0,12.0,12.0,15.0,13.0,13.0,13.0,11.0,13.0,15.0,6.0,12.0,7.0,13.0,16.0,18.0,12.0,11.0,14.0,12.0,20.0,14.0,11.0,8.0,16.0,14.0,14.0,12.0,14.0,6.0,12.0,10.0,12.0,13.0,11.0,15.0,15.0,15.0,5.0,30.0,9.0,1.0,0.0,0.0,192.0,90.0,2.0,2.0,2.0,2.0,3.0,1.0,3.0,4.0,1.0,1.0,3.0,4.0,7.0,10.0,10.0,9.0,8.0,17.0,12.0,6.0,13.0,12.0,8.0,12.0,11.0,13.0,14.0,15.0,13.0,13.0,10.0,12.0,14.0,12.0,13.0,13.0,12.0,14.0,16.0,12.0,12.0,18.0,16.0,8.0,14.0,13.0,20.0,16.0,18.0,13.0,13.0,14.0,7.0,12.0,13.0,13.0,13.0,13.0,13.0,13.0,13.0,6.0,21.0,0.0,0.0,0.0,0.0,183.0,73.0,1.0,4.0,3.0,3.0,3.0,1.0,4.0,1.0,2.0,3.0,2.0,11.0,10.0,12.0,11.0,13.0,9.0,12.0,10.0,5.0,8.0,12.0,9.0,8.0,13.0,13.0,12.0,12.0,10.0,12.0,14.0,12.0,12.0,14.0,8.0,12.0,8.0,12.0,12.0,14.0,14.0,14.0,11.0,8.0,13.0,13.0,20.0,12.0,12.0,12.0,5.0,10.0,7.0,12.0,15.0,11.0,11.0,10.0,11.0,12.0,11.0,4.0,23.0,1.0,0.0,0.0,0.0,185.0,70.0,4.0,3.0,1.0,2.0,1.0,3.0,2.0,3.0,1.0,2.0,3.0,5.0,8.0,12.0,13.0,13.0,7.0,14.0,11.0,5.0,5.0,8.0,13.0,5.0,13.0,6.0,13.0,10.0,12.0,12.0,11.0,11.0,13.0,12.0,7.0,13.0,9.0,8.0,10.0,16.0,12.0,14.0,12.0,8.0,14.0,15.0,20.0,13.0,13.0,12.0,7.0,15.0,7.0,7.0,13.0,13.0,12.0,10.0,12.0,15.0,15.0,7.0,28.0,0.0,0.0,0.0,0.0,176.0,72.0,2.0,1.0,2.0,2.0,3.0,3.0,2.0,2.0,3.0,2.0,1.0,6.0,11.0,13.0,10.0,13.0,9.0,12.0,12.0,5.0,5.0,11.0,13.0,5.0,13.0,10.0,13.0,11.0,12.0,13.0,10.0,12.0,13.0,12.0,6.0,14.0,8.0,12.0,14.0,15.0,14.0,14.0,10.0,8.0,12.0,13.0,20.0,14.0,13.0,11.0,10.0,9.0,8.0,5.0,10.0,13.0,15.0,12.0,13.0,11.0,11.0,8.0,23.0,1.0,0.0,0.0,0.0,192.0,80.0,3.0,3.0,3.0,2.0,3.0,1.0,3.0,3.0,1.0,2.0,2.0,4.0,6.0,12.0,13.0,12.0,7.0,13.0,12.0,5.0,5.0,9.0,11.0,5.0,12.0,13.0,12.0,13.0,12.0,13.0,9.0,13.0,4.0,11.0,8.0,13.0,7.0,9.0,12.0,14.0,13.0,15.0,16.0,20.0,14.0,13.0,8.0,13.0,15.0,12.0,11.0,11.0,7.0,5.0,14.0,13.0,14.0,11.0,9.0,9.0,18.0,3.0
0,1,17.0,0.0,0.0,0.0,0.0,193.0,82.0,13.0,11.0,12.0,2.0,12.0,10.0,14.0,15.0,14.0,12.0,10.0,3.0,1.0,1.0,3.0,5.0,6.0,2.0,2.0,1.0,3.0,9.0,3.0,1.0,8.0,7.0,12.0,13.0,13.0,13.0,11.0,11.0,15.0,3.0,8.0,3.0,12.0,12.0,11.0,10.0,12.0,14.0,17.0,5.0,15.0,11.0,20.0,13.0,12.0,13.0,8.0,11.0,5.0,11.0,13.0,15.0,15.0,17.0,14.0,15.0,15.0,5.0,23.0,0.0,0.0,0.0,0.0,196.0,88.0,1.0,3.0,1.0,1.0,3.0,3.0,2.0,3.0,1.0,2.0,3.0,4.0,7.0,6.0,10.0,10.0,4.0,16.0,7.0,10.0,13.0,11.0,5.0,13.0,10.0,14.0,13.0,13.0,8.0,12.0,6.0,12.0,11.0,5.0,9.0,6.0,10.0,14.0,9.0,13.0,12.0,13.0,17.0,7.0,12.0,15.0,20.0,14.0,15.0,13.0,13.0,12.0,7.0,10.0,7.0,14.0,12.0,7.0,10.0,14.0,14.0,10.0,19.0,0.0,0.0,0.0,0.0,194.0,92.0,2.0,1.0,3.0,3.0,3.0,3.0,1.0,3.0,3.0,2.0,1.0,3.0,3.0,5.0,6.0,10.0,5.0,16.0,10.0,8.0,12.0,9.0,4.0,15.0,11.0,14.0,11.0,12.0,10.0,11.0,10.0,12.0,15.0,3.0,13.0,13.0,12.0,14.0,14.0,11.0,8.0,15.0,17.0,5.0,16.0,12.0,20.0,12.0,16.0,12.0,13.0,12.0,5.0,7.0,10.0,14.0,13.0,8.0,10.0,11.0,18.0,6.0,23.0,0.0,0.0,0.0,0.0,180.0,77.0,2.0,1.0,3.0,2.0,3.0,2.0,2.0,2.0,3.0,1.0,2.0,6.0,11.0,11.0,6.0,13.0,7.0,11.0,5.0,8.0,14.0,12.0,9.0,12.0,9.0,15.0,14.0,17.0,10.0,14.0,8.0,13.0,14.0,7.0,8.0,7.0,10.0,13.0,15.0,15.0,13.0,13.0,10.0,5.0,14.0,14.0,20.0,15.0,14.0,14.0,15.0,6.0,7.0,11.0,18.0,13.0,14.0,15.0,13.0,12.0,14.0,2.0,26.0,4.0,0.0,2.0,0.0,180.0,74.0,3.0,3.0,1.0,2.0,2.0,1.0,3.0,4.0,1.0,2.0,1.0,8.0,13.0,13.0,6.0,13.0,9.0,12.0,7.0,11.0,13.0,13.0,11.0,12.0,12.0,16.0,14.0,14.0,9.0,12.0,11.0,13.0,4.0,4.0,6.0,11.0,12.0,8.0,12.0,14.0,14.0,13.0,9.0,20.0,16.0,13.0,5.0,15.0,13.0,12.0,6.0,9.0,10.0,12.0,8.0,14.0,8.0,11.0,12.0,11.0,13.0,2.0,19.0,0.0,0.0,0.0,0.0,184.0,78.0,3.0,1.0,2.0,1.0,2.0,2.0,2.0,3.0,3.0,4.0,2.0,6.0,8.0,9.0,5.0,13.0,6.0,11.0,8.0,5.0,13.0,13.0,8.0,12.0,13.0,13.0,13.0,15.0,12.0,12.0,13.0,12.0,14.0,7.0,11.0,8.0,15.0,14.0,15.0,13.0,12.0,14.0,11.0,5.0,15.0,12.0,20.0,16.0,14.0,13.0,12.0,11.0,7.0,10.0,19.0,13.0,15.0,12.0,14.0,13.0,12.0,6.0,28.0,0.0,0.0,0.0,0.0,180.0,79.0,3.0,2.0,3.0,3.0,2.0,2.0,2.0,1.0,3.0,2.0,3.0,8.0,11.0,15.0,12.0,15.0,12.0,7.0,10.0,7.0,8.0,13.0,13.0,6.0,16.0,11.0,11.0,10.0,13.0,10.0,15.0,12.0,3.0,15.0,6.0,13.0,13.0,12.0,12.0,15.0,16.0,14.0,8.0,12.0,12.0,14.0,20.0,12.0,12.0,13.0,6.0,13.0,6.0,6.0,8.0,9.0,13.0,10.0,12.0,12.0,2.0,2.0,29.0,46.0,9.0,28.0,13.0,192.0,78.0,3.0,3.0,3.0,2.0,1.0,2.0,2.0,4.0,3.0,3.0,2.0,11.0,11.0,12.0,12.0,13.0,12.0,14.0,13.0,5.0,3.0,13.0,12.0,3.0,13.0,17.0,12.0,14.0,14.0,11.0,14.0,12.0,10.0,9.0,10.0,16.0,6.0,11.0,10.0,12.0,14.0,15.0,15.0,13.0,13.0,10.0,20.0,15.0,13.0,11.0,12.0,10.0,5.0,12.0,10.0,16.0,11.0,16.0,16.0,8.0,15.0,14.0,20.0,0.0,0.0,8.0,0.0,170.0,65.0,3.0,1.0,1.0,3.0,2.0,3.0,2.0,2.0,2.0,1.0,3.0,10.0,10.0,13.0,13.0,13.0,10.0,9.0,10.0,3.0,4.0,11.0,12.0,4.0,13.0,12.0,12.0,14.0,11.0,11.0,11.0,11.0,15.0,12.0,7.0,14.0,7.0,12.0,15.0,16.0,16.0,12.0,7.0,7.0,14.0,15.0,20.0,14.0,11.0,13.0,9.0,13.0,8.0,12.0,9.0,13.0,14.0,14.0,15.0,15.0,14.0,6.0,25.0,14.0,1.0,2.0,0.0,177.0,77.0,3.0,3.0,1.0,2.0,3.0,3.0,1.0,3.0,3.0,4.0,1.0,8.0,11.0,13.0,12.0,12.0,10.0,11.0,10.0,2.0,3.0,11.0,10.0,5.0,13.0,12.0,12.0,13.0,11.0,10.0,11.0,10.0,14.0,16.0,14.0,15.0,5.0,13.0,14.0,15.0,14.0,12.0,12.0,12.0,14.0,16.0,20.0,13.0,14.0,13.0,7.0,14.0,11.0,13.0,14.0,11.0,12.0,8.0,12.0,13.0,15.0,6.0,24.0,0.0,0.0,0.0,0.0,182.0,82.0,3.0,3.0,2.0,1.0,1.0,3.0,2.0,2.0,3.0,2.0,2.0,4.0,7.0,13.0,14.0,13.0,12.0,14.0,12.0,5.0,7.0,10.0,14.0,6.0,15.0,13.0,13.0,16.0,8.0,12.0,11.0,11.0,12.0,14.0,7.0,13.0,8.0,12.0,13.0,14.0,14.0,15.0,12.0,10.0,10.0,12.0,20.0,16.0,15.0,12.0,13.0,14.0,10.0,8.0,8.0,13.0,5.0,10.0,11.0,9.0,9.0,13.0,36.0,0.0,0.0,0.0,0.0,185.0,78.0,11.0,14.0,12.0,7.0,13.0,12.0,14.0,15.0,13.0,14.0,10.0,4.0,1.0,3.0,1.0,8.0,8.0,11.0,8.0,3.0,3.0,7.0,2.0,1.0,8.0,11.0,13.0,15.0,11.0,12.0,7.0,13.0,9.0,5.0,14.0,3.0,13.0,15.0,8.0,11.0,14.0,13.0,12.0,5.0,15.0,11.0,20.0,12.0,14.0,13.0,11.0,13.0,8.0,1.0,19.0,14.0,16.0,10.0,17.0,9.0,9.0,11.0,34.0,23.0,1.0,0.0,0.0,186.0,81.0,3.0,3.0,1.0,2.0,1.0,3.0,2.0,3.0,1.0,3.0,3.0,4.0,8.0,6.0,10.0,7.0,8.0,17.0,12.0,10.0,14.0,7.0,9.0,15.0,7.0,15.0,13.0,17.0,8.0,12.0,7.0,12.0,15.0,6.0,17.0,7.0,14.0,15.0,14.0,8.0,10.0,16.0,13.0,12.0,13.0,9.0,20.0,13.0,15.0,11.0,15.0,14.0,9.0,10.0,10.0,14.0,11.0,13.0,15.0,11.0,11.0,12.0,27.0,25.0,1.0,0.0,0.0,189.0,82.0,3.0,1.0,3.0,4.0,3.0,1.0,3.0,3.0,1.0,2.0,3.0,6.0,7.0,5.0,8.0,9.0,8.0,12.0,8.0,6.0,14.0,13.0,11.0,14.0,5.0,12.0,14.0,15.0,13.0,13.0,8.0,13.0,12.0,5.0,11.0,5.0,13.0,15.0,14.0,12.0,12.0,14.0,15.0,6.0,16.0,12.0,20.0,13.0,14.0,11.0,10.0,12.0,5.0,8.0,11.0,13.0,14.0,17.0,8.0,6.0,8.0,13.0,28.0,0.0,0.0,0.0,0.0,183.0,81.0,1.0,2.0,4.0,1.0,1.0,3.0,2.0,3.0,3.0,3.0,1.0,5.0,5.0,6.0,10.0,12.0,6.0,14.0,8.0,6.0,15.0,11.0,6.0,13.0,12.0,13.0,14.0,16.0,14.0,14.0,10.0,12.0,14.0,5.0,14.0,8.0,14.0,15.0,15.0,9.0,12.0,15.0,13.0,7.0,11.0,12.0,20.0,15.0,15.0,14.0,14.0,14.0,9.0,8.0,14.0,14.0,11.0,13.0,15.0,13.0,15.0,6.0,18.0,0.0,0.0,0.0,0.0,178.0,70.0,1.0,2.0,3.0,1.0,1.0,3.0,2.0,2.0,3.0,3.0,2.0,6.0,9.0,11.0,6.0,13.0,8.0,6.0,10.0,5.0,10.0,14.0,6.0,8.0,13.0,10.0,10.0,10.0,13.0,12.0,12.0,10.0,16.0,12.0,5.0,12.0,6.0,10.0,11.0,12.0,13.0,12.0,9.0,20.0,14.0,14.0,5.0,8.0,11.0,10.0,6.0,2.0,8.0,10.0,20.0,9.0,11.0,11.0,10.0,12.0,12.0,1.0,30.0,0.0,0.0,0.0,0.0,167.0,60.0,3.0,1.0,1.0,2.0,3.0,1.0,1.0,3.0,1.0,1.0,3.0,10.0,11.0,12.0,8.0,13.0,10.0,6.0,9.0,10.0,12.0,14.0,9.0,10.0,14.0,11.0,14.0,14.0,14.0,14.0,13.0,14.0,12.0,14.0,11.0,13.0,12.0,15.0,15.0,15.0,14.0,11.0,5.0,11.0,11.0,15.0,20.0,11.0,8.0,14.0,10.0,12.0,13.0,11.0,11.0,12.0,11.0,10.0,12.0,11.0,11.0,2.0,33.0,0.0,0.0,0.0,0.0,187.0,76.0,2.0,2.0,3.0,1.0,1.0,3.0,2.0,1.0,2.0,3.0,2.0,15.0,14.0,14.0,10.0,15.0,13.0,10.0,12.0,7.0,4.0,15.0,13.0,7.0,15.0,6.0,12.0,9.0,14.0,11.0,15.0,12.0,12.0,14.0,12.0,13.0,7.0,13.0,12.0,11.0,12.0,14.0,12.0,14.0,15.0,12.0,20.0,11.0,12.0,12.0,6.0,14.0,6.0,11.0,14.0,13.0,12.0,12.0,15.0,15.0,13.0,9.0,36.0,0.0,0.0,7.0,2.0,171.0,74.0,1.0,1.0,2.0,3.0,2.0,3.0,2.0,4.0,1.0,1.0,2.0,12.0,12.0,10.0,5.0,15.0,12.0,4.0,10.0,4.0,8.0,16.0,11.0,12.0,14.0,10.0,15.0,13.0,13.0,14.0,16.0,12.0,11.0,11.0,12.0,10.0,13.0,17.0,13.0,9.0,9.0,9.0,6.0,14.0,13.0,9.0,20.0,9.0,9.0,13.0,10.0,13.0,14.0,12.0,14.0,13.0,14.0,12.0,15.0,16.0,16.0,6.0,17.0,0.0,0.0,0.0,0.0,181.0,68.0,1.0,2.0,1.0,1.0,2.0,2.0,3.0,3.0,3.0,2.0,1.0,8.0,11.0,14.0,11.0,13.0,8.0,11.0,9.0,5.0,3.0,11.0,5.0,5.0,14.0,5.0,11.0,6.0,10.0,10.0,11.0,12.0,14.0,13.0,6.0,13.0,9.0,10.0,8.0,14.0,14.0,14.0,10.0,5.0,12.0,14.0,20.0,12.0,11.0,10.0,6.0,5.0,10.0,12.0,20.0,12.0,11.0,12.0,12.0,11.0,14.0,5.0,30.0,0.0,0.0,0.0,0.0,178.0,73.0,3.0,4.0,1.0,1.0,2.0,4.0,3.0,2.0,2.0,2.0,3.0,13.0,14.0,12.0,7.0,13.0,12.0,7.0,13.0,5.0,10.0,13.0,9.0,10.0,13.0,11.0,11.0,12.0,12.0,13.0,11.0,14.0,14.0,11.0,7.0,11.0,10.0,13.0,15.0,13.0,15.0,15.0,8.0,20.0,14.0,14.0,8.0,14.0,11.0,13.0,11.0,14.0,8.0,10.0,19.0,12.0,12.0,9.0,12.0,12.0,10.0,10.0,27.0,0.0,0.0,0.0,0.0,190.0,87.0,1.0,3.0,2.0,3.0,1.0,3.0,1.0,1.0,2.0,3.0,2.0,5.0,7.0,9.0,14.0,14.0,10.0,14.0,13.0,5.0,6.0,12.0,12.0,8.0,14.0,14.0,13.0,16.0,14.0,11.0,10.0,13.0,15.0,10.0,11.0,14.0,9.0,15.0,14.0,10.0,11.0,16.0,15.0,9.0,12.0,12.0,20.0,14.0,16.0,13.0,13.0,12.0,7.0,5.0,10.0,12.0,14.0,12.0,14.0,14.0,19.0,12.0
1,1,25.0,0.0,0.0,0.0,0.0,187.0,83.0,11.0,14.0,12.0,8.0,13.0,11.0,14.0,15.0,13.0,13.0,9.0,8.0,1.0,1.0,1.0,11.0,11.0,1.0,2.0,2.0,1.0,10.0,3.0,2.0,11.0,8.0,12.0,14.0,12.0,12.0,10.0,12.0,14.0,6.0,14.0,2.0,12.0,12.0,8.0,13.0,15.0,14.0,13.0,20.0,15.0,11.0,5.0,14.0,13.0,13.0,8.0,8.0,10.0,1.0,9.0,13.0,14.0,12.0,15.0,15.0,15.0,5.0,28.0,0.0,0.0,0.0,0.0,184.0,85.0,2.0,3.0,2.0,1.0,1.0,3.0,2.0,2.0,3.0,1.0,3.0,4.0,8.0,8.0,6.0,12.0,6.0,14.0,8.0,5.0,13.0,12.0,6.0,14.0,12.0,11.0,13.0,14.0,13.0,12.0,11.0,11.0,13.0,7.0,14.0,10.0,15.0,16.0,12.0,12.0,11.0,15.0,12.0,20.0,13.0,11.0,7.0,14.0,16.0,13.0,11.0,13.0,13.0,12.0,15.0,13.0,13.0,14.0,15.0,14.0,14.0,6.0,25.0,0.0,0.0,3.0,0.0,184.0,80.0,2.0,2.0,4.0,2.0,1.0,3.0,2.0,1.0,1.0,2.0,1.0,5.0,8.0,7.0,6.0,9.0,6.0,14.0,6.0,6.0,14.0,7.0,6.0,13.0,9.0,12.0,14.0,13.0,11.0,13.0,7.0,12.0,14.0,8.0,10.0,7.0,14.0,13.0,14.0,15.0,12.0,14.0,12.0,8.0,15.0,15.0,20.0,14.0,14.0,13.0,12.0,14.0,5.0,10.0,16.0,13.0,15.0,15.0,12.0,14.0,14.0,8.0,26.0,11.0,0.0,4.0,0.0,183.0,79.0,3.0,2.0,1.0,2.0,2.0,2.0,3.0,2.0,2.0,2.0,1.0,5.0,7.0,9.0,6.0,10.0,11.0,15.0,11.0,7.0,14.0,10.0,7.0,13.0,10.0,14.0,13.0,15.0,13.0,12.0,10.0,12.0,17.0,8.0,11.0,10.0,13.0,15.0,16.0,13.0,13.0,16.0,13.0,5.0,15.0,13.0,20.0,16.0,15.0,13.0,14.0,15.0,7.0,14.0,16.0,12.0,14.0,14.0,15.0,14.0,14.0,5.0,26.0,0.0,0.0,0.0,0.0,177.0,68.0,4.0,2.0,1.0,2.0,3.0,1.0,1.0,2.0,3.0,3.0,3.0,12.0,13.0,11.0,8.0,13.0,11.0,8.0,10.0,8.0,10.0,13.0,10.0,12.0,13.0,7.0,12.0,10.0,13.0,11.0,15.0,13.0,14.0,11.0,7.0,14.0,10.0,14.0,14.0,13.0,15.0,12.0,9.0,20.0,15.0,14.0,5.0,15.0,8.0,13.0,7.0,14.0,6.0,12.0,11.0,12.0,14.0,13.0,16.0,16.0,16.0,5.0,21.0,0.0,0.0,4.0,0.0,178.0,72.0,2.0,3.0,1.0,2.0,2.0,3.0,3.0,1.0,2.0,2.0,3.0,6.0,12.0,10.0,7.0,11.0,7.0,9.0,8.0,11.0,12.0,11.0,8.0,13.0,11.0,10.0,12.0,11.0,12.0,13.0,11.0,11.0,13.0,8.0,11.0,12.0,12.0,13.0,14.0,15.0,13.0,13.0,9.0,7.0,14.0,14.0,20.0,14.0,12.0,13.0,10.0,12.0,9.0,14.0,16.0,15.0,8.0,10.0,12.0,16.0,17.0,10.0,31.0,0.0,0.0,4.0,0.0,174.0,72.0,2.0,1.0,4.0,2.0,2.0,3.0,1.0,1.0,3.0,3.0,4.0,12.0,9.0,11.0,6.0,14.0,11.0,7.0,10.0,6.0,8.0,16.0,12.0,9.0,14.0,9.0,14.0,10.0,13.0,12.0,12.0,11.0,14.0,8.0,8.0,11.0,12.0,14.0,12.0,13.0,14.0,12.0,7.0,12.0,14.0,12.0,20.0,15.0,11.0,11.0,9.0,12.0,8.0,10.0,10.0,14.0,13.0,10.0,12.0,14.0,14.0,9.0,28.0,0.0,0.0,0.0,0.0,170.0,67.0,2.0,3.0,3.0,4.0,3.0,2.0,1.0,1.0,2.0,2.0,3.0,8.0,12.0,12.0,10.0,14.0,7.0,5.0,10.0,6.0,5.0,12.0,5.0,4.0,13.0,7.0,16.0,12.0,9.0,11.0,12.0,10.0,3.0,12.0,6.0,13.0,6.0,8.0,13.0,16.0,13.0,10.0,5.0,5.0,13.0,16.0,20.0,15.0,7.0,12.0,4.0,9.0,7.0,10.0,20.0,13.0,12.0,10.0,13.0,11.0,10.0,2.0,22.0,0.0,0.0,0.0,0.0,164.0,65.0,1.0,2.0,3.0,1.0,2.0,2.0,3.0,2.0,2.0,1.0,2.0,10.0,12.0,13.0,11.0,13.0,10.0,5.0,10.0,7.0,5.0,12.0,10.0,3.0,13.0,7.0,11.0,11.0,11.0,13.0,13.0,11.0,13.0,13.0,6.0,14.0,7.0,12.0,12.0,15.0,15.0,8.0,2.0,9.0,13.0,14.0,20.0,13.0,8.0,13.0,7.0,10.0,8.0,12.0,10.0,12.0,11.0,12.0,11.0,10.0,10.0,8.0,33.0,0.0,0.0,5.0,1.0,181.0,80.0,3.0,1.0,2.0,2.0,3.0,2.0,1.0,1.0,4.0,3.0,1.0,7.0,8.0,13.0,13.0,13.0,11.0,12.0,10.0,5.0,5.0,12.0,13.0,4.0,14.0,11.0,13.0,14.0,11.0,13.0,13.0,12.0,13.0,14.0,11.0,14.0,8.0,11.0,12.0,13.0,12.0,13.0,10.0,9.0,11.0,12.0,20.0,13.0,12.0,12.0,11.0,14.0,13.0,8.0,12.0,13.0,10.0,10.0,13.0,15.0,14.0,8.0,24.0,24.0,4.0,0.0,0.0,172.0,74.0,2.0,4.0,3.0,2.0,2.0,1.0,2.0,2.0,3.0,2.0,4.0,8.0,9.0,14.0,13.0,14.0,9.0,11.0,10.0,7.0,5.0,12.0,12.0,3.0,13.0,10.0,12.0,12.0,13.0,12.0,11.0,10.0,14.0,13.0,7.0,14.0,9.0,9.0,13.0,16.0,15.0,13.0,6.0,8.0,13.0,16.0,20.0,14.0,12.0,11.0,11.0,13.0,9.0,8.0,9.0,13.0,9.0,11.0,12.0,13.0,10.0,9.0,34.0,1.0,0.0,0.0,0.0,187.0,87.0,13.0,14.0,15.0,7.0,13.0,11.0,14.0,15.0,11.0,17.0,12.0,2.0,1.0,1.0,3.0,8.0,7.0,2.0,1.0,2.0,1.0,9.0,8.0,2.0,6.0,12.0,15.0,17.0,14.0,15.0,8.0,13.0,17.0,7.0,14.0,6.0,14.0,12.0,6.0,7.0,13.0,14.0,13.0,8.0,13.0,8.0,20.0,11.0,16.0,14.0,10.0,14.0,6.0,1.0,12.0,12.0,15.0,16.0,16.0,14.0,15.0,6.0,31.0,2.0,0.0,0.0,0.0,187.0,83.0,3.0,1.0,3.0,1.0,3.0,2.0,1.0,3.0,3.0,1.0,1.0,8.0,11.0,10.0,8.0,11.0,8.0,15.0,8.0,13.0,14.0,11.0,11.0,14.0,8.0,16.0,13.0,15.0,14.0,12.0,5.0,12.0,13.0,9.0,9.0,11.0,14.0,12.0,13.0,13.0,8.0,16.0,14.0,5.0,14.0,13.0,20.0,12.0,14.0,14.0,15.0,12.0,5.0,8.0,12.0,14.0,11.0,11.0,14.0,12.0,13.0,5.0,20.0,0.0,0.0,6.0,0.0,188.0,79.0,2.0,3.0,2.0,1.0,1.0,3.0,2.0,1.0,2.0,2.0,1.0,4.0,4.0,11.0,6.0,11.0,8.0,13.0,8.0,9.0,13.0,12.0,9.0,13.0,11.0,14.0,13.0,15.0,14.0,13.0,8.0,12.0,14.0,9.0,11.0,10.0,12.0,12.0,13.0,11.0,11.0,11.0,13.0,8.0,12.0,13.0,20.0,13.0,12.0,13.0,14.0,13.0,10.0,11.0,11.0,13.0,12.0,14.0,14.0,15.0,10.0,7.0,23.0,0.0,0.0,0.0,0.0,174.0,64.0,4.0,3.0,1.0,1.0,3.0,3.0,2.0,3.0,3.0,2.0,3.0,8.0,12.0,10.0,8.0,11.0,7.0,10.0,9.0,12.0,14.0,9.0,10.0,13.0,12.0,12.0,12.0,12.0,11.0,12.0,10.0,12.0,13.0,8.0,9.0,12.0,11.0,13.0,14.0,15.0,14.0,11.0,10.0,10.0,14.0,14.0,20.0,15.0,10.0,14.0,12.0,12.0,8.0,13.0,10.0,12.0,15.0,12.0,13.0,10.0,17.0,6.0,26.0,0.0,0.0,0.0,0.0,176.0,70.0,2.0,1.0,4.0,3.0,3.0,3.0,1.0,3.0,3.0,2.0,1.0,10.0,11.0,11.0,6.0,13.0,9.0,5.0,12.0,11.0,13.0,13.0,7.0,14.0,13.0,15.0,11.0,14.0,12.0,11.0,9.0,12.0,13.0,9.0,9.0,13.0,12.0,15.0,14.0,12.0,16.0,12.0,7.0,20.0,13.0,13.0,10.0,15.0,11.0,13.0,14.0,13.0,11.0,9.0,8.0,9.0,17.0,12.0,14.0,14.0,15.0,3.0,32.0,36.0,0.0,12.0,2.0,183.0,77.0,1.0,3.0,2.0,1.0,3.0,1.0,1.0,2.0,1.0,1.0,3.0,6.0,11.0,8.0,6.0,13.0,11.0,13.0,10.0,6.0,15.0,14.0,10.0,17.0,12.0,15.0,16.0,18.0,14.0,17.0,12.0,15.0,17.0,11.0,17.0,7.0,17.0,20.0,16.0,9.0,11.0,15.0,11.0,8.0,15.0,10.0,20.0,14.0,14.0,17.0,10.0,16.0,10.0,13.0,15.0,15.0,15.0,14.0,18.0,15.0,13.0,6.0,26.0,0.0,0.0,0.0,0.0,184.0,76.0,3.0,1.0,3.0,1.0,3.0,2.0,3.0,2.0,1.0,1.0,3.0,10.0,11.0,13.0,9.0,13.0,12.0,13.0,10.0,6.0,11.0,13.0,9.0,14.0,12.0,12.0,13.0,12.0,12.0,11.0,13.0,12.0,13.0,13.0,10.0,12.0,13.0,12.0,16.0,15.0,13.0,15.0,13.0,20.0,15.0,14.0,5.0,16.0,15.0,13.0,12.0,14.0,5.0,12.0,18.0,14.0,10.0,7.0,11.0,11.0,13.0,10.0,20.0,0.0,0.0,0.0,0.0,173.0,66.0,1.0,1.0,1.0,1.0,1.0,2.0,3.0,1.0,3.0,3.0,4.0,15.0,13.0,13.0,10.0,15.0,12.0,5.0,13.0,5.0,7.0,15.0,12.0,7.0,15.0,10.0,10.0,13.0,12.0,10.0,16.0,13.0,18.0,14.0,7.0,14.0,12.0,14.0,14.0,8.0,14.0,13.0,7.0,14.0,12.0,9.0,20.0,12.0,13.0,12.0,8.0,15.0,6.0,12.0,12.0,14.0,14.0,14.0,15.0,14.0,11.0,6.0,19.0,0.0,0.0,11.0,1.0,171.0,65.0,2.0,2.0,2.0,2.0,2.0,3.0,3.0,3.0,1.0,1.0,3.0,14.0,13.0,13.0,11.0,14.0,15.0,8.0,12.0,6.0,4.0,13.0,12.0,4.0,15.0,8.0,12.0,10.0,12.0,8.0,13.0,13.0,14.0,15.0,8.0,14.0,6.0,13.0,12.0,15.0,16.0,10.0,7.0,20.0,13.0,15.0,10.0,12.0,7.0,11.0,6.0,11.0,8.0,11.0,12.0,13.0,11.0,12.0,12.0,6.0,12.0,5.0,23.0,21.0,3.0,9.0,4.0,176.0,69.0,1.0,2.0,1.0,3.0,3.0,1.0,2.0,1.0,1.0,2.0,3.0,9.0,9.0,14.0,13.0,14.0,10.0,10.0,9.0,3.0,5.0,12.0,14.0,6.0,15.0,9.0,13.0,9.0,11.0,10.0,12.0,12.0,13.0,14.0,10.0,13.0,8.0,8.0,10.0,16.0,15.0,10.0,8.0,10.0,12.0,15.0,20.0,13.0,10.0,9.0,8.0,13.0,11.0,13.0,7.0,14.0,12.0,13.0,8.0,14.0,13.0,8.0,19.0,0.0,0.0,0.0,0.0,172.0,64.0,1.0,3.0,2.0,2.0,4.0,2.0,1.0,2.0,3.0,3.0,1.0,13.0,13.0,15.0,12.0,15.0,12.0,6.0,12.0,3.0,2.0,13.0,11.0,3.0,16.0,8.0,10.0,9.0,12.0,9.0,13.0,10.0,12.0,15.0,8.0,13.0,4.0,5.0,7.0,17.0,16.0,14.0,5.0,20.0,11.0,15.0,12.0,10.0,8.0,8.0,10.0,14.0,8.0,10.0,17.0,14.0,9.0,10.0,9.0,4.0,10.0,10.0
1,0,33.0,0.0,0.0,2.0,0.0,196.0,89.0,15.0,13.0,12.0,7.0,14.0,10.0,14.0,14.0,11.0,9.0,12.0,4.0,3.0,1.0,1.0,9.0,7.0,2.0,2.0,1.0,1.0,10.0,2.0,2.0,9.0,10.0,14.0,14.0,13.0,12.0,11.0,12.0,14.0,6.0,12.0,1.0,13.0,11.0,6.0,9.0,13.0,16.0,18.0,5.0,12.0,10.0,20.0,12.0,16.0,14.0,10.0,15.0,13.0,1.0,8.0,14.0,14.0,14.0,10.0,15.0,15.0,9.0,30.0,19.0,0.0,7.0,0.0,189.0,77.0,3.0,2.0,3.0,2.0,3.0,3.0,1.0,3.0,3.0,1.0,2.0,5.0,8.0,7.0,10.0,10.0,9.0,15.0,9.0,8.0,14.0,12.0,10.0,15.0,10.0,15.0,14.0,13.0,13.0,14.0,10.0,12.0,14.0,10.0,14.0,11.0,12.0,14.0,14.0,8.0,10.0,12.0,16.0,10.0,16.0,10.0,20.0,13.0,16.0,13.0,11.0,13.0,7.0,10.0,6.0,14.0,12.0,13.0,14.0,13.0,13.0,7.0,34.0,5.0,0.0,2.0,1.0,186.0,78.0,2.0,1.0,3.0,3.0,1.0,3.0,2.0,3.0,1.0,3.0,1.0,7.0,11.0,10.0,6.0,12.0,8.0,14.0,7.0,14.0,14.0,10.0,9.0,14.0,12.0,13.0,13.0,15.0,13.0,13.0,9.0,12.0,15.0,10.0,13.0,8.0,13.0,13.0,14.0,11.0,12.0,14.0,13.0,8.0,13.0,12.0,20.0,14.0,14.0,13.0,13.0,15.0,9.0,12.0,8.0,16.0,13.0,14.0,13.0,16.0,16.0,7.0,35.0,80.0,0.0,11.0,0.0,174.0,74.0,3.0,4.0,2.0,2.0,2.0,2.0,1.0,2.0,2.0,3.0,2.0,8.0,14.0,13.0,7.0,15.0,8.0,14.0,4.0,14.0,14.0,13.0,9.0,16.0,15.0,15.0,15.0,16.0,17.0,13.0,11.0,15.0,19.0,14.0,18.0,14.0,17.0,16.0,14.0,12.0,13.0,15.0,9.0,20.0,17.0,12.0,9.0,13.0,11.0,16.0,14.0,16.0,4.0,10.0,18.0,14.0,17.0,17.0,14.0,14.0,14.0,12.0,26.0,27.0,0.0,0.0,0.0,183.0,70.0,1.0,3.0,1.0,3.0,4.0,1.0,3.0,3.0,2.0,1.0,3.0,9.0,14.0,12.0,8.0,10.0,8.0,12.0,13.0,14.0,9.0,12.0,7.0,13.0,11.0,14.0,9.0,15.0,10.0,12.0,9.0,10.0,16.0,10.0,9.0,12.0,8.0,12.0,17.0,14.0,11.0,13.0,12.0,10.0,16.0,16.0,20.0,16.0,13.0,13.0,10.0,14.0,6.0,15.0,10.0,15.0,14.0,10.0,16.0,13.0,13.0,4.0,21.0,0.0,0.0,11.0,2.0,180.0,72.0,2.0,3.0,3.0,3.0,3.0,2.0,2.0,1.0,3.0,2.0,3.0,12.0,13.0,14.0,9.0,14.0,13.0,8.0,12.0,5.0,8.0,14.0,10.0,9.0,14.0,12.0,12.0,9.0,13.0,12.0,15.0,13.0,14.0,15.0,8.0,13.0,10.0,16.0,14.0,15.0,14.0,12.0,9.0,8.0,15.0,14.0,20.0,13.0,12.0,12.0,8.0,11.0,10.0,11.0,10.0,14.0,16.0,14.0,15.0,15.0,15.0,6.0,18.0,0.0,0.0,0.0,0.0,167.0,60.0,2.0,1.0,2.0,2.0,2.0,1.0,2.0,1.0,1.0,1.0,1.0,10.0,11.0,12.0,8.0,13.0,10.0,3.0,10.0,5.0,6.0,13.0,12.0,8.0,15.0,8.0,11.0,8.0,12.0,11.0,13.0,12.0,13.0,12.0,6.0,11.0,11.0,12.0,13.0,15.0,14.0,8.0,5.0,8.0,15.0,12.0,20.0,12.0,7.0,8.0,8.0,14.0,7.0,8.0,18.0,11.0,12.0,11.0,12.0,15.0,15.0,7.0,27.0,0.0,0.0,2.0,0.0,179.0,73.0,3.0,2.0,2.0,2.0,1.0,2.0,1.0,1.0,2.0,2.0,1.0,9.0,10.0,12.0,8.0,13.0,9.0,12.0,13.0,6.0,12.0,13.0,10.0,14.0,13.0,14.0,13.0,13.0,14.0,9.0,13.0,11.0,8.0,12.0,7.0,12.0,12.0,11.0,13.0,14.0,14.0,13.0,9.0,12.0,14.0,12.0,20.0,16.0,12.0,13.0,14.0,14.0,10.0,8.0,12.0,12.0,12.0,9.0,13.0,11.0,11.0,13.0,26.0,4.0,0.0,17.0,4.0,171.0,62.0,2.0,3.0,2.0,2.0,2.0,1.0,3.0,2.0,3.0,1.0,4.0,12.0,12.0,14.0,12.0,15.0,12.0,6.0,12.0,5.0,3.0,14.0,14.0,4.0,15.0,10.0,13.0,11.0,13.0,12.0,12.0,11.0,14.0,15.0,7.0,15.0,7.0,11.0,10.0,16.0,15.0,10.0,6.0,12.0,14.0,15.0,20.0,13.0,7.0,12.0,10.0,13.0,6.0,12.0,13.0,13.0,15.0,13.0,14.0,12.0,15.0,5.0,23.0,0.0,0.0,10.0,7.0,179.0,70.0,1.0,1.0,2.0,2.0,1.0,3.0,3.0,2.0,1.0,4.0,3.0,10.0,13.0,14.0,12.0,15.0,11.0,10.0,13.0,6.0,3.0,13.0,12.0,4.0,16.0,11.0,12.0,11.0,13.0,11.0,13.0,12.0,12.0,16.0,6.0,14.0,6.0,10.0,12.0,16.0,14.0,12.0,9.0,20.0,13.0,14.0,10.0,13.0,10.0,12.0,7.0,12.0,6.0,8.0,12.0,13.0,5.0,10.0,8.0,14.0,12.0,8.0,30.0,12.0,3.0,0.0,0.0,184.0,77.0,1.0,2.0,1.0,1.0,1.0,4.0,2.0,1.0,1.0,2.0,3.0,4.0,8.0,12.0,15.0,12.0,9.0,16.0,11.0,5.0,6.0,11.0,16.0,4.0,13.0,9.0,14.0,15.0,13.0,13.0,9.0,12.0,12.0,15.0,10.0,14.0,5.0,12.0,10.0,12.0,13.0,14.0,13.0,10.0,11.0,13.0,20.0,15.0,16.0,11.0,9.0,14.0,6.0,5.0,10.0,17.0,11.0,14.0,14.0,15.0,17.0,10.0,30.0,0.0,0.0,0.0,0.0,180.0,75.0,11.0,13.0,13.0,9.0,13.0,11.0,12.0,15.0,15.0,14.0,13.0,6.0,1.0,2.0,3.0,7.0,8.0,1.0,1.0,1.0,2.0,7.0,2.0,1.0,7.0,8.0,12.0,14.0,13.0,14.0,7.0,12.0,14.0,5.0,12.0,3.0,13.0,15.0,9.0,13.0,14.0,13.0,10.0,5.0,14.0,11.0,20.0,12.0,13.0,12.0,8.0,14.0,6.0,1.0,9.0,13.0,14.0,13.0,16.0,15.0,15.0,5.0,23.0,0.0,0.0,0.0,0.0,186.0,82.0,1.0,3.0,3.0,3.0,3.0,2.0,1.0,2.0,2.0,2.0,1.0,4.0,9.0,8.0,6.0,11.0,6.0,14.0,7.0,8.0,12.0,11.0,6.0,10.0,11.0,12.0,12.0,14.0,11.0,11.0,12.0,10.0,14.0,7.0,7.0,8.0,11.0,13.0,13.0,10.0,11.0,15.0,11.0,10.0,15.0,12.0,20.0,13.0,15.0,13.0,12.0,9.0,6.0,10.0,19.0,12.0,15.0,11.0,13.0,15.0,15.0,6.0,21.0,0.0,0.0,0.0,0.0,182.0,74.0,2.0,2.0,2.0,2.0,2.0,1.0,1.0,1.0,3.0,2.0,2.0,9.0,11.0,12.0,7.0,9.0,8.0,12.0,7.0,11.0,12.0,7.0,8.0,13.0,11.0,12.0,12.0,14.0,12.0,13.0,7.0,12.0,11.0,1.0,9.0,11.0,9.0,10.0,12.0,14.0,10.0,13.0,11.0,9.0,8.0,12.0,20.0,13.0,11.0,10.0,13.0,8.0,10.0,10.0,15.0,11.0,13.0,10.0,10.0,8.0,13.0,7.0,26.0,11.0,0.0,0.0,0.0,180.0,81.0,3.0,2.0,2.0,3.0,3.0,2.0,1.0,2.0,2.0,1.0,2.0,5.0,9.0,8.0,5.0,11.0,5.0,13.0,10.0,8.0,15.0,10.0,7.0,13.0,10.0,15.0,14.0,17.0,11.0,12.0,9.0,12.0,16.0,8.0,10.0,8.0,13.0,14.0,15.0,13.0,12.0,14.0,12.0,20.0,14.0,12.0,8.0,14.0,14.0,14.0,10.0,15.0,13.0,8.0,9.0,14.0,17.0,13.0,13.0,13.0,11.0,8.0,28.0,22.0,0.0,20.0,1.0,176.0,74.0,2.0,3.0,2.0,1.0,1.0,1.0,3.0,3.0,2.0,2.0,1.0,15.0,15.0,12.0,8.0,13.0,12.0,5.0,11.0,15.0,10.0,13.0,9.0,10.0,12.0,10.0,11.0,10.0,13.0,12.0,11.0,12.0,11.0,11.0,7.0,13.0,10.0,14.0,15.0,15.0,14.0,10.0,8.0,20.0,13.0,14.0,8.0,15.0,8.0,14.0,5.0,12.0,5.0,14.0,15.0,15.0,10.0,14.0,13.0,12.0,12.0,2.0,31.0,0.0,0.0,0.0,0.0,178.0,70.0,3.0,1.0,3.0,3.0,2.0,2.0,2.0,1.0,2.0,1.0,2.0,5.0,8.0,7.0,7.0,12.0,5.0,8.0,8.0,7.0,14.0,13.0,8.0,13.0,12.0,15.0,14.0,17.0,12.0,13.0,9.0,13.0,16.0,10.0,15.0,8.0,13.0,18.0,15.0,13.0,14.0,12.0,9.0,10.0,15.0,13.0,20.0,16.0,13.0,14.0,12.0,14.0,5.0,16.0,13.0,12.0,16.0,13.0,13.0,13.0,13.0,6.0,22.0,0.0,0.0,6.0,1.0,175.0,75.0,3.0,3.0,2.0,1.0,1.0,2.0,3.0,2.0,2.0,1.0,1.0,10.0,9.0,12.0,6.0,11.0,7.0,10.0,11.0,7.0,9.0,11.0,6.0,10.0,14.0,12.0,10.0,12.0,10.0,10.0,12.0,11.0,10.0,13.0,6.0,11.0,8.0,11.0,13.0,12.0,14.0,12.0,8.0,5.0,14.0,13.0,20.0,11.0,12.0,10.0,10.0,10.0,8.0,10.0,8.0,11.0,10.0,9.0,12.0,12.0,15.0,6.0,20.0,0.0,0.0,0.0,0.0,175.0,77.0,2.0,1.0,2.0,3.0,3.0,3.0,3.0,1.0,4.0,3.0,1.0,8.0,8.0,12.0,12.0,11.0,8.0,13.0,10.0,9.0,10.0,11.0,10.0,9.0,12.0,12.0,6.0,9.0,9.0,11.0,15.0,11.0,4.0,10.0,8.0,12.0,11.0,10.0,13.0,14.0,15.0,15.0,8.0,8.0,9.0,15.0,20.0,11.0,12.0,12.0,8.0,4.0,10.0,10.0,15.0,11.0,12.0,11.0,9.0,10.0,10.0,7.0,34.0,0.0,0.0,0.0,0.0,176.0,65.0,2.0,3.0,3.0,3.0,2.0,2.0,1.0,2.0,1.0,1.0,2.0,14.0,15.0,13.0,10.0,15.0,13.0,6.0,15.0,10.0,3.0,14.0,13.0,6.0,14.0,8.0,12.0,9.0,13.0,12.0,14.0,13.0,11.0,12.0,7.0,13.0,8.0,14.0,15.0,14.0,13.0,12.0,8.0,20.0,14.0,13.0,10.0,12.0,7.0,13.0,8.0,15.0,7.0,6.0,13.0,14.0,14.0,9.0,14.0,14.0,11.0,10.0,19.0,0.0,0.0,0.0,0.0,173.0,67.0,3.0,2.0,4.0,2.0,1.0,1.0,3.0,1.0,1.0,1.0,2.0,13.0,13.0,15.0,10.0,14.0,11.0,6.0,12.0,4.0,4.0,12.0,11.0,5.0,14.0,10.0,12.0,9.0,10.0,8.0,12.0,8.0,11.0,15.0,5.0,12.0,6.0,8.0,10.0,16.0,15.0,13.0,7.0,8.0,13.0,15.0,20.0,11.0,9.0,12.0,6.0,12.0,6.0,15.0,8.0,13.0,8.0,12.0,9.0,14.0,13.0,9.0,21.0,0.0,0.0,4.0,1.0,184.0,79.0,1.0,2.0,3.0,1.0,2.0,1.0,3.0,2.0,2.0,1.0,3.0,3.0,6.0,10.0,12.0,12.0,7.0,15.0,8.0,4.0,5.0,13.0,10.0,8.0,12.0,18.0,12.0,19.0,13.0,10.0,13.0,12.0,14.0,13.0,10.0,12.0,9.0,16.0,15.0,12.0,14.0,14.0,14.0,12.0,13.0,10.0,20.0,14.0,14.0,11.0,14.0,14.0,11.0,5.0,10.0,13.0,14.0,15.0,10.0,8.0,4.0,15.0
1,1,25.0,0.0,0.0,11.0,0.0,189.0,83.0,12.0,12.0,11.0,7.0,13.0,12.0,17.0,17.0,16.0,12.0,13.0,6.0,2.0,1.0,1.0,10.0,10.0,7.0,1.0,1.0,1.0,9.0,5.0,1.0,10.0,8.0,15.0,14.0,14.0,12.0,7.0,13.0,12.0,6.0,9.0,3.0,16.0,17.0,10.0,13.0,16.0,14.0,12.0,8.0,15.0,10.0,20.0,13.0,14.0,14.0,5.0,14.0,4.0,12.0,15.0,15.0,13.0,13.0,17.0,15.0,17.0,4.0,29.0,0.0,0.0,0.0,0.0,170.0,65.0,2.0,1.0,3.0,3.0,1.0,3.0,2.0,1.0,2.0,3.0,2.0,5.0,11.0,4.0,6.0,7.0,4.0,7.0,5.0,6.0,6.0,6.0,2.0,6.0,7.0,9.0,10.0,13.0,8.0,12.0,8.0,13.0,15.0,2.0,7.0,5.0,9.0,8.0,8.0,12.0,12.0,14.0,4.0,9.0,12.0,11.0,20.0,12.0,5.0,9.0,9.0,9.0,9.0,9.0,10.0,12.0,12.0,12.0,12.0,7.0,5.0,8.0,20.0,0.0,0.0,7.0,0.0,186.0,72.0,3.0,3.0,2.0,3.0,3.0,4.0,3.0,3.0,2.0,2.0,2.0,4.0,9.0,8.0,6.0,13.0,6.0,14.0,6.0,7.0,14.0,12.0,8.0,13.0,13.0,11.0,13.0,14.0,14.0,14.0,9.0,13.0,13.0,8.0,8.0,8.0,13.0,14.0,14.0,13.0,13.0,15.0,13.0,20.0,15.0,14.0,8.0,14.0,13.0,12.0,8.0,12.0,4.0,10.0,8.0,15.0,14.0,12.0,14.0,15.0,14.0,7.0,28.0,0.0,0.0,0.0,0.0,169.0,0.0,3.0,3.0,2.0,3.0,3.0,1.0,1.0,3.0,2.0,1.0,3.0,5.0,8.0,11.0,9.0,8.0,8.0,7.0,8.0,4.0,2.0,9.0,5.0,3.0,11.0,11.0,11.0,13.0,9.0,11.0,8.0,15.0,14.0,11.0,7.0,10.0,8.0,8.0,10.0,11.0,11.0,6.0,5.0,14.0,11.0,12.0,20.0,14.0,5.0,9.0,12.0,9.0,5.0,6.0,9.0,12.0,11.0,9.0,9.0,10.0,12.0,11.0,23.0,25.0,0.0,0.0,0.0,174.0,74.0,2.0,1.0,1.0,1.0,3.0,3.0,3.0,3.0,3.0,1.0,2.0,8.0,13.0,12.0,8.0,12.0,8.0,14.0,9.0,13.0,14.0,12.0,6.0,16.0,13.0,13.0,14.0,15.0,13.0,11.0,10.0,12.0,15.0,9.0,10.0,14.0,11.0,14.0,17.0,16.0,13.0,14.0,10.0,8.0,17.0,15.0,20.0,18.0,15.0,14.0,13.0,14.0,8.0,12.0,12.0,14.0,13.0,13.0,12.0,12.0,15.0,13.0,33.0,30.0,1.0,0.0,0.0,187.0,83.0,1.0,3.0,4.0,2.0,1.0,1.0,2.0,3.0,1.0,1.0,3.0,13.0,13.0,12.0,8.0,16.0,10.0,16.0,13.0,10.0,14.0,16.0,13.0,16.0,15.0,13.0,15.0,14.0,16.0,15.0,14.0,14.0,13.0,11.0,13.0,10.0,17.0,18.0,10.0,10.0,12.0,17.0,14.0,20.0,12.0,12.0,10.0,13.0,16.0,16.0,16.0,15.0,13.0,11.0,16.0,16.0,13.0,15.0,12.0,8.0,8.0,11.0,20.0,0.0,0.0,0.0,0.0,176.0,69.0,1.0,2.0,1.0,2.0,2.0,3.0,2.0,1.0,3.0,3.0,3.0,11.0,15.0,13.0,9.0,16.0,13.0,10.0,12.0,8.0,9.0,15.0,14.0,9.0,15.0,11.0,11.0,12.0,13.0,13.0,15.0,14.0,15.0,15.0,11.0,12.0,12.0,12.0,11.0,13.0,12.0,13.0,11.0,20.0,12.0,13.0,8.0,13.0,11.0,12.0,11.0,11.0,11.0,10.0,8.0,13.0,15.0,11.0,15.0,12.0,10.0,8.0,21.0,0.0,0.0,15.0,1.0,189.0,75.0,3.0,3.0,3.0,3.0,1.0,1.0,3.0,3.0,3.0,2.0,3.0,10.0,12.0,13.0,7.0,14.0,8.0,14.0,12.0,5.0,13.0,15.0,8.0,15.0,14.0,14.0,14.0,15.0,14.0,14.0,13.0,14.0,15.0,12.0,10.0,12.0,14.0,15.0,16.0,12.0,13.0,15.0,14.0,20.0,14.0,13.0,10.0,16.0,13.0,14.0,11.0,14.0,7.0,10.0,8.0,16.0,10.0,12.0,13.0,13.0,11.0,14.0,16.0,0.0,0.0,0.0,0.0,173.0,0.0,3.0,1.0,1.0,1.0,2.0,1.0,4.0,1.0,2.0,3.0,1.0,1.0,1.0,4.0,4.0,5.0,4.0,4.0,4.0,1.0,5.0,6.0,5.0,8.0,9.0,10.0,6.0,6.0,3.0,5.0,4.0,10.0,7.0,8.0,8.0,3.0,11.0,13.0,9.0,7.0,5.0,14.0,4.0,20.0,6.0,5.0,8.0,6.0,9.0,5.0,7.0,8.0,5.0,7.0,6.0,11.0,7.0,10.0,18.0,19.0,15.0,9.0,28.0,66.0,15.0,13.0,3.0,180.0,70.0,2.0,2.0,1.0,2.0,1.0,1.0,3.0,2.0,3.0,3.0,1.0,14.0,15.0,16.0,13.0,17.0,15.0,6.0,15.0,4.0,5.0,16.0,14.0,8.0,17.0,13.0,16.0,11.0,15.0,13.0,16.0,14.0,13.0,17.0,10.0,14.0,9.0,13.0,13.0,16.0,18.0,12.0,10.0,20.0,14.0,15.0,8.0,16.0,9.0,13.0,14.0,12.0,10.0,15.0,14.0,15.0,10.0,16.0,14.0,6.0,12.0,10.0,29.0,76.0,27.0,13.0,9.0,188.0,72.0,2.0,3.0,1.0,2.0,3.0,3.0,1.0,3.0,3.0,3.0,3.0,5.0,10.0,13.0,16.0,13.0,11.0,17.0,13.0,5.0,10.0,13.0,14.0,10.0,13.0,15.0,16.0,18.0,14.0,15.0,10.0,13.0,14.0,13.0,10.0,18.0,12.0,14.0,19.0,15.0,14.0,16.0,14.0,10.0,18.0,16.0,20.0,18.0,14.0,14.0,8.0,15.0,5.0,16.0,10.0,16.0,12.0,14.0,16.0,14.0,10.0,10.0,36.0,0.0,0.0,0.0,0.0,185.0,78.0,11.0,14.0,12.0,7.0,13.0,12.0,14.0,15.0,13.0,14.0,10.0,4.0,1.0,3.0,1.0,8.0,8.0,11.0,8.0,3.0,3.0,7.0,2.0,1.0,8.0,11.0,13.0,15.0,11.0,12.0,7.0,13.0,9.0,5.0,14.0,3.0,13.0,15.0,8.0,11.0,14.0,13.0,12.0,5.0,15.0,11.0,20.0,12.0,14.0,13.0,11.0,13.0,8.0,1.0,19.0,14.0,16.0,10.0,17.0,9.0,9.0,11.0,28.0,8.0,0.0,1.0,0.0,182.0,79.0,1.0,1.0,3.0,2.0,4.0,1.0,3.0,3.0,1.0,1.0,3.0,5.0,9.0,9.0,9.0,11.0,6.0,13.0,8.0,12.0,14.0,9.0,8.0,14.0,11.0,14.0,14.0,15.0,10.0,13.0,7.0,12.0,16.0,8.0,8.0,9.0,14.0,13.0,14.0,15.0,12.0,13.0,11.0,5.0,13.0,14.0,20.0,15.0,14.0,12.0,14.0,13.0,7.0,15.0,11.0,13.0,10.0,13.0,10.0,11.0,12.0,5.0,27.0,25.0,1.0,0.0,0.0,189.0,82.0,3.0,1.0,3.0,4.0,3.0,1.0,3.0,3.0,1.0,2.0,3.0,6.0,7.0,5.0,8.0,9.0,8.0,12.0,8.0,6.0,14.0,13.0,11.0,14.0,5.0,12.0,14.0,15.0,13.0,13.0,8.0,13.0,12.0,5.0,11.0,5.0,13.0,15.0,14.0,12.0,12.0,14.0,15.0,6.0,16.0,12.0,20.0,13.0,14.0,11.0,10.0,12.0,5.0,8.0,11.0,13.0,14.0,17.0,8.0,6.0,8.0,13.0,21.0,0.0,0.0,1.0,0.0,177.0,68.0,4.0,1.0,2.0,1.0,1.0,1.0,1.0,1.0,2.0,1.0,2.0,5.0,12.0,9.0,7.0,12.0,8.0,13.0,10.0,16.0,13.0,12.0,8.0,14.0,12.0,12.0,13.0,12.0,12.0,12.0,10.0,13.0,15.0,11.0,13.0,11.0,13.0,13.0,14.0,13.0,14.0,13.0,11.0,10.0,14.0,12.0,20.0,12.0,14.0,12.0,11.0,12.0,8.0,14.0,13.0,10.0,14.0,12.0,14.0,12.0,11.0,5.0,27.0,10.0,0.0,0.0,0.0,181.0,69.0,1.0,1.0,3.0,3.0,3.0,3.0,2.0,3.0,3.0,3.0,1.0,5.0,13.0,10.0,7.0,13.0,9.0,10.0,10.0,12.0,12.0,11.0,7.0,12.0,11.0,11.0,13.0,12.0,11.0,13.0,9.0,9.0,12.0,8.0,7.0,12.0,11.0,11.0,13.0,15.0,13.0,13.0,10.0,20.0,12.0,15.0,8.0,15.0,12.0,13.0,11.0,14.0,13.0,12.0,10.0,14.0,12.0,10.0,11.0,15.0,15.0,7.0,23.0,14.0,1.0,0.0,0.0,180.0,75.0,1.0,3.0,2.0,4.0,1.0,3.0,2.0,2.0,4.0,1.0,2.0,5.0,12.0,12.0,6.0,11.0,7.0,13.0,12.0,6.0,12.0,12.0,6.0,12.0,11.0,13.0,13.0,15.0,11.0,11.0,12.0,9.0,16.0,7.0,12.0,8.0,12.0,14.0,16.0,14.0,13.0,15.0,10.0,8.0,15.0,13.0,20.0,15.0,14.0,14.0,13.0,12.0,7.0,11.0,12.0,13.0,14.0,14.0,14.0,13.0,13.0,6.0,18.0,0.0,0.0,0.0,0.0,178.0,70.0,1.0,2.0,3.0,1.0,1.0,3.0,2.0,2.0,3.0,3.0,2.0,6.0,9.0,11.0,6.0,13.0,8.0,6.0,10.0,5.0,10.0,14.0,6.0,8.0,13.0,10.0,10.0,10.0,13.0,12.0,12.0,10.0,16.0,12.0,5.0,12.0,6.0,10.0,11.0,12.0,13.0,12.0,9.0,20.0,14.0,14.0,5.0,8.0,11.0,10.0,6.0,2.0,8.0,10.0,20.0,9.0,11.0,11.0,10.0,12.0,12.0,1.0,30.0,0.0,0.0,0.0,0.0,167.0,60.0,3.0,1.0,1.0,2.0,3.0,1.0,1.0,3.0,1.0,1.0,3.0,10.0,11.0,12.0,8.0,13.0,10.0,6.0,9.0,10.0,12.0,14.0,9.0,10.0,14.0,11.0,14.0,14.0,14.0,14.0,13.0,14.0,12.0,14.0,11.0,13.0,12.0,15.0,15.0,15.0,14.0,11.0,5.0,11.0,11.0,15.0,20.0,11.0,8.0,14.0,10.0,12.0,13.0,11.0,11.0,12.0,11.0,10.0,12.0,11.0,11.0,2.0,33.0,0.0,0.0,0.0,0.0,187.0,76.0,2.0,2.0,3.0,1.0,1.0,3.0,2.0,1.0,2.0,3.0,2.0,15.0,14.0,14.0,10.0,15.0,13.0,10.0,12.0,7.0,4.0,15.0,13.0,7.0,15.0,6.0,12.0,9.0,14.0,11.0,15.0,12.0,12.0,14.0,12.0,13.0,7.0,13.0,12.0,11.0,12.0,14.0,12.0,14.0,15.0,12.0,20.0,11.0,12.0,12.0,6.0,14.0,6.0,11.0,14.0,13.0,12.0,12.0,15.0,15.0,13.0,9.0,17.0,0.0,0.0,0.0,0.0,181.0,68.0,1.0,2.0,1.0,1.0,2.0,2.0,3.0,3.0,3.0,2.0,1.0,8.0,11.0,14.0,11.0,13.0,8.0,11.0,9.0,5.0,3.0,11.0,5.0,5.0,14.0,5.0,11.0,6.0,10.0,10.0,11.0,12.0,14.0,13.0,6.0,13.0,9.0,10.0,8.0,14.0,14.0,14.0,10.0,5.0,12.0,14.0,20.0,12.0,11.0,10.0,6.0,5.0,10.0,12.0,20.0,12.0,11.0,12.0,12.0,11.0,14.0,5.0,26.0,0.0,0.0,0.0,0.0,193.0,81.0,1.0,3.0,3.0,3.0,3.0,1.0,2.0,2.0,2.0,3.0,3.0,4.0,9.0,14.0,10.0,13.0,12.0,14.0,14.0,5.0,5.0,10.0,12.0,3.0,14.0,8.0,13.0,12.0,9.0,10.0,11.0,11.0,12.0,16.0,5.0,14.0,6.0,9.0,12.0,14.0,13.0,14.0,16.0,14.0,13.0,13.0,20.0,13.0,14.0,10.0,8.0,14.0,9.0,8.0,16.0,16.0,11.0,13.0,11.0,13.0,13.0,10.0
2,0,25.0,0.0,0.0,0.0,0.0,192.0,87.0,12.0,13.0,12.0,6.0,14.0,11.0,12.0,13.0,9.0,12.0,11.0,5.0,1.0,3.0,1.0,10.0,8.0,3.0,3.0,3.0,3.0,8.0,2.0,1.0,8.0,7.0,13.0,14.0,12.0,13.0,12.0,11.0,13.0,7.0,11.0,3.0,13.0,11.0,12.0,11.0,12.0,16.0,16.0,8.0,14.0,12.0,20.0,13.0,16.0,13.0,7.0,9.0,7.0,10.0,14.0,12.0,17.0,13.0,14.0,14.0,14.0,5.0,28.0,0.0,0.0,0.0,0.0,193.0,84.0,1.0,1.0,2.0,2.0,2.0,3.0,2.0,3.0,2.0,1.0,3.0,4.0,8.0,8.0,9.0,10.0,6.0,14.0,7.0,8.0,14.0,12.0,6.0,14.0,11.0,12.0,13.0,14.0,11.0,14.0,12.0,12.0,14.0,6.0,11.0,8.0,14.0,13.0,13.0,11.0,11.0,16.0,16.0,20.0,12.0,12.0,8.0,14.0,16.0,14.0,12.0,13.0,6.0,10.0,7.0,12.0,15.0,12.0,16.0,15.0,13.0,6.0,29.0,2.0,0.0,0.0,0.0,185.0,75.0,2.0,3.0,3.0,3.0,2.0,3.0,2.0,1.0,3.0,1.0,2.0,4.0,10.0,8.0,6.0,10.0,6.0,14.0,7.0,7.0,14.0,11.0,6.0,14.0,9.0,13.0,13.0,14.0,11.0,12.0,12.0,12.0,14.0,8.0,11.0,12.0,13.0,13.0,13.0,15.0,12.0,15.0,12.0,8.0,15.0,13.0,20.0,14.0,15.0,14.0,7.0,14.0,8.0,6.0,14.0,13.0,15.0,14.0,14.0,14.0,14.0,6.0,31.0,4.0,0.0,0.0,0.0,173.0,73.0,2.0,3.0,2.0,2.0,4.0,2.0,3.0,1.0,1.0,2.0,4.0,7.0,13.0,9.0,6.0,11.0,10.0,6.0,8.0,11.0,12.0,13.0,8.0,13.0,11.0,11.0,12.0,13.0,10.0,12.0,8.0,8.0,16.0,11.0,6.0,12.0,8.0,12.0,14.0,14.0,13.0,12.0,7.0,8.0,15.0,14.0,20.0,14.0,14.0,12.0,11.0,13.0,8.0,16.0,7.0,13.0,14.0,12.0,14.0,16.0,16.0,6.0,26.0,0.0,0.0,0.0,0.0,175.0,69.0,3.0,3.0,2.0,2.0,3.0,1.0,3.0,1.0,3.0,2.0,2.0,6.0,12.0,10.0,5.0,11.0,6.0,10.0,10.0,10.0,13.0,12.0,9.0,13.0,12.0,12.0,13.0,14.0,12.0,13.0,12.0,11.0,15.0,11.0,13.0,12.0,13.0,14.0,14.0,15.0,13.0,12.0,7.0,9.0,13.0,13.0,20.0,14.0,11.0,14.0,12.0,12.0,11.0,15.0,14.0,9.0,17.0,10.0,8.0,11.0,20.0,7.0,21.0,0.0,0.0,0.0,0.0,183.0,73.0,1.0,4.0,3.0,3.0,3.0,1.0,4.0,1.0,2.0,3.0,2.0,11.0,10.0,12.0,11.0,13.0,9.0,12.0,10.0,5.0,8.0,12.0,9.0,8.0,13.0,13.0,12.0,12.0,10.0,12.0,14.0,12.0,12.0,14.0,8.0,12.0,8.0,12.0,12.0,14.0,14.0,14.0,11.0,8.0,13.0,13.0,20.0,12.0,12.0,12.0,5.0,10.0,7.0,12.0,15.0,11.0,11.0,10.0,11.0,12.0,11.0,4.0,30.0,9.0,1.0,0.0,0.0,192.0,90.0,2.0,2.0,2.0,2.0,3.0,1.0,3.0,4.0,1.0,1.0,3.0,4.0,7.0,10.0,10.0,9.0,8.0,17.0,12.0,6.0,13.0,12.0,8.0,12.0,11.0,13.0,14.0,15.0,13.0,13.0,10.0,12.0,14.0,12.0,13.0,13.0,12.0,14.0,16.0,12.0,12.0,18.0,16.0,8.0,14.0,13.0,20.0,16.0,18.0,13.0,13.0,14.0,7.0,12.0,13.0,13.0,13.0,13.0,13.0,13.0,13.0,6.0,29.0,0.0,0.0,0.0,0.0,183.0,78.0,1.0,3.0,3.0,3.0,3.0,1.0,2.0,3.0,3.0,1.0,1.0,13.0,8.0,9.0,6.0,12.0,14.0,13.0,10.0,12.0,11.0,12.0,8.0,13.0,12.0,12.0,15.0,13.0,13.0,13.0,11.0,13.0,15.0,6.0,12.0,7.0,13.0,16.0,18.0,12.0,11.0,14.0,12.0,20.0,14.0,11.0,8.0,16.0,14.0,14.0,12.0,14.0,6.0,12.0,10.0,12.0,13.0,11.0,15.0,15.0,15.0,5.0,23.0,1.0,0.0,0.0,0.0,192.0,80.0,3.0,3.0,3.0,2.0,3.0,1.0,3.0,3.0,1.0,2.0,2.0,4.0,6.0,12.0,13.0,12.0,7.0,13.0,12.0,5.0,5.0,9.0,11.0,5.0,12.0,13.0,12.0,13.0,12.0,13.0,9.0,13.0,4.0,11.0,8.0,13.0,7.0,9.0,12.0,14.0,13.0,15.0,16.0,20.0,14.0,13.0,8.0,13.0,15.0,12.0,11.0,11.0,7.0,5.0,14.0,13.0,14.0,11.0,9.0,9.0,18.0,3.0,21.0,0.0,0.0,0.0,0.0,178.0,68.0,1.0,1.0,1.0,2.0,3.0,2.0,1.0,1.0,1.0,1.0,3.0,10.0,10.0,14.0,12.0,13.0,7.0,11.0,12.0,5.0,5.0,10.0,10.0,4.0,13.0,6.0,12.0,11.0,12.0,11.0,11.0,12.0,11.0,14.0,6.0,14.0,9.0,10.0,13.0,15.0,14.0,12.0,9.0,20.0,12.0,14.0,8.0,13.0,9.0,12.0,6.0,10.0,8.0,11.0,13.0,11.0,10.0,12.0,12.0,9.0,16.0,8.0,23.0,1.0,0.0,0.0,0.0,185.0,70.0,4.0,3.0,1.0,2.0,1.0,3.0,2.0,3.0,1.0,2.0,3.0,5.0,8.0,12.0,13.0,13.0,7.0,14.0,11.0,5.0,5.0,8.0,13.0,5.0,13.0,6.0,13.0,10.0,12.0,12.0,11.0,11.0,13.0,12.0,7.0,13.0,9.0,8.0,10.0,16.0,12.0,14.0,12.0,8.0,14.0,15.0,20.0,13.0,13.0,12.0,7.0,15.0,7.0,7.0,13.0,13.0,12.0,10.0,12.0,15.0,15.0,7.0,30.0,0.0,0.0,1.0,0.0,181.0,81.0,12.0,12.0,13.0,9.0,13.0,12.0,14.0,13.0,14.0,14.0,8.0,3.0,3.0,3.0,1.0,9.0,7.0,10.0,3.0,1.0,3.0,10.0,4.0,3.0,9.0,11.0,13.0,15.0,11.0,14.0,7.0,12.0,15.0,7.0,8.0,2.0,13.0,10.0,8.0,13.0,14.0,14.0,10.0,6.0,15.0,12.0,20.0,14.0,13.0,11.0,10.0,14.0,13.0,1.0,12.0,14.0,15.0,14.0,11.0,11.0,15.0,15.0,22.0,0.0,0.0,0.0,0.0,190.0,86.0,1.0,2.0,2.0,3.0,2.0,1.0,2.0,3.0,1.0,1.0,3.0,8.0,10.0,11.0,10.0,11.0,11.0,13.0,11.0,12.0,12.0,10.0,11.0,12.0,11.0,13.0,10.0,15.0,12.0,12.0,8.0,10.0,13.0,10.0,10.0,10.0,14.0,9.0,13.0,16.0,12.0,13.0,12.0,20.0,15.0,12.0,9.0,12.0,15.0,12.0,13.0,11.0,6.0,12.0,12.0,10.0,14.0,12.0,12.0,9.0,9.0,10.0,18.0,0.0,0.0,0.0,0.0,189.0,78.0,3.0,1.0,1.0,3.0,2.0,3.0,3.0,3.0,1.0,2.0,3.0,7.0,4.0,7.0,8.0,10.0,3.0,11.0,6.0,7.0,9.0,9.0,5.0,10.0,7.0,9.0,7.0,9.0,4.0,8.0,8.0,11.0,1.0,5.0,1.0,11.0,6.0,9.0,9.0,14.0,14.0,13.0,14.0,5.0,14.0,14.0,20.0,10.0,11.0,5.0,9.0,8.0,6.0,9.0,13.0,11.0,12.0,10.0,13.0,13.0,18.0,6.0,31.0,0.0,0.0,7.0,2.0,185.0,80.0,3.0,3.0,1.0,1.0,4.0,1.0,4.0,3.0,3.0,3.0,1.0,5.0,10.0,9.0,6.0,11.0,7.0,15.0,8.0,8.0,14.0,12.0,6.0,13.0,11.0,12.0,14.0,16.0,12.0,13.0,8.0,11.0,17.0,5.0,14.0,6.0,15.0,14.0,14.0,12.0,11.0,15.0,14.0,10.0,16.0,11.0,20.0,14.0,15.0,14.0,12.0,15.0,8.0,13.0,8.0,15.0,17.0,14.0,16.0,15.0,15.0,7.0,18.0,0.0,0.0,0.0,0.0,185.0,74.0,2.0,2.0,1.0,3.0,3.0,1.0,4.0,2.0,2.0,3.0,2.0,8.0,6.0,8.0,6.0,10.0,6.0,13.0,5.0,9.0,12.0,10.0,9.0,13.0,10.0,12.0,12.0,13.0,11.0,12.0,8.0,11.0,12.0,3.0,8.0,8.0,11.0,10.0,13.0,13.0,11.0,12.0,12.0,6.0,12.0,12.0,20.0,13.0,14.0,11.0,7.0,10.0,5.0,10.0,7.0,13.0,12.0,12.0,13.0,9.0,15.0,7.0,21.0,0.0,0.0,0.0,0.0,185.0,69.0,2.0,3.0,2.0,1.0,3.0,3.0,3.0,3.0,3.0,2.0,2.0,5.0,9.0,12.0,9.0,16.0,10.0,11.0,15.0,5.0,13.0,13.0,8.0,14.0,13.0,11.0,16.0,13.0,13.0,14.0,12.0,11.0,15.0,10.0,7.0,8.0,13.0,14.0,13.0,13.0,13.0,14.0,12.0,6.0,13.0,12.0,20.0,13.0,11.0,12.0,10.0,12.0,7.0,13.0,10.0,14.0,14.0,11.0,14.0,14.0,14.0,6.0,32.0,55.0,14.0,0.0,0.0,168.0,76.0,1.0,3.0,3.0,3.0,3.0,3.0,2.0,3.0,4.0,3.0,1.0,11.0,12.0,15.0,10.0,13.0,8.0,6.0,4.0,8.0,2.0,12.0,12.0,5.0,16.0,14.0,15.0,10.0,8.0,9.0,11.0,11.0,11.0,17.0,4.0,13.0,6.0,7.0,7.0,18.0,17.0,12.0,6.0,8.0,16.0,15.0,20.0,14.0,9.0,7.0,9.0,15.0,5.0,14.0,7.0,15.0,8.0,12.0,10.0,5.0,6.0,15.0,26.0,17.0,1.0,0.0,0.0,177.0,74.0,2.0,2.0,3.0,3.0,1.0,3.0,2.0,3.0,1.0,3.0,2.0,17.0,15.0,16.0,12.0,16.0,15.0,7.0,10.0,6.0,4.0,15.0,18.0,5.0,16.0,8.0,12.0,10.0,12.0,11.0,14.0,13.0,13.0,14.0,6.0,14.0,6.0,11.0,10.0,13.0,16.0,12.0,9.0,20.0,14.0,13.0,12.0,11.0,11.0,10.0,8.0,13.0,6.0,12.0,15.0,16.0,12.0,10.0,7.0,12.0,14.0,12.0,23.0,3.0,2.0,15.0,5.0,173.0,70.0,4.0,2.0,3.0,3.0,2.0,1.0,1.0,3.0,2.0,1.0,1.0,7.0,12.0,15.0,12.0,12.0,10.0,6.0,15.0,7.0,5.0,13.0,9.0,7.0,13.0,6.0,9.0,7.0,10.0,9.0,15.0,9.0,14.0,15.0,7.0,13.0,12.0,12.0,11.0,17.0,15.0,15.0,9.0,20.0,14.0,15.0,15.0,13.0,7.0,8.0,8.0,11.0,9.0,9.0,12.0,17.0,9.0,9.0,12.0,10.0,10.0,7.0,21.0,3.0,1.0,0.0,0.0,190.0,83.0,1.0,1.0,1.0,2.0,3.0,3.0,2.0,1.0,4.0,2.0,4.0,8.0,11.0,13.0,14.0,12.0,6.0,17.0,11.0,5.0,8.0,12.0,12.0,7.0,12.0,10.0,8.0,11.0,12.0,12.0,10.0,11.0,19.0,11.0,9.0,12.0,13.0,8.0,12.0,13.0,13.0,12.0,16.0,9.0,12.0,12.0,20.0,13.0,15.0,12.0,8.0,10.0,8.0,8.0,10.0,12.0,10.0,13.0,9.0,11.0,10.0,6.0,20.0,0.0,0.0,0.0,0.0,188.0,81.0,2.0,4.0,1.0,4.0,2.0,3.0,3.0,1.0,1.0,1.0,3.0,5.0,12.0,12.0,12.0,12.0,8.0,11.0,8.0,6.0,4.0,13.0,6.0,4.0,13.0,14.0,12.0,14.0,9.0,12.0,12.0,10.0,15.0,13.0,7.0,13.0,7.0,8.0,12.0,14.0,13.0,12.0,14.0,9.0,15.0,14.0,20.0,11.0,12.0,12.0,11.0,14.0,4.0,11.0,15.0,14.0,14.0,10.0,9.0,10.0,10.0,8.0
1,0,26.0,2.0,0.0,1.0,0.0,188.0,84.0,12.0,13.0,15.0,9.0,15.0,13.0,13.0,15.0,10.0,11.0,14.0,9.0,2.0,1.0,2.0,12.0,11.0,3.0,2.0,3.0,3.0,11.0,3.0,1.0,10.0,14.0,13.0,14.0,10.0,13.0,11.0,11.0,14.0,3.0,11.0,5.0,12.0,15.0,13.0,10.0,12.0,13.0,14.0,5.0,14.0,9.0,20.0,12.0,14.0,12.0,10.0,15.0,3.0,11.0,12.0,11.0,16.0,13.0,15.0,16.0,16.0,4.0,29.0,0.0,0.0,0.0,0.0,183.0,74.0,3.0,3.0,3.0,3.0,3.0,2.0,2.0,2.0,1.0,3.0,1.0,5.0,12.0,7.0,6.0,10.0,7.0,14.0,12.0,5.0,14.0,12.0,6.0,13.0,11.0,14.0,13.0,17.0,13.0,16.0,12.0,12.0,13.0,9.0,8.0,9.0,14.0,14.0,15.0,13.0,12.0,15.0,12.0,6.0,17.0,11.0,20.0,17.0,13.0,14.0,14.0,15.0,5.0,13.0,9.0,14.0,19.0,15.0,14.0,11.0,11.0,6.0,33.0,0.0,0.0,3.0,0.0,190.0,90.0,2.0,2.0,3.0,3.0,1.0,1.0,2.0,1.0,2.0,2.0,4.0,8.0,12.0,12.0,8.0,15.0,13.0,14.0,14.0,7.0,13.0,15.0,12.0,13.0,15.0,7.0,14.0,14.0,14.0,14.0,14.0,13.0,14.0,13.0,12.0,11.0,15.0,14.0,10.0,7.0,10.0,16.0,14.0,10.0,9.0,8.0,20.0,13.0,15.0,14.0,7.0,14.0,12.0,18.0,10.0,15.0,15.0,15.0,13.0,16.0,13.0,10.0,22.0,0.0,0.0,0.0,0.0,178.0,73.0,3.0,2.0,2.0,1.0,2.0,4.0,3.0,1.0,3.0,1.0,2.0,6.0,12.0,12.0,6.0,11.0,7.0,8.0,8.0,11.0,12.0,10.0,8.0,13.0,11.0,12.0,12.0,13.0,11.0,10.0,11.0,11.0,13.0,6.0,7.0,12.0,9.0,13.0,14.0,16.0,14.0,13.0,9.0,6.0,14.0,15.0,20.0,15.0,14.0,12.0,12.0,13.0,6.0,14.0,12.0,15.0,13.0,13.0,14.0,14.0,14.0,6.0,27.0,0.0,0.0,0.0,0.0,178.0,72.0,2.0,3.0,2.0,3.0,2.0,3.0,3.0,1.0,1.0,2.0,1.0,13.0,14.0,11.0,7.0,12.0,10.0,9.0,10.0,13.0,13.0,12.0,10.0,14.0,13.0,12.0,14.0,14.0,13.0,14.0,11.0,12.0,14.0,13.0,8.0,14.0,13.0,13.0,15.0,15.0,13.0,10.0,10.0,20.0,13.0,15.0,6.0,14.0,10.0,13.0,13.0,12.0,8.0,12.0,15.0,14.0,13.0,14.0,13.0,13.0,12.0,6.0,30.0,4.0,0.0,0.0,0.0,192.0,78.0,1.0,3.0,1.0,2.0,2.0,3.0,1.0,3.0,1.0,1.0,3.0,4.0,6.0,7.0,8.0,11.0,6.0,15.0,8.0,6.0,13.0,11.0,6.0,14.0,11.0,17.0,14.0,16.0,12.0,14.0,10.0,12.0,17.0,8.0,8.0,11.0,13.0,15.0,16.0,14.0,12.0,18.0,14.0,6.0,14.0,12.0,20.0,17.0,16.0,14.0,17.0,13.0,9.0,11.0,8.0,13.0,10.0,13.0,12.0,10.0,10.0,5.0,32.0,0.0,0.0,13.0,0.0,175.0,65.0,2.0,1.0,1.0,2.0,3.0,3.0,1.0,2.0,3.0,2.0,3.0,15.0,13.0,11.0,6.0,14.0,13.0,10.0,12.0,8.0,8.0,16.0,8.0,12.0,13.0,11.0,14.0,15.0,14.0,15.0,14.0,14.0,14.0,6.0,13.0,9.0,15.0,18.0,13.0,12.0,13.0,13.0,8.0,8.0,13.0,10.0,20.0,13.0,13.0,12.0,11.0,15.0,12.0,10.0,17.0,14.0,15.0,14.0,16.0,14.0,14.0,6.0,27.0,0.0,0.0,0.0,0.0,188.0,77.0,1.0,4.0,1.0,1.0,3.0,1.0,2.0,1.0,2.0,2.0,2.0,4.0,7.0,8.0,7.0,13.0,6.0,15.0,9.0,6.0,13.0,12.0,6.0,12.0,11.0,14.0,14.0,15.0,10.0,12.0,11.0,13.0,16.0,7.0,12.0,9.0,12.0,15.0,16.0,14.0,10.0,14.0,15.0,9.0,13.0,12.0,20.0,14.0,16.0,12.0,14.0,13.0,6.0,12.0,4.0,13.0,18.0,13.0,14.0,14.0,13.0,7.0,20.0,0.0,0.0,2.0,0.0,180.0,75.0,3.0,1.0,2.0,2.0,3.0,2.0,1.0,1.0,3.0,3.0,1.0,8.0,13.0,14.0,9.0,13.0,8.0,10.0,9.0,6.0,5.0,12.0,6.0,5.0,14.0,8.0,13.0,12.0,13.0,12.0,12.0,12.0,7.0,13.0,8.0,14.0,7.0,12.0,13.0,15.0,13.0,14.0,10.0,8.0,14.0,15.0,20.0,13.0,12.0,13.0,11.0,9.0,7.0,13.0,9.0,11.0,11.0,11.0,12.0,11.0,10.0,1.0,26.0,1.0,2.0,0.0,0.0,187.0,88.0,2.0,4.0,2.0,3.0,3.0,2.0,2.0,3.0,1.0,2.0,3.0,4.0,8.0,12.0,12.0,10.0,11.0,15.0,13.0,5.0,6.0,11.0,15.0,4.0,12.0,9.0,13.0,14.0,13.0,14.0,10.0,12.0,15.0,9.0,7.0,13.0,8.0,13.0,14.0,12.0,14.0,16.0,14.0,20.0,13.0,12.0,8.0,13.0,17.0,13.0,9.0,14.0,8.0,5.0,14.0,14.0,14.0,12.0,13.0,14.0,14.0,7.0,25.0,0.0,0.0,0.0,0.0,176.0,74.0,2.0,2.0,1.0,3.0,2.0,2.0,2.0,4.0,3.0,3.0,3.0,12.0,12.0,14.0,12.0,14.0,13.0,7.0,12.0,6.0,3.0,12.0,12.0,3.0,15.0,9.0,10.0,8.0,12.0,11.0,12.0,10.0,10.0,14.0,5.0,13.0,4.0,6.0,8.0,17.0,15.0,12.0,8.0,20.0,12.0,14.0,8.0,13.0,12.0,11.0,9.0,14.0,10.0,8.0,8.0,14.0,12.0,7.0,10.0,11.0,11.0,9.0,33.0,70.0,0.0,0.0,0.0,185.0,81.0,12.0,9.0,11.0,10.0,11.0,11.0,12.0,15.0,10.0,15.0,8.0,6.0,2.0,8.0,1.0,12.0,8.0,10.0,1.0,2.0,1.0,2.0,1.0,3.0,11.0,10.0,9.0,13.0,11.0,15.0,9.0,11.0,15.0,2.0,10.0,1.0,12.0,17.0,9.0,7.0,14.0,13.0,14.0,10.0,7.0,9.0,20.0,11.0,10.0,14.0,11.0,13.0,6.0,11.0,18.0,18.0,10.0,10.0,17.0,14.0,12.0,2.0,27.0,0.0,0.0,0.0,0.0,181.0,79.0,3.0,1.0,3.0,1.0,3.0,1.0,1.0,2.0,3.0,3.0,3.0,5.0,12.0,10.0,5.0,10.0,6.0,11.0,7.0,8.0,12.0,9.0,7.0,12.0,11.0,13.0,13.0,14.0,13.0,12.0,9.0,9.0,13.0,9.0,7.0,8.0,13.0,13.0,13.0,15.0,12.0,13.0,10.0,5.0,13.0,13.0,20.0,15.0,14.0,15.0,13.0,7.0,6.0,10.0,8.0,13.0,13.0,13.0,14.0,14.0,14.0,5.0,24.0,0.0,0.0,0.0,0.0,184.0,89.0,2.0,3.0,3.0,2.0,2.0,3.0,3.0,1.0,2.0,3.0,2.0,4.0,10.0,8.0,6.0,11.0,9.0,14.0,9.0,7.0,14.0,11.0,6.0,11.0,11.0,13.0,12.0,16.0,11.0,13.0,10.0,11.0,14.0,6.0,8.0,7.0,12.0,13.0,14.0,14.0,12.0,16.0,12.0,20.0,14.0,13.0,6.0,14.0,16.0,14.0,13.0,13.0,7.0,8.0,7.0,14.0,13.0,12.0,14.0,14.0,14.0,6.0,22.0,24.0,0.0,3.0,1.0,182.0,80.0,3.0,3.0,1.0,2.0,2.0,2.0,3.0,1.0,3.0,3.0,3.0,4.0,5.0,8.0,6.0,11.0,6.0,12.0,5.0,5.0,12.0,10.0,7.0,12.0,11.0,11.0,12.0,12.0,11.0,11.0,9.0,11.0,14.0,7.0,8.0,7.0,10.0,13.0,12.0,12.0,10.0,11.0,11.0,5.0,13.0,12.0,20.0,14.0,13.0,13.0,9.0,12.0,8.0,8.0,14.0,13.0,14.0,12.0,15.0,15.0,15.0,7.0,20.0,0.0,0.0,0.0,0.0,175.0,66.0,1.0,1.0,2.0,2.0,1.0,2.0,2.0,3.0,1.0,2.0,2.0,9.0,8.0,6.0,2.0,14.0,4.0,12.0,6.0,7.0,12.0,11.0,7.0,13.0,12.0,15.0,13.0,13.0,12.0,13.0,11.0,10.0,8.0,10.0,5.0,11.0,12.0,15.0,12.0,13.0,14.0,11.0,9.0,20.0,16.0,14.0,6.0,12.0,17.0,10.0,5.0,1.0,7.0,10.0,12.0,9.0,12.0,12.0,10.0,12.0,13.0,2.0,27.0,27.0,1.0,2.0,1.0,183.0,72.0,2.0,2.0,2.0,1.0,2.0,1.0,3.0,1.0,2.0,2.0,4.0,5.0,8.0,10.0,6.0,11.0,10.0,14.0,11.0,5.0,14.0,12.0,10.0,15.0,11.0,14.0,13.0,16.0,11.0,11.0,9.0,10.0,12.0,8.0,12.0,8.0,13.0,14.0,14.0,14.0,12.0,16.0,11.0,8.0,12.0,13.0,20.0,15.0,15.0,10.0,14.0,11.0,7.0,11.0,13.0,13.0,9.0,9.0,11.0,10.0,10.0,8.0,31.0,0.0,0.0,0.0,0.0,180.0,74.0,3.0,2.0,3.0,1.0,2.0,3.0,2.0,1.0,4.0,3.0,3.0,12.0,12.0,10.0,9.0,13.0,14.0,11.0,13.0,6.0,10.0,14.0,15.0,13.0,13.0,15.0,14.0,17.0,12.0,14.0,13.0,13.0,15.0,7.0,13.0,10.0,13.0,18.0,15.0,9.0,11.0,14.0,10.0,10.0,13.0,12.0,20.0,15.0,14.0,14.0,13.0,15.0,8.0,7.0,19.0,13.0,13.0,13.0,13.0,13.0,12.0,9.0,23.0,5.0,0.0,0.0,0.0,180.0,75.0,1.0,1.0,2.0,3.0,3.0,1.0,2.0,2.0,3.0,1.0,3.0,5.0,9.0,12.0,7.0,14.0,8.0,12.0,11.0,6.0,11.0,12.0,12.0,11.0,11.0,12.0,13.0,13.0,11.0,10.0,13.0,11.0,14.0,11.0,7.0,11.0,12.0,14.0,13.0,15.0,13.0,14.0,10.0,7.0,14.0,14.0,20.0,13.0,14.0,12.0,11.0,12.0,12.0,15.0,10.0,14.0,13.0,12.0,14.0,14.0,14.0,6.0,31.0,0.0,0.0,0.0,0.0,175.0,65.0,3.0,4.0,1.0,1.0,3.0,3.0,3.0,2.0,4.0,3.0,3.0,14.0,13.0,13.0,7.0,14.0,12.0,7.0,12.0,7.0,6.0,14.0,15.0,8.0,15.0,11.0,12.0,13.0,13.0,11.0,14.0,12.0,15.0,13.0,9.0,11.0,10.0,12.0,13.0,14.0,15.0,12.0,7.0,20.0,10.0,13.0,10.0,12.0,9.0,12.0,11.0,15.0,16.0,13.0,8.0,14.0,14.0,14.0,13.0,13.0,13.0,7.0,22.0,0.0,0.0,0.0,0.0,183.0,78.0,4.0,3.0,1.0,1.0,3.0,1.0,2.0,1.0,3.0,1.0,2.0,10.0,10.0,11.0,14.0,11.0,7.0,12.0,9.0,7.0,7.0,9.0,13.0,7.0,11.0,13.0,10.0,13.0,11.0,12.0,9.0,11.0,15.0,12.0,6.0,14.0,9.0,9.0,12.0,11.0,11.0,13.0,11.0,8.0,10.0,12.0,20.0,11.0,12.0,13.0,6.0,12.0,8.0,5.0,15.0,14.0,13.0,14.0,10.0,14.0,16.0,7.0,21.0,0.0,0.0,0.0,0.0,181.0,73.0,2.0,3.0,2.0,2.0,1.0,2.0,1.0,2.0,1.0,3.0,1.0,6.0,9.0,12.0,11.0,11.0,8.0,9.0,11.0,6.0,4.0,9.0,12.0,3.0,13.0,10.0,11.0,12.0,11.0,9.0,9.0,9.0,14.0,13.0,6.0,13.0,6.0,10.0,12.0,15.0,14.0,13.0,10.0,8.0,12.0,14.0,20.0,11.0,12.0,12.0,10.0,14.0,10.0,8.0,16.0,13.0,13.0,14.0,12.0,15.0,15.0,8.0
1,1,30.0,42.0,0.0,13.0,0.0,195.0,88.0,16.0,13.0,14.0,6.0,14.0,13.0,13.0,15.0,12.0,10.0,14.0,1.0,8.0,5.0,2.0,8.0,2.0,8.0,2.0,5.0,3.0,9.0,5.0,3.0,8.0,10.0,12.0,10.0,14.0,10.0,10.0,14.0,13.0,3.0,14.0,3.0,12.0,14.0,12.0,8.0,13.0,18.0,18.0,17.0,14.0,11.0,20.0,14.0,17.0,14.0,4.0,14.0,4.0,1.0,12.0,13.0,14.0,9.0,15.0,13.0,13.0,5.0,24.0,0.0,0.0,0.0,0.0,185.0,77.0,1.0,1.0,3.0,2.0,1.0,1.0,3.0,1.0,3.0,3.0,1.0,7.0,10.0,12.0,11.0,12.0,12.0,14.0,13.0,7.0,13.0,12.0,8.0,14.0,12.0,10.0,13.0,11.0,13.0,13.0,12.0,13.0,16.0,10.0,8.0,12.0,13.0,13.0,13.0,14.0,14.0,12.0,14.0,12.0,14.0,13.0,20.0,11.0,12.0,12.0,12.0,10.0,11.0,7.0,17.0,11.0,10.0,10.0,10.0,7.0,8.0,5.0,19.0,0.0,0.0,0.0,0.0,189.0,78.0,2.0,2.0,2.0,1.0,1.0,1.0,3.0,1.0,2.0,1.0,2.0,7.0,8.0,9.0,7.0,9.0,6.0,12.0,8.0,8.0,12.0,12.0,6.0,13.0,11.0,15.0,13.0,14.0,11.0,10.0,8.0,12.0,14.0,6.0,9.0,11.0,11.0,13.0,14.0,13.0,12.0,12.0,13.0,6.0,14.0,13.0,20.0,12.0,13.0,13.0,6.0,12.0,5.0,13.0,16.0,13.0,13.0,13.0,15.0,14.0,12.0,5.0,28.0,0.0,0.0,0.0,0.0,190.0,85.0,3.0,2.0,3.0,3.0,2.0,2.0,2.0,4.0,3.0,1.0,2.0,5.0,9.0,8.0,9.0,8.0,7.0,14.0,10.0,9.0,15.0,9.0,6.0,14.0,9.0,16.0,13.0,16.0,10.0,13.0,10.0,12.0,15.0,6.0,13.0,7.0,13.0,14.0,16.0,12.0,11.0,17.0,13.0,20.0,15.0,13.0,8.0,15.0,15.0,12.0,14.0,14.0,9.0,8.0,14.0,13.0,14.0,11.0,12.0,13.0,16.0,14.0,23.0,0.0,0.0,0.0,0.0,184.0,71.0,1.0,2.0,1.0,2.0,2.0,2.0,2.0,4.0,2.0,1.0,3.0,4.0,10.0,10.0,6.0,11.0,6.0,14.0,8.0,7.0,14.0,11.0,6.0,13.0,11.0,12.0,12.0,13.0,12.0,11.0,12.0,12.0,14.0,6.0,8.0,10.0,13.0,13.0,14.0,15.0,13.0,14.0,13.0,8.0,12.0,14.0,20.0,13.0,14.0,13.0,12.0,14.0,15.0,8.0,11.0,13.0,13.0,10.0,8.0,9.0,16.0,7.0,21.0,0.0,0.0,0.0,0.0,177.0,0.0,1.0,1.0,1.0,2.0,3.0,3.0,2.0,3.0,2.0,2.0,3.0,6.0,4.0,13.0,13.0,13.0,6.0,13.0,7.0,3.0,5.0,7.0,6.0,1.0,11.0,9.0,7.0,8.0,7.0,7.0,7.0,8.0,7.0,11.0,8.0,13.0,7.0,6.0,7.0,12.0,13.0,7.0,6.0,8.0,8.0,13.0,20.0,5.0,5.0,9.0,5.0,9.0,9.0,9.0,10.0,10.0,12.0,12.0,11.0,10.0,9.0,6.0,22.0,0.0,0.0,0.0,0.0,187.0,84.0,2.0,2.0,1.0,2.0,3.0,2.0,2.0,3.0,3.0,2.0,2.0,4.0,7.0,10.0,6.0,9.0,10.0,13.0,12.0,5.0,11.0,11.0,7.0,10.0,12.0,12.0,11.0,13.0,10.0,9.0,11.0,9.0,15.0,8.0,7.0,9.0,11.0,11.0,14.0,13.0,10.0,15.0,14.0,8.0,15.0,11.0,20.0,14.0,15.0,11.0,12.0,7.0,9.0,8.0,7.0,13.0,15.0,13.0,11.0,14.0,14.0,7.0,22.0,0.0,0.0,0.0,0.0,177.0,72.0,2.0,1.0,2.0,4.0,2.0,2.0,1.0,3.0,4.0,2.0,3.0,10.0,12.0,13.0,11.0,12.0,10.0,12.0,12.0,4.0,10.0,13.0,11.0,11.0,13.0,11.0,12.0,11.0,13.0,9.0,13.0,12.0,3.0,12.0,8.0,14.0,12.0,12.0,13.0,16.0,13.0,12.0,9.0,8.0,15.0,14.0,20.0,14.0,13.0,10.0,4.0,11.0,11.0,12.0,19.0,9.0,12.0,13.0,12.0,11.0,14.0,7.0,24.0,0.0,0.0,0.0,0.0,172.0,72.0,1.0,1.0,3.0,2.0,2.0,1.0,1.0,1.0,1.0,3.0,1.0,10.0,11.0,12.0,10.0,11.0,8.0,8.0,10.0,7.0,7.0,11.0,11.0,6.0,12.0,8.0,11.0,11.0,10.0,10.0,11.0,12.0,15.0,12.0,5.0,10.0,11.0,13.0,15.0,15.0,13.0,10.0,9.0,8.0,14.0,13.0,20.0,14.0,11.0,11.0,8.0,13.0,7.0,12.0,18.0,13.0,10.0,10.0,11.0,11.0,11.0,6.0,29.0,30.0,6.0,0.0,0.0,178.0,76.0,2.0,3.0,3.0,4.0,3.0,2.0,2.0,2.0,2.0,1.0,1.0,6.0,11.0,16.0,10.0,12.0,5.0,8.0,8.0,5.0,4.0,13.0,7.0,3.0,12.0,7.0,8.0,12.0,11.0,10.0,8.0,9.0,13.0,15.0,4.0,13.0,7.0,12.0,10.0,16.0,15.0,14.0,8.0,11.0,13.0,16.0,20.0,10.0,13.0,10.0,11.0,10.0,7.0,5.0,9.0,16.0,9.0,10.0,11.0,11.0,14.0,3.0,25.0,0.0,0.0,0.0,0.0,187.0,83.0,2.0,1.0,3.0,3.0,1.0,3.0,3.0,3.0,1.0,1.0,3.0,4.0,8.0,10.0,14.0,12.0,8.0,14.0,9.0,5.0,7.0,11.0,13.0,5.0,12.0,11.0,13.0,13.0,13.0,11.0,10.0,12.0,16.0,9.0,8.0,13.0,11.0,13.0,16.0,14.0,13.0,15.0,13.0,20.0,14.0,12.0,8.0,14.0,16.0,13.0,11.0,13.0,7.0,5.0,13.0,14.0,13.0,14.0,14.0,13.0,13.0,6.0,23.0,3.0,0.0,12.0,0.0,187.0,98.0,12.0,14.0,15.0,6.0,14.0,12.0,14.0,15.0,11.0,10.0,14.0,2.0,1.0,1.0,1.0,7.0,2.0,2.0,2.0,5.0,6.0,9.0,9.0,8.0,6.0,10.0,11.0,14.0,11.0,11.0,6.0,12.0,15.0,15.0,16.0,4.0,12.0,12.0,2.0,12.0,12.0,12.0,13.0,5.0,13.0,12.0,20.0,9.0,14.0,14.0,10.0,11.0,10.0,1.0,10.0,13.0,13.0,17.0,8.0,11.0,8.0,10.0,19.0,0.0,0.0,0.0,0.0,182.0,77.0,1.0,1.0,2.0,2.0,3.0,2.0,2.0,1.0,2.0,2.0,2.0,2.0,7.0,6.0,4.0,10.0,5.0,12.0,6.0,5.0,9.0,9.0,8.0,11.0,11.0,8.0,9.0,10.0,11.0,11.0,8.0,15.0,12.0,5.0,12.0,6.0,9.0,10.0,12.0,9.0,10.0,13.0,11.0,10.0,15.0,11.0,20.0,12.0,11.0,10.0,8.0,6.0,10.0,10.0,18.0,14.0,10.0,9.0,14.0,15.0,15.0,8.0,19.0,0.0,0.0,0.0,0.0,182.0,89.0,1.0,2.0,2.0,1.0,1.0,1.0,2.0,1.0,3.0,3.0,3.0,5.0,8.0,6.0,5.0,11.0,5.0,14.0,6.0,6.0,12.0,11.0,8.0,13.0,10.0,13.0,12.0,15.0,12.0,13.0,9.0,12.0,12.0,8.0,8.0,7.0,12.0,13.0,14.0,12.0,11.0,15.0,12.0,10.0,15.0,13.0,20.0,14.0,16.0,13.0,4.0,10.0,6.0,11.0,9.0,13.0,10.0,13.0,13.0,14.0,14.0,6.0,24.0,9.0,0.0,0.0,0.0,176.0,71.0,3.0,1.0,1.0,2.0,3.0,1.0,1.0,1.0,3.0,1.0,4.0,5.0,12.0,10.0,6.0,11.0,5.0,6.0,9.0,11.0,8.0,9.0,6.0,11.0,12.0,12.0,11.0,11.0,9.0,10.0,8.0,10.0,14.0,9.0,8.0,12.0,10.0,12.0,13.0,16.0,13.0,12.0,8.0,10.0,16.0,14.0,20.0,15.0,10.0,13.0,12.0,10.0,5.0,15.0,9.0,13.0,13.0,10.0,12.0,14.0,14.0,7.0,29.0,0.0,0.0,4.0,0.0,184.0,72.0,3.0,2.0,4.0,2.0,3.0,1.0,1.0,3.0,1.0,1.0,1.0,8.0,13.0,10.0,6.0,11.0,7.0,12.0,8.0,10.0,12.0,11.0,9.0,13.0,11.0,9.0,14.0,14.0,11.0,14.0,10.0,12.0,16.0,9.0,14.0,12.0,13.0,15.0,16.0,15.0,12.0,14.0,12.0,8.0,13.0,14.0,20.0,16.0,12.0,13.0,9.0,16.0,8.0,15.0,13.0,13.0,17.0,14.0,16.0,16.0,16.0,5.0,21.0,0.0,0.0,1.0,0.0,186.0,75.0,3.0,4.0,2.0,2.0,2.0,2.0,1.0,2.0,2.0,1.0,3.0,10.0,11.0,10.0,8.0,13.0,11.0,10.0,11.0,8.0,12.0,11.0,7.0,14.0,12.0,11.0,12.0,14.0,11.0,10.0,10.0,11.0,14.0,12.0,11.0,14.0,11.0,12.0,12.0,13.0,11.0,12.0,14.0,20.0,11.0,14.0,5.0,13.0,12.0,12.0,11.0,11.0,10.0,11.0,11.0,14.0,11.0,12.0,9.0,8.0,7.0,2.0,22.0,5.0,0.0,9.0,2.0,181.0,73.0,3.0,1.0,2.0,1.0,3.0,2.0,2.0,3.0,3.0,1.0,1.0,12.0,13.0,12.0,7.0,14.0,12.0,9.0,11.0,6.0,7.0,14.0,10.0,8.0,15.0,13.0,11.0,12.0,13.0,12.0,15.0,12.0,12.0,11.0,10.0,11.0,11.0,14.0,13.0,11.0,13.0,14.0,10.0,10.0,16.0,12.0,20.0,14.0,12.0,12.0,11.0,14.0,9.0,8.0,12.0,13.0,16.0,12.0,14.0,13.0,14.0,5.0,20.0,0.0,0.0,0.0,0.0,183.0,70.0,1.0,1.0,2.0,2.0,3.0,1.0,1.0,2.0,2.0,2.0,3.0,6.0,10.0,12.0,7.0,11.0,8.0,9.0,10.0,6.0,3.0,11.0,8.0,2.0,14.0,8.0,10.0,7.0,10.0,10.0,14.0,10.0,11.0,12.0,6.0,11.0,7.0,8.0,11.0,14.0,13.0,12.0,12.0,20.0,13.0,12.0,8.0,10.0,7.0,10.0,8.0,10.0,7.0,14.0,14.0,12.0,13.0,11.0,11.0,10.0,17.0,6.0,31.0,1.0,0.0,0.0,0.0,178.0,74.0,1.0,3.0,2.0,2.0,2.0,1.0,2.0,2.0,3.0,1.0,3.0,12.0,13.0,13.0,7.0,15.0,13.0,10.0,12.0,7.0,6.0,14.0,11.0,8.0,15.0,14.0,14.0,13.0,13.0,12.0,13.0,13.0,15.0,14.0,10.0,12.0,10.0,10.0,12.0,12.0,13.0,14.0,10.0,10.0,15.0,12.0,20.0,14.0,12.0,11.0,14.0,14.0,6.0,14.0,12.0,14.0,10.0,12.0,13.0,10.0,6.0,14.0,25.0,19.0,6.0,0.0,0.0,182.0,78.0,1.0,4.0,3.0,1.0,2.0,1.0,2.0,2.0,4.0,1.0,4.0,16.0,13.0,12.0,11.0,12.0,13.0,8.0,12.0,5.0,5.0,13.0,13.0,5.0,15.0,11.0,12.0,12.0,13.0,12.0,15.0,12.0,15.0,14.0,6.0,15.0,9.0,11.0,14.0,15.0,14.0,14.0,10.0,11.0,11.0,14.0,20.0,12.0,13.0,10.0,11.0,15.0,5.0,12.0,10.0,15.0,16.0,11.0,13.0,16.0,16.0,7.0,22.0,0.0,0.0,0.0,0.0,178.0,71.0,3.0,1.0,1.0,1.0,4.0,1.0,1.0,1.0,4.0,1.0,3.0,10.0,11.0,12.0,7.0,13.0,11.0,7.0,11.0,5.0,8.0,14.0,8.0,8.0,14.0,9.0,13.0,12.0,13.0,11.0,13.0,12.0,16.0,8.0,11.0,10.0,11.0,15.0,14.0,10.0,14.0,12.0,9.0,8.0,14.0,8.0,20.0,14.0,11.0,14.0,9.0,10.0,7.0,12.0,20.0,12.0,15.0,12.0,11.0,14.0,14.0,6.0
3,1,26.0,2.0,0.0,1.0,0.0,188.0,84.0,12.0,13.0,15.0,9.0,15.0,13.0,13.0,15.0,10.0,11.0,14.0,9.0,2.0,1.0,2.0,12.0,11.0,3.0,2.0,3.0,3.0,11.0,3.0,1.0,10.0,14.0,13.0,14.0,10.0,13.0,11.0,11.0,14.0,3.0,11.0,5.0,12.0,15.0,13.0,10.0,12.0,13.0,14.0,5.0,14.0,9.0,20.0,12.0,14.0,12.0,10.0,15.0,3.0,11.0,12.0,11.0,16.0,13.0,15.0,16.0,16.0,4.0,29.0,0.0,0.0,0.0,0.0,183.0,74.0,3.0,3.0,3.0,3.0,3.0,2.0,2.0,2.0,1.0,3.0,1.0,5.0,12.0,7.0,6.0,10.0,7.0,14.0,12.0,5.0,14.0,12.0,6.0,13.0,11.0,14.0,13.0,17.0,13.0,16.0,12.0,12.0,13.0,9.0,8.0,9.0,14.0,14.0,15.0,13.0,12.0,15.0,12.0,6.0,17.0,11.0,20.0,17.0,13.0,14.0,14.0,15.0,5.0,13.0,9.0,14.0,19.0,15.0,14.0,11.0,11.0,6.0,32.0,0.0,0.0,0.0,0.0,183.0,79.0,1.0,1.0,1.0,3.0,1.0,3.0,1.0,1.0,2.0,1.0,1.0,5.0,10.0,6.0,6.0,9.0,6.0,15.0,7.0,11.0,14.0,10.0,7.0,13.0,10.0,13.0,15.0,15.0,15.0,14.0,9.0,13.0,16.0,6.0,14.0,8.0,12.0,13.0,16.0,11.0,12.0,16.0,11.0,8.0,16.0,12.0,20.0,15.0,14.0,14.0,11.0,12.0,5.0,15.0,18.0,15.0,14.0,13.0,17.0,14.0,14.0,5.0,22.0,0.0,0.0,0.0,0.0,178.0,73.0,3.0,2.0,2.0,1.0,2.0,4.0,3.0,1.0,3.0,1.0,2.0,6.0,12.0,12.0,6.0,11.0,7.0,8.0,8.0,11.0,12.0,10.0,8.0,13.0,11.0,12.0,12.0,13.0,11.0,10.0,11.0,11.0,13.0,6.0,7.0,12.0,9.0,13.0,14.0,16.0,14.0,13.0,9.0,6.0,14.0,15.0,20.0,15.0,14.0,12.0,12.0,13.0,6.0,14.0,12.0,15.0,13.0,13.0,14.0,14.0,14.0,6.0,30.0,0.0,0.0,0.0,0.0,182.0,71.0,3.0,2.0,1.0,3.0,3.0,2.0,3.0,2.0,1.0,2.0,1.0,5.0,12.0,12.0,7.0,12.0,7.0,13.0,7.0,11.0,12.0,11.0,6.0,13.0,13.0,14.0,13.0,14.0,8.0,12.0,9.0,11.0,14.0,11.0,9.0,11.0,10.0,13.0,15.0,14.0,13.0,14.0,11.0,8.0,13.0,13.0,20.0,14.0,14.0,13.0,14.0,14.0,10.0,8.0,12.0,13.0,13.0,12.0,14.0,11.0,11.0,7.0,32.0,0.0,0.0,13.0,0.0,175.0,65.0,2.0,1.0,1.0,2.0,3.0,3.0,1.0,2.0,3.0,2.0,3.0,15.0,13.0,11.0,6.0,14.0,13.0,10.0,12.0,8.0,8.0,16.0,8.0,12.0,13.0,11.0,14.0,15.0,14.0,15.0,14.0,14.0,14.0,6.0,13.0,9.0,15.0,18.0,13.0,12.0,13.0,13.0,8.0,8.0,13.0,10.0,20.0,13.0,13.0,12.0,11.0,15.0,12.0,10.0,17.0,14.0,15.0,14.0,16.0,14.0,14.0,6.0,25.0,5.0,0.0,5.0,0.0,186.0,72.0,1.0,2.0,1.0,2.0,2.0,3.0,3.0,3.0,3.0,3.0,2.0,13.0,12.0,14.0,9.0,16.0,15.0,11.0,12.0,5.0,8.0,16.0,11.0,10.0,15.0,8.0,13.0,11.0,14.0,13.0,15.0,14.0,15.0,14.0,11.0,13.0,10.0,12.0,12.0,13.0,14.0,14.0,10.0,10.0,13.0,11.0,20.0,11.0,11.0,13.0,9.0,15.0,13.0,7.0,15.0,17.0,14.0,13.0,15.0,15.0,15.0,7.0,25.0,0.0,0.0,3.0,2.0,170.0,61.0,2.0,3.0,2.0,2.0,1.0,3.0,2.0,2.0,1.0,2.0,1.0,11.0,12.0,13.0,10.0,13.0,8.0,5.0,8.0,7.0,4.0,14.0,10.0,4.0,15.0,11.0,10.0,9.0,7.0,10.0,14.0,8.0,13.0,13.0,6.0,12.0,8.0,8.0,12.0,16.0,14.0,7.0,5.0,12.0,15.0,16.0,20.0,14.0,6.0,12.0,11.0,13.0,8.0,8.0,8.0,13.0,15.0,10.0,10.0,14.0,14.0,8.0,18.0,0.0,0.0,0.0,0.0,179.0,67.0,3.0,3.0,2.0,4.0,2.0,4.0,3.0,1.0,3.0,4.0,1.0,5.0,7.0,12.0,9.0,12.0,12.0,10.0,12.0,6.0,4.0,12.0,12.0,3.0,14.0,11.0,12.0,11.0,11.0,8.0,13.0,12.0,12.0,12.0,6.0,12.0,5.0,10.0,12.0,15.0,11.0,12.0,10.0,20.0,13.0,14.0,8.0,14.0,8.0,9.0,6.0,14.0,5.0,10.0,16.0,13.0,12.0,12.0,13.0,9.0,15.0,2.0,18.0,0.0,0.0,0.0,0.0,188.0,80.0,1.0,3.0,1.0,3.0,2.0,3.0,3.0,1.0,2.0,2.0,4.0,6.0,8.0,12.0,11.0,12.0,7.0,13.0,10.0,4.0,4.0,8.0,10.0,5.0,12.0,11.0,11.0,13.0,10.0,11.0,11.0,12.0,11.0,13.0,7.0,13.0,8.0,13.0,13.0,11.0,12.0,12.0,12.0,10.0,12.0,11.0,20.0,10.0,12.0,12.0,8.0,11.0,7.0,13.0,8.0,13.0,13.0,11.0,12.0,12.0,13.0,7.0,30.0,5.0,0.0,22.0,9.0,181.0,84.0,2.0,3.0,3.0,1.0,2.0,3.0,3.0,1.0,3.0,1.0,3.0,7.0,10.0,12.0,13.0,11.0,7.0,13.0,10.0,12.0,6.0,11.0,13.0,6.0,13.0,17.0,13.0,16.0,11.0,13.0,11.0,11.0,17.0,14.0,8.0,14.0,9.0,13.0,17.0,15.0,12.0,15.0,11.0,8.0,14.0,15.0,20.0,14.0,14.0,13.0,9.0,13.0,7.0,10.0,7.0,16.0,13.0,14.0,13.0,15.0,15.0,10.0,20.0,0.0,0.0,0.0,0.0,192.0,80.0,14.0,9.0,9.0,11.0,12.0,11.0,14.0,12.0,10.0,12.0,12.0,4.0,3.0,3.0,1.0,8.0,7.0,7.0,2.0,2.0,2.0,8.0,2.0,3.0,6.0,10.0,8.0,11.0,10.0,9.0,9.0,9.0,13.0,8.0,12.0,2.0,10.0,11.0,11.0,13.0,14.0,15.0,17.0,5.0,14.0,12.0,20.0,12.0,15.0,10.0,10.0,11.0,7.0,1.0,11.0,13.0,13.0,12.0,12.0,15.0,14.0,9.0,23.0,0.0,0.0,0.0,0.0,184.0,77.0,1.0,1.0,1.0,1.0,3.0,2.0,3.0,2.0,2.0,2.0,3.0,6.0,9.0,11.0,7.0,12.0,7.0,15.0,9.0,11.0,14.0,13.0,10.0,15.0,12.0,14.0,15.0,15.0,13.0,12.0,11.0,13.0,15.0,11.0,9.0,9.0,14.0,14.0,14.0,14.0,13.0,15.0,13.0,9.0,16.0,15.0,20.0,14.0,14.0,14.0,11.0,14.0,4.0,11.0,14.0,13.0,15.0,14.0,16.0,14.0,15.0,6.0,28.0,46.0,3.0,14.0,3.0,190.0,80.0,2.0,3.0,3.0,2.0,2.0,1.0,1.0,3.0,1.0,3.0,1.0,4.0,6.0,7.0,9.0,11.0,7.0,17.0,11.0,10.0,15.0,12.0,11.0,16.0,10.0,17.0,15.0,18.0,13.0,14.0,12.0,14.0,18.0,6.0,17.0,8.0,15.0,15.0,14.0,11.0,10.0,17.0,16.0,7.0,17.0,13.0,20.0,15.0,18.0,17.0,14.0,16.0,4.0,6.0,14.0,15.0,16.0,17.0,18.0,14.0,15.0,6.0,32.0,0.0,0.0,0.0,0.0,185.0,79.0,2.0,1.0,1.0,1.0,1.0,1.0,3.0,3.0,3.0,3.0,3.0,7.0,8.0,7.0,8.0,12.0,5.0,16.0,8.0,10.0,12.0,12.0,8.0,12.0,8.0,12.0,12.0,14.0,11.0,12.0,11.0,12.0,10.0,7.0,12.0,7.0,15.0,13.0,17.0,9.0,10.0,10.0,14.0,20.0,14.0,10.0,5.0,13.0,12.0,12.0,11.0,10.0,7.0,9.0,7.0,10.0,9.0,11.0,10.0,10.0,15.0,8.0,20.0,0.0,0.0,0.0,0.0,184.0,80.0,1.0,4.0,4.0,1.0,3.0,1.0,4.0,3.0,3.0,3.0,2.0,7.0,14.0,13.0,8.0,12.0,7.0,16.0,7.0,12.0,13.0,13.0,11.0,12.0,13.0,12.0,13.0,14.0,13.0,12.0,12.0,12.0,15.0,12.0,10.0,14.0,13.0,14.0,13.0,14.0,12.0,14.0,12.0,6.0,13.0,14.0,20.0,13.0,14.0,14.0,8.0,15.0,10.0,13.0,9.0,16.0,15.0,14.0,16.0,16.0,17.0,5.0,19.0,0.0,0.0,12.0,4.0,177.0,75.0,2.0,1.0,1.0,1.0,2.0,2.0,3.0,1.0,1.0,3.0,3.0,11.0,12.0,13.0,8.0,15.0,11.0,5.0,12.0,8.0,5.0,15.0,16.0,8.0,16.0,10.0,12.0,14.0,13.0,13.0,13.0,11.0,10.0,15.0,9.0,12.0,5.0,10.0,7.0,13.0,15.0,7.0,9.0,14.0,13.0,13.0,20.0,11.0,6.0,12.0,11.0,13.0,5.0,11.0,12.0,15.0,16.0,14.0,12.0,15.0,15.0,5.0,29.0,90.0,4.0,16.0,2.0,170.0,61.0,2.0,3.0,3.0,1.0,3.0,1.0,2.0,2.0,2.0,2.0,1.0,15.0,14.0,15.0,9.0,17.0,16.0,7.0,12.0,4.0,11.0,18.0,15.0,12.0,17.0,15.0,15.0,16.0,13.0,16.0,17.0,14.0,16.0,15.0,14.0,12.0,14.0,18.0,16.0,13.0,14.0,12.0,8.0,10.0,14.0,11.0,20.0,14.0,10.0,14.0,9.0,17.0,10.0,14.0,13.0,17.0,15.0,16.0,17.0,15.0,16.0,7.0,31.0,0.0,0.0,6.0,0.0,174.0,80.0,1.0,1.0,1.0,1.0,1.0,5.0,1.0,1.0,1.0,1.0,1.0,14.0,12.0,11.0,7.0,12.0,13.0,9.0,7.0,10.0,11.0,11.0,10.0,10.0,12.0,11.0,11.0,11.0,10.0,6.0,10.0,9.0,12.0,12.0,12.0,10.0,12.0,12.0,14.0,12.0,15.0,10.0,9.0,20.0,12.0,12.0,7.0,12.0,9.0,9.0,10.0,12.0,7.0,9.0,11.0,14.0,9.0,7.0,14.0,8.0,9.0,9.0,20.0,0.0,0.0,7.0,1.0,170.0,58.0,1.0,2.0,2.0,2.0,2.0,2.0,2.0,4.0,1.0,3.0,2.0,16.0,14.0,16.0,13.0,16.0,17.0,5.0,14.0,2.0,6.0,15.0,13.0,4.0,17.0,9.0,12.0,14.0,12.0,12.0,14.0,13.0,15.0,16.0,7.0,13.0,9.0,13.0,15.0,15.0,16.0,11.0,7.0,20.0,14.0,15.0,8.0,14.0,8.0,15.0,5.0,15.0,7.0,16.0,15.0,15.0,15.0,14.0,16.0,18.0,16.0,3.0,20.0,0.0,0.0,10.0,1.0,174.0,68.0,1.0,3.0,3.0,3.0,2.0,3.0,3.0,2.0,1.0,2.0,2.0,11.0,12.0,15.0,11.0,14.0,12.0,6.0,12.0,2.0,4.0,14.0,11.0,4.0,15.0,9.0,11.0,10.0,12.0,11.0,14.0,12.0,14.0,14.0,7.0,13.0,7.0,11.0,13.0,14.0,15.0,13.0,7.0,20.0,12.0,14.0,10.0,13.0,9.0,12.0,7.0,12.0,10.0,12.0,15.0,16.0,12.0,14.0,13.0,15.0,15.0,5.0,19.0,0.0,0.0,0.0,0.0,185.0,65.0,1.0,3.0,4.0,2.0,1.0,3.0,3.0,1.0,3.0,3.0,1.0,4.0,12.0,12.0,9.0,11.0,8.0,12.0,10.0,6.0,4.0,10.0,12.0,6.0,13.0,8.0,11.0,11.0,11.0,11.0,10.0,11.0,11.0,13.0,7.0,13.0,7.0,11.0,13.0,14.0,12.0,14.0,14.0,20.0,13.0,15.0,8.0,12.0,8.0,11.0,8.0,12.0,8.0,11.0,7.0,12.0,9.0,12.0,12.0,13.0,15.0,5.0
1,1,33.0,70.0,0.0,0.0,0.0,185.0,81.0,12.0,9.0,11.0,10.0,11.0,11.0,12.0,15.0,10.0,15.0,8.0,6.0,2.0,8.0,1.0,12.0,8.0,10.0,1.0,2.0,1.0,2.0,1.0,3.0,11.0,10.0,9.0,13.0,11.0,15.0,9.0,11.0,15.0,2.0,10.0,1.0,12.0,17.0,9.0,7.0,14.0,13.0,14.0,10.0,7.0,9.0,20.0,11.0,10.0,14.0,11.0,13.0,6.0,11.0,18.0,18.0,10.0,10.0,17.0,14.0,12.0,2.0,24.0,0.0,0.0,0.0,0.0,175.0,68.0,4.0,3.0,3.0,4.0,1.0,3.0,2.0,2.0,3.0,3.0,1.0,8.0,12.0,11.0,7.0,11.0,8.0,9.0,12.0,13.0,11.0,11.0,7.0,12.0,13.0,12.0,11.0,14.0,12.0,11.0,10.0,12.0,14.0,6.0,8.0,13.0,12.0,14.0,14.0,13.0,13.0,10.0,6.0,12.0,14.0,13.0,20.0,14.0,9.0,13.0,6.0,12.0,5.0,15.0,15.0,10.0,10.0,13.0,14.0,15.0,13.0,4.0,26.0,1.0,0.0,0.0,0.0,185.0,80.0,3.0,1.0,3.0,3.0,3.0,3.0,2.0,3.0,4.0,2.0,1.0,5.0,9.0,11.0,8.0,11.0,6.0,12.0,8.0,10.0,15.0,11.0,12.0,14.0,12.0,16.0,12.0,17.0,14.0,9.0,9.0,10.0,15.0,13.0,9.0,7.0,10.0,8.0,12.0,15.0,13.0,17.0,14.0,8.0,13.0,18.0,20.0,13.0,14.0,11.0,12.0,11.0,4.0,10.0,12.0,12.0,13.0,10.0,10.0,8.0,7.0,14.0,29.0,0.0,0.0,0.0,0.0,170.0,66.0,1.0,1.0,1.0,1.0,4.0,3.0,1.0,2.0,3.0,1.0,1.0,11.0,13.0,12.0,7.0,12.0,10.0,7.0,12.0,9.0,13.0,12.0,8.0,12.0,13.0,14.0,11.0,15.0,12.0,14.0,10.0,12.0,14.0,12.0,10.0,13.0,8.0,13.0,15.0,14.0,13.0,10.0,7.0,20.0,15.0,13.0,10.0,15.0,7.0,14.0,14.0,14.0,6.0,16.0,9.0,13.0,14.0,14.0,16.0,11.0,9.0,9.0,20.0,0.0,0.0,0.0,0.0,190.0,80.0,2.0,2.0,1.0,4.0,2.0,2.0,3.0,4.0,2.0,2.0,1.0,12.0,12.0,10.0,9.0,11.0,7.0,12.0,8.0,12.0,10.0,10.0,9.0,12.0,11.0,13.0,11.0,13.0,11.0,12.0,8.0,11.0,11.0,7.0,8.0,10.0,10.0,13.0,12.0,13.0,12.0,12.0,15.0,20.0,13.0,14.0,6.0,13.0,14.0,12.0,6.0,10.0,5.0,13.0,16.0,13.0,9.0,12.0,10.0,10.0,11.0,4.0,27.0,27.0,1.0,2.0,1.0,183.0,72.0,2.0,2.0,2.0,1.0,2.0,1.0,3.0,1.0,2.0,2.0,4.0,5.0,8.0,10.0,6.0,11.0,10.0,14.0,11.0,5.0,14.0,12.0,10.0,15.0,11.0,14.0,13.0,16.0,11.0,11.0,9.0,10.0,12.0,8.0,12.0,8.0,13.0,14.0,14.0,14.0,12.0,16.0,11.0,8.0,12.0,13.0,20.0,15.0,15.0,10.0,14.0,11.0,7.0,11.0,13.0,13.0,9.0,9.0,11.0,10.0,10.0,8.0,24.0,0.0,0.0,0.0,0.0,174.0,68.0,3.0,1.0,3.0,1.0,1.0,2.0,1.0,3.0,1.0,1.0,1.0,13.0,12.0,12.0,10.0,13.0,13.0,8.0,13.0,10.0,6.0,14.0,12.0,7.0,13.0,9.0,13.0,11.0,13.0,11.0,13.0,13.0,12.0,11.0,7.0,12.0,9.0,12.0,12.0,14.0,13.0,12.0,8.0,8.0,14.0,12.0,20.0,13.0,10.0,13.0,10.0,13.0,7.0,12.0,14.0,14.0,15.0,9.0,11.0,13.0,12.0,8.0,31.0,0.0,0.0,0.0,0.0,180.0,74.0,3.0,2.0,3.0,1.0,2.0,3.0,2.0,1.0,4.0,3.0,3.0,12.0,12.0,10.0,9.0,13.0,14.0,11.0,13.0,6.0,10.0,14.0,15.0,13.0,13.0,15.0,14.0,17.0,12.0,14.0,13.0,13.0,15.0,7.0,13.0,10.0,13.0,18.0,15.0,9.0,11.0,14.0,10.0,10.0,13.0,12.0,20.0,15.0,14.0,14.0,13.0,15.0,8.0,7.0,19.0,13.0,13.0,13.0,13.0,13.0,12.0,9.0,27.0,0.0,0.0,11.0,1.0,174.0,72.0,2.0,3.0,4.0,1.0,1.0,4.0,3.0,3.0,3.0,3.0,1.0,10.0,13.0,14.0,8.0,14.0,7.0,6.0,11.0,5.0,6.0,13.0,10.0,5.0,14.0,7.0,12.0,10.0,10.0,12.0,9.0,12.0,12.0,12.0,4.0,14.0,6.0,9.0,13.0,16.0,14.0,10.0,6.0,9.0,13.0,16.0,20.0,12.0,9.0,14.0,6.0,11.0,7.0,10.0,10.0,13.0,12.0,11.0,14.0,14.0,16.0,8.0,26.0,0.0,0.0,15.0,6.0,182.0,80.0,1.0,4.0,1.0,3.0,1.0,3.0,3.0,1.0,2.0,1.0,3.0,5.0,9.0,11.0,12.0,10.0,9.0,13.0,10.0,5.0,4.0,9.0,13.0,6.0,12.0,9.0,12.0,12.0,12.0,12.0,11.0,12.0,12.0,13.0,8.0,13.0,10.0,12.0,12.0,16.0,15.0,12.0,12.0,7.0,14.0,16.0,20.0,12.0,15.0,12.0,6.0,12.0,7.0,10.0,11.0,11.0,13.0,8.0,12.0,14.0,14.0,7.0,28.0,0.0,0.0,2.0,2.0,182.0,79.0,1.0,1.0,2.0,2.0,3.0,1.0,2.0,3.0,1.0,2.0,2.0,8.0,11.0,14.0,12.0,14.0,11.0,12.0,13.0,6.0,4.0,11.0,13.0,5.0,14.0,11.0,12.0,13.0,10.0,12.0,11.0,11.0,15.0,13.0,7.0,14.0,7.0,12.0,14.0,15.0,14.0,14.0,12.0,8.0,15.0,14.0,20.0,15.0,14.0,12.0,11.0,15.0,8.0,8.0,16.0,15.0,12.0,11.0,14.0,13.0,12.0,8.0,36.0,0.0,0.0,0.0,0.0,185.0,78.0,11.0,14.0,12.0,7.0,13.0,12.0,14.0,15.0,13.0,14.0,10.0,4.0,1.0,3.0,1.0,8.0,8.0,11.0,8.0,3.0,3.0,7.0,2.0,1.0,8.0,11.0,13.0,15.0,11.0,12.0,7.0,13.0,9.0,5.0,14.0,3.0,13.0,15.0,8.0,11.0,14.0,13.0,12.0,5.0,15.0,11.0,20.0,12.0,14.0,13.0,11.0,13.0,8.0,1.0,19.0,14.0,16.0,10.0,17.0,9.0,9.0,11.0,28.0,8.0,0.0,1.0,0.0,182.0,79.0,1.0,1.0,3.0,2.0,4.0,1.0,3.0,3.0,1.0,1.0,3.0,5.0,9.0,9.0,9.0,11.0,6.0,13.0,8.0,12.0,14.0,9.0,8.0,14.0,11.0,14.0,14.0,15.0,10.0,13.0,7.0,12.0,16.0,8.0,8.0,9.0,14.0,13.0,14.0,15.0,12.0,13.0,11.0,5.0,13.0,14.0,20.0,15.0,14.0,12.0,14.0,13.0,7.0,15.0,11.0,13.0,10.0,13.0,10.0,11.0,12.0,5.0,28.0,0.0,0.0,0.0,0.0,183.0,81.0,1.0,2.0,4.0,1.0,1.0,3.0,2.0,3.0,3.0,3.0,1.0,5.0,5.0,6.0,10.0,12.0,6.0,14.0,8.0,6.0,15.0,11.0,6.0,13.0,12.0,13.0,14.0,16.0,14.0,14.0,10.0,12.0,14.0,5.0,14.0,8.0,14.0,15.0,15.0,9.0,12.0,15.0,13.0,7.0,11.0,12.0,20.0,15.0,15.0,14.0,14.0,14.0,9.0,8.0,14.0,14.0,11.0,13.0,15.0,13.0,15.0,6.0,21.0,0.0,0.0,0.0,0.0,182.0,74.0,2.0,2.0,2.0,2.0,2.0,1.0,1.0,1.0,3.0,2.0,2.0,9.0,11.0,12.0,7.0,9.0,8.0,12.0,7.0,11.0,12.0,7.0,8.0,13.0,11.0,12.0,12.0,14.0,12.0,13.0,7.0,12.0,11.0,1.0,9.0,11.0,9.0,10.0,12.0,14.0,10.0,13.0,11.0,9.0,8.0,12.0,20.0,13.0,11.0,10.0,13.0,8.0,10.0,10.0,15.0,11.0,13.0,10.0,10.0,8.0,13.0,7.0,21.0,0.0,0.0,1.0,0.0,177.0,68.0,4.0,1.0,2.0,1.0,1.0,1.0,1.0,1.0,2.0,1.0,2.0,5.0,12.0,9.0,7.0,12.0,8.0,13.0,10.0,16.0,13.0,12.0,8.0,14.0,12.0,12.0,13.0,12.0,12.0,12.0,10.0,13.0,15.0,11.0,13.0,11.0,13.0,13.0,14.0,13.0,14.0,13.0,11.0,10.0,14.0,12.0,20.0,12.0,14.0,12.0,11.0,12.0,8.0,14.0,13.0,10.0,14.0,12.0,14.0,12.0,11.0,5.0,24.0,10.0,0.0,0.0,0.0,180.0,73.0,3.0,2.0,3.0,1.0,1.0,1.0,1.0,3.0,3.0,3.0,2.0,5.0,10.0,8.0,5.0,8.0,6.0,13.0,8.0,6.0,14.0,12.0,6.0,13.0,10.0,12.0,13.0,13.0,11.0,12.0,9.0,12.0,14.0,1.0,7.0,7.0,12.0,12.0,13.0,15.0,11.0,13.0,10.0,5.0,15.0,14.0,20.0,12.0,14.0,12.0,12.0,11.0,8.0,11.0,8.0,11.0,9.0,15.0,12.0,11.0,19.0,6.0,18.0,2.0,0.0,0.0,0.0,179.0,71.0,2.0,1.0,2.0,1.0,2.0,2.0,4.0,4.0,1.0,2.0,2.0,4.0,6.0,1.0,4.0,11.0,6.0,13.0,6.0,4.0,10.0,7.0,1.0,13.0,7.0,9.0,8.0,8.0,6.0,7.0,5.0,13.0,9.0,9.0,6.0,2.0,11.0,7.0,11.0,11.0,11.0,7.0,8.0,5.0,9.0,10.0,20.0,13.0,6.0,8.0,9.0,9.0,9.0,9.0,14.0,12.0,10.0,12.0,12.0,12.0,14.0,3.0,19.0,0.0,0.0,0.0,0.0,171.0,70.0,2.0,3.0,2.0,1.0,1.0,1.0,2.0,1.0,2.0,3.0,1.0,11.0,11.0,12.0,11.0,11.0,11.0,9.0,11.0,7.0,9.0,13.0,4.0,9.0,13.0,4.0,10.0,10.0,11.0,11.0,14.0,12.0,13.0,13.0,14.0,11.0,11.0,12.0,12.0,12.0,11.0,11.0,9.0,20.0,10.0,12.0,10.0,11.0,11.0,13.0,8.0,12.0,9.0,10.0,10.0,13.0,14.0,12.0,11.0,12.0,12.0,9.0,33.0,0.0,0.0,0.0,0.0,187.0,76.0,2.0,2.0,3.0,1.0,1.0,3.0,2.0,1.0,2.0,3.0,2.0,15.0,14.0,14.0,10.0,15.0,13.0,10.0,12.0,7.0,4.0,15.0,13.0,7.0,15.0,6.0,12.0,9.0,14.0,11.0,15.0,12.0,12.0,14.0,12.0,13.0,7.0,13.0,12.0,11.0,12.0,14.0,12.0,14.0,15.0,12.0,20.0,11.0,12.0,12.0,6.0,14.0,6.0,11.0,14.0,13.0,12.0,12.0,15.0,15.0,13.0,9.0,21.0,0.0,0.0,4.0,1.0,184.0,79.0,1.0,2.0,3.0,1.0,2.0,1.0,3.0,2.0,2.0,1.0,3.0,3.0,6.0,10.0,12.0,12.0,7.0,15.0,8.0,4.0,5.0,13.0,10.0,8.0,12.0,18.0,12.0,19.0,13.0,10.0,13.0,12.0,14.0,13.0,10.0,12.0,9.0,16.0,15.0,12.0,14.0,14.0,14.0,12.0,13.0,10.0,20.0,14.0,14.0,11.0,14.0,14.0,11.0,5.0,10.0,13.0,14.0,15.0,10.0,8.0,4.0,15.0,26.0,0.0,0.0,0.0,0.0,193.0,81.0,1.0,3.0,3.0,3.0,3.0,1.0,2.0,2.0,2.0,3.0,3.0,4.0,9.0,14.0,10.0,13.0,12.0,14.0,14.0,5.0,5.0,10.0,12.0,3.0,14.0,8.0,13.0,12.0,9.0,10.0,11.0,11.0,12.0,16.0,5.0,14.0,6.0,9.0,12.0,14.0,13.0,14.0,16.0,14.0,13.0,13.0,20.0,13.0,14.0,10.0,8.0,14.0,9.0,8.0,16.0,16.0,11.0,13.0,11.0,13.0,13.0,10.0
2,0,25.0,4.0,0.0,11.0,0.0,184.0,81.0,14.0,14.0,13.0,9.0,15.0,12.0,16.0,16.0,13.0,7.0,11.0,8.0,1.0,2.0,1.0,11.0,12.0,6.0,1.0,3.0,3.0,11.0,5.0,3.0,11.0,8.0,15.0,15.0,13.0,14.0,10.0,11.0,14.0,8.0,13.0,5.0,13.0,10.0,10.0,14.0,16.0,14.0,13.0,20.0,14.0,12.0,5.0,14.0,14.0,15.0,9.0,16.0,6.0,1.0,17.0,11.0,15.0,13.0,14.0,12.0,12.0,4.0,27.0,0.0,0.0,0.0,0.0,184.0,81.0,1.0,1.0,1.0,3.0,3.0,2.0,2.0,2.0,1.0,2.0,3.0,8.0,6.0,8.0,12.0,10.0,8.0,12.0,9.0,1.0,3.0,8.0,14.0,4.0,9.0,4.0,11.0,12.0,11.0,8.0,8.0,11.0,10.0,9.0,8.0,11.0,9.0,8.0,11.0,10.0,8.0,13.0,13.0,9.0,13.0,9.0,20.0,12.0,13.0,13.0,9.0,2.0,9.0,9.0,15.0,10.0,12.0,10.0,11.0,6.0,4.0,6.0,32.0,0.0,0.0,0.0,0.0,172.0,71.0,2.0,1.0,3.0,1.0,2.0,3.0,2.0,3.0,2.0,2.0,2.0,8.0,9.0,7.0,6.0,10.0,6.0,10.0,9.0,10.0,14.0,11.0,6.0,14.0,11.0,10.0,16.0,15.0,12.0,12.0,7.0,12.0,15.0,9.0,13.0,8.0,14.0,15.0,15.0,14.0,14.0,14.0,10.0,20.0,14.0,14.0,8.0,15.0,13.0,13.0,11.0,13.0,7.0,13.0,17.0,14.0,17.0,8.0,13.0,15.0,15.0,6.0,21.0,0.0,0.0,0.0,0.0,179.0,68.0,2.0,3.0,2.0,1.0,2.0,1.0,2.0,3.0,2.0,1.0,1.0,6.0,13.0,12.0,6.0,13.0,6.0,8.0,7.0,12.0,10.0,12.0,8.0,12.0,13.0,10.0,11.0,11.0,12.0,10.0,11.0,11.0,12.0,11.0,7.0,13.0,10.0,12.0,14.0,15.0,13.0,12.0,10.0,20.0,14.0,14.0,8.0,14.0,10.0,13.0,8.0,13.0,8.0,12.0,13.0,14.0,10.0,12.0,10.0,10.0,12.0,10.0,37.0,0.0,0.0,0.0,0.0,185.0,83.0,1.0,1.0,2.0,1.0,3.0,2.0,3.0,1.0,1.0,3.0,1.0,6.0,8.0,9.0,12.0,10.0,8.0,13.0,9.0,4.0,5.0,10.0,14.0,4.0,11.0,11.0,10.0,11.0,13.0,12.0,12.0,13.0,15.0,14.0,12.0,11.0,7.0,12.0,8.0,7.0,7.0,12.0,12.0,11.0,11.0,7.0,20.0,8.0,14.0,12.0,8.0,13.0,9.0,12.0,12.0,12.0,19.0,14.0,15.0,14.0,8.0,8.0,19.0,0.0,0.0,0.0,0.0,185.0,82.0,4.0,2.0,3.0,1.0,3.0,2.0,1.0,2.0,1.0,2.0,3.0,7.0,7.0,10.0,6.0,13.0,7.0,14.0,7.0,6.0,12.0,13.0,7.0,13.0,13.0,13.0,13.0,13.0,11.0,12.0,11.0,12.0,14.0,9.0,14.0,11.0,11.0,15.0,15.0,12.0,12.0,14.0,13.0,5.0,14.0,12.0,20.0,14.0,13.0,10.0,11.0,11.0,6.0,10.0,10.0,12.0,12.0,14.0,14.0,11.0,16.0,6.0,19.0,0.0,0.0,0.0,0.0,175.0,67.0,3.0,2.0,1.0,3.0,3.0,1.0,1.0,1.0,2.0,1.0,3.0,7.0,8.0,12.0,8.0,10.0,6.0,12.0,9.0,8.0,10.0,10.0,8.0,12.0,11.0,14.0,10.0,12.0,9.0,10.0,11.0,10.0,12.0,12.0,10.0,12.0,12.0,13.0,14.0,13.0,11.0,14.0,8.0,6.0,14.0,12.0,20.0,14.0,12.0,12.0,8.0,11.0,6.0,12.0,17.0,13.0,10.0,11.0,12.0,11.0,17.0,5.0,18.0,0.0,0.0,0.0,0.0,170.0,67.0,3.0,1.0,3.0,3.0,3.0,4.0,1.0,2.0,1.0,2.0,2.0,11.0,11.0,12.0,13.0,12.0,11.0,6.0,10.0,8.0,7.0,12.0,10.0,7.0,13.0,9.0,11.0,8.0,10.0,10.0,12.0,12.0,15.0,12.0,12.0,11.0,12.0,11.0,12.0,12.0,12.0,10.0,6.0,5.0,14.0,12.0,20.0,10.0,9.0,10.0,8.0,2.0,6.0,12.0,11.0,11.0,12.0,13.0,14.0,11.0,13.0,4.0,22.0,24.0,3.0,7.0,0.0,177.0,78.0,2.0,1.0,2.0,3.0,2.0,2.0,4.0,3.0,3.0,2.0,1.0,10.0,13.0,16.0,14.0,16.0,16.0,8.0,16.0,4.0,4.0,15.0,12.0,4.0,16.0,12.0,11.0,12.0,13.0,10.0,11.0,8.0,13.0,17.0,5.0,14.0,5.0,10.0,12.0,15.0,14.0,13.0,9.0,10.0,17.0,16.0,20.0,15.0,14.0,12.0,11.0,15.0,4.0,12.0,19.0,16.0,14.0,14.0,11.0,13.0,10.0,12.0,20.0,29.0,2.0,0.0,0.0,181.0,75.0,1.0,1.0,2.0,2.0,2.0,3.0,2.0,1.0,1.0,3.0,2.0,5.0,9.0,15.0,10.0,11.0,9.0,10.0,8.0,7.0,3.0,10.0,10.0,5.0,15.0,7.0,10.0,9.0,12.0,10.0,8.0,11.0,14.0,12.0,5.0,13.0,5.0,11.0,12.0,16.0,12.0,9.0,12.0,20.0,14.0,16.0,7.0,12.0,10.0,9.0,10.0,10.0,11.0,6.0,10.0,15.0,9.0,13.0,11.0,14.0,18.0,7.0,22.0,5.0,1.0,1.0,0.0,173.0,72.0,1.0,3.0,1.0,3.0,3.0,3.0,3.0,3.0,3.0,2.0,2.0,14.0,13.0,16.0,14.0,16.0,14.0,5.0,11.0,5.0,5.0,15.0,11.0,5.0,16.0,8.0,13.0,9.0,14.0,13.0,15.0,13.0,15.0,16.0,5.0,13.0,5.0,9.0,10.0,15.0,16.0,14.0,5.0,20.0,14.0,15.0,5.0,12.0,14.0,13.0,11.0,13.0,8.0,14.0,10.0,15.0,14.0,10.0,13.0,10.0,10.0,13.0,30.0,42.0,0.0,13.0,0.0,195.0,88.0,16.0,13.0,14.0,6.0,14.0,13.0,13.0,15.0,12.0,10.0,14.0,1.0,8.0,5.0,2.0,8.0,2.0,8.0,2.0,5.0,3.0,9.0,5.0,3.0,8.0,10.0,12.0,10.0,14.0,10.0,10.0,14.0,13.0,3.0,14.0,3.0,12.0,14.0,12.0,8.0,13.0,18.0,18.0,17.0,14.0,11.0,20.0,14.0,17.0,14.0,4.0,14.0,4.0,1.0,12.0,13.0,14.0,9.0,15.0,13.0,13.0,5.0,28.0,0.0,0.0,0.0,0.0,190.0,85.0,3.0,2.0,3.0,3.0,2.0,2.0,2.0,4.0,3.0,1.0,2.0,5.0,9.0,8.0,9.0,8.0,7.0,14.0,10.0,9.0,15.0,9.0,6.0,14.0,9.0,16.0,13.0,16.0,10.0,13.0,10.0,12.0,15.0,6.0,13.0,7.0,13.0,14.0,16.0,12.0,11.0,17.0,13.0,20.0,15.0,13.0,8.0,15.0,15.0,12.0,14.0,14.0,9.0,8.0,14.0,13.0,14.0,11.0,12.0,13.0,16.0,14.0,23.0,0.0,0.0,0.0,0.0,184.0,71.0,1.0,2.0,1.0,2.0,2.0,2.0,2.0,4.0,2.0,1.0,3.0,4.0,10.0,10.0,6.0,11.0,6.0,14.0,8.0,7.0,14.0,11.0,6.0,13.0,11.0,12.0,12.0,13.0,12.0,11.0,12.0,12.0,14.0,6.0,8.0,10.0,13.0,13.0,14.0,15.0,13.0,14.0,13.0,8.0,12.0,14.0,20.0,13.0,14.0,13.0,12.0,14.0,15.0,8.0,11.0,13.0,13.0,10.0,8.0,9.0,16.0,7.0,21.0,0.0,0.0,0.0,0.0,178.0,65.0,2.0,3.0,3.0,3.0,3.0,1.0,1.0,1.0,1.0,3.0,1.0,9.0,13.0,11.0,6.0,12.0,7.0,9.0,8.0,8.0,13.0,12.0,7.0,13.0,12.0,8.0,12.0,13.0,12.0,12.0,13.0,13.0,14.0,9.0,8.0,12.0,12.0,13.0,13.0,12.0,14.0,13.0,11.0,8.0,15.0,12.0,20.0,13.0,12.0,14.0,8.0,11.0,7.0,10.0,19.0,10.0,13.0,10.0,11.0,15.0,15.0,6.0,21.0,0.0,0.0,0.0,0.0,177.0,0.0,1.0,1.0,1.0,2.0,3.0,3.0,2.0,3.0,2.0,2.0,3.0,6.0,4.0,13.0,13.0,13.0,6.0,13.0,7.0,3.0,5.0,7.0,6.0,1.0,11.0,9.0,7.0,8.0,7.0,7.0,7.0,8.0,7.0,11.0,8.0,13.0,7.0,6.0,7.0,12.0,13.0,7.0,6.0,8.0,8.0,13.0,20.0,5.0,5.0,9.0,5.0,9.0,9.0,9.0,10.0,10.0,12.0,12.0,11.0,10.0,9.0,6.0,19.0,0.0,0.0,0.0,0.0,174.0,61.0,1.0,3.0,2.0,3.0,2.0,1.0,2.0,2.0,3.0,1.0,1.0,5.0,9.0,10.0,6.0,12.0,6.0,8.0,8.0,5.0,9.0,10.0,7.0,9.0,13.0,11.0,12.0,12.0,11.0,9.0,11.0,11.0,8.0,9.0,10.0,8.0,10.0,12.0,16.0,13.0,13.0,10.0,8.0,20.0,15.0,11.0,8.0,13.0,9.0,15.0,11.0,10.0,6.0,13.0,10.0,9.0,14.0,11.0,12.0,14.0,14.0,8.0,22.0,0.0,0.0,0.0,0.0,187.0,84.0,2.0,2.0,1.0,2.0,3.0,2.0,2.0,3.0,3.0,2.0,2.0,4.0,7.0,10.0,6.0,9.0,10.0,13.0,12.0,5.0,11.0,11.0,7.0,10.0,12.0,12.0,11.0,13.0,10.0,9.0,11.0,9.0,15.0,8.0,7.0,9.0,11.0,11.0,14.0,13.0,10.0,15.0,14.0,8.0,15.0,11.0,20.0,14.0,15.0,11.0,12.0,7.0,9.0,8.0,7.0,13.0,15.0,13.0,11.0,14.0,14.0,7.0,21.0,0.0,0.0,0.0,0.0,172.0,66.0,2.0,3.0,2.0,2.0,1.0,1.0,1.0,3.0,2.0,1.0,1.0,10.0,10.0,13.0,9.0,14.0,9.0,8.0,10.0,7.0,13.0,13.0,9.0,12.0,13.0,10.0,12.0,13.0,13.0,12.0,14.0,13.0,13.0,11.0,9.0,14.0,13.0,14.0,14.0,14.0,13.0,12.0,8.0,8.0,12.0,12.0,20.0,13.0,12.0,14.0,10.0,11.0,8.0,12.0,15.0,10.0,15.0,8.0,11.0,14.0,14.0,6.0,24.0,0.0,0.0,0.0,0.0,172.0,72.0,1.0,1.0,3.0,2.0,2.0,1.0,1.0,1.0,1.0,3.0,1.0,10.0,11.0,12.0,10.0,11.0,8.0,8.0,10.0,7.0,7.0,11.0,11.0,6.0,12.0,8.0,11.0,11.0,10.0,10.0,11.0,12.0,15.0,12.0,5.0,10.0,11.0,13.0,15.0,15.0,13.0,10.0,9.0,8.0,14.0,13.0,20.0,14.0,11.0,11.0,8.0,13.0,7.0,12.0,18.0,13.0,10.0,10.0,11.0,11.0,11.0,6.0,22.0,0.0,0.0,0.0,0.0,177.0,72.0,2.0,1.0,2.0,4.0,2.0,2.0,1.0,3.0,4.0,2.0,3.0,10.0,12.0,13.0,11.0,12.0,10.0,12.0,12.0,4.0,10.0,13.0,11.0,11.0,13.0,11.0,12.0,11.0,13.0,9.0,13.0,12.0,3.0,12.0,8.0,14.0,12.0,12.0,13.0,16.0,13.0,12.0,9.0,8.0,15.0,14.0,20.0,14.0,13.0,10.0,4.0,11.0,11.0,12.0,19.0,9.0,12.0,13.0,12.0,11.0,14.0,7.0,29.0,30.0,6.0,0.0,0.0,178.0,76.0,2.0,3.0,3.0,4.0,3.0,2.0,2.0,2.0,2.0,1.0,1.0,6.0,11.0,16.0,10.0,12.0,5.0,8.0,8.0,5.0,4.0,13.0,7.0,3.0,12.0,7.0,8.0,12.0,11.0,10.0,8.0,9.0,13.0,15.0,4.0,13.0,7.0,12.0,10.0,16.0,15.0,14.0,8.0,11.0,13.0,16.0,20.0,10.0,13.0,10.0,11.0,10.0,7.0,5.0,9.0,16.0,9.0,10.0,11.0,11.0,14.0,3.0
3,1,20.0,0.0,0.0,0.0,0.0,189.0,80.0,13.0,13.0,12.0,8.0,13.0,11.0,12.0,13.0,9.0,10.0,12.0,5.0,1.0,1.0,1.0,9.0,10.0,3.0,10.0,3.0,3.0,11.0,2.0,1.0,8.0,8.0,12.0,13.0,13.0,12.0,5.0,16.0,11.0,1.0,7.0,2.0,12.0,10.0,8.0,9.0,13.0,14.0,14.0,5.0,15.0,8.0,20.0,10.0,14.0,13.0,11.0,13.0,5.0,1.0,11.0,12.0,12.0,11.0,12.0,8.0,12.0,7.0,22.0,0.0,0.0,3.0,1.0,180.0,80.0,1.0,1.0,2.0,3.0,1.0,2.0,3.0,3.0,3.0,3.0,1.0,7.0,9.0,10.0,6.0,10.0,8.0,12.0,8.0,10.0,11.0,10.0,9.0,14.0,12.0,13.0,11.0,11.0,11.0,10.0,8.0,10.0,3.0,9.0,9.0,9.0,10.0,12.0,11.0,14.0,15.0,10.0,10.0,8.0,12.0,12.0,20.0,11.0,9.0,13.0,12.0,10.0,10.0,16.0,14.0,15.0,10.0,12.0,12.0,11.0,11.0,5.0,24.0,0.0,0.0,0.0,0.0,187.0,93.0,4.0,3.0,2.0,1.0,2.0,2.0,2.0,2.0,1.0,2.0,1.0,4.0,5.0,6.0,6.0,12.0,6.0,15.0,8.0,6.0,15.0,10.0,6.0,13.0,9.0,14.0,13.0,16.0,12.0,14.0,7.0,12.0,15.0,5.0,8.0,6.0,12.0,14.0,15.0,9.0,10.0,18.0,13.0,6.0,14.0,12.0,20.0,15.0,17.0,13.0,14.0,14.0,11.0,10.0,19.0,14.0,15.0,11.0,13.0,14.0,14.0,5.0,18.0,0.0,0.0,6.0,1.0,179.0,75.0,2.0,3.0,1.0,2.0,3.0,2.0,3.0,2.0,2.0,1.0,3.0,10.0,12.0,11.0,9.0,11.0,7.0,11.0,8.0,10.0,9.0,10.0,7.0,11.0,11.0,12.0,10.0,14.0,11.0,8.0,12.0,9.0,12.0,10.0,1.0,8.0,9.0,12.0,14.0,14.0,13.0,14.0,9.0,20.0,14.0,12.0,6.0,13.0,10.0,7.0,10.0,10.0,8.0,10.0,19.0,12.0,10.0,11.0,12.0,6.0,12.0,6.0,24.0,0.0,0.0,0.0,0.0,181.0,73.0,3.0,3.0,3.0,2.0,3.0,2.0,1.0,3.0,1.0,3.0,2.0,6.0,12.0,13.0,9.0,12.0,6.0,9.0,9.0,5.0,11.0,12.0,9.0,12.0,13.0,13.0,11.0,14.0,10.0,11.0,8.0,10.0,14.0,13.0,6.0,12.0,8.0,10.0,13.0,16.0,13.0,13.0,12.0,5.0,14.0,17.0,20.0,13.0,14.0,12.0,9.0,13.0,12.0,12.0,19.0,14.0,13.0,12.0,11.0,15.0,15.0,8.0,19.0,0.0,0.0,0.0,0.0,179.0,73.0,1.0,2.0,3.0,4.0,3.0,1.0,3.0,3.0,2.0,2.0,3.0,8.0,9.0,12.0,11.0,12.0,8.0,13.0,10.0,13.0,15.0,14.0,8.0,15.0,14.0,13.0,14.0,15.0,11.0,13.0,12.0,14.0,16.0,8.0,12.0,12.0,14.0,14.0,13.0,12.0,12.0,13.0,10.0,20.0,14.0,12.0,10.0,15.0,14.0,12.0,11.0,13.0,10.0,8.0,9.0,15.0,14.0,16.0,12.0,10.0,12.0,9.0,19.0,5.0,1.0,0.0,0.0,180.0,78.0,1.0,1.0,1.0,1.0,2.0,1.0,3.0,4.0,1.0,3.0,1.0,8.0,5.0,6.0,9.0,14.0,5.0,6.0,11.0,4.0,9.0,10.0,3.0,9.0,14.0,10.0,6.0,6.0,6.0,6.0,11.0,14.0,4.0,6.0,8.0,8.0,9.0,9.0,12.0,14.0,14.0,9.0,10.0,10.0,13.0,14.0,20.0,14.0,12.0,9.0,7.0,10.0,10.0,10.0,13.0,11.0,11.0,9.0,13.0,12.0,20.0,8.0,21.0,0.0,0.0,9.0,6.0,178.0,72.0,1.0,1.0,1.0,1.0,2.0,3.0,2.0,3.0,3.0,4.0,3.0,5.0,8.0,15.0,13.0,15.0,6.0,11.0,10.0,5.0,3.0,10.0,13.0,3.0,14.0,10.0,12.0,11.0,12.0,10.0,12.0,9.0,12.0,16.0,5.0,14.0,7.0,7.0,11.0,13.0,14.0,13.0,9.0,12.0,13.0,12.0,20.0,13.0,11.0,10.0,10.0,8.0,7.0,8.0,8.0,11.0,11.0,9.0,7.0,13.0,10.0,5.0,20.0,0.0,0.0,0.0,0.0,175.0,67.0,3.0,3.0,3.0,1.0,2.0,2.0,2.0,3.0,2.0,2.0,2.0,10.0,13.0,14.0,11.0,12.0,8.0,8.0,11.0,8.0,8.0,12.0,10.0,10.0,12.0,12.0,12.0,11.0,11.0,8.0,13.0,11.0,9.0,14.0,10.0,12.0,10.0,11.0,12.0,13.0,15.0,11.0,7.0,20.0,12.0,14.0,11.0,11.0,8.0,13.0,5.0,10.0,7.0,11.0,7.0,10.0,11.0,11.0,10.0,5.0,15.0,2.0,21.0,0.0,0.0,0.0,0.0,178.0,68.0,1.0,1.0,1.0,2.0,3.0,2.0,1.0,1.0,1.0,1.0,3.0,10.0,10.0,14.0,12.0,13.0,7.0,11.0,12.0,5.0,5.0,10.0,10.0,4.0,13.0,6.0,12.0,11.0,12.0,11.0,11.0,12.0,11.0,14.0,6.0,14.0,9.0,10.0,13.0,15.0,14.0,12.0,9.0,20.0,12.0,14.0,8.0,13.0,9.0,12.0,6.0,10.0,8.0,11.0,13.0,11.0,10.0,12.0,12.0,9.0,16.0,8.0,20.0,0.0,0.0,0.0,0.0,182.0,78.0,2.0,3.0,2.0,2.0,1.0,1.0,2.0,4.0,2.0,1.0,2.0,9.0,5.0,10.0,9.0,11.0,9.0,10.0,10.0,4.0,5.0,9.0,7.0,6.0,11.0,13.0,10.0,14.0,10.0,10.0,7.0,13.0,10.0,9.0,10.0,11.0,6.0,10.0,15.0,12.0,12.0,14.0,10.0,6.0,15.0,13.0,20.0,10.0,13.0,9.0,9.0,1.0,9.0,9.0,14.0,12.0,13.0,11.0,14.0,13.0,14.0,5.0,33.0,70.0,0.0,0.0,0.0,185.0,81.0,12.0,9.0,11.0,10.0,11.0,11.0,12.0,15.0,10.0,15.0,8.0,6.0,2.0,8.0,1.0,12.0,8.0,10.0,1.0,2.0,1.0,2.0,1.0,3.0,11.0,10.0,9.0,13.0,11.0,15.0,9.0,11.0,15.0,2.0,10.0,1.0,12.0,17.0,9.0,7.0,14.0,13.0,14.0,10.0,7.0,9.0,20.0,11.0,10.0,14.0,11.0,13.0,6.0,11.0,18.0,18.0,10.0,10.0,17.0,14.0,12.0,2.0,26.0,1.0,0.0,0.0,0.0,185.0,80.0,3.0,1.0,3.0,3.0,3.0,3.0,2.0,3.0,4.0,2.0,1.0,5.0,9.0,11.0,8.0,11.0,6.0,12.0,8.0,10.0,15.0,11.0,12.0,14.0,12.0,16.0,12.0,17.0,14.0,9.0,9.0,10.0,15.0,13.0,9.0,7.0,10.0,8.0,12.0,15.0,13.0,17.0,14.0,8.0,13.0,18.0,20.0,13.0,14.0,11.0,12.0,11.0,4.0,10.0,12.0,12.0,13.0,10.0,10.0,8.0,7.0,14.0,24.0,0.0,0.0,0.0,0.0,175.0,68.0,4.0,3.0,3.0,4.0,1.0,3.0,2.0,2.0,3.0,3.0,1.0,8.0,12.0,11.0,7.0,11.0,8.0,9.0,12.0,13.0,11.0,11.0,7.0,12.0,13.0,12.0,11.0,14.0,12.0,11.0,10.0,12.0,14.0,6.0,8.0,13.0,12.0,14.0,14.0,13.0,13.0,10.0,6.0,12.0,14.0,13.0,20.0,14.0,9.0,13.0,6.0,12.0,5.0,15.0,15.0,10.0,10.0,13.0,14.0,15.0,13.0,4.0,29.0,0.0,0.0,0.0,0.0,170.0,66.0,1.0,1.0,1.0,1.0,4.0,3.0,1.0,2.0,3.0,1.0,1.0,11.0,13.0,12.0,7.0,12.0,10.0,7.0,12.0,9.0,13.0,12.0,8.0,12.0,13.0,14.0,11.0,15.0,12.0,14.0,10.0,12.0,14.0,12.0,10.0,13.0,8.0,13.0,15.0,14.0,13.0,10.0,7.0,20.0,15.0,13.0,10.0,15.0,7.0,14.0,14.0,14.0,6.0,16.0,9.0,13.0,14.0,14.0,16.0,11.0,9.0,9.0,20.0,0.0,0.0,0.0,0.0,190.0,80.0,2.0,2.0,1.0,4.0,2.0,2.0,3.0,4.0,2.0,2.0,1.0,12.0,12.0,10.0,9.0,11.0,7.0,12.0,8.0,12.0,10.0,10.0,9.0,12.0,11.0,13.0,11.0,13.0,11.0,12.0,8.0,11.0,11.0,7.0,8.0,10.0,10.0,13.0,12.0,13.0,12.0,12.0,15.0,20.0,13.0,14.0,6.0,13.0,14.0,12.0,6.0,10.0,5.0,13.0,16.0,13.0,9.0,12.0,10.0,10.0,11.0,4.0,27.0,27.0,1.0,2.0,1.0,183.0,72.0,2.0,2.0,2.0,1.0,2.0,1.0,3.0,1.0,2.0,2.0,4.0,5.0,8.0,10.0,6.0,11.0,10.0,14.0,11.0,5.0,14.0,12.0,10.0,15.0,11.0,14.0,13.0,16.0,11.0,11.0,9.0,10.0,12.0,8.0,12.0,8.0,13.0,14.0,14.0,14.0,12.0,16.0,11.0,8.0,12.0,13.0,20.0,15.0,15.0,10.0,14.0,11.0,7.0,11.0,13.0,13.0,9.0,9.0,11.0,10.0,10.0,8.0,24.0,0.0,0.0,0.0,0.0,174.0,68.0,3.0,1.0,3.0,1.0,1.0,2.0,1.0,3.0,1.0,1.0,1.0,13.0,12.0,12.0,10.0,13.0,13.0,8.0,13.0,10.0,6.0,14.0,12.0,7.0,13.0,9.0,13.0,11.0,13.0,11.0,13.0,13.0,12.0,11.0,7.0,12.0,9.0,12.0,12.0,14.0,13.0,12.0,8.0,8.0,14.0,12.0,20.0,13.0,10.0,13.0,10.0,13.0,7.0,12.0,14.0,14.0,15.0,9.0,11.0,13.0,12.0,8.0,31.0,0.0,0.0,0.0,0.0,180.0,74.0,3.0,2.0,3.0,1.0,2.0,3.0,2.0,1.0,4.0,3.0,3.0,12.0,12.0,10.0,9.0,13.0,14.0,11.0,13.0,6.0,10.0,14.0,15.0,13.0,13.0,15.0,14.0,17.0,12.0,14.0,13.0,13.0,15.0,7.0,13.0,10.0,13.0,18.0,15.0,9.0,11.0,14.0,10.0,10.0,13.0,12.0,20.0,15.0,14.0,14.0,13.0,15.0,8.0,7.0,19.0,13.0,13.0,13.0,13.0,13.0,12.0,9.0,27.0,0.0,0.0,11.0,1.0,174.0,72.0,2.0,3.0,4.0,1.0,1.0,4.0,3.0,3.0,3.0,3.0,1.0,10.0,13.0,14.0,8.0,14.0,7.0,6.0,11.0,5.0,6.0,13.0,10.0,5.0,14.0,7.0,12.0,10.0,10.0,12.0,9.0,12.0,12.0,12.0,4.0,14.0,6.0,9.0,13.0,16.0,14.0,10.0,6.0,9.0,13.0,16.0,20.0,12.0,9.0,14.0,6.0,11.0,7.0,10.0,10.0,13.0,12.0,11.0,14.0,14.0,16.0,8.0,26.0,0.0,0.0,15.0,6.0,182.0,80.0,1.0,4.0,1.0,3.0,1.0,3.0,3.0,1.0,2.0,1.0,3.0,5.0,9.0,11.0,12.0,10.0,9.0,13.0,10.0,5.0,4.0,9.0,13.0,6.0,12.0,9.0,12.0,12.0,12.0,12.0,11.0,12.0,12.0,13.0,8.0,13.0,10.0,12.0,12.0,16.0,15.0,12.0,12.0,7.0,14.0,16.0,20.0,12.0,15.0,12.0,6.0,12.0,7.0,10.0,11.0,11.0,13.0,8.0,12.0,14.0,14.0,7.0,28.0,0.0,0.0,2.0,2.0,182.0,79.0,1.0,1.0,2.0,2.0,3.0,1.0,2.0,3.0,1.0,2.0,2.0,8.0,11.0,14.0,12.0,14.0,11.0,12.0,13.0,6.0,4.0,11.0,13.0,5.0,14.0,11.0,12.0,13.0,10.0,12.0,11.0,11.0,15.0,13.0,7.0,14.0,7.0,12.0,14.0,15.0,14.0,14.0,12.0,8.0,15.0,14.0,20.0,15.0,14.0,12.0,11.0,15.0,8.0,8.0,16.0,15.0,12.0,11.0,14.0,13.0,12.0,8.0
3,1,24.0,0.0,0.0,0.0,0.0,186.0,80.0,9.0,10.0,13.0,6.0,12.0,11.0,13.0,14.0,11.0,12.0,7.0,5.0,2.0,2.0,3.0,9.0,10.0,2.0,2.0,2.0,1.0,8.0,2.0,1.0,9.0,8.0,11.0,13.0,9.0,10.0,7.0,9.0,14.0,6.0,9.0,1.0,11.0,12.0,6.0,10.0,13.0,14.0,13.0,20.0,14.0,7.0,5.0,12.0,14.0,10.0,8.0,14.0,7.0,1.0,15.0,13.0,15.0,11.0,14.0,13.0,12.0,8.0,23.0,0.0,0.0,0.0,0.0,188.0,75.0,2.0,2.0,2.0,2.0,3.0,4.0,2.0,2.0,2.0,3.0,3.0,4.0,10.0,7.0,5.0,10.0,7.0,13.0,10.0,5.0,13.0,11.0,6.0,13.0,12.0,13.0,13.0,14.0,11.0,11.0,8.0,11.0,12.0,5.0,6.0,10.0,12.0,13.0,14.0,13.0,11.0,15.0,14.0,5.0,14.0,12.0,20.0,14.0,14.0,12.0,13.0,11.0,7.0,12.0,9.0,12.0,11.0,7.0,12.0,10.0,10.0,8.0,24.0,0.0,0.0,0.0,0.0,185.0,70.0,3.0,2.0,3.0,2.0,2.0,1.0,2.0,1.0,1.0,2.0,3.0,5.0,6.0,9.0,7.0,11.0,8.0,15.0,12.0,7.0,14.0,13.0,7.0,11.0,11.0,11.0,14.0,14.0,13.0,9.0,9.0,12.0,4.0,8.0,5.0,10.0,12.0,15.0,12.0,11.0,11.0,14.0,13.0,6.0,15.0,11.0,20.0,13.0,14.0,13.0,9.0,11.0,7.0,10.0,15.0,11.0,13.0,11.0,10.0,9.0,14.0,4.0,26.0,0.0,0.0,0.0,0.0,167.0,67.0,3.0,1.0,3.0,1.0,2.0,2.0,3.0,1.0,3.0,1.0,3.0,7.0,11.0,11.0,5.0,12.0,6.0,6.0,7.0,10.0,12.0,12.0,6.0,12.0,13.0,11.0,11.0,10.0,13.0,12.0,9.0,12.0,13.0,7.0,5.0,8.0,11.0,13.0,13.0,15.0,14.0,10.0,6.0,7.0,15.0,15.0,20.0,14.0,8.0,14.0,8.0,13.0,7.0,10.0,14.0,13.0,13.0,14.0,14.0,16.0,16.0,6.0,24.0,0.0,0.0,0.0,0.0,175.0,72.0,3.0,2.0,4.0,3.0,2.0,4.0,1.0,1.0,1.0,2.0,2.0,8.0,12.0,12.0,6.0,11.0,7.0,10.0,9.0,12.0,11.0,12.0,8.0,12.0,11.0,11.0,12.0,13.0,10.0,10.0,9.0,9.0,3.0,9.0,9.0,11.0,12.0,11.0,11.0,14.0,13.0,11.0,8.0,20.0,12.0,13.0,6.0,12.0,11.0,10.0,10.0,10.0,9.0,10.0,10.0,13.0,10.0,11.0,10.0,13.0,18.0,1.0,21.0,0.0,0.0,3.0,0.0,174.0,70.0,3.0,1.0,3.0,3.0,2.0,2.0,1.0,3.0,3.0,2.0,1.0,10.0,11.0,12.0,10.0,13.0,8.0,7.0,11.0,6.0,10.0,14.0,11.0,8.0,13.0,7.0,11.0,11.0,12.0,12.0,14.0,11.0,8.0,11.0,10.0,12.0,8.0,13.0,14.0,13.0,14.0,13.0,9.0,20.0,11.0,12.0,8.0,13.0,11.0,13.0,7.0,10.0,5.0,12.0,13.0,11.0,12.0,9.0,11.0,12.0,10.0,5.0,26.0,0.0,0.0,0.0,0.0,178.0,74.0,2.0,3.0,1.0,3.0,3.0,3.0,2.0,2.0,3.0,1.0,3.0,14.0,12.0,12.0,10.0,13.0,14.0,9.0,12.0,5.0,6.0,12.0,8.0,8.0,13.0,11.0,11.0,12.0,10.0,11.0,12.0,13.0,15.0,12.0,8.0,11.0,12.0,12.0,15.0,14.0,15.0,15.0,10.0,5.0,13.0,13.0,20.0,14.0,13.0,13.0,13.0,14.0,8.0,6.0,14.0,13.0,12.0,11.0,13.0,12.0,16.0,7.0,24.0,0.0,0.0,0.0,0.0,169.0,65.0,3.0,3.0,2.0,1.0,2.0,4.0,1.0,3.0,4.0,3.0,2.0,11.0,12.0,12.0,7.0,12.0,9.0,5.0,10.0,7.0,3.0,11.0,12.0,5.0,13.0,7.0,10.0,9.0,12.0,9.0,12.0,10.0,4.0,11.0,6.0,12.0,6.0,12.0,14.0,16.0,14.0,11.0,6.0,20.0,14.0,15.0,5.0,14.0,7.0,12.0,7.0,14.0,6.0,8.0,16.0,13.0,16.0,12.0,12.0,10.0,15.0,6.0,39.0,0.0,0.0,0.0,0.0,178.0,75.0,4.0,3.0,1.0,2.0,2.0,2.0,3.0,3.0,2.0,2.0,1.0,12.0,12.0,13.0,12.0,15.0,12.0,12.0,11.0,6.0,6.0,15.0,15.0,8.0,16.0,7.0,12.0,12.0,13.0,14.0,14.0,12.0,14.0,11.0,12.0,9.0,12.0,12.0,14.0,11.0,12.0,14.0,8.0,10.0,15.0,10.0,20.0,10.0,12.0,15.0,7.0,16.0,6.0,10.0,14.0,14.0,14.0,14.0,14.0,14.0,14.0,6.0,19.0,0.0,0.0,0.0,0.0,168.0,64.0,3.0,2.0,4.0,1.0,2.0,2.0,1.0,1.0,1.0,1.0,3.0,9.0,11.0,13.0,10.0,11.0,8.0,4.0,10.0,3.0,4.0,11.0,10.0,4.0,12.0,8.0,11.0,11.0,9.0,8.0,10.0,10.0,12.0,11.0,6.0,9.0,9.0,10.0,9.0,14.0,11.0,10.0,7.0,11.0,12.0,14.0,20.0,11.0,10.0,11.0,12.0,9.0,8.0,11.0,10.0,11.0,9.0,11.0,8.0,7.0,8.0,10.0,23.0,0.0,0.0,7.0,3.0,181.0,71.0,2.0,2.0,2.0,2.0,2.0,2.0,4.0,2.0,3.0,3.0,2.0,7.0,12.0,12.0,14.0,13.0,7.0,11.0,11.0,7.0,6.0,11.0,15.0,7.0,12.0,12.0,13.0,16.0,12.0,12.0,10.0,11.0,6.0,12.0,7.0,14.0,9.0,12.0,16.0,13.0,14.0,13.0,9.0,8.0,14.0,12.0,20.0,12.0,12.0,12.0,10.0,12.0,8.0,10.0,19.0,10.0,10.0,10.0,11.0,11.0,12.0,6.0,36.0,0.0,0.0,0.0,0.0,185.0,78.0,11.0,14.0,12.0,7.0,13.0,12.0,14.0,15.0,13.0,14.0,10.0,4.0,1.0,3.0,1.0,8.0,8.0,11.0,8.0,3.0,3.0,7.0,2.0,1.0,8.0,11.0,13.0,15.0,11.0,12.0,7.0,13.0,9.0,5.0,14.0,3.0,13.0,15.0,8.0,11.0,14.0,13.0,12.0,5.0,15.0,11.0,20.0,12.0,14.0,13.0,11.0,13.0,8.0,1.0,19.0,14.0,16.0,10.0,17.0,9.0,9.0,11.0,28.0,8.0,0.0,1.0,0.0,182.0,79.0,1.0,1.0,3.0,2.0,4.0,1.0,3.0,3.0,1.0,1.0,3.0,5.0,9.0,9.0,9.0,11.0,6.0,13.0,8.0,12.0,14.0,9.0,8.0,14.0,11.0,14.0,14.0,15.0,10.0,13.0,7.0,12.0,16.0,8.0,8.0,9.0,14.0,13.0,14.0,15.0,12.0,13.0,11.0,5.0,13.0,14.0,20.0,15.0,14.0,12.0,14.0,13.0,7.0,15.0,11.0,13.0,10.0,13.0,10.0,11.0,12.0,5.0,28.0,0.0,0.0,0.0,0.0,183.0,81.0,1.0,2.0,4.0,1.0,1.0,3.0,2.0,3.0,3.0,3.0,1.0,5.0,5.0,6.0,10.0,12.0,6.0,14.0,8.0,6.0,15.0,11.0,6.0,13.0,12.0,13.0,14.0,16.0,14.0,14.0,10.0,12.0,14.0,5.0,14.0,8.0,14.0,15.0,15.0,9.0,12.0,15.0,13.0,7.0,11.0,12.0,20.0,15.0,15.0,14.0,14.0,14.0,9.0,8.0,14.0,14.0,11.0,13.0,15.0,13.0,15.0,6.0,21.0,0.0,0.0,0.0,0.0,182.0,74.0,2.0,2.0,2.0,2.0,2.0,1.0,1.0,1.0,3.0,2.0,2.0,9.0,11.0,12.0,7.0,9.0,8.0,12.0,7.0,11.0,12.0,7.0,8.0,13.0,11.0,12.0,12.0,14.0,12.0,13.0,7.0,12.0,11.0,1.0,9.0,11.0,9.0,10.0,12.0,14.0,10.0,13.0,11.0,9.0,8.0,12.0,20.0,13.0,11.0,10.0,13.0,8.0,10.0,10.0,15.0,11.0,13.0,10.0,10.0,8.0,13.0,7.0,21.0,0.0,0.0,1.0,0.0,177.0,68.0,4.0,1.0,2.0,1.0,1.0,1.0,1.0,1.0,2.0,1.0,2.0,5.0,12.0,9.0,7.0,12.0,8.0,13.0,10.0,16.0,13.0,12.0,8.0,14.0,12.0,12.0,13.0,12.0,12.0,12.0,10.0,13.0,15.0,11.0,13.0,11.0,13.0,13.0,14.0,13.0,14.0,13.0,11.0,10.0,14.0,12.0,20.0,12.0,14.0,12.0,11.0,12.0,8.0,14.0,13.0,10.0,14.0,12.0,14.0,12.0,11.0,5.0,24.0,10.0,0.0,0.0,0.0,180.0,73.0,3.0,2.0,3.0,1.0,1.0,1.0,1.0,3.0,3.0,3.0,2.0,5.0,10.0,8.0,5.0,8.0,6.0,13.0,8.0,6.0,14.0,12.0,6.0,13.0,10.0,12.0,13.0,13.0,11.0,12.0,9.0,12.0,14.0,1.0,7.0,7.0,12.0,12.0,13.0,15.0,11.0,13.0,10.0,5.0,15.0,14.0,20.0,12.0,14.0,12.0,12.0,11.0,8.0,11.0,8.0,11.0,9.0,15.0,12.0,11.0,19.0,6.0,19.0,0.0,0.0,0.0,0.0,184.0,72.0,2.0,2.0,3.0,2.0,1.0,2.0,1.0,3.0,2.0,1.0,2.0,11.0,9.0,9.0,10.0,15.0,11.0,11.0,16.0,8.0,14.0,11.0,9.0,16.0,10.0,11.0,13.0,6.0,12.0,11.0,10.0,12.0,12.0,7.0,4.0,12.0,13.0,12.0,15.0,14.0,9.0,13.0,12.0,7.0,13.0,11.0,20.0,10.0,12.0,10.0,11.0,8.0,8.0,11.0,12.0,14.0,8.0,13.0,12.0,5.0,9.0,3.0,33.0,0.0,0.0,0.0,0.0,187.0,76.0,2.0,2.0,3.0,1.0,1.0,3.0,2.0,1.0,2.0,3.0,2.0,15.0,14.0,14.0,10.0,15.0,13.0,10.0,12.0,7.0,4.0,15.0,13.0,7.0,15.0,6.0,12.0,9.0,14.0,11.0,15.0,12.0,12.0,14.0,12.0,13.0,7.0,13.0,12.0,11.0,12.0,14.0,12.0,14.0,15.0,12.0,20.0,11.0,12.0,12.0,6.0,14.0,6.0,11.0,14.0,13.0,12.0,12.0,15.0,15.0,13.0,9.0,25.0,0.0,0.0,0.0,0.0,182.0,72.0,1.0,3.0,2.0,3.0,1.0,1.0,2.0,2.0,2.0,1.0,2.0,5.0,8.0,12.0,13.0,13.0,6.0,9.0,10.0,6.0,5.0,8.0,11.0,5.0,13.0,8.0,11.0,12.0,11.0,12.0,6.0,12.0,10.0,12.0,5.0,13.0,6.0,9.0,11.0,15.0,13.0,13.0,11.0,10.0,13.0,14.0,20.0,13.0,12.0,13.0,8.0,5.0,8.0,11.0,12.0,13.0,13.0,12.0,11.0,10.0,11.0,1.0,30.0,0.0,0.0,0.0,0.0,178.0,73.0,3.0,4.0,1.0,1.0,2.0,4.0,3.0,2.0,2.0,2.0,3.0,13.0,14.0,12.0,7.0,13.0,12.0,7.0,13.0,5.0,10.0,13.0,9.0,10.0,13.0,11.0,11.0,12.0,12.0,13.0,11.0,14.0,14.0,11.0,7.0,11.0,10.0,13.0,15.0,13.0,15.0,15.0,8.0,20.0,14.0,14.0,8.0,14.0,11.0,13.0,11.0,14.0,8.0,10.0,19.0,12.0,12.0,9.0,12.0,12.0,10.0,10.0,27.0,0.0,0.0,0.0,0.0,190.0,87.0,1.0,3.0,2.0,3.0,1.0,3.0,1.0,1.0,2.0,3.0,2.0,5.0,7.0,9.0,14.0,14.0,10.0,14.0,13.0,5.0,6.0,12.0,12.0,8.0,14.0,14.0,13.0,16.0,14.0,11.0,10.0,13.0,15.0,10.0,11.0,14.0,9.0,15.0,14.0,10.0,11.0,16.0,15.0,9.0,12.0,12.0,20.0,14.0,16.0,13.0,13.0,12.0,7.0,5.0,10.0,12.0,14.0,12.0,14.0,14.0,19.0,12.0
0,2,33.0,0.0,0.0,3.0,0.0,188.0,84.0,14.0,13.0,13.0,9.0,13.0,13.0,15.0,15.0,11.0,11.0,9.0,7.0,3.0,3.0,1.0,7.0,10.0,2.0,1.0,1.0,2.0,6.0,4.0,1.0,7.0,8.0,13.0,14.0,14.0,14.0,8.0,11.0,15.0,6.0,13.0,3.0,13.0,12.0,8.0,12.0,14.0,15.0,14.0,8.0,13.0,11.0,20.0,13.0,15.0,16.0,8.0,13.0,6.0,1.0,11.0,14.0,13.0,11.0,16.0,14.0,11.0,6.0,26.0,0.0,0.0,10.0,1.0,196.0,91.0,3.0,1.0,2.0,2.0,2.0,3.0,2.0,4.0,2.0,2.0,1.0,3.0,5.0,8.0,6.0,9.0,5.0,14.0,7.0,8.0,13.0,10.0,5.0,12.0,10.0,10.0,13.0,14.0,12.0,12.0,7.0,10.0,13.0,6.0,9.0,6.0,12.0,14.0,10.0,9.0,8.0,13.0,18.0,8.0,17.0,11.0,20.0,12.0,16.0,13.0,12.0,10.0,7.0,4.0,18.0,10.0,12.0,9.0,13.0,7.0,10.0,7.0,29.0,2.0,0.0,0.0,0.0,185.0,75.0,2.0,3.0,3.0,3.0,2.0,3.0,2.0,1.0,3.0,1.0,2.0,4.0,10.0,8.0,6.0,10.0,6.0,14.0,7.0,7.0,14.0,11.0,6.0,14.0,9.0,13.0,13.0,14.0,11.0,12.0,12.0,12.0,14.0,8.0,11.0,12.0,13.0,13.0,13.0,15.0,12.0,15.0,12.0,8.0,15.0,13.0,20.0,14.0,15.0,14.0,7.0,14.0,8.0,6.0,14.0,13.0,15.0,14.0,14.0,14.0,14.0,6.0,26.0,0.0,0.0,0.0,0.0,175.0,69.0,3.0,3.0,2.0,2.0,3.0,1.0,3.0,1.0,3.0,2.0,2.0,6.0,12.0,10.0,5.0,11.0,6.0,10.0,10.0,10.0,13.0,12.0,9.0,13.0,12.0,12.0,13.0,14.0,12.0,13.0,12.0,11.0,15.0,11.0,13.0,12.0,13.0,14.0,14.0,15.0,13.0,12.0,7.0,9.0,13.0,13.0,20.0,14.0,11.0,14.0,12.0,12.0,11.0,15.0,14.0,9.0,17.0,10.0,8.0,11.0,20.0,7.0,26.0,0.0,0.0,0.0,0.0,182.0,68.0,1.0,4.0,3.0,2.0,3.0,1.0,2.0,1.0,2.0,4.0,1.0,7.0,12.0,9.0,5.0,10.0,6.0,12.0,7.0,15.0,12.0,9.0,6.0,12.0,10.0,12.0,13.0,14.0,11.0,10.0,9.0,9.0,13.0,7.0,6.0,10.0,10.0,14.0,15.0,16.0,13.0,13.0,11.0,5.0,15.0,15.0,20.0,14.0,10.0,12.0,12.0,13.0,7.0,12.0,12.0,14.0,14.0,15.0,13.0,14.0,14.0,7.0,29.0,0.0,0.0,0.0,0.0,183.0,78.0,1.0,3.0,3.0,3.0,3.0,1.0,2.0,3.0,3.0,1.0,1.0,13.0,8.0,9.0,6.0,12.0,14.0,13.0,10.0,12.0,11.0,12.0,8.0,13.0,12.0,12.0,15.0,13.0,13.0,13.0,11.0,13.0,15.0,6.0,12.0,7.0,13.0,16.0,18.0,12.0,11.0,14.0,12.0,20.0,14.0,11.0,8.0,16.0,14.0,14.0,12.0,14.0,6.0,12.0,10.0,12.0,13.0,11.0,15.0,15.0,15.0,5.0,27.0,32.0,6.0,0.0,0.0,188.0,78.0,3.0,2.0,3.0,2.0,1.0,3.0,3.0,3.0,2.0,2.0,2.0,4.0,8.0,11.0,12.0,12.0,6.0,16.0,13.0,8.0,13.0,14.0,7.0,12.0,12.0,12.0,10.0,14.0,13.0,12.0,11.0,12.0,15.0,9.0,11.0,12.0,6.0,13.0,12.0,14.0,13.0,15.0,15.0,5.0,13.0,12.0,20.0,16.0,15.0,14.0,12.0,15.0,11.0,10.0,9.0,15.0,12.0,12.0,13.0,13.0,13.0,7.0,21.0,0.0,0.0,0.0,0.0,183.0,73.0,1.0,4.0,3.0,3.0,3.0,1.0,4.0,1.0,2.0,3.0,2.0,11.0,10.0,12.0,11.0,13.0,9.0,12.0,10.0,5.0,8.0,12.0,9.0,8.0,13.0,13.0,12.0,12.0,10.0,12.0,14.0,12.0,12.0,14.0,8.0,12.0,8.0,12.0,12.0,14.0,14.0,14.0,11.0,8.0,13.0,13.0,20.0,12.0,12.0,12.0,5.0,10.0,7.0,12.0,15.0,11.0,11.0,10.0,11.0,12.0,11.0,4.0,29.0,0.0,0.0,0.0,0.0,180.0,71.0,1.0,3.0,1.0,1.0,1.0,4.0,4.0,1.0,1.0,2.0,3.0,10.0,11.0,12.0,9.0,13.0,11.0,8.0,14.0,6.0,8.0,11.0,10.0,8.0,12.0,10.0,11.0,12.0,12.0,9.0,12.0,11.0,14.0,12.0,7.0,12.0,10.0,12.0,14.0,15.0,14.0,12.0,10.0,20.0,16.0,13.0,12.0,15.0,10.0,13.0,10.0,15.0,7.0,8.0,16.0,12.0,12.0,13.0,14.0,15.0,15.0,6.0,23.0,0.0,0.0,0.0,0.0,175.0,70.0,2.0,1.0,2.0,2.0,1.0,2.0,2.0,3.0,4.0,1.0,2.0,10.0,11.0,12.0,9.0,13.0,8.0,6.0,13.0,2.0,5.0,13.0,10.0,6.0,13.0,7.0,13.0,9.0,13.0,11.0,13.0,12.0,13.0,12.0,10.0,12.0,10.0,13.0,12.0,11.0,12.0,13.0,8.0,8.0,14.0,12.0,20.0,14.0,12.0,13.0,9.0,11.0,10.0,11.0,19.0,12.0,14.0,11.0,13.0,10.0,16.0,7.0,23.0,1.0,0.0,0.0,0.0,185.0,70.0,4.0,3.0,1.0,2.0,1.0,3.0,2.0,3.0,1.0,2.0,3.0,5.0,8.0,12.0,13.0,13.0,7.0,14.0,11.0,5.0,5.0,8.0,13.0,5.0,13.0,6.0,13.0,10.0,12.0,12.0,11.0,11.0,13.0,12.0,7.0,13.0,9.0,8.0,10.0,16.0,12.0,14.0,12.0,8.0,14.0,15.0,20.0,13.0,13.0,12.0,7.0,15.0,7.0,7.0,13.0,13.0,12.0,10.0,12.0,15.0,15.0,7.0,30.0,42.0,0.0,13.0,0.0,195.0,88.0,16.0,13.0,14.0,6.0,14.0,13.0,13.0,15.0,12.0,10.0,14.0,1.0,8.0,5.0,2.0,8.0,2.0,8.0,2.0,5.0,3.0,9.0,5.0,3.0,8.0,10.0,12.0,10.0,14.0,10.0,10.0,14.0,13.0,3.0,14.0,3.0,12.0,14.0,12.0,8.0,13.0,18.0,18.0,17.0,14.0,11.0,20.0,14.0,17.0,14.0,4.0,14.0,4.0,1.0,12.0,13.0,14.0,9.0,15.0,13.0,13.0,5.0,23.0,0.0,0.0,0.0,0.0,184.0,71.0,1.0,2.0,1.0,2.0,2.0,2.0,2.0,4.0,2.0,1.0,3.0,4.0,10.0,10.0,6.0,11.0,6.0,14.0,8.0,7.0,14.0,11.0,6.0,13.0,11.0,12.0,12.0,13.0,12.0,11.0,12.0,12.0,14.0,6.0,8.0,10.0,13.0,13.0,14.0,15.0,13.0,14.0,13.0,8.0,12.0,14.0,20.0,13.0,14.0,13.0,12.0,14.0,15.0,8.0,11.0,13.0,13.0,10.0,8.0,9.0,16.0,7.0,28.0,0.0,0.0,0.0,0.0,190.0,85.0,3.0,2.0,3.0,3.0,2.0,2.0,2.0,4.0,3.0,1.0,2.0,5.0,9.0,8.0,9.0,8.0,7.0,14.0,10.0,9.0,15.0,9.0,6.0,14.0,9.0,16.0,13.0,16.0,10.0,13.0,10.0,12.0,15.0,6.0,13.0,7.0,13.0,14.0,16.0,12.0,11.0,17.0,13.0,20.0,15.0,13.0,8.0,15.0,15.0,12.0,14.0,14.0,9.0,8.0,14.0,13.0,14.0,11.0,12.0,13.0,16.0,14.0,21.0,0.0,0.0,0.0,0.0,178.0,65.0,2.0,3.0,3.0,3.0,3.0,1.0,1.0,1.0,1.0,3.0,1.0,9.0,13.0,11.0,6.0,12.0,7.0,9.0,8.0,8.0,13.0,12.0,7.0,13.0,12.0,8.0,12.0,13.0,12.0,12.0,13.0,13.0,14.0,9.0,8.0,12.0,12.0,13.0,13.0,12.0,14.0,13.0,11.0,8.0,15.0,12.0,20.0,13.0,12.0,14.0,8.0,11.0,7.0,10.0,19.0,10.0,13.0,10.0,11.0,15.0,15.0,6.0,21.0,0.0,0.0,0.0,0.0,177.0,0.0,1.0,1.0,1.0,2.0,3.0,3.0,2.0,3.0,2.0,2.0,3.0,6.0,4.0,13.0,13.0,13.0,6.0,13.0,7.0,3.0,5.0,7.0,6.0,1.0,11.0,9.0,7.0,8.0,7.0,7.0,7.0,8.0,7.0,11.0,8.0,13.0,7.0,6.0,7.0,12.0,13.0,7.0,6.0,8.0,8.0,13.0,20.0,5.0,5.0,9.0,5.0,9.0,9.0,9.0,10.0,10.0,12.0,12.0,11.0,10.0,9.0,6.0,26.0,25.0,1.0,7.0,0.0,189.0,78.0,1.0,1.0,1.0,1.0,1.0,1.0,1.0,1.0,1.0,1.0,1.0,8.0,9.0,10.0,6.0,12.0,8.0,13.0,14.0,7.0,11.0,14.0,11.0,13.0,13.0,13.0,13.0,16.0,13.0,13.0,12.0,13.0,14.0,10.0,10.0,12.0,13.0,15.0,15.0,12.0,11.0,9.0,15.0,10.0,14.0,13.0,20.0,14.0,14.0,12.0,13.0,11.0,14.0,12.0,14.0,11.0,14.0,12.0,16.0,15.0,13.0,5.0,19.0,0.0,0.0,0.0,0.0,174.0,61.0,1.0,3.0,2.0,3.0,2.0,1.0,2.0,2.0,3.0,1.0,1.0,5.0,9.0,10.0,6.0,12.0,6.0,8.0,8.0,5.0,9.0,10.0,7.0,9.0,13.0,11.0,12.0,12.0,11.0,9.0,11.0,11.0,8.0,9.0,10.0,8.0,10.0,12.0,16.0,13.0,13.0,10.0,8.0,20.0,15.0,11.0,8.0,13.0,9.0,15.0,11.0,10.0,6.0,13.0,10.0,9.0,14.0,11.0,12.0,14.0,14.0,8.0,21.0,0.0,0.0,0.0,0.0,172.0,66.0,2.0,3.0,2.0,2.0,1.0,1.0,1.0,3.0,2.0,1.0,1.0,10.0,10.0,13.0,9.0,14.0,9.0,8.0,10.0,7.0,13.0,13.0,9.0,12.0,13.0,10.0,12.0,13.0,13.0,12.0,14.0,13.0,13.0,11.0,9.0,14.0,13.0,14.0,14.0,14.0,13.0,12.0,8.0,8.0,12.0,12.0,20.0,13.0,12.0,14.0,10.0,11.0,8.0,12.0,15.0,10.0,15.0,8.0,11.0,14.0,14.0,6.0,22.0,0.0,0.0,0.0,0.0,187.0,84.0,2.0,2.0,1.0,2.0,3.0,2.0,2.0,3.0,3.0,2.0,2.0,4.0,7.0,10.0,6.0,9.0,10.0,13.0,12.0,5.0,11.0,11.0,7.0,10.0,12.0,12.0,11.0,13.0,10.0,9.0,11.0,9.0,15.0,8.0,7.0,9.0,11.0,11.0,14.0,13.0,10.0,15.0,14.0,8.0,15.0,11.0,20.0,14.0,15.0,11.0,12.0,7.0,9.0,8.0,7.0,13.0,15.0,13.0,11.0,14.0,14.0,7.0,24.0,2.0,0.0,0.0,0.0,195.0,84.0,1.0,4.0,1.0,2.0,3.0,1.0,2.0,1.0,2.0,1.0,1.0,6.0,6.0,9.0,11.0,10.0,8.0,14.0,11.0,5.0,8.0,10.0,11.0,2.0,11.0,11.0,12.0,14.0,11.0,14.0,8.0,12.0,13.0,8.0,6.0,11.0,7.0,13.0,14.0,13.0,12.0,18.0,18.0,8.0,13.0,14.0,20.0,14.0,17.0,12.0,11.0,10.0,7.0,5.0,8.0,12.0,9.0,12.0,13.0,12.0,14.0,2.0,25.0,0.0,0.0,0.0,0.0,187.0,83.0,2.0,1.0,3.0,3.0,1.0,3.0,3.0,3.0,1.0,1.0,3.0,4.0,8.0,10.0,14.0,12.0,8.0,14.0,9.0,5.0,7.0,11.0,13.0,5.0,12.0,11.0,13.0,13.0,13.0,11.0,10.0,12.0,16.0,9.0,8.0,13.0,11.0,13.0,16.0,14.0,13.0,15.0,13.0,20.0,14.0,12.0,8.0,14.0,16.0,13.0,11.0,13.0,7.0,5.0,13.0,14.0,13.0,14.0,14.0,13.0,13.0,6.0
3,2,27.0,0.0,0.0,0.0,0.0,185.0,81.0,13.0,11.0,11.0,9.0,11.0,11.0,12.0,13.0,11.0,14.0,8.0,4.0,1.0,1.0,2.0,9.0,8.0,7.0,2.0,2.0,1.0,8.0,5.0,1.0,8.0,10.0,12.0,15.0,12.0,12.0,8.0,11.0,14.0,6.0,11.0,2.0,11.0,12.0,6.0,12.0,13.0,14.0,13.0,5.0,14.0,10.0,20.0,12.0,13.0,12.0,10.0,13.0,10.0,1.0,10.0,14.0,14.0,12.0,13.0,14.0,11.0,7.0,16.0,0.0,0.0,0.0,0.0,177.0,0.0,3.0,2.0,1.0,1.0,3.0,3.0,2.0,2.0,2.0,1.0,3.0,1.0,3.0,2.0,2.0,4.0,1.0,3.0,1.0,6.0,9.0,2.0,1.0,9.0,6.0,14.0,4.0,5.0,5.0,3.0,2.0,5.0,4.0,5.0,7.0,4.0,8.0,4.0,3.0,10.0,7.0,13.0,7.0,15.0,13.0,9.0,20.0,5.0,8.0,7.0,11.0,5.0,8.0,8.0,11.0,11.0,5.0,14.0,20.0,7.0,12.0,5.0,33.0,24.0,1.0,3.0,0.0,193.0,90.0,1.0,2.0,2.0,2.0,3.0,2.0,3.0,1.0,3.0,2.0,3.0,3.0,6.0,8.0,8.0,11.0,10.0,17.0,8.0,5.0,13.0,10.0,7.0,14.0,11.0,14.0,14.0,16.0,11.0,10.0,9.0,10.0,14.0,7.0,13.0,7.0,13.0,14.0,11.0,9.0,10.0,15.0,15.0,7.0,13.0,10.0,20.0,10.0,13.0,10.0,13.0,15.0,9.0,8.0,12.0,15.0,13.0,11.0,15.0,12.0,13.0,7.0,23.0,0.0,0.0,8.0,0.0,183.0,77.0,2.0,3.0,1.0,2.0,1.0,3.0,3.0,3.0,3.0,2.0,2.0,7.0,13.0,12.0,7.0,12.0,6.0,8.0,9.0,11.0,12.0,9.0,7.0,12.0,12.0,10.0,12.0,14.0,13.0,12.0,11.0,11.0,15.0,11.0,7.0,13.0,12.0,12.0,13.0,16.0,13.0,14.0,11.0,8.0,15.0,15.0,20.0,13.0,13.0,11.0,10.0,13.0,7.0,8.0,11.0,13.0,14.0,11.0,14.0,15.0,15.0,5.0,24.0,0.0,0.0,0.0,0.0,178.0,77.0,2.0,1.0,3.0,2.0,1.0,3.0,3.0,3.0,1.0,3.0,2.0,5.0,10.0,8.0,5.0,9.0,6.0,11.0,8.0,12.0,11.0,8.0,6.0,12.0,9.0,11.0,11.0,13.0,11.0,12.0,7.0,11.0,15.0,9.0,6.0,9.0,11.0,12.0,14.0,16.0,12.0,14.0,10.0,5.0,15.0,15.0,20.0,14.0,13.0,14.0,11.0,13.0,5.0,8.0,17.0,12.0,14.0,14.0,14.0,14.0,14.0,6.0,29.0,0.0,0.0,0.0,0.0,181.0,69.0,1.0,3.0,1.0,4.0,1.0,2.0,2.0,3.0,4.0,3.0,2.0,4.0,6.0,7.0,8.0,12.0,8.0,12.0,12.0,7.0,11.0,12.0,13.0,13.0,11.0,15.0,13.0,14.0,13.0,14.0,8.0,12.0,15.0,7.0,10.0,7.0,13.0,15.0,17.0,12.0,12.0,14.0,10.0,8.0,13.0,11.0,20.0,14.0,11.0,14.0,15.0,14.0,9.0,8.0,9.0,13.0,14.0,12.0,13.0,10.0,10.0,6.0,22.0,0.0,0.0,0.0,0.0,188.0,79.0,1.0,2.0,2.0,3.0,2.0,2.0,3.0,4.0,3.0,2.0,1.0,8.0,10.0,11.0,7.0,11.0,8.0,10.0,8.0,7.0,8.0,10.0,10.0,11.0,11.0,11.0,12.0,13.0,11.0,10.0,8.0,11.0,10.0,8.0,8.0,12.0,10.0,12.0,15.0,13.0,12.0,14.0,14.0,20.0,13.0,12.0,8.0,14.0,14.0,12.0,10.0,6.0,8.0,15.0,11.0,11.0,11.0,11.0,11.0,10.0,12.0,6.0,26.0,0.0,0.0,0.0,0.0,184.0,76.0,2.0,3.0,1.0,3.0,1.0,1.0,3.0,1.0,3.0,2.0,2.0,10.0,12.0,14.0,12.0,14.0,12.0,11.0,13.0,11.0,13.0,14.0,13.0,12.0,15.0,14.0,13.0,12.0,11.0,11.0,13.0,14.0,14.0,12.0,13.0,12.0,11.0,11.0,14.0,15.0,14.0,13.0,10.0,5.0,14.0,14.0,20.0,14.0,14.0,14.0,7.0,16.0,6.0,8.0,19.0,14.0,14.0,14.0,14.0,14.0,14.0,6.0,29.0,0.0,0.0,0.0,0.0,180.0,74.0,2.0,1.0,3.0,3.0,2.0,4.0,1.0,3.0,3.0,2.0,2.0,9.0,13.0,13.0,10.0,14.0,10.0,12.0,12.0,6.0,8.0,12.0,8.0,8.0,14.0,10.0,13.0,14.0,13.0,12.0,13.0,11.0,13.0,11.0,7.0,10.0,10.0,14.0,14.0,14.0,13.0,13.0,12.0,10.0,14.0,13.0,20.0,14.0,11.0,14.0,10.0,15.0,8.0,10.0,8.0,12.0,14.0,16.0,14.0,15.0,15.0,6.0,28.0,0.0,0.0,0.0,0.0,181.0,75.0,4.0,2.0,1.0,3.0,3.0,3.0,2.0,2.0,2.0,2.0,2.0,13.0,12.0,12.0,9.0,12.0,13.0,7.0,11.0,7.0,7.0,13.0,5.0,7.0,13.0,9.0,13.0,3.0,12.0,11.0,12.0,12.0,3.0,12.0,14.0,12.0,9.0,12.0,13.0,13.0,13.0,10.0,11.0,20.0,13.0,12.0,6.0,13.0,9.0,13.0,6.0,13.0,8.0,10.0,20.0,12.0,14.0,11.0,13.0,10.0,11.0,4.0,24.0,0.0,0.0,4.0,0.0,181.0,79.0,1.0,3.0,2.0,2.0,1.0,1.0,1.0,2.0,2.0,2.0,1.0,4.0,6.0,10.0,11.0,11.0,7.0,12.0,10.0,5.0,5.0,7.0,13.0,3.0,10.0,9.0,12.0,12.0,11.0,10.0,6.0,10.0,8.0,9.0,5.0,11.0,5.0,9.0,12.0,15.0,13.0,13.0,11.0,5.0,11.0,14.0,20.0,13.0,14.0,11.0,9.0,12.0,13.0,5.0,19.0,11.0,9.0,9.0,7.0,14.0,14.0,13.0,25.0,0.0,0.0,3.0,0.0,187.0,83.0,15.0,9.0,12.0,8.0,13.0,11.0,12.0,14.0,7.0,12.0,8.0,4.0,2.0,3.0,2.0,9.0,9.0,6.0,2.0,2.0,1.0,9.0,2.0,1.0,9.0,8.0,13.0,15.0,12.0,10.0,7.0,9.0,15.0,5.0,9.0,3.0,12.0,13.0,8.0,12.0,12.0,15.0,14.0,20.0,13.0,9.0,5.0,14.0,14.0,12.0,8.0,10.0,7.0,1.0,14.0,11.0,16.0,11.0,14.0,14.0,14.0,6.0,19.0,0.0,0.0,0.0,0.0,193.0,89.0,3.0,2.0,2.0,3.0,1.0,3.0,1.0,4.0,2.0,2.0,3.0,8.0,10.0,5.0,4.0,10.0,10.0,14.0,12.0,6.0,12.0,10.0,4.0,12.0,9.0,11.0,11.0,14.0,11.0,12.0,8.0,14.0,13.0,8.0,8.0,11.0,11.0,13.0,13.0,10.0,9.0,14.0,16.0,6.0,14.0,10.0,20.0,12.0,14.0,11.0,7.0,6.0,6.0,8.0,16.0,10.0,10.0,12.0,13.0,16.0,16.0,5.0,32.0,0.0,0.0,0.0,0.0,172.0,71.0,2.0,1.0,3.0,1.0,2.0,3.0,2.0,3.0,2.0,2.0,2.0,8.0,9.0,7.0,6.0,10.0,6.0,10.0,9.0,10.0,14.0,11.0,6.0,14.0,11.0,10.0,16.0,15.0,12.0,12.0,7.0,12.0,15.0,9.0,13.0,8.0,14.0,15.0,15.0,14.0,14.0,14.0,10.0,20.0,14.0,14.0,8.0,15.0,13.0,13.0,11.0,13.0,7.0,13.0,17.0,14.0,17.0,8.0,13.0,15.0,15.0,6.0,37.0,0.0,0.0,0.0,0.0,185.0,83.0,1.0,1.0,2.0,1.0,3.0,2.0,3.0,1.0,1.0,3.0,1.0,6.0,8.0,9.0,12.0,10.0,8.0,13.0,9.0,4.0,5.0,10.0,14.0,4.0,11.0,11.0,10.0,11.0,13.0,12.0,12.0,13.0,15.0,14.0,12.0,11.0,7.0,12.0,8.0,7.0,7.0,12.0,12.0,11.0,11.0,7.0,20.0,8.0,14.0,12.0,8.0,13.0,9.0,12.0,12.0,12.0,19.0,14.0,15.0,14.0,8.0,8.0,21.0,0.0,0.0,0.0,0.0,179.0,68.0,2.0,3.0,2.0,1.0,2.0,1.0,2.0,3.0,2.0,1.0,1.0,6.0,13.0,12.0,6.0,13.0,6.0,8.0,7.0,12.0,10.0,12.0,8.0,12.0,13.0,10.0,11.0,11.0,12.0,10.0,11.0,11.0,12.0,11.0,7.0,13.0,10.0,12.0,14.0,15.0,13.0,12.0,10.0,20.0,14.0,14.0,8.0,14.0,10.0,13.0,8.0,13.0,8.0,12.0,13.0,14.0,10.0,12.0,10.0,10.0,12.0,10.0,19.0,0.0,0.0,0.0,0.0,185.0,82.0,4.0,2.0,3.0,1.0,3.0,2.0,1.0,2.0,1.0,2.0,3.0,7.0,7.0,10.0,6.0,13.0,7.0,14.0,7.0,6.0,12.0,13.0,7.0,13.0,13.0,13.0,13.0,13.0,11.0,12.0,11.0,12.0,14.0,9.0,14.0,11.0,11.0,15.0,15.0,12.0,12.0,14.0,13.0,5.0,14.0,12.0,20.0,14.0,13.0,10.0,11.0,11.0,6.0,10.0,10.0,12.0,12.0,14.0,14.0,11.0,16.0,6.0,19.0,0.0,0.0,0.0,0.0,175.0,67.0,3.0,2.0,1.0,3.0,3.0,1.0,1.0,1.0,2.0,1.0,3.0,7.0,8.0,12.0,8.0,10.0,6.0,12.0,9.0,8.0,10.0,10.0,8.0,12.0,11.0,14.0,10.0,12.0,9.0,10.0,11.0,10.0,12.0,12.0,10.0,12.0,12.0,13.0,14.0,13.0,11.0,14.0,8.0,6.0,14.0,12.0,20.0,14.0,12.0,12.0,8.0,11.0,6.0,12.0,17.0,13.0,10.0,11.0,12.0,11.0,17.0,5.0,18.0,0.0,0.0,0.0,0.0,170.0,67.0,3.0,1.0,3.0,3.0,3.0,4.0,1.0,2.0,1.0,2.0,2.0,11.0,11.0,12.0,13.0,12.0,11.0,6.0,10.0,8.0,7.0,12.0,10.0,7.0,13.0,9.0,11.0,8.0,10.0,10.0,12.0,12.0,15.0,12.0,12.0,11.0,12.0,11.0,12.0,12.0,12.0,10.0,6.0,5.0,14.0,12.0,20.0,10.0,9.0,10.0,8.0,2.0,6.0,12.0,11.0,11.0,12.0,13.0,14.0,11.0,13.0,4.0,22.0,24.0,3.0,7.0,0.0,177.0,78.0,2.0,1.0,2.0,3.0,2.0,2.0,4.0,3.0,3.0,2.0,1.0,10.0,13.0,16.0,14.0,16.0,16.0,8.0,16.0,4.0,4.0,15.0,12.0,4.0,16.0,12.0,11.0,12.0,13.0,10.0,11.0,8.0,13.0,17.0,5.0,14.0,5.0,10.0,12.0,15.0,14.0,13.0,9.0,10.0,17.0,16.0,20.0,15.0,14.0,12.0,11.0,15.0,4.0,12.0,19.0,16.0,14.0,14.0,11.0,13.0,10.0,12.0,20.0,29.0,2.0,0.0,0.0,181.0,75.0,1.0,1.0,2.0,2.0,2.0,3.0,2.0,1.0,1.0,3.0,2.0,5.0,9.0,15.0,10.0,11.0,9.0,10.0,8.0,7.0,3.0,10.0,10.0,5.0,15.0,7.0,10.0,9.0,12.0,10.0,8.0,11.0,14.0,12.0,5.0,13.0,5.0,11.0,12.0,16.0,12.0,9.0,12.0,20.0,14.0,16.0,7.0,12.0,10.0,9.0,10.0,10.0,11.0,6.0,10.0,15.0,9.0,13.0,11.0,14.0,18.0,7.0,22.0,5.0,1.0,1.0,0.0,173.0,72.0,1.0,3.0,1.0,3.0,3.0,3.0,3.0,3.0,3.0,2.0,2.0,14.0,13.0,16.0,14.0,16.0,14.0,5.0,11.0,5.0,5.0,15.0,11.0,5.0,16.0,8.0,13.0,9.0,14.0,13.0,15.0,13.0,15.0,16.0,5.0,13.0,5.0,9.0,10.0,15.0,16.0,14.0,5.0,20.0,14.0,15.0,5.0,12.0,14.0,13.0,11.0,13.0,8.0,14.0,10.0,15.0,14.0,10.0,13.0,10.0,10.0,13.0
4,0,25.0,4.0,0.0,11.0,0.0,184.0,81.0,14.0,14.0,13.0,9.0,15.0,12.0,16.0,16.0,13.0,7.0,11.0,8.0,1.0,2.0,1.0,11.0,12.0,6.0,1.0,3.0,3.0,11.0,5.0,3.0,11.0,8.0,15.0,15.0,13.0,14.0,10.0,11.0,14.0,8.0,13.0,5.0,13.0,10.0,10.0,14.0,16.0,14.0,13.0,20.0,14.0,12.0,5.0,14.0,14.0,15.0,9.0,16.0,6.0,1.0,17.0,11.0,15.0,13.0,14.0,12.0,12.0,4.0,27.0,0.0,0.0,0.0,0.0,184.0,81.0,1.0,1.0,1.0,3.0,3.0,2.0,2.0,2.0,1.0,2.0,3.0,8.0,6.0,8.0,12.0,10.0,8.0,12.0,9.0,1.0,3.0,8.0,14.0,4.0,9.0,4.0,11.0,12.0,11.0,8.0,8.0,11.0,10.0,9.0,8.0,11.0,9.0,8.0,11.0,10.0,8.0,13.0,13.0,9.0,13.0,9.0,20.0,12.0,13.0,13.0,9.0,2.0,9.0,9.0,15.0,10.0,12.0,10.0,11.0,6.0,4.0,6.0,32.0,0.0,0.0,0.0,0.0,172.0,71.0,2.0,1.0,3.0,1.0,2.0,3.0,2.0,3.0,2.0,2.0,2.0,8.0,9.0,7.0,6.0,10.0,6.0,10.0,9.0,10.0,14.0,11.0,6.0,14.0,11.0,10.0,16.0,15.0,12.0,12.0,7.0,12.0,15.0,9.0,13.0,8.0,14.0,15.0,15.0,14.0,14.0,14.0,10.0,20.0,14.0,14.0,8.0,15.0,13.0,13.0,11.0,13.0,7.0,13.0,17.0,14.0,17.0,8.0,13.0,15.0,15.0,6.0,27.0,0.0,0.0,0.0,0.0,178.0,72.0,2.0,3.0,2.0,3.0,2.0,3.0,3.0,1.0,1.0,2.0,1.0,13.0,14.0,11.0,7.0,12.0,10.0,9.0,10.0,13.0,13.0,12.0,10.0,14.0,13.0,12.0,14.0,14.0,13.0,14.0,11.0,12.0,14.0,13.0,8.0,14.0,13.0,13.0,15.0,15.0,13.0,10.0,10.0,20.0,13.0,15.0,6.0,14.0,10.0,13.0,13.0,12.0,8.0,12.0,15.0,14.0,13.0,14.0,13.0,13.0,12.0,6.0,37.0,0.0,0.0,0.0,0.0,185.0,83.0,1.0,1.0,2.0,1.0,3.0,2.0,3.0,1.0,1.0,3.0,1.0,6.0,8.0,9.0,12.0,10.0,8.0,13.0,9.0,4.0,5.0,10.0,14.0,4.0,11.0,11.0,10.0,11.0,13.0,12.0,12.0,13.0,15.0,14.0,12.0,11.0,7.0,12.0,8.0,7.0,7.0,12.0,12.0,11.0,11.0,7.0,20.0,8.0,14.0,12.0,8.0,13.0,9.0,12.0,12.0,12.0,19.0,14.0,15.0,14.0,8.0,8.0,19.0,0.0,0.0,0.0,0.0,185.0,82.0,4.0,2.0,3.0,1.0,3.0,2.0,1.0,2.0,1.0,2.0,3.0,7.0,7.0,10.0,6.0,13.0,7.0,14.0,7.0,6.0,12.0,13.0,7.0,13.0,13.0,13.0,13.0,13.0,11.0,12.0,11.0,12.0,14.0,9.0,14.0,11.0,11.0,15.0,15.0,12.0,12.0,14.0,13.0,5.0,14.0,12.0,20.0,14.0,13.0,10.0,11.0,11.0,6.0,10.0,10.0,12.0,12.0,14.0,14.0,11.0,16.0,6.0,22.0,0.0,0.0,4.0,0.0,180.0,80.0,4.0,1.0,1.0,3.0,2.0,3.0,1.0,3.0,3.0,3.0,4.0,7.0,10.0,11.0,8.0,15.0,11.0,10.0,14.0,5.0,14.0,15.0,10.0,15.0,15.0,13.0,14.0,13.0,12.0,14.0,15.0,13.0,16.0,12.0,8.0,15.0,13.0,13.0,13.0,13.0,13.0,12.0,10.0,12.0,12.0,12.0,20.0,13.0,12.0,13.0,10.0,12.0,7.0,11.0,12.0,15.0,12.0,16.0,15.0,10.0,10.0,7.0,22.0,0.0,0.0,0.0,0.0,186.0,0.0,1.0,2.0,3.0,3.0,1.0,3.0,1.0,2.0,1.0,2.0,1.0,4.0,1.0,12.0,12.0,12.0,1.0,7.0,5.0,1.0,3.0,5.0,1.0,1.0,8.0,8.0,6.0,6.0,4.0,5.0,4.0,11.0,6.0,9.0,12.0,12.0,5.0,4.0,5.0,12.0,12.0,5.0,11.0,12.0,10.0,12.0,20.0,6.0,8.0,8.0,8.0,8.0,7.0,8.0,13.0,11.0,12.0,13.0,12.0,5.0,14.0,5.0,20.0,29.0,2.0,0.0,0.0,181.0,75.0,1.0,1.0,2.0,2.0,2.0,3.0,2.0,1.0,1.0,3.0,2.0,5.0,9.0,15.0,10.0,11.0,9.0,10.0,8.0,7.0,3.0,10.0,10.0,5.0,15.0,7.0,10.0,9.0,12.0,10.0,8.0,11.0,14.0,12.0,5.0,13.0,5.0,11.0,12.0,16.0,12.0,9.0,12.0,20.0,14.0,16.0,7.0,12.0,10.0,9.0,10.0,10.0,11.0,6.0,10.0,15.0,9.0,13.0,11.0,14.0,18.0,7.0,22.0,5.0,1.0,1.0,0.0,173.0,72.0,1.0,3.0,1.0,3.0,3.0,3.0,3.0,3.0,3.0,2.0,2.0,14.0,13.0,16.0,14.0,16.0,14.0,5.0,11.0,5.0,5.0,15.0,11.0,5.0,16.0,8.0,13.0,9.0,14.0,13.0,15.0,13.0,15.0,16.0,5.0,13.0,5.0,9.0,10.0,15.0,16.0,14.0,5.0,20.0,14.0,15.0,5.0,12.0,14.0,13.0,11.0,13.0,8.0,14.0,10.0,15.0,14.0,10.0,13.0,10.0,10.0,13.0,22.0,24.0,3.0,7.0,0.0,177.0,78.0,2.0,1.0,2.0,3.0,2.0,2.0,4.0,3.0,3.0,2.0,1.0,10.0,13.0,16.0,14.0,16.0,16.0,8.0,16.0,4.0,4.0,15.0,12.0,4.0,16.0,12.0,11.0,12.0,13.0,10.0,11.0,8.0,13.0,17.0,5.0,14.0,5.0,10.0,12.0,15.0,14.0,13.0,9.0,10.0,17.0,16.0,20.0,15.0,14.0,12.0,11.0,15.0,4.0,12.0,19.0,16.0,14.0,14.0,11.0,13.0,10.0,12.0,19.0,0.0,0.0,0.0,0.0,193.0,84.0,14.0,11.0,10.0,9.0,12.0,13.0,13.0,13.0,9.0,8.0,13.0,4.0,2.0,1.0,3.0,7.0,7.0,2.0,3.0,1.0,1.0,8.0,1.0,3.0,7.0,8.0,11.0,12.0,10.0,12.0,8.0,10.0,10.0,6.0,7.0,1.0,12.0,11.0,10.0,9.0,13.0,12.0,13.0,5.0,15.0,8.0,20.0,12.0,14.0,12.0,10.0,4.0,3.0,10.0,18.0,13.0,13.0,9.0,13.0,11.0,19.0,4.0,33.0,24.0,1.0,3.0,0.0,193.0,90.0,1.0,2.0,2.0,2.0,3.0,2.0,3.0,1.0,3.0,2.0,3.0,3.0,6.0,8.0,8.0,11.0,10.0,17.0,8.0,5.0,13.0,10.0,7.0,14.0,11.0,14.0,14.0,16.0,11.0,10.0,9.0,10.0,14.0,7.0,13.0,7.0,13.0,14.0,11.0,9.0,10.0,15.0,15.0,7.0,13.0,10.0,20.0,10.0,13.0,10.0,13.0,15.0,9.0,8.0,12.0,15.0,13.0,11.0,15.0,12.0,13.0,7.0,16.0,0.0,0.0,0.0,0.0,177.0,0.0,3.0,2.0,1.0,1.0,3.0,3.0,2.0,2.0,2.0,1.0,3.0,1.0,3.0,2.0,2.0,4.0,1.0,3.0,1.0,6.0,9.0,2.0,1.0,9.0,6.0,14.0,4.0,5.0,5.0,3.0,2.0,5.0,4.0,5.0,7.0,4.0,8.0,4.0,3.0,10.0,7.0,13.0,7.0,15.0,13.0,9.0,20.0,5.0,8.0,7.0,11.0,5.0,8.0,8.0,11.0,11.0,5.0,14.0,20.0,7.0,12.0,5.0,23.0,2.0,0.0,0.0,0.0,188.0,85.0,1.0,3.0,2.0,2.0,1.0,3.0,3.0,2.0,3.0,2.0,1.0,7.0,8.0,7.0,5.0,12.0,5.0,14.0,9.0,7.0,13.0,11.0,6.0,13.0,12.0,14.0,13.0,13.0,11.0,12.0,6.0,12.0,5.0,1.0,6.0,8.0,12.0,14.0,13.0,12.0,11.0,14.0,15.0,6.0,13.0,11.0,20.0,14.0,15.0,13.0,9.0,7.0,10.0,10.0,12.0,12.0,13.0,10.0,9.0,8.0,8.0,2.0,24.0,0.0,0.0,0.0,0.0,178.0,77.0,2.0,1.0,3.0,2.0,1.0,3.0,3.0,3.0,1.0,3.0,2.0,5.0,10.0,8.0,5.0,9.0,6.0,11.0,8.0,12.0,11.0,8.0,6.0,12.0,9.0,11.0,11.0,13.0,11.0,12.0,7.0,11.0,15.0,9.0,6.0,9.0,11.0,12.0,14.0,16.0,12.0,14.0,10.0,5.0,15.0,15.0,20.0,14.0,13.0,14.0,11.0,13.0,5.0,8.0,17.0,12.0,14.0,14.0,14.0,14.0,14.0,6.0,26.0,0.0,0.0,0.0,0.0,184.0,76.0,2.0,3.0,1.0,3.0,1.0,1.0,3.0,1.0,3.0,2.0,2.0,10.0,12.0,14.0,12.0,14.0,12.0,11.0,13.0,11.0,13.0,14.0,13.0,12.0,15.0,14.0,13.0,12.0,11.0,11.0,13.0,14.0,14.0,12.0,13.0,12.0,11.0,11.0,14.0,15.0,14.0,13.0,10.0,5.0,14.0,14.0,20.0,14.0,14.0,14.0,7.0,16.0,6.0,8.0,19.0,14.0,14.0,14.0,14.0,14.0,14.0,6.0,22.0,0.0,0.0,0.0,0.0,188.0,79.0,1.0,2.0,2.0,3.0,2.0,2.0,3.0,4.0,3.0,2.0,1.0,8.0,10.0,11.0,7.0,11.0,8.0,10.0,8.0,7.0,8.0,10.0,10.0,11.0,11.0,11.0,12.0,13.0,11.0,10.0,8.0,11.0,10.0,8.0,8.0,12.0,10.0,12.0,15.0,13.0,12.0,14.0,14.0,20.0,13.0,12.0,8.0,14.0,14.0,12.0,10.0,6.0,8.0,15.0,11.0,11.0,11.0,11.0,11.0,10.0,12.0,6.0,28.0,0.0,0.0,0.0,0.0,181.0,75.0,4.0,2.0,1.0,3.0,3.0,3.0,2.0,2.0,2.0,2.0,2.0,13.0,12.0,12.0,9.0,12.0,13.0,7.0,11.0,7.0,7.0,13.0,5.0,7.0,13.0,9.0,13.0,3.0,12.0,11.0,12.0,12.0,3.0,12.0,14.0,12.0,9.0,12.0,13.0,13.0,13.0,10.0,11.0,20.0,13.0,12.0,6.0,13.0,9.0,13.0,6.0,13.0,8.0,10.0,20.0,12.0,14.0,11.0,13.0,10.0,11.0,4.0,29.0,0.0,0.0,0.0,0.0,180.0,74.0,2.0,1.0,3.0,3.0,2.0,4.0,1.0,3.0,3.0,2.0,2.0,9.0,13.0,13.0,10.0,14.0,10.0,12.0,12.0,6.0,8.0,12.0,8.0,8.0,14.0,10.0,13.0,14.0,13.0,12.0,13.0,11.0,13.0,11.0,7.0,10.0,10.0,14.0,14.0,14.0,13.0,13.0,12.0,10.0,14.0,13.0,20.0,14.0,11.0,14.0,10.0,15.0,8.0,10.0,8.0,12.0,14.0,16.0,14.0,15.0,15.0,6.0,24.0,0.0,0.0,0.0,0.0,179.0,85.0,2.0,4.0,2.0,3.0,1.0,1.0,1.0,1.0,1.0,1.0,2.0,4.0,8.0,12.0,14.0,11.0,8.0,13.0,11.0,7.0,8.0,9.0,12.0,6.0,12.0,12.0,12.0,13.0,13.0,14.0,9.0,14.0,16.0,11.0,8.0,13.0,5.0,11.0,12.0,11.0,13.0,16.0,10.0,9.0,2.0,12.0,20.0,14.0,16.0,14.0,12.0,13.0,7.0,5.0,19.0,13.0,13.0,8.0,12.0,12.0,12.0,10.0,25.0,1.0,1.0,0.0,0.0,182.0,70.0,2.0,1.0,2.0,3.0,3.0,2.0,2.0,4.0,1.0,3.0,2.0,9.0,7.0,13.0,13.0,12.0,6.0,13.0,12.0,8.0,8.0,10.0,14.0,6.0,11.0,13.0,10.0,13.0,12.0,12.0,10.0,12.0,13.0,8.0,9.0,14.0,8.0,11.0,12.0,14.0,13.0,14.0,11.0,8.0,13.0,14.0,20.0,13.0,13.0,12.0,6.0,12.0,6.0,11.0,14.0,11.0,10.0,11.0,10.0,9.0,19.0,5.0
1,3,20.0,0.0,0.0,3.0,0.0,193.0,80.0,10.0,12.0,12.0,9.0,11.0,11.0,13.0,15.0,13.0,7.0,12.0,7.0,1.0,1.0,2.0,8.0,11.0,1.0,2.0,1.0,2.0,11.0,2.0,1.0,8.0,4.0,14.0,14.0,11.0,9.0,11.0,12.0,12.0,2.0,15.0,1.0,13.0,11.0,6.0,12.0,13.0,15.0,16.0,20.0,15.0,10.0,6.0,13.0,14.0,12.0,11.0,11.0,10.0,1.0,11.0,9.0,12.0,12.0,13.0,10.0,10.0,1.0,26.0,1.0,0.0,0.0,0.0,185.0,80.0,3.0,1.0,3.0,3.0,3.0,3.0,2.0,3.0,4.0,2.0,1.0,5.0,9.0,11.0,8.0,11.0,6.0,12.0,8.0,10.0,15.0,11.0,12.0,14.0,12.0,16.0,12.0,17.0,14.0,9.0,9.0,10.0,15.0,13.0,9.0,7.0,10.0,8.0,12.0,15.0,13.0,17.0,14.0,8.0,13.0,18.0,20.0,13.0,14.0,11.0,12.0,11.0,4.0,10.0,12.0,12.0,13.0,10.0,10.0,8.0,7.0,14.0,24.0,0.0,0.0,0.0,0.0,175.0,68.0,4.0,3.0,3.0,4.0,1.0,3.0,2.0,2.0,3.0,3.0,1.0,8.0,12.0,11.0,7.0,11.0,8.0,9.0,12.0,13.0,11.0,11.0,7.0,12.0,13.0,12.0,11.0,14.0,12.0,11.0,10.0,12.0,14.0,6.0,8.0,13.0,12.0,14.0,14.0,13.0,13.0,10.0,6.0,12.0,14.0,13.0,20.0,14.0,9.0,13.0,6.0,12.0,5.0,15.0,15.0,10.0,10.0,13.0,14.0,15.0,13.0,4.0,24.0,0.0,0.0,0.0,0.0,184.0,89.0,2.0,3.0,3.0,2.0,2.0,3.0,3.0,1.0,2.0,3.0,2.0,4.0,10.0,8.0,6.0,11.0,9.0,14.0,9.0,7.0,14.0,11.0,6.0,11.0,11.0,13.0,12.0,16.0,11.0,13.0,10.0,11.0,14.0,6.0,8.0,7.0,12.0,13.0,14.0,14.0,12.0,16.0,12.0,20.0,14.0,13.0,6.0,14.0,16.0,14.0,13.0,13.0,7.0,8.0,7.0,14.0,13.0,12.0,14.0,14.0,14.0,6.0,32.0,19.0,0.0,9.0,0.0,185.0,85.0,2.0,3.0,2.0,1.0,2.0,1.0,1.0,2.0,2.0,3.0,3.0,5.0,10.0,9.0,8.0,11.0,11.0,15.0,13.0,9.0,15.0,12.0,10.0,14.0,11.0,14.0,15.0,16.0,12.0,11.0,9.0,11.0,17.0,7.0,12.0,9.0,15.0,13.0,10.0,9.0,9.0,15.0,13.0,10.0,13.0,11.0,20.0,13.0,15.0,12.0,15.0,12.0,13.0,10.0,11.0,13.0,11.0,13.0,18.0,15.0,13.0,5.0,32.0,23.0,0.0,0.0,0.0,178.0,77.0,3.0,2.0,3.0,1.0,3.0,1.0,3.0,2.0,1.0,3.0,1.0,9.0,12.0,12.0,6.0,13.0,12.0,10.0,10.0,10.0,13.0,12.0,7.0,14.0,13.0,15.0,14.0,13.0,13.0,10.0,10.0,12.0,5.0,12.0,11.0,12.0,13.0,14.0,14.0,14.0,13.0,12.0,9.0,20.0,14.0,14.0,10.0,13.0,12.0,13.0,6.0,14.0,6.0,10.0,13.0,5.0,11.0,8.0,10.0,14.0,9.0,15.0,23.0,0.0,0.0,0.0,0.0,173.0,63.0,3.0,1.0,3.0,4.0,2.0,1.0,3.0,2.0,1.0,1.0,1.0,8.0,13.0,11.0,8.0,12.0,8.0,11.0,7.0,11.0,12.0,13.0,12.0,13.0,13.0,11.0,13.0,14.0,10.0,12.0,13.0,12.0,14.0,11.0,14.0,13.0,13.0,16.0,15.0,12.0,12.0,13.0,10.0,12.0,15.0,13.0,20.0,14.0,14.0,13.0,14.0,13.0,7.0,13.0,13.0,14.0,15.0,14.0,15.0,13.0,12.0,8.0,31.0,0.0,0.0,0.0,0.0,180.0,74.0,3.0,2.0,3.0,1.0,2.0,3.0,2.0,1.0,4.0,3.0,3.0,12.0,12.0,10.0,9.0,13.0,14.0,11.0,13.0,6.0,10.0,14.0,15.0,13.0,13.0,15.0,14.0,17.0,12.0,14.0,13.0,13.0,15.0,7.0,13.0,10.0,13.0,18.0,15.0,9.0,11.0,14.0,10.0,10.0,13.0,12.0,20.0,15.0,14.0,14.0,13.0,15.0,8.0,7.0,19.0,13.0,13.0,13.0,13.0,13.0,12.0,9.0,19.0,0.0,0.0,0.0,0.0,170.0,62.0,1.0,3.0,3.0,3.0,3.0,3.0,1.0,1.0,3.0,1.0,3.0,10.0,10.0,10.0,9.0,12.0,10.0,6.0,14.0,10.0,8.0,13.0,8.0,8.0,12.0,10.0,11.0,10.0,14.0,9.0,12.0,12.0,18.0,10.0,10.0,11.0,10.0,12.0,14.0,13.0,12.0,11.0,6.0,20.0,15.0,10.0,7.0,12.0,6.0,10.0,10.0,6.0,9.0,9.0,11.0,9.0,11.0,10.0,11.0,9.0,16.0,8.0,31.0,0.0,0.0,0.0,0.0,175.0,65.0,3.0,4.0,1.0,1.0,3.0,3.0,3.0,2.0,4.0,3.0,3.0,14.0,13.0,13.0,7.0,14.0,12.0,7.0,12.0,7.0,6.0,14.0,15.0,8.0,15.0,11.0,12.0,13.0,13.0,11.0,14.0,12.0,15.0,13.0,9.0,11.0,10.0,12.0,13.0,14.0,15.0,12.0,7.0,20.0,10.0,13.0,10.0,12.0,9.0,12.0,11.0,15.0,16.0,13.0,8.0,14.0,14.0,14.0,13.0,13.0,13.0,7.0,28.0,0.0,0.0,2.0,2.0,182.0,79.0,1.0,1.0,2.0,2.0,3.0,1.0,2.0,3.0,1.0,2.0,2.0,8.0,11.0,14.0,12.0,14.0,11.0,12.0,13.0,6.0,4.0,11.0,13.0,5.0,14.0,11.0,12.0,13.0,10.0,12.0,11.0,11.0,15.0,13.0,7.0,14.0,7.0,12.0,14.0,15.0,14.0,14.0,12.0,8.0,15.0,14.0,20.0,15.0,14.0,12.0,11.0,15.0,8.0,8.0,16.0,15.0,12.0,11.0,14.0,13.0,12.0,8.0,26.0,2.0,0.0,1.0,0.0,188.0,84.0,12.0,13.0,15.0,9.0,15.0,13.0,13.0,15.0,10.0,11.0,14.0,9.0,2.0,1.0,2.0,12.0,11.0,3.0,2.0,3.0,3.0,11.0,3.0,1.0,10.0,14.0,13.0,14.0,10.0,13.0,11.0,11.0,14.0,3.0,11.0,5.0,12.0,15.0,13.0,10.0,12.0,13.0,14.0,5.0,14.0,9.0,20.0,12.0,14.0,12.0,10.0,15.0,3.0,11.0,12.0,11.0,16.0,13.0,15.0,16.0,16.0,4.0,29.0,0.0,0.0,0.0,0.0,183.0,74.0,3.0,3.0,3.0,3.0,3.0,2.0,2.0,2.0,1.0,3.0,1.0,5.0,12.0,7.0,6.0,10.0,7.0,14.0,12.0,5.0,14.0,12.0,6.0,13.0,11.0,14.0,13.0,17.0,13.0,16.0,12.0,12.0,13.0,9.0,8.0,9.0,14.0,14.0,15.0,13.0,12.0,15.0,12.0,6.0,17.0,11.0,20.0,17.0,13.0,14.0,14.0,15.0,5.0,13.0,9.0,14.0,19.0,15.0,14.0,11.0,11.0,6.0,32.0,0.0,0.0,0.0,0.0,183.0,79.0,1.0,1.0,1.0,3.0,1.0,3.0,1.0,1.0,2.0,1.0,1.0,5.0,10.0,6.0,6.0,9.0,6.0,15.0,7.0,11.0,14.0,10.0,7.0,13.0,10.0,13.0,15.0,15.0,15.0,14.0,9.0,13.0,16.0,6.0,14.0,8.0,12.0,13.0,16.0,11.0,12.0,16.0,11.0,8.0,16.0,12.0,20.0,15.0,14.0,14.0,11.0,12.0,5.0,15.0,18.0,15.0,14.0,13.0,17.0,14.0,14.0,5.0,22.0,0.0,0.0,0.0,0.0,178.0,73.0,3.0,2.0,2.0,1.0,2.0,4.0,3.0,1.0,3.0,1.0,2.0,6.0,12.0,12.0,6.0,11.0,7.0,8.0,8.0,11.0,12.0,10.0,8.0,13.0,11.0,12.0,12.0,13.0,11.0,10.0,11.0,11.0,13.0,6.0,7.0,12.0,9.0,13.0,14.0,16.0,14.0,13.0,9.0,6.0,14.0,15.0,20.0,15.0,14.0,12.0,12.0,13.0,6.0,14.0,12.0,15.0,13.0,13.0,14.0,14.0,14.0,6.0,21.0,0.0,0.0,0.0,0.0,172.0,68.0,3.0,3.0,1.0,2.0,1.0,2.0,3.0,2.0,2.0,3.0,2.0,12.0,13.0,12.0,8.0,12.0,12.0,5.0,8.0,12.0,11.0,13.0,8.0,13.0,12.0,14.0,13.0,14.0,13.0,13.0,10.0,11.0,15.0,9.0,13.0,13.0,12.0,13.0,14.0,12.0,12.0,12.0,6.0,20.0,13.0,13.0,13.0,13.0,11.0,12.0,10.0,10.0,11.0,9.0,20.0,13.0,15.0,12.0,16.0,13.0,13.0,8.0,21.0,4.0,1.0,0.0,0.0,176.0,60.0,1.0,1.0,3.0,2.0,3.0,2.0,1.0,3.0,3.0,4.0,2.0,9.0,10.0,13.0,9.0,13.0,8.0,7.0,12.0,7.0,11.0,13.0,7.0,12.0,11.0,9.0,14.0,12.0,9.0,11.0,12.0,11.0,10.0,9.0,5.0,10.0,12.0,12.0,15.0,15.0,14.0,13.0,7.0,12.0,10.0,12.0,20.0,14.0,4.0,9.0,9.0,9.0,7.0,5.0,15.0,16.0,12.0,10.0,9.0,16.0,8.0,3.0,27.0,0.0,0.0,0.0,0.0,188.0,77.0,1.0,4.0,1.0,1.0,3.0,1.0,2.0,1.0,2.0,2.0,2.0,4.0,7.0,8.0,7.0,13.0,6.0,15.0,9.0,6.0,13.0,12.0,6.0,12.0,11.0,14.0,14.0,15.0,10.0,12.0,11.0,13.0,16.0,7.0,12.0,9.0,12.0,15.0,16.0,14.0,10.0,14.0,15.0,9.0,13.0,12.0,20.0,14.0,16.0,12.0,14.0,13.0,6.0,12.0,4.0,13.0,18.0,13.0,14.0,14.0,13.0,7.0,26.0,16.0,4.0,0.0,0.0,177.0,71.0,1.0,2.0,1.0,3.0,3.0,2.0,1.0,1.0,3.0,3.0,1.0,10.0,12.0,13.0,9.0,12.0,10.0,7.0,12.0,7.0,5.0,12.0,10.0,6.0,12.0,6.0,9.0,7.0,8.0,8.0,12.0,8.0,16.0,12.0,8.0,11.0,6.0,8.0,9.0,17.0,14.0,8.0,8.0,20.0,14.0,17.0,7.0,12.0,14.0,11.0,6.0,11.0,6.0,8.0,15.0,15.0,14.0,10.0,11.0,14.0,12.0,11.0,20.0,0.0,0.0,2.0,0.0,180.0,75.0,3.0,1.0,2.0,2.0,3.0,2.0,1.0,1.0,3.0,3.0,1.0,8.0,13.0,14.0,9.0,13.0,8.0,10.0,9.0,6.0,5.0,12.0,6.0,5.0,14.0,8.0,13.0,12.0,13.0,12.0,12.0,12.0,7.0,13.0,8.0,14.0,7.0,12.0,13.0,15.0,13.0,14.0,10.0,8.0,14.0,15.0,20.0,13.0,12.0,13.0,11.0,9.0,7.0,13.0,9.0,11.0,11.0,11.0,12.0,11.0,10.0,1.0,25.0,0.0,0.0,0.0,0.0,176.0,74.0,2.0,2.0,1.0,3.0,2.0,2.0,2.0,4.0,3.0,3.0,3.0,12.0,12.0,14.0,12.0,14.0,13.0,7.0,12.0,6.0,3.0,12.0,12.0,3.0,15.0,9.0,10.0,8.0,12.0,11.0,12.0,10.0,10.0,14.0,5.0,13.0,4.0,6.0,8.0,17.0,15.0,12.0,8.0,20.0,12.0,14.0,8.0,13.0,12.0,11.0,9.0,14.0,10.0,8.0,8.0,14.0,12.0,7.0,10.0,11.0,11.0,9.0,30.0,5.0,0.0,22.0,9.0,181.0,84.0,2.0,3.0,3.0,1.0,2.0,3.0,3.0,1.0,3.0,1.0,3.0,7.0,10.0,12.0,13.0,11.0,7.0,13.0,10.0,12.0,6.0,11.0,13.0,6.0,13.0,17.0,13.0,16.0,11.0,13.0,11.0,11.0,17.0,14.0,8.0,14.0,9.0,13.0,17.0,15.0,12.0,15.0,11.0,8.0,14.0,15.0,20.0,14.0,14.0,13.0,9.0,13.0,7.0,10.0,7.0,16.0,13.0,14.0,13.0,15.0,15.0,10.0
1,0,25.0,0.0,0.0,0.0,0.0,187.0,83.0,11.0,14.0,12.0,8.0,13.0,11.0,14.0,15.0,13.0,13.0,9.0,8.0,1.0,1.0,1.0,11.0,11.0,1.0,2.0,2.0,1.0,10.0,3.0,2.0,11.0,8.0,12.0,14.0,12.0,12.0,10.0,12.0,14.0,6.0,14.0,2.0,12.0,12.0,8.0,13.0,15.0,14.0,13.0,20.0,15.0,11.0,5.0,14.0,13.0,13.0,8.0,8.0,10.0,1.0,9.0,13.0,14.0,12.0,15.0,15.0,15.0,5.0,31.0,0.0,0.0,7.0,2.0,185.0,80.0,3.0,3.0,1.0,1.0,4.0,1.0,4.0,3.0,3.0,3.0,1.0,5.0,10.0,9.0,6.0,11.0,7.0,15.0,8.0,8.0,14.0,12.0,6.0,13.0,11.0,12.0,14.0,16.0,12.0,13.0,8.0,11.0,17.0,5.0,14.0,6.0,15.0,14.0,14.0,12.0,11.0,15.0,14.0,10.0,16.0,11.0,20.0,14.0,15.0,14.0,12.0,15.0,8.0,13.0,8.0,15.0,17.0,14.0,16.0,15.0,15.0,7.0,26.0,0.0,0.0,0.0,0.0,183.0,79.0,1.0,1.0,3.0,4.0,3.0,2.0,2.0,1.0,2.0,1.0,1.0,9.0,8.0,12.0,11.0,10.0,11.0,10.0,9.0,7.0,6.0,8.0,9.0,5.0,12.0,10.0,9.0,8.0,11.0,11.0,9.0,8.0,11.0,14.0,6.0,12.0,8.0,10.0,11.0,11.0,12.0,11.0,10.0,10.0,10.0,12.0,20.0,11.0,11.0,9.0,9.0,9.0,6.0,13.0,17.0,11.0,10.0,11.0,12.0,10.0,10.0,4.0,18.0,0.0,0.0,0.0,0.0,185.0,74.0,2.0,2.0,1.0,3.0,3.0,1.0,4.0,2.0,2.0,3.0,2.0,8.0,6.0,8.0,6.0,10.0,6.0,13.0,5.0,9.0,12.0,10.0,9.0,13.0,10.0,12.0,12.0,13.0,11.0,12.0,8.0,11.0,12.0,3.0,8.0,8.0,11.0,10.0,13.0,13.0,11.0,12.0,12.0,6.0,12.0,12.0,20.0,13.0,14.0,11.0,7.0,10.0,5.0,10.0,7.0,13.0,12.0,12.0,13.0,9.0,15.0,7.0,23.0,0.0,0.0,0.0,0.0,175.0,80.0,1.0,2.0,3.0,1.0,3.0,1.0,2.0,2.0,2.0,2.0,1.0,7.0,13.0,10.0,13.0,10.0,7.0,6.0,11.0,10.0,12.0,12.0,8.0,12.0,11.0,11.0,10.0,13.0,11.0,11.0,11.0,12.0,14.0,13.0,6.0,13.0,13.0,12.0,12.0,17.0,13.0,13.0,7.0,20.0,13.0,16.0,5.0,14.0,13.0,14.0,11.0,14.0,10.0,15.0,20.0,15.0,14.0,12.0,14.0,14.0,14.0,7.0,21.0,0.0,0.0,0.0,0.0,185.0,69.0,2.0,3.0,2.0,1.0,3.0,3.0,3.0,3.0,3.0,2.0,2.0,5.0,9.0,12.0,9.0,16.0,10.0,11.0,15.0,5.0,13.0,13.0,8.0,14.0,13.0,11.0,16.0,13.0,13.0,14.0,12.0,11.0,15.0,10.0,7.0,8.0,13.0,14.0,13.0,13.0,13.0,14.0,12.0,6.0,13.0,12.0,20.0,13.0,11.0,12.0,10.0,12.0,7.0,13.0,10.0,14.0,14.0,11.0,14.0,14.0,14.0,6.0,27.0,0.0,0.0,0.0,0.0,186.0,77.0,2.0,4.0,2.0,2.0,1.0,1.0,1.0,3.0,2.0,2.0,1.0,10.0,11.0,12.0,10.0,13.0,11.0,12.0,14.0,8.0,10.0,14.0,6.0,12.0,13.0,13.0,12.0,13.0,12.0,12.0,12.0,12.0,14.0,9.0,10.0,12.0,11.0,14.0,15.0,12.0,13.0,14.0,12.0,20.0,12.0,11.0,9.0,16.0,13.0,13.0,13.0,13.0,15.0,12.0,14.0,13.0,14.0,13.0,15.0,15.0,15.0,5.0,18.0,0.0,0.0,0.0,0.0,175.0,67.0,3.0,2.0,3.0,2.0,1.0,1.0,1.0,2.0,3.0,2.0,1.0,9.0,9.0,14.0,10.0,13.0,11.0,7.0,12.0,7.0,4.0,9.0,6.0,4.0,14.0,8.0,10.0,12.0,10.0,9.0,9.0,10.0,11.0,14.0,5.0,11.0,7.0,9.0,10.0,13.0,15.0,12.0,9.0,20.0,14.0,14.0,8.0,11.0,9.0,11.0,8.0,12.0,6.0,9.0,18.0,12.0,10.0,12.0,12.0,10.0,10.0,4.0,28.0,0.0,0.0,0.0,0.0,176.0,72.0,2.0,1.0,2.0,2.0,3.0,3.0,2.0,2.0,3.0,2.0,1.0,6.0,11.0,13.0,10.0,13.0,9.0,12.0,12.0,5.0,5.0,11.0,13.0,5.0,13.0,10.0,13.0,11.0,12.0,13.0,10.0,12.0,13.0,12.0,6.0,14.0,8.0,12.0,14.0,15.0,14.0,14.0,10.0,8.0,12.0,13.0,20.0,14.0,13.0,11.0,10.0,9.0,8.0,5.0,10.0,13.0,15.0,12.0,13.0,11.0,11.0,8.0,20.0,0.0,0.0,0.0,0.0,188.0,81.0,2.0,4.0,1.0,4.0,2.0,3.0,3.0,1.0,1.0,1.0,3.0,5.0,12.0,12.0,12.0,12.0,8.0,11.0,8.0,6.0,4.0,13.0,6.0,4.0,13.0,14.0,12.0,14.0,9.0,12.0,12.0,10.0,15.0,13.0,7.0,13.0,7.0,8.0,12.0,14.0,13.0,12.0,14.0,9.0,15.0,14.0,20.0,11.0,12.0,12.0,11.0,14.0,4.0,11.0,15.0,14.0,14.0,10.0,9.0,10.0,10.0,8.0,33.0,35.0,7.0,0.0,0.0,174.0,75.0,3.0,2.0,1.0,1.0,2.0,1.0,4.0,3.0,2.0,3.0,2.0,8.0,11.0,12.0,12.0,12.0,11.0,15.0,13.0,7.0,5.0,10.0,14.0,4.0,13.0,7.0,13.0,12.0,11.0,12.0,11.0,11.0,14.0,11.0,14.0,14.0,9.0,15.0,14.0,14.0,13.0,13.0,10.0,7.0,15.0,13.0,20.0,12.0,13.0,13.0,7.0,14.0,7.0,8.0,14.0,12.0,14.0,12.0,14.0,15.0,15.0,6.0,36.0,0.0,0.0,0.0,0.0,185.0,78.0,11.0,14.0,12.0,7.0,13.0,12.0,14.0,15.0,13.0,14.0,10.0,4.0,1.0,3.0,1.0,8.0,8.0,11.0,8.0,3.0,3.0,7.0,2.0,1.0,8.0,11.0,13.0,15.0,11.0,12.0,7.0,13.0,9.0,5.0,14.0,3.0,13.0,15.0,8.0,11.0,14.0,13.0,12.0,5.0,15.0,11.0,20.0,12.0,14.0,13.0,11.0,13.0,8.0,1.0,19.0,14.0,16.0,10.0,17.0,9.0,9.0,11.0,28.0,8.0,0.0,1.0,0.0,182.0,79.0,1.0,1.0,3.0,2.0,4.0,1.0,3.0,3.0,1.0,1.0,3.0,5.0,9.0,9.0,9.0,11.0,6.0,13.0,8.0,12.0,14.0,9.0,8.0,14.0,11.0,14.0,14.0,15.0,10.0,13.0,7.0,12.0,16.0,8.0,8.0,9.0,14.0,13.0,14.0,15.0,12.0,13.0,11.0,5.0,13.0,14.0,20.0,15.0,14.0,12.0,14.0,13.0,7.0,15.0,11.0,13.0,10.0,13.0,10.0,11.0,12.0,5.0,21.0,0.0,0.0,0.0,0.0,182.0,74.0,2.0,2.0,2.0,2.0,2.0,1.0,1.0,1.0,3.0,2.0,2.0,9.0,11.0,12.0,7.0,9.0,8.0,12.0,7.0,11.0,12.0,7.0,8.0,13.0,11.0,12.0,12.0,14.0,12.0,13.0,7.0,12.0,11.0,1.0,9.0,11.0,9.0,10.0,12.0,14.0,10.0,13.0,11.0,9.0,8.0,12.0,20.0,13.0,11.0,10.0,13.0,8.0,10.0,10.0,15.0,11.0,13.0,10.0,10.0,8.0,13.0,7.0,21.0,0.0,0.0,1.0,0.0,177.0,68.0,4.0,1.0,2.0,1.0,1.0,1.0,1.0,1.0,2.0,1.0,2.0,5.0,12.0,9.0,7.0,12.0,8.0,13.0,10.0,16.0,13.0,12.0,8.0,14.0,12.0,12.0,13.0,12.0,12.0,12.0,10.0,13.0,15.0,11.0,13.0,11.0,13.0,13.0,14.0,13.0,14.0,13.0,11.0,10.0,14.0,12.0,20.0,12.0,14.0,12.0,11.0,12.0,8.0,14.0,13.0,10.0,14.0,12.0,14.0,12.0,11.0,5.0,18.0,2.0,0.0,0.0,0.0,179.0,71.0,2.0,1.0,2.0,1.0,2.0,2.0,4.0,4.0,1.0,2.0,2.0,4.0,6.0,1.0,4.0,11.0,6.0,13.0,6.0,4.0,10.0,7.0,1.0,13.0,7.0,9.0,8.0,8.0,6.0,7.0,5.0,13.0,9.0,9.0,6.0,2.0,11.0,7.0,11.0,11.0,11.0,7.0,8.0,5.0,9.0,10.0,20.0,13.0,6.0,8.0,9.0,9.0,9.0,9.0,14.0,12.0,10.0,12.0,12.0,12.0,14.0,3.0,30.0,0.0,0.0,0.0,0.0,167.0,60.0,3.0,1.0,1.0,2.0,3.0,1.0,1.0,3.0,1.0,1.0,3.0,10.0,11.0,12.0,8.0,13.0,10.0,6.0,9.0,10.0,12.0,14.0,9.0,10.0,14.0,11.0,14.0,14.0,14.0,14.0,13.0,14.0,12.0,14.0,11.0,13.0,12.0,15.0,15.0,15.0,14.0,11.0,5.0,11.0,11.0,15.0,20.0,11.0,8.0,14.0,10.0,12.0,13.0,11.0,11.0,12.0,11.0,10.0,12.0,11.0,11.0,2.0,33.0,0.0,0.0,0.0,0.0,187.0,76.0,2.0,2.0,3.0,1.0,1.0,3.0,2.0,1.0,2.0,3.0,2.0,15.0,14.0,14.0,10.0,15.0,13.0,10.0,12.0,7.0,4.0,15.0,13.0,7.0,15.0,6.0,12.0,9.0,14.0,11.0,15.0,12.0,12.0,14.0,12.0,13.0,7.0,13.0,12.0,11.0,12.0,14.0,12.0,14.0,15.0,12.0,20.0,11.0,12.0,12.0,6.0,14.0,6.0,11.0,14.0,13.0,12.0,12.0,15.0,15.0,13.0,9.0,26.0,0.0,0.0,0.0,0.0,193.0,81.0,1.0,3.0,3.0,3.0,3.0,1.0,2.0,2.0,2.0,3.0,3.0,4.0,9.0,14.0,10.0,13.0,12.0,14.0,14.0,5.0,5.0,10.0,12.0,3.0,14.0,8.0,13.0,12.0,9.0,10.0,11.0,11.0,12.0,16.0,5.0,14.0,6.0,9.0,12.0,14.0,13.0,14.0,16.0,14.0,13.0,13.0,20.0,13.0,14.0,10.0,8.0,14.0,9.0,8.0,16.0,16.0,11.0,13.0,11.0,13.0,13.0,10.0,26.0,1.0,0.0,0.0,0.0,180.0,73.0,2.0,3.0,2.0,1.0,3.0,1.0,1.0,1.0,2.0,3.0,3.0,6.0,12.0,13.0,12.0,13.0,12.0,7.0,11.0,6.0,4.0,11.0,12.0,5.0,14.0,7.0,12.0,9.0,12.0,12.0,8.0,10.0,16.0,13.0,5.0,13.0,7.0,9.0,14.0,16.0,14.0,13.0,10.0,20.0,13.0,15.0,6.0,13.0,13.0,10.0,7.0,13.0,7.0,8.0,12.0,14.0,15.0,13.0,12.0,14.0,14.0,9.0,27.0,0.0,0.0,0.0,0.0,190.0,87.0,1.0,3.0,2.0,3.0,1.0,3.0,1.0,1.0,2.0,3.0,2.0,5.0,7.0,9.0,14.0,14.0,10.0,14.0,13.0,5.0,6.0,12.0,12.0,8.0,14.0,14.0,13.0,16.0,14.0,11.0,10.0,13.0,15.0,10.0,11.0,14.0,9.0,15.0,14.0,10.0,11.0,16.0,15.0,9.0,12.0,12.0,20.0,14.0,16.0,13.0,13.0,12.0,7.0,5.0,10.0,12.0,14.0,12.0,14.0,14.0,19.0,12.0,30.0,0.0,0.0,0.0,0.0,178.0,73.0,3.0,4.0,1.0,1.0,2.0,4.0,3.0,2.0,2.0,2.0,3.0,13.0,14.0,12.0,7.0,13.0,12.0,7.0,13.0,5.0,10.0,13.0,9.0,10.0,13.0,11.0,11.0,12.0,12.0,13.0,11.0,14.0,14.0,11.0,7.0,11.0,10.0,13.0,15.0,13.0,15.0,15.0,8.0,20.0,14.0,14.0,8.0,14.0,11.0,13.0,11.0,14.0,8.0,10.0,19.0,12.0,12.0,9.0,12.0,12.0,10.0,10.0
2,2,25.0,0.0,0.0,0.0,0.0,192.0,87.0,12.0,13.0,12.0,6.0,14.0,11.0,12.0,13.0,9.0,12.0,11.0,5.0,1.0,3.0,1.0,10.0,8.0,3.0,3.0,3.0,3.0,8.0,2.0,1.0,8.0,7.0,13.0,14.0,12.0,13.0,12.0,11.0,13.0,7.0,11.0,3.0,13.0,11.0,12.0,11.0,12.0,16.0,16.0,8.0,14.0,12.0,20.0,13.0,16.0,13.0,7.0,9.0,7.0,10.0,14.0,12.0,17.0,13.0,14.0,14.0,14.0,5.0,29.0,2.0,0.0,0.0,0.0,185.0,75.0,2.0,3.0,3.0,3.0,2.0,3.0,2.0,1.0,3.0,1.0,2.0,4.0,10.0,8.0,6.0,10.0,6.0,14.0,7.0,7.0,14.0,11.0,6.0,14.0,9.0,13.0,13.0,14.0,11.0,12.0,12.0,12.0,14.0,8.0,11.0,12.0,13.0,13.0,13.0,15.0,12.0,15.0,12.0,8.0,15.0,13.0,20.0,14.0,15.0,14.0,7.0,14.0,8.0,6.0,14.0,13.0,15.0,14.0,14.0,14.0,14.0,6.0,28.0,0.0,0.0,0.0,0.0,193.0,84.0,1.0,1.0,2.0,2.0,2.0,3.0,2.0,3.0,2.0,1.0,3.0,4.0,8.0,8.0,9.0,10.0,6.0,14.0,7.0,8.0,14.0,12.0,6.0,14.0,11.0,12.0,13.0,14.0,11.0,14.0,12.0,12.0,14.0,6.0,11.0,8.0,14.0,13.0,13.0,11.0,11.0,16.0,16.0,20.0,12.0,12.0,8.0,14.0,16.0,14.0,12.0,13.0,6.0,10.0,7.0,12.0,15.0,12.0,16.0,15.0,13.0,6.0,26.0,0.0,0.0,0.0,0.0,175.0,69.0,3.0,3.0,2.0,2.0,3.0,1.0,3.0,1.0,3.0,2.0,2.0,6.0,12.0,10.0,5.0,11.0,6.0,10.0,10.0,10.0,13.0,12.0,9.0,13.0,12.0,12.0,13.0,14.0,12.0,13.0,12.0,11.0,15.0,11.0,13.0,12.0,13.0,14.0,14.0,15.0,13.0,12.0,7.0,9.0,13.0,13.0,20.0,14.0,11.0,14.0,12.0,12.0,11.0,15.0,14.0,9.0,17.0,10.0,8.0,11.0,20.0,7.0,20.0,0.0,0.0,0.0,0.0,175.0,77.0,2.0,1.0,2.0,3.0,3.0,3.0,3.0,1.0,4.0,3.0,1.0,8.0,8.0,12.0,12.0,11.0,8.0,13.0,10.0,9.0,10.0,11.0,10.0,9.0,12.0,12.0,6.0,9.0,9.0,11.0,15.0,11.0,4.0,10.0,8.0,12.0,11.0,10.0,13.0,14.0,15.0,15.0,8.0,8.0,9.0,15.0,20.0,11.0,12.0,12.0,8.0,4.0,10.0,10.0,15.0,11.0,12.0,11.0,9.0,10.0,10.0,7.0,21.0,0.0,0.0,0.0,0.0,183.0,73.0,1.0,4.0,3.0,3.0,3.0,1.0,4.0,1.0,2.0,3.0,2.0,11.0,10.0,12.0,11.0,13.0,9.0,12.0,10.0,5.0,8.0,12.0,9.0,8.0,13.0,13.0,12.0,12.0,10.0,12.0,14.0,12.0,12.0,14.0,8.0,12.0,8.0,12.0,12.0,14.0,14.0,14.0,11.0,8.0,13.0,13.0,20.0,12.0,12.0,12.0,5.0,10.0,7.0,12.0,15.0,11.0,11.0,10.0,11.0,12.0,11.0,4.0,29.0,0.0,0.0,0.0,0.0,183.0,78.0,1.0,3.0,3.0,3.0,3.0,1.0,2.0,3.0,3.0,1.0,1.0,13.0,8.0,9.0,6.0,12.0,14.0,13.0,10.0,12.0,11.0,12.0,8.0,13.0,12.0,12.0,15.0,13.0,13.0,13.0,11.0,13.0,15.0,6.0,12.0,7.0,13.0,16.0,18.0,12.0,11.0,14.0,12.0,20.0,14.0,11.0,8.0,16.0,14.0,14.0,12.0,14.0,6.0,12.0,10.0,12.0,13.0,11.0,15.0,15.0,15.0,5.0,29.0,0.0,0.0,0.0,0.0,180.0,71.0,1.0,3.0,1.0,1.0,1.0,4.0,4.0,1.0,1.0,2.0,3.0,10.0,11.0,12.0,9.0,13.0,11.0,8.0,14.0,6.0,8.0,11.0,10.0,8.0,12.0,10.0,11.0,12.0,12.0,9.0,12.0,11.0,14.0,12.0,7.0,12.0,10.0,12.0,14.0,15.0,14.0,12.0,10.0,20.0,16.0,13.0,12.0,15.0,10.0,13.0,10.0,15.0,7.0,8.0,16.0,12.0,12.0,13.0,14.0,15.0,15.0,6.0,19.0,0.0,0.0,0.0,0.0,185.0,80.0,3.0,2.0,2.0,3.0,3.0,4.0,3.0,3.0,3.0,2.0,1.0,8.0,12.0,13.0,8.0,12.0,13.0,12.0,9.0,6.0,12.0,13.0,9.0,13.0,12.0,12.0,13.0,12.0,12.0,10.0,12.0,12.0,4.0,13.0,8.0,12.0,8.0,12.0,14.0,13.0,14.0,12.0,11.0,5.0,15.0,14.0,20.0,13.0,13.0,12.0,10.0,9.0,11.0,15.0,15.0,9.0,10.0,9.0,12.0,11.0,10.0,5.0,25.0,0.0,0.0,0.0,0.0,181.0,75.0,2.0,2.0,3.0,3.0,1.0,3.0,1.0,3.0,1.0,1.0,3.0,5.0,14.0,14.0,12.0,12.0,10.0,9.0,11.0,5.0,5.0,12.0,10.0,3.0,13.0,5.0,10.0,10.0,10.0,10.0,12.0,9.0,14.0,14.0,10.0,11.0,8.0,13.0,10.0,15.0,15.0,13.0,9.0,10.0,12.0,16.0,20.0,10.0,13.0,11.0,5.0,15.0,10.0,8.0,11.0,15.0,16.0,13.0,14.0,14.0,14.0,7.0,21.0,0.0,0.0,0.0,0.0,189.0,77.0,2.0,1.0,1.0,1.0,3.0,3.0,3.0,3.0,3.0,3.0,1.0,5.0,11.0,12.0,10.0,13.0,6.0,13.0,11.0,6.0,5.0,12.0,11.0,5.0,12.0,8.0,12.0,13.0,11.0,10.0,10.0,10.0,13.0,10.0,6.0,13.0,8.0,13.0,14.0,12.0,12.0,15.0,14.0,7.0,14.0,13.0,20.0,13.0,14.0,12.0,8.0,10.0,8.0,8.0,8.0,14.0,13.0,11.0,14.0,15.0,16.0,6.0,28.0,0.0,0.0,0.0,0.0,188.0,86.0,14.0,13.0,15.0,8.0,14.0,11.0,14.0,16.0,13.0,12.0,8.0,6.0,2.0,1.0,3.0,8.0,8.0,1.0,1.0,3.0,1.0,8.0,4.0,1.0,8.0,8.0,13.0,13.0,14.0,14.0,11.0,12.0,15.0,7.0,10.0,2.0,14.0,12.0,11.0,13.0,14.0,16.0,13.0,5.0,16.0,12.0,20.0,14.0,15.0,14.0,8.0,15.0,5.0,1.0,11.0,15.0,14.0,14.0,16.0,14.0,11.0,6.0,32.0,36.0,0.0,12.0,2.0,183.0,77.0,1.0,3.0,2.0,1.0,3.0,1.0,1.0,2.0,1.0,1.0,3.0,6.0,11.0,8.0,6.0,13.0,11.0,13.0,10.0,6.0,15.0,14.0,10.0,17.0,12.0,15.0,16.0,18.0,14.0,17.0,12.0,15.0,17.0,11.0,17.0,7.0,17.0,20.0,16.0,9.0,11.0,15.0,11.0,8.0,15.0,10.0,20.0,14.0,14.0,17.0,10.0,16.0,10.0,13.0,15.0,15.0,15.0,14.0,18.0,15.0,13.0,6.0,20.0,0.0,0.0,6.0,0.0,188.0,79.0,2.0,3.0,2.0,1.0,1.0,3.0,2.0,1.0,2.0,2.0,1.0,4.0,4.0,11.0,6.0,11.0,8.0,13.0,8.0,9.0,13.0,12.0,9.0,13.0,11.0,14.0,13.0,15.0,14.0,13.0,8.0,12.0,14.0,9.0,11.0,10.0,12.0,12.0,13.0,11.0,11.0,11.0,13.0,8.0,12.0,13.0,20.0,13.0,12.0,13.0,14.0,13.0,10.0,11.0,11.0,13.0,12.0,14.0,14.0,15.0,10.0,7.0,23.0,0.0,0.0,0.0,0.0,174.0,64.0,4.0,3.0,1.0,1.0,3.0,3.0,2.0,3.0,3.0,2.0,3.0,8.0,12.0,10.0,8.0,11.0,7.0,10.0,9.0,12.0,14.0,9.0,10.0,13.0,12.0,12.0,12.0,12.0,11.0,12.0,10.0,12.0,13.0,8.0,9.0,12.0,11.0,13.0,14.0,15.0,14.0,11.0,10.0,10.0,14.0,14.0,20.0,15.0,10.0,14.0,12.0,12.0,8.0,13.0,10.0,12.0,15.0,12.0,13.0,10.0,17.0,6.0,22.0,0.0,0.0,0.0,0.0,182.0,71.0,1.0,3.0,1.0,1.0,1.0,2.0,4.0,1.0,3.0,3.0,1.0,10.0,13.0,12.0,6.0,12.0,11.0,12.0,5.0,7.0,12.0,10.0,5.0,13.0,11.0,12.0,13.0,12.0,10.0,11.0,13.0,12.0,19.0,13.0,2.0,10.0,9.0,11.0,12.0,14.0,12.0,12.0,12.0,20.0,7.0,13.0,5.0,13.0,9.0,10.0,14.0,4.0,10.0,10.0,12.0,12.0,11.0,10.0,10.0,12.0,14.0,3.0,26.0,0.0,0.0,0.0,0.0,184.0,76.0,3.0,1.0,3.0,1.0,3.0,2.0,3.0,2.0,1.0,1.0,3.0,10.0,11.0,13.0,9.0,13.0,12.0,13.0,10.0,6.0,11.0,13.0,9.0,14.0,12.0,12.0,13.0,12.0,12.0,11.0,13.0,12.0,13.0,13.0,10.0,12.0,13.0,12.0,16.0,15.0,13.0,15.0,13.0,20.0,15.0,14.0,5.0,16.0,15.0,13.0,12.0,14.0,5.0,12.0,18.0,14.0,10.0,7.0,11.0,11.0,13.0,10.0,22.0,0.0,0.0,1.0,0.0,181.0,73.0,3.0,2.0,4.0,1.0,3.0,3.0,3.0,2.0,3.0,3.0,2.0,10.0,11.0,9.0,8.0,12.0,9.0,12.0,8.0,10.0,14.0,13.0,6.0,14.0,8.0,15.0,13.0,16.0,13.0,14.0,8.0,14.0,15.0,5.0,12.0,11.0,13.0,16.0,16.0,10.0,10.0,12.0,11.0,8.0,14.0,12.0,20.0,16.0,10.0,13.0,12.0,11.0,6.0,11.0,12.0,15.0,16.0,14.0,13.0,13.0,8.0,5.0,20.0,0.0,0.0,0.0,0.0,173.0,66.0,1.0,1.0,1.0,1.0,1.0,2.0,3.0,1.0,3.0,3.0,4.0,15.0,13.0,13.0,10.0,15.0,12.0,5.0,13.0,5.0,7.0,15.0,12.0,7.0,15.0,10.0,10.0,13.0,12.0,10.0,16.0,13.0,18.0,14.0,7.0,14.0,12.0,14.0,14.0,8.0,14.0,13.0,7.0,14.0,12.0,9.0,20.0,12.0,13.0,12.0,8.0,15.0,6.0,12.0,12.0,14.0,14.0,14.0,15.0,14.0,11.0,6.0,19.0,0.0,0.0,11.0,1.0,171.0,65.0,2.0,2.0,2.0,2.0,2.0,3.0,3.0,3.0,1.0,1.0,3.0,14.0,13.0,13.0,11.0,14.0,15.0,8.0,12.0,6.0,4.0,13.0,12.0,4.0,15.0,8.0,12.0,10.0,12.0,8.0,13.0,13.0,14.0,15.0,8.0,14.0,6.0,13.0,12.0,15.0,16.0,10.0,7.0,20.0,13.0,15.0,10.0,12.0,7.0,11.0,6.0,11.0,8.0,11.0,12.0,13.0,11.0,12.0,12.0,6.0,12.0,5.0,32.0,0.0,0.0,0.0,0.0,187.0,76.0,1.0,3.0,1.0,2.0,3.0,2.0,3.0,3.0,2.0,1.0,2.0,5.0,8.0,11.0,6.0,12.0,6.0,9.0,8.0,8.0,11.0,12.0,8.0,13.0,14.0,8.0,14.0,12.0,11.0,10.0,10.0,10.0,12.0,14.0,5.0,11.0,8.0,13.0,15.0,11.0,11.0,13.0,13.0,7.0,10.0,13.0,20.0,9.0,11.0,13.0,4.0,12.0,6.0,15.0,17.0,9.0,11.0,11.0,14.0,17.0,16.0,2.0,20.0,7.0,1.0,0.0,0.0,182.0,75.0,2.0,1.0,3.0,2.0,2.0,1.0,3.0,1.0,3.0,2.0,1.0,11.0,11.0,13.0,12.0,13.0,11.0,12.0,10.0,5.0,4.0,12.0,8.0,5.0,13.0,11.0,12.0,11.0,11.0,8.0,10.0,10.0,3.0,10.0,1.0,13.0,8.0,12.0,12.0,15.0,14.0,13.0,11.0,6.0,14.0,13.0,20.0,12.0,13.0,12.0,9.0,11.0,9.0,11.0,9.0,9.0,9.0,12.0,11.0,9.0,17.0,7.0
2,0,28.0,0.0,0.0,0.0,0.0,188.0,86.0,14.0,13.0,15.0,8.0,14.0,11.0,14.0,16.0,13.0,12.0,8.0,6.0,2.0,1.0,3.0,8.0,8.0,1.0,1.0,3.0,1.0,8.0,4.0,1.0,8.0,8.0,13.0,13.0,14.0,14.0,11.0,12.0,15.0,7.0,10.0,2.0,14.0,12.0,11.0,13.0,14.0,16.0,13.0,5.0,16.0,12.0,20.0,14.0,15.0,14.0,8.0,15.0,5.0,1.0,11.0,15.0,14.0,14.0,16.0,14.0,11.0,6.0,20.0,0.0,0.0,6.0,0.0,188.0,79.0,2.0,3.0,2.0,1.0,1.0,3.0,2.0,1.0,2.0,2.0,1.0,4.0,4.0,11.0,6.0,11.0,8.0,13.0,8.0,9.0,13.0,12.0,9.0,13.0,11.0,14.0,13.0,15.0,14.0,13.0,8.0,12.0,14.0,9.0,11.0,10.0,12.0,12.0,13.0,11.0,11.0,11.0,13.0,8.0,12.0,13.0,20.0,13.0,12.0,13.0,14.0,13.0,10.0,11.0,11.0,13.0,12.0,14.0,14.0,15.0,10.0,7.0,32.0,36.0,0.0,12.0,2.0,183.0,77.0,1.0,3.0,2.0,1.0,3.0,1.0,1.0,2.0,1.0,1.0,3.0,6.0,11.0,8.0,6.0,13.0,11.0,13.0,10.0,6.0,15.0,14.0,10.0,17.0,12.0,15.0,16.0,18.0,14.0,17.0,12.0,15.0,17.0,11.0,17.0,7.0,17.0,20.0,16.0,9.0,11.0,15.0,11.0,8.0,15.0,10.0,20.0,14.0,14.0,17.0,10.0,16.0,10.0,13.0,15.0,15.0,15.0,14.0,18.0,15.0,13.0,6.0,23.0,0.0,0.0,0.0,0.0,174.0,64.0,4.0,3.0,1.0,1.0,3.0,3.0,2.0,3.0,3.0,2.0,3.0,8.0,12.0,10.0,8.0,11.0,7.0,10.0,9.0,12.0,14.0,9.0,10.0,13.0,12.0,12.0,12.0,12.0,11.0,12.0,10.0,12.0,13.0,8.0,9.0,12.0,11.0,13.0,14.0,15.0,14.0,11.0,10.0,10.0,14.0,14.0,20.0,15.0,10.0,14.0,12.0,12.0,8.0,13.0,10.0,12.0,15.0,12.0,13.0,10.0,17.0,6.0,22.0,0.0,0.0,0.0,0.0,182.0,71.0,1.0,3.0,1.0,1.0,1.0,2.0,4.0,1.0,3.0,3.0,1.0,10.0,13.0,12.0,6.0,12.0,11.0,12.0,5.0,7.0,12.0,10.0,5.0,13.0,11.0,12.0,13.0,12.0,10.0,11.0,13.0,12.0,19.0,13.0,2.0,10.0,9.0,11.0,12.0,14.0,12.0,12.0,12.0,20.0,7.0,13.0,5.0,13.0,9.0,10.0,14.0,4.0,10.0,10.0,12.0,12.0,11.0,10.0,10.0,12.0,14.0,3.0,26.0,0.0,0.0,0.0,0.0,184.0,76.0,3.0,1.0,3.0,1.0,3.0,2.0,3.0,2.0,1.0,1.0,3.0,10.0,11.0,13.0,9.0,13.0,12.0,13.0,10.0,6.0,11.0,13.0,9.0,14.0,12.0,12.0,13.0,12.0,12.0,11.0,13.0,12.0,13.0,13.0,10.0,12.0,13.0,12.0,16.0,15.0,13.0,15.0,13.0,20.0,15.0,14.0,5.0,16.0,15.0,13.0,12.0,14.0,5.0,12.0,18.0,14.0,10.0,7.0,11.0,11.0,13.0,10.0,22.0,0.0,0.0,1.0,0.0,181.0,73.0,3.0,2.0,4.0,1.0,3.0,3.0,3.0,2.0,3.0,3.0,2.0,10.0,11.0,9.0,8.0,12.0,9.0,12.0,8.0,10.0,14.0,13.0,6.0,14.0,8.0,15.0,13.0,16.0,13.0,14.0,8.0,14.0,15.0,5.0,12.0,11.0,13.0,16.0,16.0,10.0,10.0,12.0,11.0,8.0,14.0,12.0,20.0,16.0,10.0,13.0,12.0,11.0,6.0,11.0,12.0,15.0,16.0,14.0,13.0,13.0,8.0,5.0,20.0,0.0,0.0,0.0,0.0,173.0,66.0,1.0,1.0,1.0,1.0,1.0,2.0,3.0,1.0,3.0,3.0,4.0,15.0,13.0,13.0,10.0,15.0,12.0,5.0,13.0,5.0,7.0,15.0,12.0,7.0,15.0,10.0,10.0,13.0,12.0,10.0,16.0,13.0,18.0,14.0,7.0,14.0,12.0,14.0,14.0,8.0,14.0,13.0,7.0,14.0,12.0,9.0,20.0,12.0,13.0,12.0,8.0,15.0,6.0,12.0,12.0,14.0,14.0,14.0,15.0,14.0,11.0,6.0,19.0,0.0,0.0,11.0,1.0,171.0,65.0,2.0,2.0,2.0,2.0,2.0,3.0,3.0,3.0,1.0,1.0,3.0,14.0,13.0,13.0,11.0,14.0,15.0,8.0,12.0,6.0,4.0,13.0,12.0,4.0,15.0,8.0,12.0,10.0,12.0,8.0,13.0,13.0,14.0,15.0,8.0,14.0,6.0,13.0,12.0,15.0,16.0,10.0,7.0,20.0,13.0,15.0,10.0,12.0,7.0,11.0,6.0,11.0,8.0,11.0,12.0,13.0,11.0,12.0,12.0,6.0,12.0,5.0,32.0,0.0,0.0,0.0,0.0,187.0,76.0,1.0,3.0,1.0,2.0,3.0,2.0,3.0,3.0,2.0,1.0,2.0,5.0,8.0,11.0,6.0,12.0,6.0,9.0,8.0,8.0,11.0,12.0,8.0,13.0,14.0,8.0,14.0,12.0,11.0,10.0,10.0,10.0,12.0,14.0,5.0,11.0,8.0,13.0,15.0,11.0,11.0,13.0,13.0,7.0,10.0,13.0,20.0,9.0,11.0,13.0,4.0,12.0,6.0,15.0,17.0,9.0,11.0,11.0,14.0,17.0,16.0,2.0,20.0,7.0,1.0,0.0,0.0,182.0,75.0,2.0,1.0,3.0,2.0,2.0,1.0,3.0,1.0,3.0,2.0,1.0,11.0,11.0,13.0,12.0,13.0,11.0,12.0,10.0,5.0,4.0,12.0,8.0,5.0,13.0,11.0,12.0,11.0,11.0,8.0,10.0,10.0,3.0,10.0,1.0,13.0,8.0,12.0,12.0,15.0,14.0,13.0,11.0,6.0,14.0,13.0,20.0,12.0,13.0,12.0,9.0,11.0,9.0,11.0,9.0,9.0,9.0,12.0,11.0,9.0,17.0,7.0,20.0,0.0,0.0,3.0,0.0,193.0,80.0,10.0,12.0,12.0,9.0,11.0,11.0,13.0,15.0,13.0,7.0,12.0,7.0,1.0,1.0,2.0,8.0,11.0,1.0,2.0,1.0,2.0,11.0,2.0,1.0,8.0,4.0,14.0,14.0,11.0,9.0,11.0,12.0,12.0,2.0,15.0,1.0,13.0,11.0,6.0,12.0,13.0,15.0,16.0,20.0,15.0,10.0,6.0,13.0,14.0,12.0,11.0,11.0,10.0,1.0,11.0,9.0,12.0,12.0,13.0,10.0,10.0,1.0,32.0,19.0,0.0,9.0,0.0,185.0,85.0,2.0,3.0,2.0,1.0,2.0,1.0,1.0,2.0,2.0,3.0,3.0,5.0,10.0,9.0,8.0,11.0,11.0,15.0,13.0,9.0,15.0,12.0,10.0,14.0,11.0,14.0,15.0,16.0,12.0,11.0,9.0,11.0,17.0,7.0,12.0,9.0,15.0,13.0,10.0,9.0,9.0,15.0,13.0,10.0,13.0,11.0,20.0,13.0,15.0,12.0,15.0,12.0,13.0,10.0,11.0,13.0,11.0,13.0,18.0,15.0,13.0,5.0,22.0,24.0,0.0,3.0,1.0,182.0,80.0,3.0,3.0,1.0,2.0,2.0,2.0,3.0,1.0,3.0,3.0,3.0,4.0,5.0,8.0,6.0,11.0,6.0,12.0,5.0,5.0,12.0,10.0,7.0,12.0,11.0,11.0,12.0,12.0,11.0,11.0,9.0,11.0,14.0,7.0,8.0,7.0,10.0,13.0,12.0,12.0,10.0,11.0,11.0,5.0,13.0,12.0,20.0,14.0,13.0,13.0,9.0,12.0,8.0,8.0,14.0,13.0,14.0,12.0,15.0,15.0,15.0,7.0,26.0,1.0,0.0,0.0,0.0,185.0,80.0,3.0,1.0,3.0,3.0,3.0,3.0,2.0,3.0,4.0,2.0,1.0,5.0,9.0,11.0,8.0,11.0,6.0,12.0,8.0,10.0,15.0,11.0,12.0,14.0,12.0,16.0,12.0,17.0,14.0,9.0,9.0,10.0,15.0,13.0,9.0,7.0,10.0,8.0,12.0,15.0,13.0,17.0,14.0,8.0,13.0,18.0,20.0,13.0,14.0,11.0,12.0,11.0,4.0,10.0,12.0,12.0,13.0,10.0,10.0,8.0,7.0,14.0,27.0,0.0,0.0,0.0,0.0,181.0,79.0,3.0,1.0,3.0,1.0,3.0,1.0,1.0,2.0,3.0,3.0,3.0,5.0,12.0,10.0,5.0,10.0,6.0,11.0,7.0,8.0,12.0,9.0,7.0,12.0,11.0,13.0,13.0,14.0,13.0,12.0,9.0,9.0,13.0,9.0,7.0,8.0,13.0,13.0,13.0,15.0,12.0,13.0,10.0,5.0,13.0,13.0,20.0,15.0,14.0,15.0,13.0,7.0,6.0,10.0,8.0,13.0,13.0,13.0,14.0,14.0,14.0,5.0,32.0,23.0,0.0,0.0,0.0,178.0,77.0,3.0,2.0,3.0,1.0,3.0,1.0,3.0,2.0,1.0,3.0,1.0,9.0,12.0,12.0,6.0,13.0,12.0,10.0,10.0,10.0,13.0,12.0,7.0,14.0,13.0,15.0,14.0,13.0,13.0,10.0,10.0,12.0,5.0,12.0,11.0,12.0,13.0,14.0,14.0,14.0,13.0,12.0,9.0,20.0,14.0,14.0,10.0,13.0,12.0,13.0,6.0,14.0,6.0,10.0,13.0,5.0,11.0,8.0,10.0,14.0,9.0,15.0,23.0,0.0,0.0,0.0,0.0,173.0,63.0,3.0,1.0,3.0,4.0,2.0,1.0,3.0,2.0,1.0,1.0,1.0,8.0,13.0,11.0,8.0,12.0,8.0,11.0,7.0,11.0,12.0,13.0,12.0,13.0,13.0,11.0,13.0,14.0,10.0,12.0,13.0,12.0,14.0,11.0,14.0,13.0,13.0,16.0,15.0,12.0,12.0,13.0,10.0,12.0,15.0,13.0,20.0,14.0,14.0,13.0,14.0,13.0,7.0,13.0,13.0,14.0,15.0,14.0,15.0,13.0,12.0,8.0,31.0,0.0,0.0,0.0,0.0,180.0,74.0,3.0,2.0,3.0,1.0,2.0,3.0,2.0,1.0,4.0,3.0,3.0,12.0,12.0,10.0,9.0,13.0,14.0,11.0,13.0,6.0,10.0,14.0,15.0,13.0,13.0,15.0,14.0,17.0,12.0,14.0,13.0,13.0,15.0,7.0,13.0,10.0,13.0,18.0,15.0,9.0,11.0,14.0,10.0,10.0,13.0,12.0,20.0,15.0,14.0,14.0,13.0,15.0,8.0,7.0,19.0,13.0,13.0,13.0,13.0,13.0,12.0,9.0,31.0,0.0,0.0,0.0,0.0,175.0,65.0,3.0,4.0,1.0,1.0,3.0,3.0,3.0,2.0,4.0,3.0,3.0,14.0,13.0,13.0,7.0,14.0,12.0,7.0,12.0,7.0,6.0,14.0,15.0,8.0,15.0,11.0,12.0,13.0,13.0,11.0,14.0,12.0,15.0,13.0,9.0,11.0,10.0,12.0,13.0,14.0,15.0,12.0,7.0,20.0,10.0,13.0,10.0,12.0,9.0,12.0,11.0,15.0,16.0,13.0,8.0,14.0,14.0,14.0,13.0,13.0,13.0,7.0,21.0,0.0,0.0,0.0,0.0,181.0,73.0,2.0,3.0,2.0,2.0,1.0,2.0,1.0,2.0,1.0,3.0,1.0,6.0,9.0,12.0,11.0,11.0,8.0,9.0,11.0,6.0,4.0,9.0,12.0,3.0,13.0,10.0,11.0,12.0,11.0,9.0,9.0,9.0,14.0,13.0,6.0,13.0,6.0,10.0,12.0,15.0,14.0,13.0,10.0,8.0,12.0,14.0,20.0,11.0,12.0,12.0,10.0,14.0,10.0,8.0,16.0,13.0,13.0,14.0,12.0,15.0,15.0,8.0,28.0,0.0,0.0,2.0,2.0,182.0,79.0,1.0,1.0,2.0,2.0,3.0,1.0,2.0,3.0,1.0,2.0,2.0,8.0,11.0,14.0,12.0,14.0,11.0,12.0,13.0,6.0,4.0,11.0,13.0,5.0,14.0,11.0,12.0,13.0,10.0,12.0,11.0,11.0,15.0,13.0,7.0,14.0,7.0,12.0,14.0,15.0,14.0,14.0,12.0,8.0,15.0,14.0,20.0,15.0,14.0,12.0,11.0,15.0,8.0,8.0,16.0,15.0,12.0,11.0,14.0,13.0,12.0,8.0
3,3,25.0,4.0,0.0,11.0,0.0,184.0,81.0,14.0,14.0,13.0,9.0,15.0,12.0,16.0,16.0,13.0,7.0,11.0,8.0,1.0,2.0,1.0,11.0,12.0,6.0,1.0,3.0,3.0,11.0,5.0,3.0,11.0,8.0,15.0,15.0,13.0,14.0,10.0,11.0,14.0,8.0,13.0,5.0,13.0,10.0,10.0,14.0,16.0,14.0,13.0,20.0,14.0,12.0,5.0,14.0,14.0,15.0,9.0,16.0,6.0,1.0,17.0,11.0,15.0,13.0,14.0,12.0,12.0,4.0,32.0,0.0,0.0,0.0,0.0,172.0,71.0,2.0,1.0,3.0,1.0,2.0,3.0,2.0,3.0,2.0,2.0,2.0,8.0,9.0,7.0,6.0,10.0,6.0,10.0,9.0,10.0,14.0,11.0,6.0,14.0,11.0,10.0,16.0,15.0,12.0,12.0,7.0,12.0,15.0,9.0,13.0,8.0,14.0,15.0,15.0,14.0,14.0,14.0,10.0,20.0,14.0,14.0,8.0,15.0,13.0,13.0,11.0,13.0,7.0,13.0,17.0,14.0,17.0,8.0,13.0,15.0,15.0,6.0,27.0,0.0,0.0,0.0,0.0,184.0,81.0,1.0,1.0,1.0,3.0,3.0,2.0,2.0,2.0,1.0,2.0,3.0,8.0,6.0,8.0,12.0,10.0,8.0,12.0,9.0,1.0,3.0,8.0,14.0,4.0,9.0,4.0,11.0,12.0,11.0,8.0,8.0,11.0,10.0,9.0,8.0,11.0,9.0,8.0,11.0,10.0,8.0,13.0,13.0,9.0,13.0,9.0,20.0,12.0,13.0,13.0,9.0,2.0,9.0,9.0,15.0,10.0,12.0,10.0,11.0,6.0,4.0,6.0,27.0,0.0,0.0,0.0,0.0,178.0,72.0,2.0,3.0,2.0,3.0,2.0,3.0,3.0,1.0,1.0,2.0,1.0,13.0,14.0,11.0,7.0,12.0,10.0,9.0,10.0,13.0,13.0,12.0,10.0,14.0,13.0,12.0,14.0,14.0,13.0,14.0,11.0,12.0,14.0,13.0,8.0,14.0,13.0,13.0,15.0,15.0,13.0,10.0,10.0,20.0,13.0,15.0,6.0,14.0,10.0,13.0,13.0,12.0,8.0,12.0,15.0,14.0,13.0,14.0,13.0,13.0,12.0,6.0,20.0,4.0,0.0,0.0,0.0,180.0,77.0,4.0,1.0,2.0,2.0,1.0,1.0,1.0,1.0,3.0,3.0,3.0,7.0,9.0,11.0,5.0,12.0,5.0,11.0,7.0,10.0,15.0,11.0,6.0,16.0,11.0,15.0,11.0,15.0,11.0,11.0,10.0,13.0,13.0,9.0,7.0,12.0,14.0,12.0,14.0,14.0,13.0,14.0,12.0,10.0,14.0,14.0,20.0,14.0,14.0,13.0,9.0,13.0,5.0,12.0,7.0,12.0,10.0,10.0,10.0,4.0,7.0,10.0,19.0,0.0,0.0,0.0,0.0,185.0,82.0,4.0,2.0,3.0,1.0,3.0,2.0,1.0,2.0,1.0,2.0,3.0,7.0,7.0,10.0,6.0,13.0,7.0,14.0,7.0,6.0,12.0,13.0,7.0,13.0,13.0,13.0,13.0,13.0,11.0,12.0,11.0,12.0,14.0,9.0,14.0,11.0,11.0,15.0,15.0,12.0,12.0,14.0,13.0,5.0,14.0,12.0,20.0,14.0,13.0,10.0,11.0,11.0,6.0,10.0,10.0,12.0,12.0,14.0,14.0,11.0,16.0,6.0,22.0,0.0,0.0,4.0,0.0,180.0,80.0,4.0,1.0,1.0,3.0,2.0,3.0,1.0,3.0,3.0,3.0,4.0,7.0,10.0,11.0,8.0,15.0,11.0,10.0,14.0,5.0,14.0,15.0,10.0,15.0,15.0,13.0,14.0,13.0,12.0,14.0,15.0,13.0,16.0,12.0,8.0,15.0,13.0,13.0,13.0,13.0,13.0,12.0,10.0,12.0,12.0,12.0,20.0,13.0,12.0,13.0,10.0,12.0,7.0,11.0,12.0,15.0,12.0,16.0,15.0,10.0,10.0,7.0,22.0,24.0,3.0,7.0,0.0,177.0,78.0,2.0,1.0,2.0,3.0,2.0,2.0,4.0,3.0,3.0,2.0,1.0,10.0,13.0,16.0,14.0,16.0,16.0,8.0,16.0,4.0,4.0,15.0,12.0,4.0,16.0,12.0,11.0,12.0,13.0,10.0,11.0,8.0,13.0,17.0,5.0,14.0,5.0,10.0,12.0,15.0,14.0,13.0,9.0,10.0,17.0,16.0,20.0,15.0,14.0,12.0,11.0,15.0,4.0,12.0,19.0,16.0,14.0,14.0,11.0,13.0,10.0,12.0,22.0,0.0,0.0,0.0,0.0,186.0,0.0,1.0,2.0,3.0,3.0,1.0,3.0,1.0,2.0,1.0,2.0,1.0,4.0,1.0,12.0,12.0,12.0,1.0,7.0,5.0,1.0,3.0,5.0,1.0,1.0,8.0,8.0,6.0,6.0,4.0,5.0,4.0,11.0,6.0,9.0,12.0,12.0,5.0,4.0,5.0,12.0,12.0,5.0,11.0,12.0,10.0,12.0,20.0,6.0,8.0,8.0,8.0,8.0,7.0,8.0,13.0,11.0,12.0,13.0,12.0,5.0,14.0,5.0,20.0,29.0,2.0,0.0,0.0,181.0,75.0,1.0,1.0,2.0,2.0,2.0,3.0,2.0,1.0,1.0,3.0,2.0,5.0,9.0,15.0,10.0,11.0,9.0,10.0,8.0,7.0,3.0,10.0,10.0,5.0,15.0,7.0,10.0,9.0,12.0,10.0,8.0,11.0,14.0,12.0,5.0,13.0,5.0,11.0,12.0,16.0,12.0,9.0,12.0,20.0,14.0,16.0,7.0,12.0,10.0,9.0,10.0,10.0,11.0,6.0,10.0,15.0,9.0,13.0,11.0,14.0,18.0,7.0,22.0,5.0,1.0,1.0,0.0,173.0,72.0,1.0,3.0,1.0,3.0,3.0,3.0,3.0,3.0,3.0,2.0,2.0,14.0,13.0,16.0,14.0,16.0,14.0,5.0,11.0,5.0,5.0,15.0,11.0,5.0,16.0,8.0,13.0,9.0,14.0,13.0,15.0,13.0,15.0,16.0,5.0,13.0,5.0,9.0,10.0,15.0,16.0,14.0,5.0,20.0,14.0,15.0,5.0,12.0,14.0,13.0,11.0,13.0,8.0,14.0,10.0,15.0,14.0,10.0,13.0,10.0,10.0,13.0,28.0,0.0,0.0,0.0,0.0,188.0,86.0,14.0,13.0,15.0,8.0,14.0,11.0,14.0,16.0,13.0,12.0,8.0,6.0,2.0,1.0,3.0,8.0,8.0,1.0,1.0,3.0,1.0,8.0,4.0,1.0,8.0,8.0,13.0,13.0,14.0,14.0,11.0,12.0,15.0,7.0,10.0,2.0,14.0,12.0,11.0,13.0,14.0,16.0,13.0,5.0,16.0,12.0,20.0,14.0,15.0,14.0,8.0,15.0,5.0,1.0,11.0,15.0,14.0,14.0,16.0,14.0,11.0,6.0,20.0,0.0,0.0,6.0,0.0,188.0,79.0,2.0,3.0,2.0,1.0,1.0,3.0,2.0,1.0,2.0,2.0,1.0,4.0,4.0,11.0,6.0,11.0,8.0,13.0,8.0,9.0,13.0,12.0,9.0,13.0,11.0,14.0,13.0,15.0,14.0,13.0,8.0,12.0,14.0,9.0,11.0,10.0,12.0,12.0,13.0,11.0,11.0,11.0,13.0,8.0,12.0,13.0,20.0,13.0,12.0,13.0,14.0,13.0,10.0,11.0,11.0,13.0,12.0,14.0,14.0,15.0,10.0,7.0,32.0,36.0,0.0,12.0,2.0,183.0,77.0,1.0,3.0,2.0,1.0,3.0,1.0,1.0,2.0,1.0,1.0,3.0,6.0,11.0,8.0,6.0,13.0,11.0,13.0,10.0,6.0,15.0,14.0,10.0,17.0,12.0,15.0,16.0,18.0,14.0,17.0,12.0,15.0,17.0,11.0,17.0,7.0,17.0,20.0,16.0,9.0,11.0,15.0,11.0,8.0,15.0,10.0,20.0,14.0,14.0,17.0,10.0,16.0,10.0,13.0,15.0,15.0,15.0,14.0,18.0,15.0,13.0,6.0,23.0,0.0,0.0,0.0,0.0,174.0,64.0,4.0,3.0,1.0,1.0,3.0,3.0,2.0,3.0,3.0,2.0,3.0,8.0,12.0,10.0,8.0,11.0,7.0,10.0,9.0,12.0,14.0,9.0,10.0,13.0,12.0,12.0,12.0,12.0,11.0,12.0,10.0,12.0,13.0,8.0,9.0,12.0,11.0,13.0,14.0,15.0,14.0,11.0,10.0,10.0,14.0,14.0,20.0,15.0,10.0,14.0,12.0,12.0,8.0,13.0,10.0,12.0,15.0,12.0,13.0,10.0,17.0,6.0,22.0,0.0,0.0,0.0,0.0,182.0,71.0,1.0,3.0,1.0,1.0,1.0,2.0,4.0,1.0,3.0,3.0,1.0,10.0,13.0,12.0,6.0,12.0,11.0,12.0,5.0,7.0,12.0,10.0,5.0,13.0,11.0,12.0,13.0,12.0,10.0,11.0,13.0,12.0,19.0,13.0,2.0,10.0,9.0,11.0,12.0,14.0,12.0,12.0,12.0,20.0,7.0,13.0,5.0,13.0,9.0,10.0,14.0,4.0,10.0,10.0,12.0,12.0,11.0,10.0,10.0,12.0,14.0,3.0,26.0,0.0,0.0,0.0,0.0,184.0,76.0,3.0,1.0,3.0,1.0,3.0,2.0,3.0,2.0,1.0,1.0,3.0,10.0,11.0,13.0,9.0,13.0,12.0,13.0,10.0,6.0,11.0,13.0,9.0,14.0,12.0,12.0,13.0,12.0,12.0,11.0,13.0,12.0,13.0,13.0,10.0,12.0,13.0,12.0,16.0,15.0,13.0,15.0,13.0,20.0,15.0,14.0,5.0,16.0,15.0,13.0,12.0,14.0,5.0,12.0,18.0,14.0,10.0,7.0,11.0,11.0,13.0,10.0,22.0,0.0,0.0,1.0,0.0,181.0,73.0,3.0,2.0,4.0,1.0,3.0,3.0,3.0,2.0,3.0,3.0,2.0,10.0,11.0,9.0,8.0,12.0,9.0,12.0,8.0,10.0,14.0,13.0,6.0,14.0,8.0,15.0,13.0,16.0,13.0,14.0,8.0,14.0,15.0,5.0,12.0,11.0,13.0,16.0,16.0,10.0,10.0,12.0,11.0,8.0,14.0,12.0,20.0,16.0,10.0,13.0,12.0,11.0,6.0,11.0,12.0,15.0,16.0,14.0,13.0,13.0,8.0,5.0,20.0,0.0,0.0,0.0,0.0,173.0,66.0,1.0,1.0,1.0,1.0,1.0,2.0,3.0,1.0,3.0,3.0,4.0,15.0,13.0,13.0,10.0,15.0,12.0,5.0,13.0,5.0,7.0,15.0,12.0,7.0,15.0,10.0,10.0,13.0,12.0,10.0,16.0,13.0,18.0,14.0,7.0,14.0,12.0,14.0,14.0,8.0,14.0,13.0,7.0,14.0,12.0,9.0,20.0,12.0,13.0,12.0,8.0,15.0,6.0,12.0,12.0,14.0,14.0,14.0,15.0,14.0,11.0,6.0,19.0,0.0,0.0,11.0,1.0,171.0,65.0,2.0,2.0,2.0,2.0,2.0,3.0,3.0,3.0,1.0,1.0,3.0,14.0,13.0,13.0,11.0,14.0,15.0,8.0,12.0,6.0,4.0,13.0,12.0,4.0,15.0,8.0,12.0,10.0,12.0,8.0,13.0,13.0,14.0,15.0,8.0,14.0,6.0,13.0,12.0,15.0,16.0,10.0,7.0,20.0,13.0,15.0,10.0,12.0,7.0,11.0,6.0,11.0,8.0,11.0,12.0,13.0,11.0,12.0,12.0,6.0,12.0,5.0,32.0,0.0,0.0,0.0,0.0,187.0,76.0,1.0,3.0,1.0,2.0,3.0,2.0,3.0,3.0,2.0,1.0,2.0,5.0,8.0,11.0,6.0,12.0,6.0,9.0,8.0,8.0,11.0,12.0,8.0,13.0,14.0,8.0,14.0,12.0,11.0,10.0,10.0,10.0,12.0,14.0,5.0,11.0,8.0,13.0,15.0,11.0,11.0,13.0,13.0,7.0,10.0,13.0,20.0,9.0,11.0,13.0,4.0,12.0,6.0,15.0,17.0,9.0,11.0,11.0,14.0,17.0,16.0,2.0,20.0,7.0,1.0,0.0,0.0,182.0,75.0,2.0,1.0,3.0,2.0,2.0,1.0,3.0,1.0,3.0,2.0,1.0,11.0,11.0,13.0,12.0,13.0,11.0,12.0,10.0,5.0,4.0,12.0,8.0,5.0,13.0,11.0,12.0,11.0,11.0,8.0,10.0,10.0,3.0,10.0,1.0,13.0,8.0,12.0,12.0,15.0,14.0,13.0,11.0,6.0,14.0,13.0,20.0,12.0,13.0,12.0,9.0,11.0,9.0,11.0,9.0,9.0,9.0,12.0,11.0,9.0,17.0,7.0
1,1,25.0,0.0,0.0,0.0,0.0,187.0,83.0,11.0,14.0,12.0,8.0,13.0,11.0,14.0,15.0,13.0,13.0,9.0,8.0,1.0,1.0,1.0,11.0,11.0,1.0,2.0,2.0,1.0,10.0,3.0,2.0,11.0,8.0,12.0,14.0,12.0,12.0,10.0,12.0,14.0,6.0,14.0,2.0,12.0,12.0,8.0,13.0,15.0,14.0,13.0,20.0,15.0,11.0,5.0,14.0,13.0,13.0,8.0,8.0,10.0,1.0,9.0,13.0,14.0,12.0,15.0,15.0,15.0,5.0,26.0,0.0,0.0,0.0,0.0,183.0,79.0,1.0,1.0,3.0,4.0,3.0,2.0,2.0,1.0,2.0,1.0,1.0,9.0,8.0,12.0,11.0,10.0,11.0,10.0,9.0,7.0,6.0,8.0,9.0,5.0,12.0,10.0,9.0,8.0,11.0,11.0,9.0,8.0,11.0,14.0,6.0,12.0,8.0,10.0,11.0,11.0,12.0,11.0,10.0,10.0,10.0,12.0,20.0,11.0,11.0,9.0,9.0,9.0,6.0,13.0,17.0,11.0,10.0,11.0,12.0,10.0,10.0,4.0,31.0,0.0,0.0,7.0,2.0,185.0,80.0,3.0,3.0,1.0,1.0,4.0,1.0,4.0,3.0,3.0,3.0,1.0,5.0,10.0,9.0,6.0,11.0,7.0,15.0,8.0,8.0,14.0,12.0,6.0,13.0,11.0,12.0,14.0,16.0,12.0,13.0,8.0,11.0,17.0,5.0,14.0,6.0,15.0,14.0,14.0,12.0,11.0,15.0,14.0,10.0,16.0,11.0,20.0,14.0,15.0,14.0,12.0,15.0,8.0,13.0,8.0,15.0,17.0,14.0,16.0,15.0,15.0,7.0,23.0,0.0,0.0,0.0,0.0,172.0,70.0,3.0,3.0,3.0,1.0,1.0,2.0,4.0,2.0,4.0,2.0,1.0,5.0,12.0,11.0,7.0,12.0,6.0,9.0,7.0,11.0,12.0,12.0,8.0,13.0,12.0,12.0,12.0,14.0,11.0,12.0,9.0,11.0,14.0,8.0,7.0,12.0,10.0,14.0,15.0,13.0,13.0,11.0,7.0,6.0,14.0,14.0,20.0,15.0,11.0,12.0,10.0,12.0,10.0,11.0,16.0,12.0,14.0,10.0,14.0,12.0,10.0,6.0,18.0,0.0,0.0,0.0,0.0,185.0,74.0,2.0,2.0,1.0,3.0,3.0,1.0,4.0,2.0,2.0,3.0,2.0,8.0,6.0,8.0,6.0,10.0,6.0,13.0,5.0,9.0,12.0,10.0,9.0,13.0,10.0,12.0,12.0,13.0,11.0,12.0,8.0,11.0,12.0,3.0,8.0,8.0,11.0,10.0,13.0,13.0,11.0,12.0,12.0,6.0,12.0,12.0,20.0,13.0,14.0,11.0,7.0,10.0,5.0,10.0,7.0,13.0,12.0,12.0,13.0,9.0,15.0,7.0,27.0,0.0,0.0,0.0,0.0,186.0,77.0,2.0,4.0,2.0,2.0,1.0,1.0,1.0,3.0,2.0,2.0,1.0,10.0,11.0,12.0,10.0,13.0,11.0,12.0,14.0,8.0,10.0,14.0,6.0,12.0,13.0,13.0,12.0,13.0,12.0,12.0,12.0,12.0,14.0,9.0,10.0,12.0,11.0,14.0,15.0,12.0,13.0,14.0,12.0,20.0,12.0,11.0,9.0,16.0,13.0,13.0,13.0,13.0,15.0,12.0,14.0,13.0,14.0,13.0,15.0,15.0,15.0,5.0,26.0,0.0,0.0,16.0,0.0,189.0,79.0,4.0,3.0,1.0,3.0,1.0,3.0,3.0,1.0,2.0,1.0,2.0,8.0,8.0,9.0,8.0,10.0,12.0,11.0,10.0,6.0,13.0,13.0,13.0,12.0,12.0,14.0,18.0,13.0,13.0,17.0,6.0,12.0,13.0,9.0,8.0,10.0,15.0,14.0,15.0,10.0,10.0,12.0,15.0,10.0,12.0,12.0,20.0,14.0,12.0,17.0,10.0,13.0,5.0,6.0,18.0,13.0,14.0,13.0,12.0,12.0,13.0,6.0,32.0,55.0,14.0,0.0,0.0,168.0,76.0,1.0,3.0,3.0,3.0,3.0,3.0,2.0,3.0,4.0,3.0,1.0,11.0,12.0,15.0,10.0,13.0,8.0,6.0,4.0,8.0,2.0,12.0,12.0,5.0,16.0,14.0,15.0,10.0,8.0,9.0,11.0,11.0,11.0,17.0,4.0,13.0,6.0,7.0,7.0,18.0,17.0,12.0,6.0,8.0,16.0,15.0,20.0,14.0,9.0,7.0,9.0,15.0,5.0,14.0,7.0,15.0,8.0,12.0,10.0,5.0,6.0,15.0,20.0,0.0,0.0,0.0,0.0,188.0,81.0,2.0,4.0,1.0,4.0,2.0,3.0,3.0,1.0,1.0,1.0,3.0,5.0,12.0,12.0,12.0,12.0,8.0,11.0,8.0,6.0,4.0,13.0,6.0,4.0,13.0,14.0,12.0,14.0,9.0,12.0,12.0,10.0,15.0,13.0,7.0,13.0,7.0,8.0,12.0,14.0,13.0,12.0,14.0,9.0,15.0,14.0,20.0,11.0,12.0,12.0,11.0,14.0,4.0,11.0,15.0,14.0,14.0,10.0,9.0,10.0,10.0,8.0,28.0,0.0,0.0,0.0,0.0,176.0,72.0,2.0,1.0,2.0,2.0,3.0,3.0,2.0,2.0,3.0,2.0,1.0,6.0,11.0,13.0,10.0,13.0,9.0,12.0,12.0,5.0,5.0,11.0,13.0,5.0,13.0,10.0,13.0,11.0,12.0,13.0,10.0,12.0,13.0,12.0,6.0,14.0,8.0,12.0,14.0,15.0,14.0,14.0,10.0,8.0,12.0,13.0,20.0,14.0,13.0,11.0,10.0,9.0,8.0,5.0,10.0,13.0,15.0,12.0,13.0,11.0,11.0,8.0,27.0,17.0,2.0,0.0,0.0,180.0,78.0,2.0,3.0,2.0,1.0,1.0,2.0,1.0,1.0,2.0,3.0,2.0,7.0,10.0,13.0,12.0,13.0,11.0,12.0,12.0,7.0,5.0,12.0,9.0,4.0,12.0,12.0,13.0,14.0,10.0,11.0,11.0,10.0,12.0,14.0,5.0,13.0,7.0,10.0,14.0,16.0,15.0,14.0,11.0,20.0,12.0,15.0,8.0,14.0,14.0,11.0,12.0,15.0,9.0,10.0,6.0,14.0,12.0,11.0,13.0,13.0,13.0,10.0,19.0,0.0,0.0,0.0,0.0,193.0,84.0,14.0,11.0,10.0,9.0,12.0,13.0,13.0,13.0,9.0,8.0,13.0,4.0,2.0,1.0,3.0,7.0,7.0,2.0,3.0,1.0,1.0,8.0,1.0,3.0,7.0,8.0,11.0,12.0,10.0,12.0,8.0,10.0,10.0,6.0,7.0,1.0,12.0,11.0,10.0,9.0,13.0,12.0,13.0,5.0,15.0,8.0,20.0,12.0,14.0,12.0,10.0,4.0,3.0,10.0,18.0,13.0,13.0,9.0,13.0,11.0,19.0,4.0,33.0,24.0,1.0,3.0,0.0,193.0,90.0,1.0,2.0,2.0,2.0,3.0,2.0,3.0,1.0,3.0,2.0,3.0,3.0,6.0,8.0,8.0,11.0,10.0,17.0,8.0,5.0,13.0,10.0,7.0,14.0,11.0,14.0,14.0,16.0,11.0,10.0,9.0,10.0,14.0,7.0,13.0,7.0,13.0,14.0,11.0,9.0,10.0,15.0,15.0,7.0,13.0,10.0,20.0,10.0,13.0,10.0,13.0,15.0,9.0,8.0,12.0,15.0,13.0,11.0,15.0,12.0,13.0,7.0,23.0,2.0,0.0,0.0,0.0,188.0,85.0,1.0,3.0,2.0,2.0,1.0,3.0,3.0,2.0,3.0,2.0,1.0,7.0,8.0,7.0,5.0,12.0,5.0,14.0,9.0,7.0,13.0,11.0,6.0,13.0,12.0,14.0,13.0,13.0,11.0,12.0,6.0,12.0,5.0,1.0,6.0,8.0,12.0,14.0,13.0,12.0,11.0,14.0,15.0,6.0,13.0,11.0,20.0,14.0,15.0,13.0,9.0,7.0,10.0,10.0,12.0,12.0,13.0,10.0,9.0,8.0,8.0,2.0,16.0,0.0,0.0,0.0,0.0,177.0,0.0,3.0,2.0,1.0,1.0,3.0,3.0,2.0,2.0,2.0,1.0,3.0,1.0,3.0,2.0,2.0,4.0,1.0,3.0,1.0,6.0,9.0,2.0,1.0,9.0,6.0,14.0,4.0,5.0,5.0,3.0,2.0,5.0,4.0,5.0,7.0,4.0,8.0,4.0,3.0,10.0,7.0,13.0,7.0,15.0,13.0,9.0,20.0,5.0,8.0,7.0,11.0,5.0,8.0,8.0,11.0,11.0,5.0,14.0,20.0,7.0,12.0,5.0,24.0,0.0,0.0,0.0,0.0,178.0,77.0,2.0,1.0,3.0,2.0,1.0,3.0,3.0,3.0,1.0,3.0,2.0,5.0,10.0,8.0,5.0,9.0,6.0,11.0,8.0,12.0,11.0,8.0,6.0,12.0,9.0,11.0,11.0,13.0,11.0,12.0,7.0,11.0,15.0,9.0,6.0,9.0,11.0,12.0,14.0,16.0,12.0,14.0,10.0,5.0,15.0,15.0,20.0,14.0,13.0,14.0,11.0,13.0,5.0,8.0,17.0,12.0,14.0,14.0,14.0,14.0,14.0,6.0,30.0,0.0,0.0,0.0,0.0,178.0,79.0,1.0,2.0,2.0,3.0,2.0,2.0,1.0,2.0,1.0,2.0,1.0,11.0,13.0,9.0,6.0,11.0,11.0,12.0,11.0,10.0,12.0,12.0,7.0,13.0,11.0,15.0,13.0,15.0,11.0,12.0,10.0,12.0,13.0,12.0,15.0,10.0,12.0,16.0,15.0,14.0,12.0,13.0,9.0,5.0,13.0,12.0,20.0,15.0,14.0,14.0,14.0,13.0,9.0,14.0,18.0,12.0,15.0,14.0,14.0,14.0,14.0,6.0,26.0,0.0,0.0,0.0,0.0,184.0,76.0,2.0,3.0,1.0,3.0,1.0,1.0,3.0,1.0,3.0,2.0,2.0,10.0,12.0,14.0,12.0,14.0,12.0,11.0,13.0,11.0,13.0,14.0,13.0,12.0,15.0,14.0,13.0,12.0,11.0,11.0,13.0,14.0,14.0,12.0,13.0,12.0,11.0,11.0,14.0,15.0,14.0,13.0,10.0,5.0,14.0,14.0,20.0,14.0,14.0,14.0,7.0,16.0,6.0,8.0,19.0,14.0,14.0,14.0,14.0,14.0,14.0,6.0,22.0,0.0,0.0,0.0,0.0,188.0,79.0,1.0,2.0,2.0,3.0,2.0,2.0,3.0,4.0,3.0,2.0,1.0,8.0,10.0,11.0,7.0,11.0,8.0,10.0,8.0,7.0,8.0,10.0,10.0,11.0,11.0,11.0,12.0,13.0,11.0,10.0,8.0,11.0,10.0,8.0,8.0,12.0,10.0,12.0,15.0,13.0,12.0,14.0,14.0,20.0,13.0,12.0,8.0,14.0,14.0,12.0,10.0,6.0,8.0,15.0,11.0,11.0,11.0,11.0,11.0,10.0,12.0,6.0,29.0,0.0,0.0,0.0,0.0,180.0,74.0,2.0,1.0,3.0,3.0,2.0,4.0,1.0,3.0,3.0,2.0,2.0,9.0,13.0,13.0,10.0,14.0,10.0,12.0,12.0,6.0,8.0,12.0,8.0,8.0,14.0,10.0,13.0,14.0,13.0,12.0,13.0,11.0,13.0,11.0,7.0,10.0,10.0,14.0,14.0,14.0,13.0,13.0,12.0,10.0,14.0,13.0,20.0,14.0,11.0,14.0,10.0,15.0,8.0,10.0,8.0,12.0,14.0,16.0,14.0,15.0,15.0,6.0,18.0,0.0,0.0,0.0,0.0,183.0,70.0,1.0,2.0,2.0,1.0,1.0,2.0,2.0,1.0,2.0,1.0,3.0,10.0,11.0,12.0,7.0,11.0,9.0,10.0,9.0,10.0,5.0,10.0,8.0,5.0,12.0,9.0,10.0,10.0,9.0,8.0,9.0,9.0,11.0,10.0,7.0,12.0,6.0,11.0,12.0,14.0,12.0,10.0,11.0,6.0,12.0,13.0,20.0,11.0,9.0,12.0,10.0,3.0,9.0,10.0,17.0,12.0,12.0,13.0,11.0,12.0,12.0,2.0,24.0,0.0,0.0,0.0,0.0,179.0,85.0,2.0,4.0,2.0,3.0,1.0,1.0,1.0,1.0,1.0,1.0,2.0,4.0,8.0,12.0,14.0,11.0,8.0,13.0,11.0,7.0,8.0,9.0,12.0,6.0,12.0,12.0,12.0,13.0,13.0,14.0,9.0,14.0,16.0,11.0,8.0,13.0,5.0,11.0,12.0,11.0,13.0,16.0,10.0,9.0,2.0,12.0,20.0,14.0,16.0,14.0,12.0,13.0,7.0,5.0,19.0,13.0,13.0,8.0,12.0,12.0,12.0,10.0
0,0,30.0,42.0,0.0,13.0,0.0,195.0,88.0,16.0,13.0,14.0,6.0,14.0,13.0,13.0,15.0,12.0,10.0,14.0,1.0,8.0,5.0,2.0,8.0,2.0,8.0,2.0,5.0,3.0,9.0,5.0,3.0,8.0,10.0,12.0,10.0,14.0,10.0,10.0,14.0,13.0,3.0,14.0,3.0,12.0,14.0,12.0,8.0,13.0,18.0,18.0,17.0,14.0,11.0,20.0,14.0,17.0,14.0,4.0,14.0,4.0,1.0,12.0,13.0,14.0,9.0,15.0,13.0,13.0,5.0,24.0,0.0,0.0,0.0,0.0,185.0,77.0,1.0,1.0,3.0,2.0,1.0,1.0,3.0,1.0,3.0,3.0,1.0,7.0,10.0,12.0,11.0,12.0,12.0,14.0,13.0,7.0,13.0,12.0,8.0,14.0,12.0,10.0,13.0,11.0,13.0,13.0,12.0,13.0,16.0,10.0,8.0,12.0,13.0,13.0,13.0,14.0,14.0,12.0,14.0,12.0,14.0,13.0,20.0,11.0,12.0,12.0,12.0,10.0,11.0,7.0,17.0,11.0,10.0,10.0,10.0,7.0,8.0,5.0,28.0,0.0,0.0,0.0,0.0,190.0,85.0,3.0,2.0,3.0,3.0,2.0,2.0,2.0,4.0,3.0,1.0,2.0,5.0,9.0,8.0,9.0,8.0,7.0,14.0,10.0,9.0,15.0,9.0,6.0,14.0,9.0,16.0,13.0,16.0,10.0,13.0,10.0,12.0,15.0,6.0,13.0,7.0,13.0,14.0,16.0,12.0,11.0,17.0,13.0,20.0,15.0,13.0,8.0,15.0,15.0,12.0,14.0,14.0,9.0,8.0,14.0,13.0,14.0,11.0,12.0,13.0,16.0,14.0,23.0,0.0,0.0,0.0,0.0,184.0,71.0,1.0,2.0,1.0,2.0,2.0,2.0,2.0,4.0,2.0,1.0,3.0,4.0,10.0,10.0,6.0,11.0,6.0,14.0,8.0,7.0,14.0,11.0,6.0,13.0,11.0,12.0,12.0,13.0,12.0,11.0,12.0,12.0,14.0,6.0,8.0,10.0,13.0,13.0,14.0,15.0,13.0,14.0,13.0,8.0,12.0,14.0,20.0,13.0,14.0,13.0,12.0,14.0,15.0,8.0,11.0,13.0,13.0,10.0,8.0,9.0,16.0,7.0,28.0,0.0,0.0,0.0,0.0,174.0,67.0,3.0,4.0,1.0,1.0,1.0,3.0,1.0,3.0,2.0,1.0,2.0,11.0,8.0,11.0,9.0,13.0,6.0,7.0,12.0,8.0,10.0,10.0,3.0,6.0,12.0,10.0,13.0,7.0,12.0,8.0,10.0,9.0,12.0,13.0,5.0,12.0,9.0,12.0,11.0,14.0,14.0,11.0,7.0,10.0,15.0,12.0,20.0,11.0,6.0,9.0,6.0,10.0,10.0,9.0,11.0,14.0,9.0,11.0,12.0,8.0,8.0,8.0,21.0,0.0,0.0,0.0,0.0,178.0,65.0,2.0,3.0,3.0,3.0,3.0,1.0,1.0,1.0,1.0,3.0,1.0,9.0,13.0,11.0,6.0,12.0,7.0,9.0,8.0,8.0,13.0,12.0,7.0,13.0,12.0,8.0,12.0,13.0,12.0,12.0,13.0,13.0,14.0,9.0,8.0,12.0,12.0,13.0,13.0,12.0,14.0,13.0,11.0,8.0,15.0,12.0,20.0,13.0,12.0,14.0,8.0,11.0,7.0,10.0,19.0,10.0,13.0,10.0,11.0,15.0,15.0,6.0,22.0,0.0,0.0,0.0,0.0,187.0,84.0,2.0,2.0,1.0,2.0,3.0,2.0,2.0,3.0,3.0,2.0,2.0,4.0,7.0,10.0,6.0,9.0,10.0,13.0,12.0,5.0,11.0,11.0,7.0,10.0,12.0,12.0,11.0,13.0,10.0,9.0,11.0,9.0,15.0,8.0,7.0,9.0,11.0,11.0,14.0,13.0,10.0,15.0,14.0,8.0,15.0,11.0,20.0,14.0,15.0,11.0,12.0,7.0,9.0,8.0,7.0,13.0,15.0,13.0,11.0,14.0,14.0,7.0,22.0,0.0,0.0,0.0,0.0,177.0,72.0,2.0,1.0,2.0,4.0,2.0,2.0,1.0,3.0,4.0,2.0,3.0,10.0,12.0,13.0,11.0,12.0,10.0,12.0,12.0,4.0,10.0,13.0,11.0,11.0,13.0,11.0,12.0,11.0,13.0,9.0,13.0,12.0,3.0,12.0,8.0,14.0,12.0,12.0,13.0,16.0,13.0,12.0,9.0,8.0,15.0,14.0,20.0,14.0,13.0,10.0,4.0,11.0,11.0,12.0,19.0,9.0,12.0,13.0,12.0,11.0,14.0,7.0,24.0,0.0,0.0,0.0,0.0,172.0,72.0,1.0,1.0,3.0,2.0,2.0,1.0,1.0,1.0,1.0,3.0,1.0,10.0,11.0,12.0,10.0,11.0,8.0,8.0,10.0,7.0,7.0,11.0,11.0,6.0,12.0,8.0,11.0,11.0,10.0,10.0,11.0,12.0,15.0,12.0,5.0,10.0,11.0,13.0,15.0,15.0,13.0,10.0,9.0,8.0,14.0,13.0,20.0,14.0,11.0,11.0,8.0,13.0,7.0,12.0,18.0,13.0,10.0,10.0,11.0,11.0,11.0,6.0,24.0,2.0,0.0,0.0,0.0,195.0,84.0,1.0,4.0,1.0,2.0,3.0,1.0,2.0,1.0,2.0,1.0,1.0,6.0,6.0,9.0,11.0,10.0,8.0,14.0,11.0,5.0,8.0,10.0,11.0,2.0,11.0,11.0,12.0,14.0,11.0,14.0,8.0,12.0,13.0,8.0,6.0,11.0,7.0,13.0,14.0,13.0,12.0,18.0,18.0,8.0,13.0,14.0,20.0,14.0,17.0,12.0,11.0,10.0,7.0,5.0,8.0,12.0,9.0,12.0,13.0,12.0,14.0,2.0,25.0,0.0,0.0,0.0,0.0,187.0,83.0,2.0,1.0,3.0,3.0,1.0,3.0,3.0,3.0,1.0,1.0,3.0,4.0,8.0,10.0,14.0,12.0,8.0,14.0,9.0,5.0,7.0,11.0,13.0,5.0,12.0,11.0,13.0,13.0,13.0,11.0,10.0,12.0,16.0,9.0,8.0,13.0,11.0,13.0,16.0,14.0,13.0,15.0,13.0,20.0,14.0,12.0,8.0,14.0,16.0,13.0,11.0,13.0,7.0,5.0,13.0,14.0,13.0,14.0,14.0,13.0,13.0,6.0,25.0,4.0,0.0,11.0,0.0,184.0,81.0,14.0,14.0,13.0,9.0,15.0,12.0,16.0,16.0,13.0,7.0,11.0,8.0,1.0,2.0,1.0,11.0,12.0,6.0,1.0,3.0,3.0,11.0,5.0,3.0,11.0,8.0,15.0,15.0,13.0,14.0,10.0,11.0,14.0,8.0,13.0,5.0,13.0,10.0,10.0,14.0,16.0,14.0,13.0,20.0,14.0,12.0,5.0,14.0,14.0,15.0,9.0,16.0,6.0,1.0,17.0,11.0,15.0,13.0,14.0,12.0,12.0,4.0,27.0,0.0,0.0,0.0,0.0,184.0,81.0,1.0,1.0,1.0,3.0,3.0,2.0,2.0,2.0,1.0,2.0,3.0,8.0,6.0,8.0,12.0,10.0,8.0,12.0,9.0,1.0,3.0,8.0,14.0,4.0,9.0,4.0,11.0,12.0,11.0,8.0,8.0,11.0,10.0,9.0,8.0,11.0,9.0,8.0,11.0,10.0,8.0,13.0,13.0,9.0,13.0,9.0,20.0,12.0,13.0,13.0,9.0,2.0,9.0,9.0,15.0,10.0,12.0,10.0,11.0,6.0,4.0,6.0,32.0,0.0,0.0,0.0,0.0,172.0,71.0,2.0,1.0,3.0,1.0,2.0,3.0,2.0,3.0,2.0,2.0,2.0,8.0,9.0,7.0,6.0,10.0,6.0,10.0,9.0,10.0,14.0,11.0,6.0,14.0,11.0,10.0,16.0,15.0,12.0,12.0,7.0,12.0,15.0,9.0,13.0,8.0,14.0,15.0,15.0,14.0,14.0,14.0,10.0,20.0,14.0,14.0,8.0,15.0,13.0,13.0,11.0,13.0,7.0,13.0,17.0,14.0,17.0,8.0,13.0,15.0,15.0,6.0,19.0,0.0,0.0,3.0,1.0,181.0,69.0,3.0,2.0,3.0,3.0,2.0,1.0,1.0,1.0,3.0,3.0,4.0,10.0,10.0,12.0,12.0,12.0,7.0,8.0,11.0,5.0,7.0,10.0,10.0,7.0,11.0,8.0,10.0,10.0,12.0,8.0,11.0,8.0,14.0,13.0,6.0,14.0,8.0,13.0,13.0,16.0,14.0,13.0,9.0,20.0,15.0,16.0,10.0,15.0,13.0,12.0,8.0,11.0,7.0,12.0,11.0,11.0,15.0,10.0,12.0,14.0,14.0,1.0,21.0,0.0,0.0,0.0,0.0,179.0,68.0,2.0,3.0,2.0,1.0,2.0,1.0,2.0,3.0,2.0,1.0,1.0,6.0,13.0,12.0,6.0,13.0,6.0,8.0,7.0,12.0,10.0,12.0,8.0,12.0,13.0,10.0,11.0,11.0,12.0,10.0,11.0,11.0,12.0,11.0,7.0,13.0,10.0,12.0,14.0,15.0,13.0,12.0,10.0,20.0,14.0,14.0,8.0,14.0,10.0,13.0,8.0,13.0,8.0,12.0,13.0,14.0,10.0,12.0,10.0,10.0,12.0,10.0,20.0,4.0,0.0,0.0,0.0,180.0,77.0,4.0,1.0,2.0,2.0,1.0,1.0,1.0,1.0,3.0,3.0,3.0,7.0,9.0,11.0,5.0,12.0,5.0,11.0,7.0,10.0,15.0,11.0,6.0,16.0,11.0,15.0,11.0,15.0,11.0,11.0,10.0,13.0,13.0,9.0,7.0,12.0,14.0,12.0,14.0,14.0,13.0,14.0,12.0,10.0,14.0,14.0,20.0,14.0,14.0,13.0,9.0,13.0,5.0,12.0,7.0,12.0,10.0,10.0,10.0,4.0,7.0,10.0,19.0,0.0,0.0,0.0,0.0,185.0,82.0,4.0,2.0,3.0,1.0,3.0,2.0,1.0,2.0,1.0,2.0,3.0,7.0,7.0,10.0,6.0,13.0,7.0,14.0,7.0,6.0,12.0,13.0,7.0,13.0,13.0,13.0,13.0,13.0,11.0,12.0,11.0,12.0,14.0,9.0,14.0,11.0,11.0,15.0,15.0,12.0,12.0,14.0,13.0,5.0,14.0,12.0,20.0,14.0,13.0,10.0,11.0,11.0,6.0,10.0,10.0,12.0,12.0,14.0,14.0,11.0,16.0,6.0,24.0,0.0,0.0,6.0,1.0,172.0,70.0,3.0,1.0,1.0,3.0,1.0,2.0,3.0,1.0,1.0,3.0,3.0,11.0,12.0,11.0,8.0,12.0,10.0,6.0,14.0,7.0,11.0,15.0,8.0,12.0,13.0,14.0,14.0,18.0,13.0,12.0,13.0,13.0,15.0,12.0,12.0,12.0,11.0,18.0,18.0,13.0,14.0,13.0,7.0,10.0,16.0,12.0,20.0,14.0,12.0,14.0,14.0,15.0,4.0,8.0,7.0,14.0,14.0,13.0,14.0,12.0,10.0,6.0,22.0,0.0,0.0,0.0,0.0,186.0,0.0,1.0,2.0,3.0,3.0,1.0,3.0,1.0,2.0,1.0,2.0,1.0,4.0,1.0,12.0,12.0,12.0,1.0,7.0,5.0,1.0,3.0,5.0,1.0,1.0,8.0,8.0,6.0,6.0,4.0,5.0,4.0,11.0,6.0,9.0,12.0,12.0,5.0,4.0,5.0,12.0,12.0,5.0,11.0,12.0,10.0,12.0,20.0,6.0,8.0,8.0,8.0,8.0,7.0,8.0,13.0,11.0,12.0,13.0,12.0,5.0,14.0,5.0,20.0,29.0,2.0,0.0,0.0,181.0,75.0,1.0,1.0,2.0,2.0,2.0,3.0,2.0,1.0,1.0,3.0,2.0,5.0,9.0,15.0,10.0,11.0,9.0,10.0,8.0,7.0,3.0,10.0,10.0,5.0,15.0,7.0,10.0,9.0,12.0,10.0,8.0,11.0,14.0,12.0,5.0,13.0,5.0,11.0,12.0,16.0,12.0,9.0,12.0,20.0,14.0,16.0,7.0,12.0,10.0,9.0,10.0,10.0,11.0,6.0,10.0,15.0,9.0,13.0,11.0,14.0,18.0,7.0,22.0,5.0,1.0,1.0,0.0,173.0,72.0,1.0,3.0,1.0,3.0,3.0,3.0,3.0,3.0,3.0,2.0,2.0,14.0,13.0,16.0,14.0,16.0,14.0,5.0,11.0,5.0,5.0,15.0,11.0,5.0,16.0,8.0,13.0,9.0,14.0,13.0,15.0,13.0,15.0,16.0,5.0,13.0,5.0,9.0,10.0,15.0,16.0,14.0,5.0,20.0,14.0,15.0,5.0,12.0,14.0,13.0,11.0,13.0,8.0,14.0,10.0,15.0,14.0,10.0,13.0,10.0,10.0,13.0
2,1,28.0,0.0,0.0,0.0,0.0,188.0,86.0,14.0,13.0,15.0,8.0,14.0,11.0,14.0,16.0,13.0,12.0,8.0,6.0,2.0,1.0,3.0,8.0,8.0,1.0,1.0,3.0,1.0,8.0,4.0,1.0,8.0,8.0,13.0,13.0,14.0,14.0,11.0,12.0,15.0,7.0,10.0,2.0,14.0,12.0,11.0,13.0,14.0,16.0,13.0,5.0,16.0,12.0,20.0,14.0,15.0,14.0,8.0,15.0,5.0,1.0,11.0,15.0,14.0,14.0,16.0,14.0,11.0,6.0,20.0,0.0,0.0,6.0,0.0,188.0,79.0,2.0,3.0,2.0,1.0,1.0,3.0,2.0,1.0,2.0,2.0,1.0,4.0,4.0,11.0,6.0,11.0,8.0,13.0,8.0,9.0,13.0,12.0,9.0,13.0,11.0,14.0,13.0,15.0,14.0,13.0,8.0,12.0,14.0,9.0,11.0,10.0,12.0,12.0,13.0,11.0,11.0,11.0,13.0,8.0,12.0,13.0,20.0,13.0,12.0,13.0,14.0,13.0,10.0,11.0,11.0,13.0,12.0,14.0,14.0,15.0,10.0,7.0,32.0,36.0,0.0,12.0,2.0,183.0,77.0,1.0,3.0,2.0,1.0,3.0,1.0,1.0,2.0,1.0,1.0,3.0,6.0,11.0,8.0,6.0,13.0,11.0,13.0,10.0,6.0,15.0,14.0,10.0,17.0,12.0,15.0,16.0,18.0,14.0,17.0,12.0,15.0,17.0,11.0,17.0,7.0,17.0,20.0,16.0,9.0,11.0,15.0,11.0,8.0,15.0,10.0,20.0,14.0,14.0,17.0,10.0,16.0,10.0,13.0,15.0,15.0,15.0,14.0,18.0,15.0,13.0,6.0,23.0,0.0,0.0,0.0,0.0,174.0,64.0,4.0,3.0,1.0,1.0,3.0,3.0,2.0,3.0,3.0,2.0,3.0,8.0,12.0,10.0,8.0,11.0,7.0,10.0,9.0,12.0,14.0,9.0,10.0,13.0,12.0,12.0,12.0,12.0,11.0,12.0,10.0,12.0,13.0,8.0,9.0,12.0,11.0,13.0,14.0,15.0,14.0,11.0,10.0,10.0,14.0,14.0,20.0,15.0,10.0,14.0,12.0,12.0,8.0,13.0,10.0,12.0,15.0,12.0,13.0,10.0,17.0,6.0,22.0,0.0,0.0,0.0,0.0,182.0,71.0,1.0,3.0,1.0,1.0,1.0,2.0,4.0,1.0,3.0,3.0,1.0,10.0,13.0,12.0,6.0,12.0,11.0,12.0,5.0,7.0,12.0,10.0,5.0,13.0,11.0,12.0,13.0,12.0,10.0,11.0,13.0,12.0,19.0,13.0,2.0,10.0,9.0,11.0,12.0,14.0,12.0,12.0,12.0,20.0,7.0,13.0,5.0,13.0,9.0,10.0,14.0,4.0,10.0,10.0,12.0,12.0,11.0,10.0,10.0,12.0,14.0,3.0,28.0,0.0,0.0,0.0,0.0,172.0,68.0,4.0,4.0,2.0,1.0,3.0,2.0,2.0,1.0,3.0,3.0,1.0,6.0,5.0,10.0,7.0,14.0,8.0,8.0,8.0,5.0,9.0,11.0,6.0,6.0,12.0,10.0,11.0,8.0,10.0,8.0,12.0,14.0,9.0,11.0,6.0,12.0,9.0,9.0,13.0,11.0,12.0,9.0,6.0,10.0,13.0,11.0,20.0,10.0,6.0,10.0,4.0,6.0,10.0,10.0,12.0,12.0,13.0,10.0,11.0,7.0,13.0,1.0,22.0,0.0,0.0,1.0,0.0,181.0,73.0,3.0,2.0,4.0,1.0,3.0,3.0,3.0,2.0,3.0,3.0,2.0,10.0,11.0,9.0,8.0,12.0,9.0,12.0,8.0,10.0,14.0,13.0,6.0,14.0,8.0,15.0,13.0,16.0,13.0,14.0,8.0,14.0,15.0,5.0,12.0,11.0,13.0,16.0,16.0,10.0,10.0,12.0,11.0,8.0,14.0,12.0,20.0,16.0,10.0,13.0,12.0,11.0,6.0,11.0,12.0,15.0,16.0,14.0,13.0,13.0,8.0,5.0,26.0,0.0,0.0,0.0,0.0,184.0,76.0,3.0,1.0,3.0,1.0,3.0,2.0,3.0,2.0,1.0,1.0,3.0,10.0,11.0,13.0,9.0,13.0,12.0,13.0,10.0,6.0,11.0,13.0,9.0,14.0,12.0,12.0,13.0,12.0,12.0,11.0,13.0,12.0,13.0,13.0,10.0,12.0,13.0,12.0,16.0,15.0,13.0,15.0,13.0,20.0,15.0,14.0,5.0,16.0,15.0,13.0,12.0,14.0,5.0,12.0,18.0,14.0,10.0,7.0,11.0,11.0,13.0,10.0,19.0,0.0,0.0,11.0,1.0,171.0,65.0,2.0,2.0,2.0,2.0,2.0,3.0,3.0,3.0,1.0,1.0,3.0,14.0,13.0,13.0,11.0,14.0,15.0,8.0,12.0,6.0,4.0,13.0,12.0,4.0,15.0,8.0,12.0,10.0,12.0,8.0,13.0,13.0,14.0,15.0,8.0,14.0,6.0,13.0,12.0,15.0,16.0,10.0,7.0,20.0,13.0,15.0,10.0,12.0,7.0,11.0,6.0,11.0,8.0,11.0,12.0,13.0,11.0,12.0,12.0,6.0,12.0,5.0,24.0,0.0,0.0,0.0,0.0,173.0,64.0,2.0,2.0,2.0,2.0,1.0,1.0,3.0,2.0,2.0,1.0,1.0,11.0,11.0,16.0,14.0,12.0,12.0,6.0,11.0,4.0,3.0,11.0,11.0,5.0,14.0,11.0,11.0,13.0,13.0,9.0,13.0,11.0,14.0,15.0,8.0,15.0,6.0,10.0,11.0,17.0,18.0,13.0,7.0,8.0,13.0,15.0,20.0,13.0,10.0,12.0,11.0,14.0,6.0,16.0,13.0,13.0,17.0,14.0,14.0,9.0,9.0,8.0,20.0,7.0,1.0,0.0,0.0,182.0,75.0,2.0,1.0,3.0,2.0,2.0,1.0,3.0,1.0,3.0,2.0,1.0,11.0,11.0,13.0,12.0,13.0,11.0,12.0,10.0,5.0,4.0,12.0,8.0,5.0,13.0,11.0,12.0,11.0,11.0,8.0,10.0,10.0,3.0,10.0,1.0,13.0,8.0,12.0,12.0,15.0,14.0,13.0,11.0,6.0,14.0,13.0,20.0,12.0,13.0,12.0,9.0,11.0,9.0,11.0,9.0,9.0,9.0,12.0,11.0,9.0,17.0,7.0,26.0,11.0,0.0,0.0,0.0,198.0,88.0,13.0,11.0,10.0,8.0,12.0,10.0,14.0,15.0,11.0,13.0,9.0,3.0,3.0,3.0,6.0,6.0,6.0,12.0,12.0,2.0,1.0,8.0,6.0,1.0,6.0,9.0,12.0,14.0,12.0,12.0,11.0,11.0,12.0,6.0,9.0,2.0,13.0,12.0,8.0,12.0,13.0,18.0,17.0,5.0,16.0,9.0,20.0,15.0,15.0,11.0,9.0,12.0,5.0,1.0,16.0,14.0,16.0,13.0,12.0,15.0,15.0,7.0,32.0,67.0,9.0,7.0,0.0,191.0,85.0,1.0,1.0,1.0,3.0,2.0,2.0,4.0,3.0,3.0,2.0,3.0,7.0,7.0,6.0,9.0,12.0,3.0,16.0,7.0,3.0,15.0,11.0,7.0,13.0,12.0,14.0,11.0,14.0,10.0,11.0,10.0,14.0,11.0,8.0,13.0,13.0,13.0,13.0,15.0,9.0,7.0,14.0,16.0,8.0,7.0,10.0,20.0,12.0,15.0,13.0,14.0,5.0,6.0,11.0,8.0,11.0,9.0,12.0,11.0,6.0,9.0,11.0,23.0,0.0,0.0,0.0,0.0,188.0,75.0,2.0,2.0,2.0,2.0,3.0,4.0,2.0,2.0,2.0,3.0,3.0,4.0,10.0,7.0,5.0,10.0,7.0,13.0,10.0,5.0,13.0,11.0,6.0,13.0,12.0,13.0,13.0,14.0,11.0,11.0,8.0,11.0,12.0,5.0,6.0,10.0,12.0,13.0,14.0,13.0,11.0,15.0,14.0,5.0,14.0,12.0,20.0,14.0,14.0,12.0,13.0,11.0,7.0,12.0,9.0,12.0,11.0,7.0,12.0,10.0,10.0,8.0,24.0,0.0,0.0,0.0,0.0,183.0,78.0,2.0,3.0,1.0,3.0,2.0,1.0,1.0,1.0,1.0,3.0,3.0,5.0,10.0,9.0,5.0,12.0,11.0,12.0,11.0,8.0,13.0,13.0,11.0,14.0,10.0,15.0,14.0,14.0,13.0,15.0,10.0,14.0,14.0,6.0,6.0,9.0,14.0,13.0,14.0,12.0,12.0,14.0,11.0,5.0,15.0,11.0,20.0,14.0,14.0,14.0,13.0,12.0,7.0,10.0,12.0,13.0,16.0,13.0,15.0,15.0,15.0,5.0,24.0,0.0,0.0,0.0,0.0,175.0,72.0,3.0,2.0,4.0,3.0,2.0,4.0,1.0,1.0,1.0,2.0,2.0,8.0,12.0,12.0,6.0,11.0,7.0,10.0,9.0,12.0,11.0,12.0,8.0,12.0,11.0,11.0,12.0,13.0,10.0,10.0,9.0,9.0,3.0,9.0,9.0,11.0,12.0,11.0,11.0,14.0,13.0,11.0,8.0,20.0,12.0,13.0,6.0,12.0,11.0,10.0,10.0,10.0,9.0,10.0,10.0,13.0,10.0,11.0,10.0,13.0,18.0,1.0,29.0,0.0,0.0,0.0,0.0,188.0,74.0,1.0,2.0,3.0,3.0,2.0,3.0,1.0,3.0,2.0,1.0,1.0,4.0,8.0,10.0,6.0,13.0,7.0,14.0,9.0,6.0,13.0,12.0,8.0,13.0,13.0,12.0,14.0,13.0,14.0,11.0,13.0,12.0,14.0,6.0,13.0,8.0,14.0,15.0,15.0,9.0,12.0,14.0,14.0,10.0,13.0,10.0,20.0,16.0,12.0,13.0,12.0,15.0,9.0,11.0,11.0,14.0,14.0,12.0,15.0,13.0,13.0,6.0,25.0,0.0,0.0,0.0,0.0,174.0,73.0,1.0,1.0,3.0,2.0,1.0,1.0,1.0,2.0,3.0,3.0,3.0,11.0,12.0,12.0,6.0,13.0,11.0,7.0,11.0,10.0,9.0,13.0,9.0,10.0,14.0,11.0,13.0,13.0,12.0,11.0,15.0,11.0,14.0,13.0,7.0,11.0,12.0,15.0,16.0,12.0,14.0,12.0,8.0,20.0,14.0,13.0,7.0,12.0,11.0,12.0,11.0,13.0,9.0,12.0,8.0,13.0,13.0,12.0,15.0,15.0,15.0,6.0,39.0,0.0,0.0,0.0,0.0,178.0,75.0,4.0,3.0,1.0,2.0,2.0,2.0,3.0,3.0,2.0,2.0,1.0,12.0,12.0,13.0,12.0,15.0,12.0,12.0,11.0,6.0,6.0,15.0,15.0,8.0,16.0,7.0,12.0,12.0,13.0,14.0,14.0,12.0,14.0,11.0,12.0,9.0,12.0,12.0,14.0,11.0,12.0,14.0,8.0,10.0,15.0,10.0,20.0,10.0,12.0,15.0,7.0,16.0,6.0,10.0,14.0,14.0,14.0,14.0,14.0,14.0,14.0,6.0,19.0,0.0,0.0,0.0,0.0,168.0,64.0,3.0,2.0,4.0,1.0,2.0,2.0,1.0,1.0,1.0,1.0,3.0,9.0,11.0,13.0,10.0,11.0,8.0,4.0,10.0,3.0,4.0,11.0,10.0,4.0,12.0,8.0,11.0,11.0,9.0,8.0,10.0,10.0,12.0,11.0,6.0,9.0,9.0,10.0,9.0,14.0,11.0,10.0,7.0,11.0,12.0,14.0,20.0,11.0,10.0,11.0,12.0,9.0,8.0,11.0,10.0,11.0,9.0,11.0,8.0,7.0,8.0,10.0,32.0,0.0,0.0,0.0,0.0,183.0,77.0,2.0,2.0,3.0,2.0,1.0,2.0,2.0,1.0,2.0,2.0,3.0,13.0,14.0,12.0,11.0,14.0,14.0,10.0,13.0,8.0,6.0,13.0,14.0,5.0,14.0,7.0,12.0,11.0,13.0,13.0,13.0,13.0,12.0,12.0,9.0,12.0,8.0,14.0,13.0,11.0,12.0,13.0,11.0,20.0,11.0,11.0,8.0,14.0,13.0,13.0,7.0,12.0,8.0,8.0,6.0,14.0,12.0,12.0,14.0,13.0,13.0,7.0,23.0,0.0,0.0,7.0,3.0,181.0,71.0,2.0,2.0,2.0,2.0,2.0,2.0,4.0,2.0,3.0,3.0,2.0,7.0,12.0,12.0,14.0,13.0,7.0,11.0,11.0,7.0,6.0,11.0,15.0,7.0,12.0,12.0,13.0,16.0,12.0,12.0,10.0,11.0,6.0,12.0,7.0,14.0,9.0,12.0,16.0,13.0,14.0,13.0,9.0,8.0,14.0,12.0,20.0,12.0,12.0,12.0,10.0,12.0,8.0,10.0,19.0,10.0,10.0,10.0,11.0,11.0,12.0,6.0
2,0,26.0,2.0,0.0,1.0,0.0,188.0,84.0,12.0,13.0,15.0,9.0,15.0,13.0,13.0,15.0,10.0,11.0,14.0,9.0,2.0,1.0,2.0,12.0,11.0,3.0,2.0,3.0,3.0,11.0,3.0,1.0,10.0,14.0,13.0,14.0,10.0,13.0,11.0,11.0,14.0,3.0,11.0,5.0,12.0,15.0,13.0,10.0,12.0,13.0,14.0,5.0,14.0,9.0,20.0,12.0,14.0,12.0,10.0,15.0,3.0,11.0,12.0,11.0,16.0,13.0,15.0,16.0,16.0,4.0,32.0,0.0,0.0,0.0,0.0,183.0,79.0,1.0,1.0,1.0,3.0,1.0,3.0,1.0,1.0,2.0,1.0,1.0,5.0,10.0,6.0,6.0,9.0,6.0,15.0,7.0,11.0,14.0,10.0,7.0,13.0,10.0,13.0,15.0,15.0,15.0,14.0,9.0,13.0,16.0,6.0,14.0,8.0,12.0,13.0,16.0,11.0,12.0,16.0,11.0,8.0,16.0,12.0,20.0,15.0,14.0,14.0,11.0,12.0,5.0,15.0,18.0,15.0,14.0,13.0,17.0,14.0,14.0,5.0,29.0,0.0,0.0,0.0,0.0,183.0,74.0,3.0,3.0,3.0,3.0,3.0,2.0,2.0,2.0,1.0,3.0,1.0,5.0,12.0,7.0,6.0,10.0,7.0,14.0,12.0,5.0,14.0,12.0,6.0,13.0,11.0,14.0,13.0,17.0,13.0,16.0,12.0,12.0,13.0,9.0,8.0,9.0,14.0,14.0,15.0,13.0,12.0,15.0,12.0,6.0,17.0,11.0,20.0,17.0,13.0,14.0,14.0,15.0,5.0,13.0,9.0,14.0,19.0,15.0,14.0,11.0,11.0,6.0,30.0,0.0,0.0,0.0,0.0,182.0,71.0,3.0,2.0,1.0,3.0,3.0,2.0,3.0,2.0,1.0,2.0,1.0,5.0,12.0,12.0,7.0,12.0,7.0,13.0,7.0,11.0,12.0,11.0,6.0,13.0,13.0,14.0,13.0,14.0,8.0,12.0,9.0,11.0,14.0,11.0,9.0,11.0,10.0,13.0,15.0,14.0,13.0,14.0,11.0,8.0,13.0,13.0,20.0,14.0,14.0,13.0,14.0,14.0,10.0,8.0,12.0,13.0,13.0,12.0,14.0,11.0,11.0,7.0,22.0,0.0,0.0,0.0,0.0,178.0,73.0,3.0,2.0,2.0,1.0,2.0,4.0,3.0,1.0,3.0,1.0,2.0,6.0,12.0,12.0,6.0,11.0,7.0,8.0,8.0,11.0,12.0,10.0,8.0,13.0,11.0,12.0,12.0,13.0,11.0,10.0,11.0,11.0,13.0,6.0,7.0,12.0,9.0,13.0,14.0,16.0,14.0,13.0,9.0,6.0,14.0,15.0,20.0,15.0,14.0,12.0,12.0,13.0,6.0,14.0,12.0,15.0,13.0,13.0,14.0,14.0,14.0,6.0,21.0,4.0,1.0,0.0,0.0,176.0,60.0,1.0,1.0,3.0,2.0,3.0,2.0,1.0,3.0,3.0,4.0,2.0,9.0,10.0,13.0,9.0,13.0,8.0,7.0,12.0,7.0,11.0,13.0,7.0,12.0,11.0,9.0,14.0,12.0,9.0,11.0,12.0,11.0,10.0,9.0,5.0,10.0,12.0,12.0,15.0,15.0,14.0,13.0,7.0,12.0,10.0,12.0,20.0,14.0,4.0,9.0,9.0,9.0,7.0,5.0,15.0,16.0,12.0,10.0,9.0,16.0,8.0,3.0,30.0,4.0,0.0,0.0,0.0,192.0,78.0,1.0,3.0,1.0,2.0,2.0,3.0,1.0,3.0,1.0,1.0,3.0,4.0,6.0,7.0,8.0,11.0,6.0,15.0,8.0,6.0,13.0,11.0,6.0,14.0,11.0,17.0,14.0,16.0,12.0,14.0,10.0,12.0,17.0,8.0,8.0,11.0,13.0,15.0,16.0,14.0,12.0,18.0,14.0,6.0,14.0,12.0,20.0,17.0,16.0,14.0,17.0,13.0,9.0,11.0,8.0,13.0,10.0,13.0,12.0,10.0,10.0,5.0,20.0,0.0,0.0,2.0,0.0,180.0,75.0,3.0,1.0,2.0,2.0,3.0,2.0,1.0,1.0,3.0,3.0,1.0,8.0,13.0,14.0,9.0,13.0,8.0,10.0,9.0,6.0,5.0,12.0,6.0,5.0,14.0,8.0,13.0,12.0,13.0,12.0,12.0,12.0,7.0,13.0,8.0,14.0,7.0,12.0,13.0,15.0,13.0,14.0,10.0,8.0,14.0,15.0,20.0,13.0,12.0,13.0,11.0,9.0,7.0,13.0,9.0,11.0,11.0,11.0,12.0,11.0,10.0,1.0,18.0,0.0,0.0,0.0,0.0,188.0,80.0,1.0,3.0,1.0,3.0,2.0,3.0,3.0,1.0,2.0,2.0,4.0,6.0,8.0,12.0,11.0,12.0,7.0,13.0,10.0,4.0,4.0,8.0,10.0,5.0,12.0,11.0,11.0,13.0,10.0,11.0,11.0,12.0,11.0,13.0,7.0,13.0,8.0,13.0,13.0,11.0,12.0,12.0,12.0,10.0,12.0,11.0,20.0,10.0,12.0,12.0,8.0,11.0,7.0,13.0,8.0,13.0,13.0,11.0,12.0,12.0,13.0,7.0,30.0,5.0,0.0,22.0,9.0,181.0,84.0,2.0,3.0,3.0,1.0,2.0,3.0,3.0,1.0,3.0,1.0,3.0,7.0,10.0,12.0,13.0,11.0,7.0,13.0,10.0,12.0,6.0,11.0,13.0,6.0,13.0,17.0,13.0,16.0,11.0,13.0,11.0,11.0,17.0,14.0,8.0,14.0,9.0,13.0,17.0,15.0,12.0,15.0,11.0,8.0,14.0,15.0,20.0,14.0,14.0,13.0,9.0,13.0,7.0,10.0,7.0,16.0,13.0,14.0,13.0,15.0,15.0,10.0,25.0,0.0,0.0,0.0,0.0,176.0,74.0,2.0,2.0,1.0,3.0,2.0,2.0,2.0,4.0,3.0,3.0,3.0,12.0,12.0,14.0,12.0,14.0,13.0,7.0,12.0,6.0,3.0,12.0,12.0,3.0,15.0,9.0,10.0,8.0,12.0,11.0,12.0,10.0,10.0,14.0,5.0,13.0,4.0,6.0,8.0,17.0,15.0,12.0,8.0,20.0,12.0,14.0,8.0,13.0,12.0,11.0,9.0,14.0,10.0,8.0,8.0,14.0,12.0,7.0,10.0,11.0,11.0,9.0,19.0,0.0,0.0,0.0,0.0,193.0,84.0,14.0,11.0,10.0,9.0,12.0,13.0,13.0,13.0,9.0,8.0,13.0,4.0,2.0,1.0,3.0,7.0,7.0,2.0,3.0,1.0,1.0,8.0,1.0,3.0,7.0,8.0,11.0,12.0,10.0,12.0,8.0,10.0,10.0,6.0,7.0,1.0,12.0,11.0,10.0,9.0,13.0,12.0,13.0,5.0,15.0,8.0,20.0,12.0,14.0,12.0,10.0,4.0,3.0,10.0,18.0,13.0,13.0,9.0,13.0,11.0,19.0,4.0,33.0,24.0,1.0,3.0,0.0,193.0,90.0,1.0,2.0,2.0,2.0,3.0,2.0,3.0,1.0,3.0,2.0,3.0,3.0,6.0,8.0,8.0,11.0,10.0,17.0,8.0,5.0,13.0,10.0,7.0,14.0,11.0,14.0,14.0,16.0,11.0,10.0,9.0,10.0,14.0,7.0,13.0,7.0,13.0,14.0,11.0,9.0,10.0,15.0,15.0,7.0,13.0,10.0,20.0,10.0,13.0,10.0,13.0,15.0,9.0,8.0,12.0,15.0,13.0,11.0,15.0,12.0,13.0,7.0,16.0,0.0,0.0,0.0,0.0,177.0,0.0,3.0,2.0,1.0,1.0,3.0,3.0,2.0,2.0,2.0,1.0,3.0,1.0,3.0,2.0,2.0,4.0,1.0,3.0,1.0,6.0,9.0,2.0,1.0,9.0,6.0,14.0,4.0,5.0,5.0,3.0,2.0,5.0,4.0,5.0,7.0,4.0,8.0,4.0,3.0,10.0,7.0,13.0,7.0,15.0,13.0,9.0,20.0,5.0,8.0,7.0,11.0,5.0,8.0,8.0,11.0,11.0,5.0,14.0,20.0,7.0,12.0,5.0,23.0,2.0,0.0,0.0,0.0,188.0,85.0,1.0,3.0,2.0,2.0,1.0,3.0,3.0,2.0,3.0,2.0,1.0,7.0,8.0,7.0,5.0,12.0,5.0,14.0,9.0,7.0,13.0,11.0,6.0,13.0,12.0,14.0,13.0,13.0,11.0,12.0,6.0,12.0,5.0,1.0,6.0,8.0,12.0,14.0,13.0,12.0,11.0,14.0,15.0,6.0,13.0,11.0,20.0,14.0,15.0,13.0,9.0,7.0,10.0,10.0,12.0,12.0,13.0,10.0,9.0,8.0,8.0,2.0,24.0,0.0,0.0,0.0,0.0,178.0,77.0,2.0,1.0,3.0,2.0,1.0,3.0,3.0,3.0,1.0,3.0,2.0,5.0,10.0,8.0,5.0,9.0,6.0,11.0,8.0,12.0,11.0,8.0,6.0,12.0,9.0,11.0,11.0,13.0,11.0,12.0,7.0,11.0,15.0,9.0,6.0,9.0,11.0,12.0,14.0,16.0,12.0,14.0,10.0,5.0,15.0,15.0,20.0,14.0,13.0,14.0,11.0,13.0,5.0,8.0,17.0,12.0,14.0,14.0,14.0,14.0,14.0,6.0,22.0,0.0,0.0,0.0,0.0,188.0,79.0,1.0,2.0,2.0,3.0,2.0,2.0,3.0,4.0,3.0,2.0,1.0,8.0,10.0,11.0,7.0,11.0,8.0,10.0,8.0,7.0,8.0,10.0,10.0,11.0,11.0,11.0,12.0,13.0,11.0,10.0,8.0,11.0,10.0,8.0,8.0,12.0,10.0,12.0,15.0,13.0,12.0,14.0,14.0,20.0,13.0,12.0,8.0,14.0,14.0,12.0,10.0,6.0,8.0,15.0,11.0,11.0,11.0,11.0,11.0,10.0,12.0,6.0,26.0,0.0,0.0,0.0,0.0,184.0,76.0,2.0,3.0,1.0,3.0,1.0,1.0,3.0,1.0,3.0,2.0,2.0,10.0,12.0,14.0,12.0,14.0,12.0,11.0,13.0,11.0,13.0,14.0,13.0,12.0,15.0,14.0,13.0,12.0,11.0,11.0,13.0,14.0,14.0,12.0,13.0,12.0,11.0,11.0,14.0,15.0,14.0,13.0,10.0,5.0,14.0,14.0,20.0,14.0,14.0,14.0,7.0,16.0,6.0,8.0,19.0,14.0,14.0,14.0,14.0,14.0,14.0,6.0,29.0,0.0,0.0,0.0,0.0,180.0,74.0,2.0,1.0,3.0,3.0,2.0,4.0,1.0,3.0,3.0,2.0,2.0,9.0,13.0,13.0,10.0,14.0,10.0,12.0,12.0,6.0,8.0,12.0,8.0,8.0,14.0,10.0,13.0,14.0,13.0,12.0,13.0,11.0,13.0,11.0,7.0,10.0,10.0,14.0,14.0,14.0,13.0,13.0,12.0,10.0,14.0,13.0,20.0,14.0,11.0,14.0,10.0,15.0,8.0,10.0,8.0,12.0,14.0,16.0,14.0,15.0,15.0,6.0,18.0,0.0,0.0,0.0,0.0,183.0,70.0,1.0,2.0,2.0,1.0,1.0,2.0,2.0,1.0,2.0,1.0,3.0,10.0,11.0,12.0,7.0,11.0,9.0,10.0,9.0,10.0,5.0,10.0,8.0,5.0,12.0,9.0,10.0,10.0,9.0,8.0,9.0,9.0,11.0,10.0,7.0,12.0,6.0,11.0,12.0,14.0,12.0,10.0,11.0,6.0,12.0,13.0,20.0,11.0,9.0,12.0,10.0,3.0,9.0,10.0,17.0,12.0,12.0,13.0,11.0,12.0,12.0,2.0,24.0,0.0,0.0,0.0,0.0,179.0,85.0,2.0,4.0,2.0,3.0,1.0,1.0,1.0,1.0,1.0,1.0,2.0,4.0,8.0,12.0,14.0,11.0,8.0,13.0,11.0,7.0,8.0,9.0,12.0,6.0,12.0,12.0,12.0,13.0,13.0,14.0,9.0,14.0,16.0,11.0,8.0,13.0,5.0,11.0,12.0,11.0,13.0,16.0,10.0,9.0,2.0,12.0,20.0,14.0,16.0,14.0,12.0,13.0,7.0,5.0,19.0,13.0,13.0,8.0,12.0,12.0,12.0,10.0,18.0,0.0,0.0,0.0,0.0,184.0,71.0,2.0,3.0,2.0,3.0,1.0,2.0,1.0,3.0,2.0,1.0,3.0,8.0,10.0,14.0,10.0,12.0,8.0,5.0,10.0,3.0,5.0,12.0,7.0,6.0,13.0,8.0,8.0,8.0,11.0,8.0,11.0,14.0,12.0,10.0,11.0,10.0,9.0,9.0,13.0,14.0,13.0,5.0,10.0,10.0,13.0,14.0,20.0,12.0,8.0,10.0,8.0,10.0,4.0,10.0,11.0,12.0,11.0,12.0,13.0,11.0,13.0,6.0
6,1,31.0,25.0,0.0,6.0,0.0,191.0,84.0,11.0,14.0,13.0,12.0,15.0,14.0,15.0,16.0,13.0,14.0,14.0,8.0,2.0,10.0,5.0,11.0,11.0,7.0,10.0,2.0,5.0,10.0,11.0,11.0,9.0,12.0,13.0,15.0,13.0,13.0,8.0,13.0,16.0,12.0,14.0,1.0,16.0,13.0,11.0,12.0,13.0,16.0,16.0,8.0,16.0,13.0,20.0,15.0,15.0,17.0,8.0,15.0,7.0,2.0,15.0,15.0,17.0,15.0,17.0,16.0,15.0,6.0,23.0,0.0,0.0,0.0,0.0,184.0,77.0,1.0,1.0,1.0,1.0,3.0,2.0,3.0,2.0,2.0,2.0,3.0,6.0,9.0,11.0,7.0,12.0,7.0,15.0,9.0,11.0,14.0,13.0,10.0,15.0,12.0,14.0,15.0,15.0,13.0,12.0,11.0,13.0,15.0,11.0,9.0,9.0,14.0,14.0,14.0,14.0,13.0,15.0,13.0,9.0,16.0,15.0,20.0,14.0,14.0,14.0,11.0,14.0,4.0,11.0,14.0,13.0,15.0,14.0,16.0,14.0,15.0,6.0,28.0,46.0,3.0,14.0,3.0,190.0,80.0,2.0,3.0,3.0,2.0,2.0,1.0,1.0,3.0,1.0,3.0,1.0,4.0,6.0,7.0,9.0,11.0,7.0,17.0,11.0,10.0,15.0,12.0,11.0,16.0,10.0,17.0,15.0,18.0,13.0,14.0,12.0,14.0,18.0,6.0,17.0,8.0,15.0,15.0,14.0,11.0,10.0,17.0,16.0,7.0,17.0,13.0,20.0,15.0,18.0,17.0,14.0,16.0,4.0,6.0,14.0,15.0,16.0,17.0,18.0,14.0,15.0,6.0,23.0,0.0,0.0,1.0,0.0,182.0,71.0,3.0,1.0,2.0,3.0,4.0,2.0,3.0,1.0,2.0,1.0,3.0,9.0,13.0,14.0,8.0,14.0,13.0,12.0,10.0,13.0,14.0,14.0,13.0,15.0,13.0,14.0,14.0,13.0,11.0,12.0,12.0,13.0,16.0,12.0,12.0,15.0,13.0,14.0,15.0,15.0,13.0,14.0,12.0,9.0,16.0,15.0,20.0,15.0,15.0,15.0,10.0,14.0,6.0,12.0,8.0,15.0,14.0,16.0,15.0,15.0,16.0,6.0,32.0,0.0,0.0,0.0,0.0,185.0,79.0,2.0,1.0,1.0,1.0,1.0,1.0,3.0,3.0,3.0,3.0,3.0,7.0,8.0,7.0,8.0,12.0,5.0,16.0,8.0,10.0,12.0,12.0,8.0,12.0,8.0,12.0,12.0,14.0,11.0,12.0,11.0,12.0,10.0,7.0,12.0,7.0,15.0,13.0,17.0,9.0,10.0,10.0,14.0,20.0,14.0,10.0,5.0,13.0,12.0,12.0,11.0,10.0,7.0,9.0,7.0,10.0,9.0,11.0,10.0,10.0,15.0,8.0,31.0,0.0,0.0,6.0,0.0,174.0,80.0,1.0,1.0,1.0,1.0,1.0,5.0,1.0,1.0,1.0,1.0,1.0,14.0,12.0,11.0,7.0,12.0,13.0,9.0,7.0,10.0,11.0,11.0,10.0,10.0,12.0,11.0,11.0,11.0,10.0,6.0,10.0,9.0,12.0,12.0,12.0,10.0,12.0,12.0,14.0,12.0,15.0,10.0,9.0,20.0,12.0,12.0,7.0,12.0,9.0,9.0,10.0,12.0,7.0,9.0,11.0,14.0,9.0,7.0,14.0,8.0,9.0,9.0,29.0,90.0,4.0,16.0,2.0,170.0,61.0,2.0,3.0,3.0,1.0,3.0,1.0,2.0,2.0,2.0,2.0,1.0,15.0,14.0,15.0,9.0,17.0,16.0,7.0,12.0,4.0,11.0,18.0,15.0,12.0,17.0,15.0,15.0,16.0,13.0,16.0,17.0,14.0,16.0,15.0,14.0,12.0,14.0,18.0,16.0,13.0,14.0,12.0,8.0,10.0,14.0,11.0,20.0,14.0,10.0,14.0,9.0,17.0,10.0,14.0,13.0,17.0,15.0,16.0,17.0,15.0,16.0,7.0,20.0,0.0,0.0,10.0,1.0,174.0,68.0,1.0,3.0,3.0,3.0,2.0,3.0,3.0,2.0,1.0,2.0,2.0,11.0,12.0,15.0,11.0,14.0,12.0,6.0,12.0,2.0,4.0,14.0,11.0,4.0,15.0,9.0,11.0,10.0,12.0,11.0,14.0,12.0,14.0,14.0,7.0,13.0,7.0,11.0,13.0,14.0,15.0,13.0,7.0,20.0,12.0,14.0,10.0,13.0,9.0,12.0,7.0,12.0,10.0,12.0,15.0,16.0,12.0,14.0,13.0,15.0,15.0,5.0,20.0,0.0,0.0,7.0,1.0,170.0,58.0,1.0,2.0,2.0,2.0,2.0,2.0,2.0,4.0,1.0,3.0,2.0,16.0,14.0,16.0,13.0,16.0,17.0,5.0,14.0,2.0,6.0,15.0,13.0,4.0,17.0,9.0,12.0,14.0,12.0,12.0,14.0,13.0,15.0,16.0,7.0,13.0,9.0,13.0,15.0,15.0,16.0,11.0,7.0,20.0,14.0,15.0,8.0,14.0,8.0,15.0,5.0,15.0,7.0,16.0,15.0,15.0,15.0,14.0,16.0,18.0,16.0,3.0,19.0,0.0,0.0,0.0,0.0,185.0,65.0,1.0,3.0,4.0,2.0,1.0,3.0,3.0,1.0,3.0,3.0,1.0,4.0,12.0,12.0,9.0,11.0,8.0,12.0,10.0,6.0,4.0,10.0,12.0,6.0,13.0,8.0,11.0,11.0,11.0,11.0,10.0,11.0,11.0,13.0,7.0,13.0,7.0,11.0,13.0,14.0,12.0,14.0,14.0,20.0,13.0,15.0,8.0,12.0,8.0,11.0,8.0,12.0,8.0,11.0,7.0,12.0,9.0,12.0,12.0,13.0,15.0,5.0,30.0,62.0,25.0,13.0,8.0,177.0,72.0,1.0,3.0,3.0,1.0,3.0,2.0,1.0,3.0,1.0,4.0,1.0,8.0,11.0,12.0,17.0,14.0,12.0,18.0,14.0,3.0,4.0,13.0,18.0,5.0,16.0,14.0,15.0,16.0,17.0,13.0,14.0,16.0,16.0,16.0,16.0,16.0,6.0,13.0,13.0,13.0,14.0,13.0,11.0,14.0,13.0,12.0,20.0,12.0,12.0,15.0,8.0,19.0,10.0,6.0,13.0,18.0,14.0,19.0,15.0,16.0,17.0,10.0,31.0,22.0,0.0,17.0,0.0,185.0,82.0,12.0,12.0,13.0,6.0,14.0,11.0,15.0,18.0,14.0,10.0,13.0,7.0,3.0,8.0,5.0,9.0,10.0,8.0,12.0,2.0,2.0,9.0,6.0,3.0,10.0,6.0,12.0,15.0,16.0,12.0,8.0,12.0,14.0,8.0,15.0,3.0,13.0,13.0,8.0,13.0,17.0,14.0,13.0,7.0,12.0,11.0,20.0,15.0,14.0,13.0,6.0,16.0,3.0,1.0,8.0,16.0,12.0,13.0,16.0,16.0,16.0,7.0,21.0,1.0,0.0,4.0,0.0,189.0,84.0,1.0,2.0,2.0,3.0,2.0,3.0,2.0,3.0,1.0,3.0,2.0,5.0,5.0,10.0,6.0,11.0,11.0,15.0,10.0,12.0,14.0,11.0,11.0,14.0,11.0,10.0,13.0,12.0,11.0,12.0,10.0,11.0,12.0,12.0,12.0,10.0,12.0,14.0,12.0,14.0,13.0,14.0,15.0,20.0,15.0,13.0,6.0,14.0,15.0,11.0,5.0,15.0,5.0,6.0,6.0,8.0,10.0,12.0,10.0,12.0,10.0,12.0,30.0,19.0,0.0,7.0,0.0,189.0,77.0,3.0,2.0,3.0,2.0,3.0,3.0,1.0,3.0,3.0,1.0,2.0,5.0,8.0,7.0,10.0,10.0,9.0,15.0,9.0,8.0,14.0,12.0,10.0,15.0,10.0,15.0,14.0,13.0,13.0,14.0,10.0,12.0,14.0,10.0,14.0,11.0,12.0,14.0,14.0,8.0,10.0,12.0,16.0,10.0,16.0,10.0,20.0,13.0,16.0,13.0,11.0,13.0,7.0,10.0,6.0,14.0,12.0,13.0,14.0,13.0,13.0,7.0,30.0,46.0,0.0,0.0,0.0,184.0,74.0,2.0,3.0,1.0,1.0,2.0,2.0,1.0,2.0,3.0,2.0,2.0,5.0,7.0,9.0,6.0,11.0,6.0,14.0,8.0,12.0,14.0,11.0,7.0,14.0,10.0,12.0,14.0,16.0,14.0,14.0,11.0,13.0,13.0,7.0,7.0,11.0,14.0,15.0,16.0,11.0,12.0,14.0,12.0,10.0,17.0,13.0,20.0,14.0,11.0,16.0,9.0,14.0,12.0,11.0,15.0,12.0,14.0,11.0,16.0,14.0,16.0,7.0,22.0,0.0,0.0,3.0,0.0,176.0,70.0,1.0,1.0,1.0,3.0,2.0,1.0,2.0,3.0,1.0,3.0,3.0,10.0,15.0,14.0,6.0,13.0,10.0,13.0,10.0,9.0,9.0,13.0,8.0,11.0,14.0,10.0,11.0,12.0,10.0,13.0,11.0,13.0,14.0,13.0,7.0,13.0,9.0,11.0,13.0,17.0,13.0,12.0,10.0,20.0,14.0,16.0,5.0,15.0,11.0,13.0,10.0,14.0,8.0,10.0,11.0,13.0,16.0,11.0,15.0,14.0,13.0,7.0,26.0,27.0,0.0,0.0,0.0,183.0,70.0,1.0,3.0,1.0,3.0,4.0,1.0,3.0,3.0,2.0,1.0,3.0,9.0,14.0,12.0,8.0,10.0,8.0,12.0,13.0,14.0,9.0,12.0,7.0,13.0,11.0,14.0,9.0,15.0,10.0,12.0,9.0,10.0,16.0,10.0,9.0,12.0,8.0,12.0,17.0,14.0,11.0,13.0,12.0,10.0,16.0,16.0,20.0,16.0,13.0,13.0,10.0,14.0,6.0,15.0,10.0,15.0,14.0,10.0,16.0,13.0,13.0,4.0,28.0,41.0,2.0,0.0,0.0,187.0,80.0,3.0,2.0,3.0,2.0,1.0,1.0,2.0,3.0,1.0,4.0,2.0,7.0,10.0,11.0,7.0,12.0,7.0,10.0,12.0,13.0,15.0,13.0,8.0,18.0,12.0,18.0,13.0,17.0,12.0,14.0,10.0,12.0,17.0,7.0,13.0,9.0,14.0,17.0,18.0,14.0,13.0,16.0,14.0,20.0,18.0,13.0,12.0,18.0,14.0,15.0,16.0,15.0,6.0,15.0,14.0,13.0,10.0,14.0,12.0,8.0,7.0,8.0,21.0,0.0,0.0,11.0,2.0,180.0,72.0,2.0,3.0,3.0,3.0,3.0,2.0,2.0,1.0,3.0,2.0,3.0,12.0,13.0,14.0,9.0,14.0,13.0,8.0,12.0,5.0,8.0,14.0,10.0,9.0,14.0,12.0,12.0,9.0,13.0,12.0,15.0,13.0,14.0,15.0,8.0,13.0,10.0,16.0,14.0,15.0,14.0,12.0,9.0,8.0,15.0,14.0,20.0,13.0,12.0,12.0,8.0,11.0,10.0,11.0,10.0,14.0,16.0,14.0,15.0,15.0,15.0,6.0,26.0,0.0,0.0,0.0,0.0,183.0,76.0,2.0,2.0,1.0,1.0,1.0,2.0,3.0,1.0,3.0,1.0,1.0,13.0,12.0,12.0,7.0,14.0,14.0,12.0,14.0,5.0,10.0,14.0,12.0,10.0,14.0,6.0,13.0,14.0,13.0,13.0,13.0,12.0,15.0,10.0,13.0,12.0,12.0,13.0,14.0,11.0,13.0,14.0,9.0,12.0,11.0,12.0,20.0,14.0,13.0,13.0,7.0,13.0,8.0,15.0,18.0,14.0,12.0,11.0,14.0,13.0,13.0,6.0,23.0,0.0,0.0,10.0,7.0,179.0,70.0,1.0,1.0,2.0,2.0,1.0,3.0,3.0,2.0,1.0,4.0,3.0,10.0,13.0,14.0,12.0,15.0,11.0,10.0,13.0,6.0,3.0,13.0,12.0,4.0,16.0,11.0,12.0,11.0,13.0,11.0,13.0,12.0,12.0,16.0,6.0,14.0,6.0,10.0,12.0,16.0,14.0,12.0,9.0,20.0,13.0,14.0,10.0,13.0,10.0,12.0,7.0,12.0,6.0,8.0,12.0,13.0,5.0,10.0,8.0,14.0,12.0,8.0,26.0,0.0,0.0,4.0,0.0,180.0,73.0,2.0,3.0,1.0,4.0,2.0,3.0,3.0,1.0,1.0,4.0,1.0,11.0,13.0,13.0,14.0,14.0,11.0,15.0,12.0,3.0,7.0,14.0,14.0,8.0,13.0,12.0,14.0,17.0,13.0,15.0,14.0,14.0,16.0,12.0,15.0,16.0,12.0,18.0,16.0,13.0,14.0,13.0,12.0,8.0,14.0,13.0,20.0,15.0,12.0,15.0,8.0,14.0,7.0,15.0,19.0,14.0,17.0,14.0,18.0,16.0,16.0,5.0
1,1,29.0,3.0,0.0,3.0,0.0,188.0,89.0,13.0,13.0,15.0,9.0,14.0,12.0,15.0,17.0,14.0,15.0,8.0,6.0,3.0,3.0,2.0,7.0,10.0,3.0,2.0,1.0,3.0,8.0,1.0,1.0,9.0,12.0,14.0,16.0,13.0,14.0,9.0,13.0,18.0,6.0,13.0,2.0,15.0,12.0,8.0,12.0,14.0,16.0,14.0,6.0,16.0,11.0,20.0,14.0,16.0,16.0,12.0,13.0,3.0,1.0,10.0,15.0,17.0,13.0,16.0,12.0,8.0,10.0,24.0,0.0,0.0,5.0,0.0,197.0,95.0,3.0,2.0,2.0,2.0,3.0,3.0,3.0,3.0,1.0,3.0,2.0,4.0,5.0,5.0,6.0,7.0,5.0,17.0,7.0,10.0,15.0,8.0,5.0,14.0,9.0,12.0,9.0,16.0,9.0,13.0,5.0,12.0,9.0,4.0,7.0,8.0,12.0,13.0,12.0,9.0,9.0,17.0,18.0,10.0,11.0,11.0,20.0,15.0,17.0,12.0,12.0,12.0,14.0,6.0,15.0,11.0,16.0,8.0,13.0,9.0,14.0,7.0,30.0,0.0,0.0,0.0,0.0,180.0,76.0,1.0,2.0,2.0,2.0,3.0,2.0,2.0,1.0,2.0,3.0,3.0,5.0,12.0,10.0,8.0,12.0,9.0,14.0,11.0,10.0,14.0,12.0,7.0,15.0,11.0,11.0,14.0,13.0,15.0,14.0,12.0,13.0,14.0,6.0,16.0,7.0,15.0,16.0,15.0,12.0,12.0,14.0,11.0,8.0,14.0,10.0,20.0,15.0,13.0,15.0,8.0,14.0,11.0,17.0,18.0,14.0,19.0,13.0,16.0,15.0,15.0,5.0,20.0,0.0,0.0,2.0,0.0,180.0,80.0,1.0,3.0,2.0,3.0,1.0,1.0,2.0,2.0,2.0,2.0,3.0,3.0,10.0,13.0,7.0,12.0,2.0,7.0,9.0,6.0,10.0,10.0,4.0,8.0,13.0,10.0,13.0,8.0,11.0,10.0,11.0,8.0,11.0,11.0,4.0,13.0,11.0,13.0,12.0,15.0,12.0,12.0,7.0,7.0,10.0,16.0,20.0,13.0,13.0,8.0,4.0,5.0,17.0,13.0,18.0,11.0,10.0,10.0,11.0,11.0,20.0,8.0,18.0,0.0,0.0,0.0,0.0,177.0,0.0,2.0,1.0,3.0,2.0,2.0,3.0,2.0,2.0,4.0,2.0,4.0,7.0,10.0,12.0,7.0,11.0,7.0,10.0,8.0,6.0,10.0,10.0,5.0,12.0,11.0,10.0,10.0,11.0,10.0,9.0,10.0,10.0,12.0,9.0,6.0,12.0,9.0,13.0,14.0,14.0,11.0,12.0,8.0,5.0,15.0,13.0,20.0,12.0,10.0,10.0,8.0,8.0,7.0,10.0,12.0,12.0,11.0,9.0,13.0,11.0,15.0,4.0,18.0,0.0,0.0,0.0,0.0,175.0,68.0,1.0,1.0,2.0,3.0,3.0,1.0,1.0,2.0,4.0,1.0,1.0,7.0,9.0,12.0,7.0,13.0,7.0,11.0,7.0,5.0,12.0,13.0,8.0,13.0,12.0,13.0,11.0,13.0,11.0,11.0,13.0,12.0,14.0,10.0,9.0,11.0,12.0,14.0,14.0,12.0,14.0,15.0,8.0,20.0,15.0,13.0,12.0,15.0,14.0,13.0,12.0,11.0,6.0,13.0,14.0,12.0,12.0,12.0,12.0,12.0,11.0,5.0,24.0,0.0,0.0,1.0,0.0,187.0,79.0,1.0,1.0,3.0,3.0,2.0,3.0,3.0,3.0,2.0,2.0,2.0,5.0,13.0,13.0,8.0,12.0,10.0,12.0,8.0,6.0,13.0,12.0,10.0,14.0,12.0,13.0,13.0,14.0,11.0,10.0,10.0,11.0,13.0,12.0,8.0,9.0,12.0,13.0,15.0,15.0,14.0,14.0,11.0,5.0,16.0,14.0,20.0,15.0,14.0,11.0,13.0,11.0,7.0,13.0,3.0,15.0,12.0,10.0,11.0,10.0,17.0,9.0,25.0,0.0,0.0,15.0,1.0,176.0,64.0,2.0,2.0,3.0,3.0,1.0,1.0,3.0,3.0,2.0,1.0,3.0,9.0,9.0,11.0,7.0,13.0,11.0,14.0,9.0,6.0,12.0,14.0,6.0,13.0,13.0,13.0,14.0,15.0,14.0,14.0,13.0,13.0,15.0,8.0,11.0,9.0,12.0,15.0,18.0,14.0,14.0,12.0,10.0,5.0,15.0,11.0,20.0,16.0,10.0,15.0,13.0,15.0,5.0,10.0,11.0,14.0,14.0,14.0,17.0,13.0,13.0,5.0,29.0,0.0,0.0,0.0,0.0,177.0,74.0,1.0,2.0,3.0,2.0,2.0,2.0,2.0,1.0,3.0,2.0,1.0,12.0,13.0,14.0,12.0,15.0,11.0,6.0,11.0,4.0,3.0,12.0,8.0,4.0,15.0,9.0,11.0,11.0,12.0,11.0,13.0,12.0,14.0,14.0,7.0,14.0,6.0,10.0,12.0,16.0,14.0,12.0,8.0,10.0,14.0,15.0,20.0,14.0,11.0,11.0,9.0,14.0,8.0,10.0,9.0,13.0,14.0,14.0,13.0,15.0,15.0,6.0,26.0,4.0,0.0,17.0,4.0,171.0,62.0,2.0,3.0,2.0,2.0,2.0,1.0,3.0,2.0,3.0,1.0,4.0,12.0,12.0,14.0,12.0,15.0,12.0,6.0,12.0,5.0,3.0,14.0,14.0,4.0,15.0,10.0,13.0,11.0,13.0,12.0,12.0,11.0,14.0,15.0,7.0,15.0,7.0,11.0,10.0,16.0,15.0,10.0,6.0,12.0,14.0,15.0,20.0,13.0,7.0,12.0,10.0,13.0,6.0,12.0,13.0,13.0,15.0,13.0,14.0,12.0,15.0,5.0,23.0,0.0,0.0,0.0,0.0,183.0,80.0,3.0,2.0,1.0,3.0,1.0,3.0,2.0,3.0,1.0,2.0,3.0,4.0,12.0,13.0,14.0,12.0,9.0,10.0,14.0,5.0,5.0,12.0,11.0,7.0,12.0,11.0,12.0,12.0,10.0,12.0,10.0,11.0,5.0,11.0,9.0,14.0,10.0,13.0,12.0,15.0,14.0,13.0,11.0,8.0,12.0,14.0,20.0,13.0,14.0,10.0,8.0,13.0,7.0,7.0,16.0,14.0,11.0,10.0,12.0,9.0,9.0,2.0,25.0,0.0,0.0,0.0,0.0,192.0,87.0,12.0,13.0,12.0,6.0,14.0,11.0,12.0,13.0,9.0,12.0,11.0,5.0,1.0,3.0,1.0,10.0,8.0,3.0,3.0,3.0,3.0,8.0,2.0,1.0,8.0,7.0,13.0,14.0,12.0,13.0,12.0,11.0,13.0,7.0,11.0,3.0,13.0,11.0,12.0,11.0,12.0,16.0,16.0,8.0,14.0,12.0,20.0,13.0,16.0,13.0,7.0,9.0,7.0,10.0,14.0,12.0,17.0,13.0,14.0,14.0,14.0,5.0,28.0,0.0,0.0,0.0,0.0,193.0,84.0,1.0,1.0,2.0,2.0,2.0,3.0,2.0,3.0,2.0,1.0,3.0,4.0,8.0,8.0,9.0,10.0,6.0,14.0,7.0,8.0,14.0,12.0,6.0,14.0,11.0,12.0,13.0,14.0,11.0,14.0,12.0,12.0,14.0,6.0,11.0,8.0,14.0,13.0,13.0,11.0,11.0,16.0,16.0,20.0,12.0,12.0,8.0,14.0,16.0,14.0,12.0,13.0,6.0,10.0,7.0,12.0,15.0,12.0,16.0,15.0,13.0,6.0,29.0,2.0,0.0,0.0,0.0,185.0,75.0,2.0,3.0,3.0,3.0,2.0,3.0,2.0,1.0,3.0,1.0,2.0,4.0,10.0,8.0,6.0,10.0,6.0,14.0,7.0,7.0,14.0,11.0,6.0,14.0,9.0,13.0,13.0,14.0,11.0,12.0,12.0,12.0,14.0,8.0,11.0,12.0,13.0,13.0,13.0,15.0,12.0,15.0,12.0,8.0,15.0,13.0,20.0,14.0,15.0,14.0,7.0,14.0,8.0,6.0,14.0,13.0,15.0,14.0,14.0,14.0,14.0,6.0,27.0,0.0,0.0,0.0,0.0,175.0,64.0,1.0,1.0,1.0,2.0,1.0,4.0,2.0,1.0,1.0,3.0,3.0,7.0,13.0,9.0,6.0,12.0,6.0,12.0,10.0,10.0,14.0,13.0,6.0,13.0,12.0,14.0,13.0,13.0,12.0,12.0,10.0,12.0,14.0,7.0,9.0,11.0,12.0,13.0,15.0,14.0,13.0,15.0,11.0,10.0,12.0,12.0,20.0,14.0,12.0,12.0,12.0,13.0,10.0,10.0,10.0,12.0,14.0,13.0,14.0,15.0,15.0,6.0,26.0,0.0,0.0,0.0,0.0,182.0,68.0,1.0,4.0,3.0,2.0,3.0,1.0,2.0,1.0,2.0,4.0,1.0,7.0,12.0,9.0,5.0,10.0,6.0,12.0,7.0,15.0,12.0,9.0,6.0,12.0,10.0,12.0,13.0,14.0,11.0,10.0,9.0,9.0,13.0,7.0,6.0,10.0,10.0,14.0,15.0,16.0,13.0,13.0,11.0,5.0,15.0,15.0,20.0,14.0,10.0,12.0,12.0,13.0,7.0,12.0,12.0,14.0,14.0,15.0,13.0,14.0,14.0,7.0,21.0,0.0,0.0,0.0,0.0,183.0,73.0,1.0,4.0,3.0,3.0,3.0,1.0,4.0,1.0,2.0,3.0,2.0,11.0,10.0,12.0,11.0,13.0,9.0,12.0,10.0,5.0,8.0,12.0,9.0,8.0,13.0,13.0,12.0,12.0,10.0,12.0,14.0,12.0,12.0,14.0,8.0,12.0,8.0,12.0,12.0,14.0,14.0,14.0,11.0,8.0,13.0,13.0,20.0,12.0,12.0,12.0,5.0,10.0,7.0,12.0,15.0,11.0,11.0,10.0,11.0,12.0,11.0,4.0,29.0,0.0,0.0,0.0,0.0,183.0,78.0,1.0,3.0,3.0,3.0,3.0,1.0,2.0,3.0,3.0,1.0,1.0,13.0,8.0,9.0,6.0,12.0,14.0,13.0,10.0,12.0,11.0,12.0,8.0,13.0,12.0,12.0,15.0,13.0,13.0,13.0,11.0,13.0,15.0,6.0,12.0,7.0,13.0,16.0,18.0,12.0,11.0,14.0,12.0,20.0,14.0,11.0,8.0,16.0,14.0,14.0,12.0,14.0,6.0,12.0,10.0,12.0,13.0,11.0,15.0,15.0,15.0,5.0,19.0,0.0,0.0,0.0,0.0,185.0,80.0,3.0,2.0,2.0,3.0,3.0,4.0,3.0,3.0,3.0,2.0,1.0,8.0,12.0,13.0,8.0,12.0,13.0,12.0,9.0,6.0,12.0,13.0,9.0,13.0,12.0,12.0,13.0,12.0,12.0,10.0,12.0,12.0,4.0,13.0,8.0,12.0,8.0,12.0,14.0,13.0,14.0,12.0,11.0,5.0,15.0,14.0,20.0,13.0,13.0,12.0,10.0,9.0,11.0,15.0,15.0,9.0,10.0,9.0,12.0,11.0,10.0,5.0,29.0,0.0,0.0,0.0,0.0,180.0,71.0,1.0,3.0,1.0,1.0,1.0,4.0,4.0,1.0,1.0,2.0,3.0,10.0,11.0,12.0,9.0,13.0,11.0,8.0,14.0,6.0,8.0,11.0,10.0,8.0,12.0,10.0,11.0,12.0,12.0,9.0,12.0,11.0,14.0,12.0,7.0,12.0,10.0,12.0,14.0,15.0,14.0,12.0,10.0,20.0,16.0,13.0,12.0,15.0,10.0,13.0,10.0,15.0,7.0,8.0,16.0,12.0,12.0,13.0,14.0,15.0,15.0,6.0,23.0,1.0,0.0,0.0,0.0,185.0,70.0,4.0,3.0,1.0,2.0,1.0,3.0,2.0,3.0,1.0,2.0,3.0,5.0,8.0,12.0,13.0,13.0,7.0,14.0,11.0,5.0,5.0,8.0,13.0,5.0,13.0,6.0,13.0,10.0,12.0,12.0,11.0,11.0,13.0,12.0,7.0,13.0,9.0,8.0,10.0,16.0,12.0,14.0,12.0,8.0,14.0,15.0,20.0,13.0,13.0,12.0,7.0,15.0,7.0,7.0,13.0,13.0,12.0,10.0,12.0,15.0,15.0,7.0,21.0,0.0,0.0,4.0,1.0,184.0,79.0,1.0,2.0,3.0,1.0,2.0,1.0,3.0,2.0,2.0,1.0,3.0,3.0,6.0,10.0,12.0,12.0,7.0,15.0,8.0,4.0,5.0,13.0,10.0,8.0,12.0,18.0,12.0,19.0,13.0,10.0,13.0,12.0,14.0,13.0,10.0,12.0,9.0,16.0,15.0,12.0,14.0,14.0,14.0,12.0,13.0,10.0,20.0,14.0,14.0,11.0,14.0,14.0,11.0,5.0,10.0,13.0,14.0,15.0,10.0,8.0,4.0,15.0
3,0,32.0,61.0,0.0,0.0,0.0,194.0,89.0,15.0,12.0,16.0,8.0,14.0,10.0,16.0,15.0,13.0,8.0,11.0,4.0,3.0,2.0,3.0,7.0,9.0,6.0,1.0,2.0,3.0,8.0,1.0,1.0,7.0,6.0,12.0,14.0,10.0,15.0,7.0,12.0,14.0,4.0,15.0,3.0,15.0,13.0,10.0,10.0,16.0,14.0,14.0,8.0,15.0,10.0,20.0,12.0,16.0,17.0,5.0,16.0,5.0,12.0,15.0,12.0,16.0,14.0,18.0,15.0,12.0,6.0,28.0,46.0,3.0,14.0,3.0,190.0,80.0,2.0,3.0,3.0,2.0,2.0,1.0,1.0,3.0,1.0,3.0,1.0,4.0,6.0,7.0,9.0,11.0,7.0,17.0,11.0,10.0,15.0,12.0,11.0,16.0,10.0,17.0,15.0,18.0,13.0,14.0,12.0,14.0,18.0,6.0,17.0,8.0,15.0,15.0,14.0,11.0,10.0,17.0,16.0,7.0,17.0,13.0,20.0,15.0,18.0,17.0,14.0,16.0,4.0,6.0,14.0,15.0,16.0,17.0,18.0,14.0,15.0,6.0,23.0,0.0,0.0,0.0,0.0,184.0,77.0,1.0,1.0,1.0,1.0,3.0,2.0,3.0,2.0,2.0,2.0,3.0,6.0,9.0,11.0,7.0,12.0,7.0,15.0,9.0,11.0,14.0,13.0,10.0,15.0,12.0,14.0,15.0,15.0,13.0,12.0,11.0,13.0,15.0,11.0,9.0,9.0,14.0,14.0,14.0,14.0,13.0,15.0,13.0,9.0,16.0,15.0,20.0,14.0,14.0,14.0,11.0,14.0,4.0,11.0,14.0,13.0,15.0,14.0,16.0,14.0,15.0,6.0,23.0,0.0,0.0,1.0,0.0,182.0,71.0,3.0,1.0,2.0,3.0,4.0,2.0,3.0,1.0,2.0,1.0,3.0,9.0,13.0,14.0,8.0,14.0,13.0,12.0,10.0,13.0,14.0,14.0,13.0,15.0,13.0,14.0,14.0,13.0,11.0,12.0,12.0,13.0,16.0,12.0,12.0,15.0,13.0,14.0,15.0,15.0,13.0,14.0,12.0,9.0,16.0,15.0,20.0,15.0,15.0,15.0,10.0,14.0,6.0,12.0,8.0,15.0,14.0,16.0,15.0,15.0,16.0,6.0,32.0,0.0,0.0,0.0,0.0,185.0,79.0,2.0,1.0,1.0,1.0,1.0,1.0,3.0,3.0,3.0,3.0,3.0,7.0,8.0,7.0,8.0,12.0,5.0,16.0,8.0,10.0,12.0,12.0,8.0,12.0,8.0,12.0,12.0,14.0,11.0,12.0,11.0,12.0,10.0,7.0,12.0,7.0,15.0,13.0,17.0,9.0,10.0,10.0,14.0,20.0,14.0,10.0,5.0,13.0,12.0,12.0,11.0,10.0,7.0,9.0,7.0,10.0,9.0,11.0,10.0,10.0,15.0,8.0,31.0,0.0,0.0,6.0,0.0,174.0,80.0,1.0,1.0,1.0,1.0,1.0,5.0,1.0,1.0,1.0,1.0,1.0,14.0,12.0,11.0,7.0,12.0,13.0,9.0,7.0,10.0,11.0,11.0,10.0,10.0,12.0,11.0,11.0,11.0,10.0,6.0,10.0,9.0,12.0,12.0,12.0,10.0,12.0,12.0,14.0,12.0,15.0,10.0,9.0,20.0,12.0,12.0,7.0,12.0,9.0,9.0,10.0,12.0,7.0,9.0,11.0,14.0,9.0,7.0,14.0,8.0,9.0,9.0,19.0,0.0,0.0,12.0,4.0,177.0,75.0,2.0,1.0,1.0,1.0,2.0,2.0,3.0,1.0,1.0,3.0,3.0,11.0,12.0,13.0,8.0,15.0,11.0,5.0,12.0,8.0,5.0,15.0,16.0,8.0,16.0,10.0,12.0,14.0,13.0,13.0,13.0,11.0,10.0,15.0,9.0,12.0,5.0,10.0,7.0,13.0,15.0,7.0,9.0,14.0,13.0,13.0,20.0,11.0,6.0,12.0,11.0,13.0,5.0,11.0,12.0,15.0,16.0,14.0,12.0,15.0,15.0,5.0,20.0,0.0,0.0,10.0,1.0,174.0,68.0,1.0,3.0,3.0,3.0,2.0,3.0,3.0,2.0,1.0,2.0,2.0,11.0,12.0,15.0,11.0,14.0,12.0,6.0,12.0,2.0,4.0,14.0,11.0,4.0,15.0,9.0,11.0,10.0,12.0,11.0,14.0,12.0,14.0,14.0,7.0,13.0,7.0,11.0,13.0,14.0,15.0,13.0,7.0,20.0,12.0,14.0,10.0,13.0,9.0,12.0,7.0,12.0,10.0,12.0,15.0,16.0,12.0,14.0,13.0,15.0,15.0,5.0,24.0,6.0,1.0,0.0,0.0,183.0,66.0,1.0,1.0,2.0,2.0,1.0,2.0,1.0,2.0,3.0,2.0,1.0,14.0,14.0,14.0,10.0,14.0,14.0,9.0,10.0,8.0,8.0,14.0,10.0,8.0,15.0,9.0,11.0,13.0,11.0,11.0,13.0,10.0,14.0,13.0,5.0,12.0,9.0,14.0,13.0,14.0,16.0,12.0,9.0,20.0,13.0,14.0,5.0,15.0,9.0,12.0,10.0,12.0,8.0,9.0,16.0,9.0,16.0,13.0,11.0,12.0,13.0,9.0,30.0,62.0,25.0,13.0,8.0,177.0,72.0,1.0,3.0,3.0,1.0,3.0,2.0,1.0,3.0,1.0,4.0,1.0,8.0,11.0,12.0,17.0,14.0,12.0,18.0,14.0,3.0,4.0,13.0,18.0,5.0,16.0,14.0,15.0,16.0,17.0,13.0,14.0,16.0,16.0,16.0,16.0,16.0,6.0,13.0,13.0,13.0,14.0,13.0,11.0,14.0,13.0,12.0,20.0,12.0,12.0,15.0,8.0,19.0,10.0,6.0,13.0,18.0,14.0,19.0,15.0,16.0,17.0,10.0,26.0,40.0,16.0,6.0,2.0,183.0,79.0,1.0,2.0,1.0,2.0,2.0,1.0,2.0,1.0,3.0,2.0,2.0,9.0,14.0,16.0,14.0,17.0,13.0,10.0,13.0,4.0,5.0,15.0,14.0,7.0,17.0,12.0,13.0,10.0,14.0,12.0,14.0,15.0,14.0,17.0,13.0,12.0,7.0,11.0,11.0,14.0,15.0,14.0,11.0,11.0,8.0,15.0,20.0,12.0,12.0,13.0,12.0,15.0,16.0,13.0,13.0,15.0,13.0,13.0,15.0,16.0,18.0,7.0,19.0,0.0,0.0,0.0,0.0,193.0,84.0,14.0,11.0,10.0,9.0,12.0,13.0,13.0,13.0,9.0,8.0,13.0,4.0,2.0,1.0,3.0,7.0,7.0,2.0,3.0,1.0,1.0,8.0,1.0,3.0,7.0,8.0,11.0,12.0,10.0,12.0,8.0,10.0,10.0,6.0,7.0,1.0,12.0,11.0,10.0,9.0,13.0,12.0,13.0,5.0,15.0,8.0,20.0,12.0,14.0,12.0,10.0,4.0,3.0,10.0,18.0,13.0,13.0,9.0,13.0,11.0,19.0,4.0,16.0,0.0,0.0,0.0,0.0,177.0,0.0,3.0,2.0,1.0,1.0,3.0,3.0,2.0,2.0,2.0,1.0,3.0,1.0,3.0,2.0,2.0,4.0,1.0,3.0,1.0,6.0,9.0,2.0,1.0,9.0,6.0,14.0,4.0,5.0,5.0,3.0,2.0,5.0,4.0,5.0,7.0,4.0,8.0,4.0,3.0,10.0,7.0,13.0,7.0,15.0,13.0,9.0,20.0,5.0,8.0,7.0,11.0,5.0,8.0,8.0,11.0,11.0,5.0,14.0,20.0,7.0,12.0,5.0,33.0,24.0,1.0,3.0,0.0,193.0,90.0,1.0,2.0,2.0,2.0,3.0,2.0,3.0,1.0,3.0,2.0,3.0,3.0,6.0,8.0,8.0,11.0,10.0,17.0,8.0,5.0,13.0,10.0,7.0,14.0,11.0,14.0,14.0,16.0,11.0,10.0,9.0,10.0,14.0,7.0,13.0,7.0,13.0,14.0,11.0,9.0,10.0,15.0,15.0,7.0,13.0,10.0,20.0,10.0,13.0,10.0,13.0,15.0,9.0,8.0,12.0,15.0,13.0,11.0,15.0,12.0,13.0,7.0,27.0,0.0,0.0,0.0,0.0,169.0,60.0,3.0,2.0,1.0,3.0,3.0,2.0,1.0,3.0,3.0,2.0,2.0,11.0,11.0,13.0,9.0,13.0,12.0,8.0,10.0,4.0,5.0,14.0,8.0,5.0,13.0,12.0,9.0,9.0,10.0,10.0,10.0,9.0,16.0,13.0,4.0,14.0,8.0,11.0,8.0,16.0,16.0,9.0,9.0,5.0,13.0,15.0,20.0,11.0,11.0,10.0,8.0,7.0,5.0,11.0,14.0,10.0,12.0,11.0,12.0,10.0,13.0,8.0,29.0,0.0,0.0,0.0,0.0,185.0,84.0,3.0,2.0,2.0,2.0,1.0,3.0,1.0,2.0,1.0,3.0,1.0,3.0,6.0,6.0,7.0,10.0,5.0,14.0,5.0,4.0,14.0,9.0,7.0,13.0,9.0,13.0,13.0,14.0,12.0,13.0,8.0,12.0,14.0,8.0,16.0,8.0,12.0,13.0,15.0,11.0,11.0,15.0,12.0,5.0,14.0,12.0,20.0,14.0,16.0,13.0,12.0,10.0,7.0,7.0,7.0,12.0,13.0,13.0,14.0,13.0,12.0,8.0,26.0,0.0,0.0,0.0,0.0,184.0,76.0,2.0,3.0,1.0,3.0,1.0,1.0,3.0,1.0,3.0,2.0,2.0,10.0,12.0,14.0,12.0,14.0,12.0,11.0,13.0,11.0,13.0,14.0,13.0,12.0,15.0,14.0,13.0,12.0,11.0,11.0,13.0,14.0,14.0,12.0,13.0,12.0,11.0,11.0,14.0,15.0,14.0,13.0,10.0,5.0,14.0,14.0,20.0,14.0,14.0,14.0,7.0,16.0,6.0,8.0,19.0,14.0,14.0,14.0,14.0,14.0,14.0,6.0,22.0,0.0,0.0,0.0,0.0,188.0,79.0,1.0,2.0,2.0,3.0,2.0,2.0,3.0,4.0,3.0,2.0,1.0,8.0,10.0,11.0,7.0,11.0,8.0,10.0,8.0,7.0,8.0,10.0,10.0,11.0,11.0,11.0,12.0,13.0,11.0,10.0,8.0,11.0,10.0,8.0,8.0,12.0,10.0,12.0,15.0,13.0,12.0,14.0,14.0,20.0,13.0,12.0,8.0,14.0,14.0,12.0,10.0,6.0,8.0,15.0,11.0,11.0,11.0,11.0,11.0,10.0,12.0,6.0,18.0,0.0,0.0,0.0,0.0,184.0,71.0,2.0,3.0,2.0,3.0,1.0,2.0,1.0,3.0,2.0,1.0,3.0,8.0,10.0,14.0,10.0,12.0,8.0,5.0,10.0,3.0,5.0,12.0,7.0,6.0,13.0,8.0,8.0,8.0,11.0,8.0,11.0,14.0,12.0,10.0,11.0,10.0,9.0,9.0,13.0,14.0,13.0,5.0,10.0,10.0,13.0,14.0,20.0,12.0,8.0,10.0,8.0,10.0,4.0,10.0,11.0,12.0,11.0,12.0,13.0,11.0,13.0,6.0,18.0,0.0,0.0,0.0,0.0,183.0,70.0,1.0,2.0,2.0,1.0,1.0,2.0,2.0,1.0,2.0,1.0,3.0,10.0,11.0,12.0,7.0,11.0,9.0,10.0,9.0,10.0,5.0,10.0,8.0,5.0,12.0,9.0,10.0,10.0,9.0,8.0,9.0,9.0,11.0,10.0,7.0,12.0,6.0,11.0,12.0,14.0,12.0,10.0,11.0,6.0,12.0,13.0,20.0,11.0,9.0,12.0,10.0,3.0,9.0,10.0,17.0,12.0,12.0,13.0,11.0,12.0,12.0,2.0,24.0,0.0,0.0,0.0,0.0,179.0,85.0,2.0,4.0,2.0,3.0,1.0,1.0,1.0,1.0,1.0,1.0,2.0,4.0,8.0,12.0,14.0,11.0,8.0,13.0,11.0,7.0,8.0,9.0,12.0,6.0,12.0,12.0,12.0,13.0,13.0,14.0,9.0,14.0,16.0,11.0,8.0,13.0,5.0,11.0,12.0,11.0,13.0,16.0,10.0,9.0,2.0,12.0,20.0,14.0,16.0,14.0,12.0,13.0,7.0,5.0,19.0,13.0,13.0,8.0,12.0,12.0,12.0,10.0,25.0,1.0,1.0,0.0,0.0,182.0,70.0,2.0,1.0,2.0,3.0,3.0,2.0,2.0,4.0,1.0,3.0,2.0,9.0,7.0,13.0,13.0,12.0,6.0,13.0,12.0,8.0,8.0,10.0,14.0,6.0,11.0,13.0,10.0,13.0,12.0,12.0,10.0,12.0,13.0,8.0,9.0,14.0,8.0,11.0,12.0,14.0,13.0,14.0,11.0,8.0,13.0,14.0,20.0,13.0,13.0,12.0,6.0,12.0,6.0,11.0,14.0,11.0,10.0,11.0,10.0,9.0,19.0,5.0
1,0,30.0,42.0,0.0,13.0,0.0,195.0,88.0,16.0,13.0,14.0,6.0,14.0,13.0,13.0,15.0,12.0,10.0,14.0,1.0,8.0,5.0,2.0,8.0,2.0,8.0,2.0,5.0,3.0,9.0,5.0,3.0,8.0,10.0,12.0,10.0,14.0,10.0,10.0,14.0,13.0,3.0,14.0,3.0,12.0,14.0,12.0,8.0,13.0,18.0,18.0,17.0,14.0,11.0,20.0,14.0,17.0,14.0,4.0,14.0,4.0,1.0,12.0,13.0,14.0,9.0,15.0,13.0,13.0,5.0,23.0,0.0,0.0,0.0,0.0,184.0,71.0,1.0,2.0,1.0,2.0,2.0,2.0,2.0,4.0,2.0,1.0,3.0,4.0,10.0,10.0,6.0,11.0,6.0,14.0,8.0,7.0,14.0,11.0,6.0,13.0,11.0,12.0,12.0,13.0,12.0,11.0,12.0,12.0,14.0,6.0,8.0,10.0,13.0,13.0,14.0,15.0,13.0,14.0,13.0,8.0,12.0,14.0,20.0,13.0,14.0,13.0,12.0,14.0,15.0,8.0,11.0,13.0,13.0,10.0,8.0,9.0,16.0,7.0,24.0,0.0,0.0,0.0,0.0,185.0,77.0,1.0,1.0,3.0,2.0,1.0,1.0,3.0,1.0,3.0,3.0,1.0,7.0,10.0,12.0,11.0,12.0,12.0,14.0,13.0,7.0,13.0,12.0,8.0,14.0,12.0,10.0,13.0,11.0,13.0,13.0,12.0,13.0,16.0,10.0,8.0,12.0,13.0,13.0,13.0,14.0,14.0,12.0,14.0,12.0,14.0,13.0,20.0,11.0,12.0,12.0,12.0,10.0,11.0,7.0,17.0,11.0,10.0,10.0,10.0,7.0,8.0,5.0,28.0,0.0,0.0,0.0,0.0,190.0,85.0,3.0,2.0,3.0,3.0,2.0,2.0,2.0,4.0,3.0,1.0,2.0,5.0,9.0,8.0,9.0,8.0,7.0,14.0,10.0,9.0,15.0,9.0,6.0,14.0,9.0,16.0,13.0,16.0,10.0,13.0,10.0,12.0,15.0,6.0,13.0,7.0,13.0,14.0,16.0,12.0,11.0,17.0,13.0,20.0,15.0,13.0,8.0,15.0,15.0,12.0,14.0,14.0,9.0,8.0,14.0,13.0,14.0,11.0,12.0,13.0,16.0,14.0,19.0,0.0,0.0,0.0,0.0,189.0,78.0,2.0,2.0,2.0,1.0,1.0,1.0,3.0,1.0,2.0,1.0,2.0,7.0,8.0,9.0,7.0,9.0,6.0,12.0,8.0,8.0,12.0,12.0,6.0,13.0,11.0,15.0,13.0,14.0,11.0,10.0,8.0,12.0,14.0,6.0,9.0,11.0,11.0,13.0,14.0,13.0,12.0,12.0,13.0,6.0,14.0,13.0,20.0,12.0,13.0,13.0,6.0,12.0,5.0,13.0,16.0,13.0,13.0,13.0,15.0,14.0,12.0,5.0,21.0,0.0,0.0,0.0,0.0,177.0,0.0,1.0,1.0,1.0,2.0,3.0,3.0,2.0,3.0,2.0,2.0,3.0,6.0,4.0,13.0,13.0,13.0,6.0,13.0,7.0,3.0,5.0,7.0,6.0,1.0,11.0,9.0,7.0,8.0,7.0,7.0,7.0,8.0,7.0,11.0,8.0,13.0,7.0,6.0,7.0,12.0,13.0,7.0,6.0,8.0,8.0,13.0,20.0,5.0,5.0,9.0,5.0,9.0,9.0,9.0,10.0,10.0,12.0,12.0,11.0,10.0,9.0,6.0,21.0,0.0,0.0,0.0,0.0,178.0,65.0,2.0,3.0,3.0,3.0,3.0,1.0,1.0,1.0,1.0,3.0,1.0,9.0,13.0,11.0,6.0,12.0,7.0,9.0,8.0,8.0,13.0,12.0,7.0,13.0,12.0,8.0,12.0,13.0,12.0,12.0,13.0,13.0,14.0,9.0,8.0,12.0,12.0,13.0,13.0,12.0,14.0,13.0,11.0,8.0,15.0,12.0,20.0,13.0,12.0,14.0,8.0,11.0,7.0,10.0,19.0,10.0,13.0,10.0,11.0,15.0,15.0,6.0,22.0,0.0,0.0,0.0,0.0,187.0,84.0,2.0,2.0,1.0,2.0,3.0,2.0,2.0,3.0,3.0,2.0,2.0,4.0,7.0,10.0,6.0,9.0,10.0,13.0,12.0,5.0,11.0,11.0,7.0,10.0,12.0,12.0,11.0,13.0,10.0,9.0,11.0,9.0,15.0,8.0,7.0,9.0,11.0,11.0,14.0,13.0,10.0,15.0,14.0,8.0,15.0,11.0,20.0,14.0,15.0,11.0,12.0,7.0,9.0,8.0,7.0,13.0,15.0,13.0,11.0,14.0,14.0,7.0,24.0,0.0,0.0,0.0,0.0,172.0,72.0,1.0,1.0,3.0,2.0,2.0,1.0,1.0,1.0,1.0,3.0,1.0,10.0,11.0,12.0,10.0,11.0,8.0,8.0,10.0,7.0,7.0,11.0,11.0,6.0,12.0,8.0,11.0,11.0,10.0,10.0,11.0,12.0,15.0,12.0,5.0,10.0,11.0,13.0,15.0,15.0,13.0,10.0,9.0,8.0,14.0,13.0,20.0,14.0,11.0,11.0,8.0,13.0,7.0,12.0,18.0,13.0,10.0,10.0,11.0,11.0,11.0,6.0,22.0,0.0,0.0,0.0,0.0,177.0,72.0,2.0,1.0,2.0,4.0,2.0,2.0,1.0,3.0,4.0,2.0,3.0,10.0,12.0,13.0,11.0,12.0,10.0,12.0,12.0,4.0,10.0,13.0,11.0,11.0,13.0,11.0,12.0,11.0,13.0,9.0,13.0,12.0,3.0,12.0,8.0,14.0,12.0,12.0,13.0,16.0,13.0,12.0,9.0,8.0,15.0,14.0,20.0,14.0,13.0,10.0,4.0,11.0,11.0,12.0,19.0,9.0,12.0,13.0,12.0,11.0,14.0,7.0,25.0,0.0,0.0,0.0,0.0,187.0,83.0,2.0,1.0,3.0,3.0,1.0,3.0,3.0,3.0,1.0,1.0,3.0,4.0,8.0,10.0,14.0,12.0,8.0,14.0,9.0,5.0,7.0,11.0,13.0,5.0,12.0,11.0,13.0,13.0,13.0,11.0,10.0,12.0,16.0,9.0,8.0,13.0,11.0,13.0,16.0,14.0,13.0,15.0,13.0,20.0,14.0,12.0,8.0,14.0,16.0,13.0,11.0,13.0,7.0,5.0,13.0,14.0,13.0,14.0,14.0,13.0,13.0,6.0,36.0,0.0,0.0,0.0,0.0,185.0,78.0,11.0,14.0,12.0,7.0,13.0,12.0,14.0,15.0,13.0,14.0,10.0,4.0,1.0,3.0,1.0,8.0,8.0,11.0,8.0,3.0,3.0,7.0,2.0,1.0,8.0,11.0,13.0,15.0,11.0,12.0,7.0,13.0,9.0,5.0,14.0,3.0,13.0,15.0,8.0,11.0,14.0,13.0,12.0,5.0,15.0,11.0,20.0,12.0,14.0,13.0,11.0,13.0,8.0,1.0,19.0,14.0,16.0,10.0,17.0,9.0,9.0,11.0,28.0,8.0,0.0,1.0,0.0,182.0,79.0,1.0,1.0,3.0,2.0,4.0,1.0,3.0,3.0,1.0,1.0,3.0,5.0,9.0,9.0,9.0,11.0,6.0,13.0,8.0,12.0,14.0,9.0,8.0,14.0,11.0,14.0,14.0,15.0,10.0,13.0,7.0,12.0,16.0,8.0,8.0,9.0,14.0,13.0,14.0,15.0,12.0,13.0,11.0,5.0,13.0,14.0,20.0,15.0,14.0,12.0,14.0,13.0,7.0,15.0,11.0,13.0,10.0,13.0,10.0,11.0,12.0,5.0,28.0,0.0,0.0,0.0,0.0,183.0,81.0,1.0,2.0,4.0,1.0,1.0,3.0,2.0,3.0,3.0,3.0,1.0,5.0,5.0,6.0,10.0,12.0,6.0,14.0,8.0,6.0,15.0,11.0,6.0,13.0,12.0,13.0,14.0,16.0,14.0,14.0,10.0,12.0,14.0,5.0,14.0,8.0,14.0,15.0,15.0,9.0,12.0,15.0,13.0,7.0,11.0,12.0,20.0,15.0,15.0,14.0,14.0,14.0,9.0,8.0,14.0,14.0,11.0,13.0,15.0,13.0,15.0,6.0,21.0,0.0,0.0,1.0,0.0,177.0,68.0,4.0,1.0,2.0,1.0,1.0,1.0,1.0,1.0,2.0,1.0,2.0,5.0,12.0,9.0,7.0,12.0,8.0,13.0,10.0,16.0,13.0,12.0,8.0,14.0,12.0,12.0,13.0,12.0,12.0,12.0,10.0,13.0,15.0,11.0,13.0,11.0,13.0,13.0,14.0,13.0,14.0,13.0,11.0,10.0,14.0,12.0,20.0,12.0,14.0,12.0,11.0,12.0,8.0,14.0,13.0,10.0,14.0,12.0,14.0,12.0,11.0,5.0,19.0,0.0,0.0,0.0,0.0,184.0,72.0,2.0,2.0,3.0,2.0,1.0,2.0,1.0,3.0,2.0,1.0,2.0,11.0,9.0,9.0,10.0,15.0,11.0,11.0,16.0,8.0,14.0,11.0,9.0,16.0,10.0,11.0,13.0,6.0,12.0,11.0,10.0,12.0,12.0,7.0,4.0,12.0,13.0,12.0,15.0,14.0,9.0,13.0,12.0,7.0,13.0,11.0,20.0,10.0,12.0,10.0,11.0,8.0,8.0,11.0,12.0,14.0,8.0,13.0,12.0,5.0,9.0,3.0,19.0,0.0,0.0,0.0,0.0,171.0,70.0,2.0,3.0,2.0,1.0,1.0,1.0,2.0,1.0,2.0,3.0,1.0,11.0,11.0,12.0,11.0,11.0,11.0,9.0,11.0,7.0,9.0,13.0,4.0,9.0,13.0,4.0,10.0,10.0,11.0,11.0,14.0,12.0,13.0,13.0,14.0,11.0,11.0,12.0,12.0,12.0,11.0,11.0,9.0,20.0,10.0,12.0,10.0,11.0,11.0,13.0,8.0,12.0,9.0,10.0,10.0,13.0,14.0,12.0,11.0,12.0,12.0,9.0,33.0,0.0,0.0,0.0,0.0,187.0,76.0,2.0,2.0,3.0,1.0,1.0,3.0,2.0,1.0,2.0,3.0,2.0,15.0,14.0,14.0,10.0,15.0,13.0,10.0,12.0,7.0,4.0,15.0,13.0,7.0,15.0,6.0,12.0,9.0,14.0,11.0,15.0,12.0,12.0,14.0,12.0,13.0,7.0,13.0,12.0,11.0,12.0,14.0,12.0,14.0,15.0,12.0,20.0,11.0,12.0,12.0,6.0,14.0,6.0,11.0,14.0,13.0,12.0,12.0,15.0,15.0,13.0,9.0,25.0,0.0,0.0,0.0,0.0,182.0,72.0,1.0,3.0,2.0,3.0,1.0,1.0,2.0,2.0,2.0,1.0,2.0,5.0,8.0,12.0,13.0,13.0,6.0,9.0,10.0,6.0,5.0,8.0,11.0,5.0,13.0,8.0,11.0,12.0,11.0,12.0,6.0,12.0,10.0,12.0,5.0,13.0,6.0,9.0,11.0,15.0,13.0,13.0,11.0,10.0,13.0,14.0,20.0,13.0,12.0,13.0,8.0,5.0,8.0,11.0,12.0,13.0,13.0,12.0,11.0,10.0,11.0,1.0,30.0,0.0,0.0,0.0,0.0,178.0,73.0,3.0,4.0,1.0,1.0,2.0,4.0,3.0,2.0,2.0,2.0,3.0,13.0,14.0,12.0,7.0,13.0,12.0,7.0,13.0,5.0,10.0,13.0,9.0,10.0,13.0,11.0,11.0,12.0,12.0,13.0,11.0,14.0,14.0,11.0,7.0,11.0,10.0,13.0,15.0,13.0,15.0,15.0,8.0,20.0,14.0,14.0,8.0,14.0,11.0,13.0,11.0,14.0,8.0,10.0,19.0,12.0,12.0,9.0,12.0,12.0,10.0,10.0,26.0,0.0,0.0,0.0,0.0,193.0,81.0,1.0,3.0,3.0,3.0,3.0,1.0,2.0,2.0,2.0,3.0,3.0,4.0,9.0,14.0,10.0,13.0,12.0,14.0,14.0,5.0,5.0,10.0,12.0,3.0,14.0,8.0,13.0,12.0,9.0,10.0,11.0,11.0,12.0,16.0,5.0,14.0,6.0,9.0,12.0,14.0,13.0,14.0,16.0,14.0,13.0,13.0,20.0,13.0,14.0,10.0,8.0,14.0,9.0,8.0,16.0,16.0,11.0,13.0,11.0,13.0,13.0,10.0,27.0,0.0,0.0,0.0,0.0,190.0,87.0,1.0,3.0,2.0,3.0,1.0,3.0,1.0,1.0,2.0,3.0,2.0,5.0,7.0,9.0,14.0,14.0,10.0,14.0,13.0,5.0,6.0,12.0,12.0,8.0,14.0,14.0,13.0,16.0,14.0,11.0,10.0,13.0,15.0,10.0,11.0,14.0,9.0,15.0,14.0,10.0,11.0,16.0,15.0,9.0,12.0,12.0,20.0,14.0,16.0,13.0,13.0,12.0,7.0,5.0,10.0,12.0,14.0,12.0,14.0,14.0,19.0,12.0
0,1,25.0,0.0,0.0,0.0,0.0,192.0,87.0,12.0,13.0,12.0,6.0,14.0,11.0,12.0,13.0,9.0,12.0,11.0,5.0,1.0,3.0,1.0,10.0,8.0,3.0,3.0,3.0,3.0,8.0,2.0,1.0,8.0,7.0,13.0,14.0,12.0,13.0,12.0,11.0,13.0,7.0,11.0,3.0,13.0,11.0,12.0,11.0,12.0,16.0,16.0,8.0,14.0,12.0,20.0,13.0,16.0,13.0,7.0,9.0,7.0,10.0,14.0,12.0,17.0,13.0,14.0,14.0,14.0,5.0,28.0,0.0,0.0,0.0,0.0,193.0,84.0,1.0,1.0,2.0,2.0,2.0,3.0,2.0,3.0,2.0,1.0,3.0,4.0,8.0,8.0,9.0,10.0,6.0,14.0,7.0,8.0,14.0,12.0,6.0,14.0,11.0,12.0,13.0,14.0,11.0,14.0,12.0,12.0,14.0,6.0,11.0,8.0,14.0,13.0,13.0,11.0,11.0,16.0,16.0,20.0,12.0,12.0,8.0,14.0,16.0,14.0,12.0,13.0,6.0,10.0,7.0,12.0,15.0,12.0,16.0,15.0,13.0,6.0,29.0,2.0,0.0,0.0,0.0,185.0,75.0,2.0,3.0,3.0,3.0,2.0,3.0,2.0,1.0,3.0,1.0,2.0,4.0,10.0,8.0,6.0,10.0,6.0,14.0,7.0,7.0,14.0,11.0,6.0,14.0,9.0,13.0,13.0,14.0,11.0,12.0,12.0,12.0,14.0,8.0,11.0,12.0,13.0,13.0,13.0,15.0,12.0,15.0,12.0,8.0,15.0,13.0,20.0,14.0,15.0,14.0,7.0,14.0,8.0,6.0,14.0,13.0,15.0,14.0,14.0,14.0,14.0,6.0,27.0,0.0,0.0,0.0,0.0,175.0,64.0,1.0,1.0,1.0,2.0,1.0,4.0,2.0,1.0,1.0,3.0,3.0,7.0,13.0,9.0,6.0,12.0,6.0,12.0,10.0,10.0,14.0,13.0,6.0,13.0,12.0,14.0,13.0,13.0,12.0,12.0,10.0,12.0,14.0,7.0,9.0,11.0,12.0,13.0,15.0,14.0,13.0,15.0,11.0,10.0,12.0,12.0,20.0,14.0,12.0,12.0,12.0,13.0,10.0,10.0,10.0,12.0,14.0,13.0,14.0,15.0,15.0,6.0,26.0,0.0,0.0,0.0,0.0,182.0,68.0,1.0,4.0,3.0,2.0,3.0,1.0,2.0,1.0,2.0,4.0,1.0,7.0,12.0,9.0,5.0,10.0,6.0,12.0,7.0,15.0,12.0,9.0,6.0,12.0,10.0,12.0,13.0,14.0,11.0,10.0,9.0,9.0,13.0,7.0,6.0,10.0,10.0,14.0,15.0,16.0,13.0,13.0,11.0,5.0,15.0,15.0,20.0,14.0,10.0,12.0,12.0,13.0,7.0,12.0,12.0,14.0,14.0,15.0,13.0,14.0,14.0,7.0,21.0,0.0,0.0,0.0,0.0,183.0,73.0,1.0,4.0,3.0,3.0,3.0,1.0,4.0,1.0,2.0,3.0,2.0,11.0,10.0,12.0,11.0,13.0,9.0,12.0,10.0,5.0,8.0,12.0,9.0,8.0,13.0,13.0,12.0,12.0,10.0,12.0,14.0,12.0,12.0,14.0,8.0,12.0,8.0,12.0,12.0,14.0,14.0,14.0,11.0,8.0,13.0,13.0,20.0,12.0,12.0,12.0,5.0,10.0,7.0,12.0,15.0,11.0,11.0,10.0,11.0,12.0,11.0,4.0,29.0,0.0,0.0,0.0,0.0,183.0,78.0,1.0,3.0,3.0,3.0,3.0,1.0,2.0,3.0,3.0,1.0,1.0,13.0,8.0,9.0,6.0,12.0,14.0,13.0,10.0,12.0,11.0,12.0,8.0,13.0,12.0,12.0,15.0,13.0,13.0,13.0,11.0,13.0,15.0,6.0,12.0,7.0,13.0,16.0,18.0,12.0,11.0,14.0,12.0,20.0,14.0,11.0,8.0,16.0,14.0,14.0,12.0,14.0,6.0,12.0,10.0,12.0,13.0,11.0,15.0,15.0,15.0,5.0,19.0,0.0,0.0,0.0,0.0,185.0,80.0,3.0,2.0,2.0,3.0,3.0,4.0,3.0,3.0,3.0,2.0,1.0,8.0,12.0,13.0,8.0,12.0,13.0,12.0,9.0,6.0,12.0,13.0,9.0,13.0,12.0,12.0,13.0,12.0,12.0,10.0,12.0,12.0,4.0,13.0,8.0,12.0,8.0,12.0,14.0,13.0,14.0,12.0,11.0,5.0,15.0,14.0,20.0,13.0,13.0,12.0,10.0,9.0,11.0,15.0,15.0,9.0,10.0,9.0,12.0,11.0,10.0,5.0,29.0,0.0,0.0,0.0,0.0,180.0,71.0,1.0,3.0,1.0,1.0,1.0,4.0,4.0,1.0,1.0,2.0,3.0,10.0,11.0,12.0,9.0,13.0,11.0,8.0,14.0,6.0,8.0,11.0,10.0,8.0,12.0,10.0,11.0,12.0,12.0,9.0,12.0,11.0,14.0,12.0,7.0,12.0,10.0,12.0,14.0,15.0,14.0,12.0,10.0,20.0,16.0,13.0,12.0,15.0,10.0,13.0,10.0,15.0,7.0,8.0,16.0,12.0,12.0,13.0,14.0,15.0,15.0,6.0,23.0,1.0,0.0,0.0,0.0,185.0,70.0,4.0,3.0,1.0,2.0,1.0,3.0,2.0,3.0,1.0,2.0,3.0,5.0,8.0,12.0,13.0,13.0,7.0,14.0,11.0,5.0,5.0,8.0,13.0,5.0,13.0,6.0,13.0,10.0,12.0,12.0,11.0,11.0,13.0,12.0,7.0,13.0,9.0,8.0,10.0,16.0,12.0,14.0,12.0,8.0,14.0,15.0,20.0,13.0,13.0,12.0,7.0,15.0,7.0,7.0,13.0,13.0,12.0,10.0,12.0,15.0,15.0,7.0,21.0,0.0,0.0,0.0,0.0,189.0,77.0,2.0,1.0,1.0,1.0,3.0,3.0,3.0,3.0,3.0,3.0,1.0,5.0,11.0,12.0,10.0,13.0,6.0,13.0,11.0,6.0,5.0,12.0,11.0,5.0,12.0,8.0,12.0,13.0,11.0,10.0,10.0,10.0,13.0,10.0,6.0,13.0,8.0,13.0,14.0,12.0,12.0,15.0,14.0,7.0,14.0,13.0,20.0,13.0,14.0,12.0,8.0,10.0,8.0,8.0,8.0,14.0,13.0,11.0,14.0,15.0,16.0,6.0,33.0,70.0,0.0,0.0,0.0,185.0,81.0,12.0,9.0,11.0,10.0,11.0,11.0,12.0,15.0,10.0,15.0,8.0,6.0,2.0,8.0,1.0,12.0,8.0,10.0,1.0,2.0,1.0,2.0,1.0,3.0,11.0,10.0,9.0,13.0,11.0,15.0,9.0,11.0,15.0,2.0,10.0,1.0,12.0,17.0,9.0,7.0,14.0,13.0,14.0,10.0,7.0,9.0,20.0,11.0,10.0,14.0,11.0,13.0,6.0,11.0,18.0,18.0,10.0,10.0,17.0,14.0,12.0,2.0,22.0,24.0,0.0,3.0,1.0,182.0,80.0,3.0,3.0,1.0,2.0,2.0,2.0,3.0,1.0,3.0,3.0,3.0,4.0,5.0,8.0,6.0,11.0,6.0,12.0,5.0,5.0,12.0,10.0,7.0,12.0,11.0,11.0,12.0,12.0,11.0,11.0,9.0,11.0,14.0,7.0,8.0,7.0,10.0,13.0,12.0,12.0,10.0,11.0,11.0,5.0,13.0,12.0,20.0,14.0,13.0,13.0,9.0,12.0,8.0,8.0,14.0,13.0,14.0,12.0,15.0,15.0,15.0,7.0,32.0,19.0,0.0,9.0,0.0,185.0,85.0,2.0,3.0,2.0,1.0,2.0,1.0,1.0,2.0,2.0,3.0,3.0,5.0,10.0,9.0,8.0,11.0,11.0,15.0,13.0,9.0,15.0,12.0,10.0,14.0,11.0,14.0,15.0,16.0,12.0,11.0,9.0,11.0,17.0,7.0,12.0,9.0,15.0,13.0,10.0,9.0,9.0,15.0,13.0,10.0,13.0,11.0,20.0,13.0,15.0,12.0,15.0,12.0,13.0,10.0,11.0,13.0,11.0,13.0,18.0,15.0,13.0,5.0,24.0,0.0,0.0,0.0,0.0,175.0,68.0,4.0,3.0,3.0,4.0,1.0,3.0,2.0,2.0,3.0,3.0,1.0,8.0,12.0,11.0,7.0,11.0,8.0,9.0,12.0,13.0,11.0,11.0,7.0,12.0,13.0,12.0,11.0,14.0,12.0,11.0,10.0,12.0,14.0,6.0,8.0,13.0,12.0,14.0,14.0,13.0,13.0,10.0,6.0,12.0,14.0,13.0,20.0,14.0,9.0,13.0,6.0,12.0,5.0,15.0,15.0,10.0,10.0,13.0,14.0,15.0,13.0,4.0,20.0,0.0,0.0,0.0,0.0,190.0,80.0,2.0,2.0,1.0,4.0,2.0,2.0,3.0,4.0,2.0,2.0,1.0,12.0,12.0,10.0,9.0,11.0,7.0,12.0,8.0,12.0,10.0,10.0,9.0,12.0,11.0,13.0,11.0,13.0,11.0,12.0,8.0,11.0,11.0,7.0,8.0,10.0,10.0,13.0,12.0,13.0,12.0,12.0,15.0,20.0,13.0,14.0,6.0,13.0,14.0,12.0,6.0,10.0,5.0,13.0,16.0,13.0,9.0,12.0,10.0,10.0,11.0,4.0,20.0,0.0,0.0,0.0,0.0,175.0,66.0,1.0,1.0,2.0,2.0,1.0,2.0,2.0,3.0,1.0,2.0,2.0,9.0,8.0,6.0,2.0,14.0,4.0,12.0,6.0,7.0,12.0,11.0,7.0,13.0,12.0,15.0,13.0,13.0,12.0,13.0,11.0,10.0,8.0,10.0,5.0,11.0,12.0,15.0,12.0,13.0,14.0,11.0,9.0,20.0,16.0,14.0,6.0,12.0,17.0,10.0,5.0,1.0,7.0,10.0,12.0,9.0,12.0,12.0,10.0,12.0,13.0,2.0,23.0,0.0,0.0,0.0,0.0,173.0,63.0,3.0,1.0,3.0,4.0,2.0,1.0,3.0,2.0,1.0,1.0,1.0,8.0,13.0,11.0,8.0,12.0,8.0,11.0,7.0,11.0,12.0,13.0,12.0,13.0,13.0,11.0,13.0,14.0,10.0,12.0,13.0,12.0,14.0,11.0,14.0,13.0,13.0,16.0,15.0,12.0,12.0,13.0,10.0,12.0,15.0,13.0,20.0,14.0,14.0,13.0,14.0,13.0,7.0,13.0,13.0,14.0,15.0,14.0,15.0,13.0,12.0,8.0,31.0,0.0,0.0,0.0,0.0,180.0,74.0,3.0,2.0,3.0,1.0,2.0,3.0,2.0,1.0,4.0,3.0,3.0,12.0,12.0,10.0,9.0,13.0,14.0,11.0,13.0,6.0,10.0,14.0,15.0,13.0,13.0,15.0,14.0,17.0,12.0,14.0,13.0,13.0,15.0,7.0,13.0,10.0,13.0,18.0,15.0,9.0,11.0,14.0,10.0,10.0,13.0,12.0,20.0,15.0,14.0,14.0,13.0,15.0,8.0,7.0,19.0,13.0,13.0,13.0,13.0,13.0,12.0,9.0,27.0,0.0,0.0,11.0,1.0,174.0,72.0,2.0,3.0,4.0,1.0,1.0,4.0,3.0,3.0,3.0,3.0,1.0,10.0,13.0,14.0,8.0,14.0,7.0,6.0,11.0,5.0,6.0,13.0,10.0,5.0,14.0,7.0,12.0,10.0,10.0,12.0,9.0,12.0,12.0,12.0,4.0,14.0,6.0,9.0,13.0,16.0,14.0,10.0,6.0,9.0,13.0,16.0,20.0,12.0,9.0,14.0,6.0,11.0,7.0,10.0,10.0,13.0,12.0,11.0,14.0,14.0,16.0,8.0,28.0,0.0,0.0,2.0,2.0,182.0,79.0,1.0,1.0,2.0,2.0,3.0,1.0,2.0,3.0,1.0,2.0,2.0,8.0,11.0,14.0,12.0,14.0,11.0,12.0,13.0,6.0,4.0,11.0,13.0,5.0,14.0,11.0,12.0,13.0,10.0,12.0,11.0,11.0,15.0,13.0,7.0,14.0,7.0,12.0,14.0,15.0,14.0,14.0,12.0,8.0,15.0,14.0,20.0,15.0,14.0,12.0,11.0,15.0,8.0,8.0,16.0,15.0,12.0,11.0,14.0,13.0,12.0,8.0,21.0,0.0,0.0,0.0,0.0,181.0,73.0,2.0,3.0,2.0,2.0,1.0,2.0,1.0,2.0,1.0,3.0,1.0,6.0,9.0,12.0,11.0,11.0,8.0,9.0,11.0,6.0,4.0,9.0,12.0,3.0,13.0,10.0,11.0,12.0,11.0,9.0,9.0,9.0,14.0,13.0,6.0,13.0,6.0,10.0,12.0,15.0,14.0,13.0,10.0,8.0,12.0,14.0,20.0,11.0,12.0,12.0,10.0,14.0,10.0,8.0,16.0,13.0,13.0,14.0,12.0,15.0,15.0,8.0
0,1,20.0,0.0,0.0,3.0,0.0,193.0,80.0,10.0,12.0,12.0,9.0,11.0,11.0,13.0,15.0,13.0,7.0,12.0,7.0,1.0,1.0,2.0,8.0,11.0,1.0,2.0,1.0,2.0,11.0,2.0,1.0,8.0,4.0,14.0,14.0,11.0,9.0,11.0,12.0,12.0,2.0,15.0,1.0,13.0,11.0,6.0,12.0,13.0,15.0,16.0,20.0,15.0,10.0,6.0,13.0,14.0,12.0,11.0,11.0,10.0,1.0,11.0,9.0,12.0,12.0,13.0,10.0,10.0,1.0,22.0,24.0,0.0,3.0,1.0,182.0,80.0,3.0,3.0,1.0,2.0,2.0,2.0,3.0,1.0,3.0,3.0,3.0,4.0,5.0,8.0,6.0,11.0,6.0,12.0,5.0,5.0,12.0,10.0,7.0,12.0,11.0,11.0,12.0,12.0,11.0,11.0,9.0,11.0,14.0,7.0,8.0,7.0,10.0,13.0,12.0,12.0,10.0,11.0,11.0,5.0,13.0,12.0,20.0,14.0,13.0,13.0,9.0,12.0,8.0,8.0,14.0,13.0,14.0,12.0,15.0,15.0,15.0,7.0,32.0,19.0,0.0,9.0,0.0,185.0,85.0,2.0,3.0,2.0,1.0,2.0,1.0,1.0,2.0,2.0,3.0,3.0,5.0,10.0,9.0,8.0,11.0,11.0,15.0,13.0,9.0,15.0,12.0,10.0,14.0,11.0,14.0,15.0,16.0,12.0,11.0,9.0,11.0,17.0,7.0,12.0,9.0,15.0,13.0,10.0,9.0,9.0,15.0,13.0,10.0,13.0,11.0,20.0,13.0,15.0,12.0,15.0,12.0,13.0,10.0,11.0,13.0,11.0,13.0,18.0,15.0,13.0,5.0,24.0,0.0,0.0,0.0,0.0,175.0,68.0,4.0,3.0,3.0,4.0,1.0,3.0,2.0,2.0,3.0,3.0,1.0,8.0,12.0,11.0,7.0,11.0,8.0,9.0,12.0,13.0,11.0,11.0,7.0,12.0,13.0,12.0,11.0,14.0,12.0,11.0,10.0,12.0,14.0,6.0,8.0,13.0,12.0,14.0,14.0,13.0,13.0,10.0,6.0,12.0,14.0,13.0,20.0,14.0,9.0,13.0,6.0,12.0,5.0,15.0,15.0,10.0,10.0,13.0,14.0,15.0,13.0,4.0,20.0,0.0,0.0,0.0,0.0,190.0,80.0,2.0,2.0,1.0,4.0,2.0,2.0,3.0,4.0,2.0,2.0,1.0,12.0,12.0,10.0,9.0,11.0,7.0,12.0,8.0,12.0,10.0,10.0,9.0,12.0,11.0,13.0,11.0,13.0,11.0,12.0,8.0,11.0,11.0,7.0,8.0,10.0,10.0,13.0,12.0,13.0,12.0,12.0,15.0,20.0,13.0,14.0,6.0,13.0,14.0,12.0,6.0,10.0,5.0,13.0,16.0,13.0,9.0,12.0,10.0,10.0,11.0,4.0,20.0,0.0,0.0,0.0,0.0,175.0,66.0,1.0,1.0,2.0,2.0,1.0,2.0,2.0,3.0,1.0,2.0,2.0,9.0,8.0,6.0,2.0,14.0,4.0,12.0,6.0,7.0,12.0,11.0,7.0,13.0,12.0,15.0,13.0,13.0,12.0,13.0,11.0,10.0,8.0,10.0,5.0,11.0,12.0,15.0,12.0,13.0,14.0,11.0,9.0,20.0,16.0,14.0,6.0,12.0,17.0,10.0,5.0,1.0,7.0,10.0,12.0,9.0,12.0,12.0,10.0,12.0,13.0,2.0,23.0,0.0,0.0,0.0,0.0,173.0,63.0,3.0,1.0,3.0,4.0,2.0,1.0,3.0,2.0,1.0,1.0,1.0,8.0,13.0,11.0,8.0,12.0,8.0,11.0,7.0,11.0,12.0,13.0,12.0,13.0,13.0,11.0,13.0,14.0,10.0,12.0,13.0,12.0,14.0,11.0,14.0,13.0,13.0,16.0,15.0,12.0,12.0,13.0,10.0,12.0,15.0,13.0,20.0,14.0,14.0,13.0,14.0,13.0,7.0,13.0,13.0,14.0,15.0,14.0,15.0,13.0,12.0,8.0,31.0,0.0,0.0,0.0,0.0,180.0,74.0,3.0,2.0,3.0,1.0,2.0,3.0,2.0,1.0,4.0,3.0,3.0,12.0,12.0,10.0,9.0,13.0,14.0,11.0,13.0,6.0,10.0,14.0,15.0,13.0,13.0,15.0,14.0,17.0,12.0,14.0,13.0,13.0,15.0,7.0,13.0,10.0,13.0,18.0,15.0,9.0,11.0,14.0,10.0,10.0,13.0,12.0,20.0,15.0,14.0,14.0,13.0,15.0,8.0,7.0,19.0,13.0,13.0,13.0,13.0,13.0,12.0,9.0,27.0,0.0,0.0,11.0,1.0,174.0,72.0,2.0,3.0,4.0,1.0,1.0,4.0,3.0,3.0,3.0,3.0,1.0,10.0,13.0,14.0,8.0,14.0,7.0,6.0,11.0,5.0,6.0,13.0,10.0,5.0,14.0,7.0,12.0,10.0,10.0,12.0,9.0,12.0,12.0,12.0,4.0,14.0,6.0,9.0,13.0,16.0,14.0,10.0,6.0,9.0,13.0,16.0,20.0,12.0,9.0,14.0,6.0,11.0,7.0,10.0,10.0,13.0,12.0,11.0,14.0,14.0,16.0,8.0,28.0,0.0,0.0,2.0,2.0,182.0,79.0,1.0,1.0,2.0,2.0,3.0,1.0,2.0,3.0,1.0,2.0,2.0,8.0,11.0,14.0,12.0,14.0,11.0,12.0,13.0,6.0,4.0,11.0,13.0,5.0,14.0,11.0,12.0,13.0,10.0,12.0,11.0,11.0,15.0,13.0,7.0,14.0,7.0,12.0,14.0,15.0,14.0,14.0,12.0,8.0,15.0,14.0,20.0,15.0,14.0,12.0,11.0,15.0,8.0,8.0,16.0,15.0,12.0,11.0,14.0,13.0,12.0,8.0,21.0,0.0,0.0,0.0,0.0,181.0,73.0,2.0,3.0,2.0,2.0,1.0,2.0,1.0,2.0,1.0,3.0,1.0,6.0,9.0,12.0,11.0,11.0,8.0,9.0,11.0,6.0,4.0,9.0,12.0,3.0,13.0,10.0,11.0,12.0,11.0,9.0,9.0,9.0,14.0,13.0,6.0,13.0,6.0,10.0,12.0,15.0,14.0,13.0,10.0,8.0,12.0,14.0,20.0,11.0,12.0,12.0,10.0,14.0,10.0,8.0,16.0,13.0,13.0,14.0,12.0,15.0,15.0,8.0,26.0,11.0,0.0,0.0,0.0,198.0,88.0,13.0,11.0,10.0,8.0,12.0,10.0,14.0,15.0,11.0,13.0,9.0,3.0,3.0,3.0,6.0,6.0,6.0,12.0,12.0,2.0,1.0,8.0,6.0,1.0,6.0,9.0,12.0,14.0,12.0,12.0,11.0,11.0,12.0,6.0,9.0,2.0,13.0,12.0,8.0,12.0,13.0,18.0,17.0,5.0,16.0,9.0,20.0,15.0,15.0,11.0,9.0,12.0,5.0,1.0,16.0,14.0,16.0,13.0,12.0,15.0,15.0,7.0,23.0,0.0,0.0,0.0,0.0,188.0,75.0,2.0,2.0,2.0,2.0,3.0,4.0,2.0,2.0,2.0,3.0,3.0,4.0,10.0,7.0,5.0,10.0,7.0,13.0,10.0,5.0,13.0,11.0,6.0,13.0,12.0,13.0,13.0,14.0,11.0,11.0,8.0,11.0,12.0,5.0,6.0,10.0,12.0,13.0,14.0,13.0,11.0,15.0,14.0,5.0,14.0,12.0,20.0,14.0,14.0,12.0,13.0,11.0,7.0,12.0,9.0,12.0,11.0,7.0,12.0,10.0,10.0,8.0,24.0,0.0,0.0,0.0,0.0,185.0,70.0,3.0,2.0,3.0,2.0,2.0,1.0,2.0,1.0,1.0,2.0,3.0,5.0,6.0,9.0,7.0,11.0,8.0,15.0,12.0,7.0,14.0,13.0,7.0,11.0,11.0,11.0,14.0,14.0,13.0,9.0,9.0,12.0,4.0,8.0,5.0,10.0,12.0,15.0,12.0,11.0,11.0,14.0,13.0,6.0,15.0,11.0,20.0,13.0,14.0,13.0,9.0,11.0,7.0,10.0,15.0,11.0,13.0,11.0,10.0,9.0,14.0,4.0,24.0,0.0,0.0,0.0,0.0,183.0,78.0,2.0,3.0,1.0,3.0,2.0,1.0,1.0,1.0,1.0,3.0,3.0,5.0,10.0,9.0,5.0,12.0,11.0,12.0,11.0,8.0,13.0,13.0,11.0,14.0,10.0,15.0,14.0,14.0,13.0,15.0,10.0,14.0,14.0,6.0,6.0,9.0,14.0,13.0,14.0,12.0,12.0,14.0,11.0,5.0,15.0,11.0,20.0,14.0,14.0,14.0,13.0,12.0,7.0,10.0,12.0,13.0,16.0,13.0,15.0,15.0,15.0,5.0,24.0,0.0,0.0,0.0,0.0,175.0,72.0,3.0,2.0,4.0,3.0,2.0,4.0,1.0,1.0,1.0,2.0,2.0,8.0,12.0,12.0,6.0,11.0,7.0,10.0,9.0,12.0,11.0,12.0,8.0,12.0,11.0,11.0,12.0,13.0,10.0,10.0,9.0,9.0,3.0,9.0,9.0,11.0,12.0,11.0,11.0,14.0,13.0,11.0,8.0,20.0,12.0,13.0,6.0,12.0,11.0,10.0,10.0,10.0,9.0,10.0,10.0,13.0,10.0,11.0,10.0,13.0,18.0,1.0,29.0,0.0,0.0,0.0,0.0,188.0,74.0,1.0,2.0,3.0,3.0,2.0,3.0,1.0,3.0,2.0,1.0,1.0,4.0,8.0,10.0,6.0,13.0,7.0,14.0,9.0,6.0,13.0,12.0,8.0,13.0,13.0,12.0,14.0,13.0,14.0,11.0,13.0,12.0,14.0,6.0,13.0,8.0,14.0,15.0,15.0,9.0,12.0,14.0,14.0,10.0,13.0,10.0,20.0,16.0,12.0,13.0,12.0,15.0,9.0,11.0,11.0,14.0,14.0,12.0,15.0,13.0,13.0,6.0,26.0,0.0,0.0,0.0,0.0,178.0,74.0,2.0,3.0,1.0,3.0,3.0,3.0,2.0,2.0,3.0,1.0,3.0,14.0,12.0,12.0,10.0,13.0,14.0,9.0,12.0,5.0,6.0,12.0,8.0,8.0,13.0,11.0,11.0,12.0,10.0,11.0,12.0,13.0,15.0,12.0,8.0,11.0,12.0,12.0,15.0,14.0,15.0,15.0,10.0,5.0,13.0,13.0,20.0,14.0,13.0,13.0,13.0,14.0,8.0,6.0,14.0,13.0,12.0,11.0,13.0,12.0,16.0,7.0,25.0,0.0,0.0,0.0,0.0,174.0,73.0,1.0,1.0,3.0,2.0,1.0,1.0,1.0,2.0,3.0,3.0,3.0,11.0,12.0,12.0,6.0,13.0,11.0,7.0,11.0,10.0,9.0,13.0,9.0,10.0,14.0,11.0,13.0,13.0,12.0,11.0,15.0,11.0,14.0,13.0,7.0,11.0,12.0,15.0,16.0,12.0,14.0,12.0,8.0,20.0,14.0,13.0,7.0,12.0,11.0,12.0,11.0,13.0,9.0,12.0,8.0,13.0,13.0,12.0,15.0,15.0,15.0,6.0,21.0,0.0,0.0,0.0,0.0,180.0,68.0,4.0,1.0,1.0,1.0,1.0,3.0,1.0,2.0,2.0,2.0,3.0,10.0,10.0,13.0,9.0,13.0,9.0,8.0,8.0,6.0,11.0,13.0,10.0,10.0,12.0,8.0,8.0,8.0,11.0,10.0,13.0,10.0,20.0,13.0,6.0,9.0,9.0,7.0,10.0,14.0,14.0,13.0,10.0,10.0,10.0,14.0,20.0,12.0,11.0,10.0,10.0,7.0,6.0,13.0,17.0,12.0,10.0,12.0,12.0,8.0,10.0,2.0,19.0,0.0,0.0,0.0,0.0,168.0,64.0,3.0,2.0,4.0,1.0,2.0,2.0,1.0,1.0,1.0,1.0,3.0,9.0,11.0,13.0,10.0,11.0,8.0,4.0,10.0,3.0,4.0,11.0,10.0,4.0,12.0,8.0,11.0,11.0,9.0,8.0,10.0,10.0,12.0,11.0,6.0,9.0,9.0,10.0,9.0,14.0,11.0,10.0,7.0,11.0,12.0,14.0,20.0,11.0,10.0,11.0,12.0,9.0,8.0,11.0,10.0,11.0,9.0,11.0,8.0,7.0,8.0,10.0,23.0,0.0,0.0,7.0,3.0,181.0,71.0,2.0,2.0,2.0,2.0,2.0,2.0,4.0,2.0,3.0,3.0,2.0,7.0,12.0,12.0,14.0,13.0,7.0,11.0,11.0,7.0,6.0,11.0,15.0,7.0,12.0,12.0,13.0,16.0,12.0,12.0,10.0,11.0,6.0,12.0,7.0,14.0,9.0,12.0,16.0,13.0,14.0,13.0,9.0,8.0,14.0,12.0,20.0,12.0,12.0,12.0,10.0,12.0,8.0,10.0,19.0,10.0,10.0,10.0,11.0,11.0,12.0,6.0
1,2,19.0,0.0,0.0,0.0,0.0,193.0,84.0,14.0,11.0,10.0,9.0,12.0,13.0,13.0,13.0,9.0,8.0,13.0,4.0,2.0,1.0,3.0,7.0,7.0,2.0,3.0,1.0,1.0,8.0,1.0,3.0,7.0,8.0,11.0,12.0,10.0,12.0,8.0,10.0,10.0,6.0,7.0,1.0,12.0,11.0,10.0,9.0,13.0,12.0,13.0,5.0,15.0,8.0,20.0,12.0,14.0,12.0,10.0,4.0,3.0,10.0,18.0,13.0,13.0,9.0,13.0,11.0,19.0,4.0,33.0,24.0,1.0,3.0,0.0,193.0,90.0,1.0,2.0,2.0,2.0,3.0,2.0,3.0,1.0,3.0,2.0,3.0,3.0,6.0,8.0,8.0,11.0,10.0,17.0,8.0,5.0,13.0,10.0,7.0,14.0,11.0,14.0,14.0,16.0,11.0,10.0,9.0,10.0,14.0,7.0,13.0,7.0,13.0,14.0,11.0,9.0,10.0,15.0,15.0,7.0,13.0,10.0,20.0,10.0,13.0,10.0,13.0,15.0,9.0,8.0,12.0,15.0,13.0,11.0,15.0,12.0,13.0,7.0,29.0,0.0,0.0,0.0,0.0,185.0,84.0,3.0,2.0,2.0,2.0,1.0,3.0,1.0,2.0,1.0,3.0,1.0,3.0,6.0,6.0,7.0,10.0,5.0,14.0,5.0,4.0,14.0,9.0,7.0,13.0,9.0,13.0,13.0,14.0,12.0,13.0,8.0,12.0,14.0,8.0,16.0,8.0,12.0,13.0,15.0,11.0,11.0,15.0,12.0,5.0,14.0,12.0,20.0,14.0,16.0,13.0,12.0,10.0,7.0,7.0,7.0,12.0,13.0,13.0,14.0,13.0,12.0,8.0,27.0,0.0,0.0,0.0,0.0,169.0,60.0,3.0,2.0,1.0,3.0,3.0,2.0,1.0,3.0,3.0,2.0,2.0,11.0,11.0,13.0,9.0,13.0,12.0,8.0,10.0,4.0,5.0,14.0,8.0,5.0,13.0,12.0,9.0,9.0,10.0,10.0,10.0,9.0,16.0,13.0,4.0,14.0,8.0,11.0,8.0,16.0,16.0,9.0,9.0,5.0,13.0,15.0,20.0,11.0,11.0,10.0,8.0,7.0,5.0,11.0,14.0,10.0,12.0,11.0,12.0,10.0,13.0,8.0,24.0,0.0,0.0,0.0,0.0,178.0,77.0,2.0,1.0,3.0,2.0,1.0,3.0,3.0,3.0,1.0,3.0,2.0,5.0,10.0,8.0,5.0,9.0,6.0,11.0,8.0,12.0,11.0,8.0,6.0,12.0,9.0,11.0,11.0,13.0,11.0,12.0,7.0,11.0,15.0,9.0,6.0,9.0,11.0,12.0,14.0,16.0,12.0,14.0,10.0,5.0,15.0,15.0,20.0,14.0,13.0,14.0,11.0,13.0,5.0,8.0,17.0,12.0,14.0,14.0,14.0,14.0,14.0,6.0,22.0,0.0,0.0,0.0,0.0,188.0,79.0,1.0,2.0,2.0,3.0,2.0,2.0,3.0,4.0,3.0,2.0,1.0,8.0,10.0,11.0,7.0,11.0,8.0,10.0,8.0,7.0,8.0,10.0,10.0,11.0,11.0,11.0,12.0,13.0,11.0,10.0,8.0,11.0,10.0,8.0,8.0,12.0,10.0,12.0,15.0,13.0,12.0,14.0,14.0,20.0,13.0,12.0,8.0,14.0,14.0,12.0,10.0,6.0,8.0,15.0,11.0,11.0,11.0,11.0,11.0,10.0,12.0,6.0,26.0,0.0,0.0,0.0,0.0,184.0,76.0,2.0,3.0,1.0,3.0,1.0,1.0,3.0,1.0,3.0,2.0,2.0,10.0,12.0,14.0,12.0,14.0,12.0,11.0,13.0,11.0,13.0,14.0,13.0,12.0,15.0,14.0,13.0,12.0,11.0,11.0,13.0,14.0,14.0,12.0,13.0,12.0,11.0,11.0,14.0,15.0,14.0,13.0,10.0,5.0,14.0,14.0,20.0,14.0,14.0,14.0,7.0,16.0,6.0,8.0,19.0,14.0,14.0,14.0,14.0,14.0,14.0,6.0,29.0,0.0,0.0,0.0,0.0,180.0,74.0,2.0,1.0,3.0,3.0,2.0,4.0,1.0,3.0,3.0,2.0,2.0,9.0,13.0,13.0,10.0,14.0,10.0,12.0,12.0,6.0,8.0,12.0,8.0,8.0,14.0,10.0,13.0,14.0,13.0,12.0,13.0,11.0,13.0,11.0,7.0,10.0,10.0,14.0,14.0,14.0,13.0,13.0,12.0,10.0,14.0,13.0,20.0,14.0,11.0,14.0,10.0,15.0,8.0,10.0,8.0,12.0,14.0,16.0,14.0,15.0,15.0,6.0,28.0,0.0,0.0,0.0,0.0,181.0,75.0,4.0,2.0,1.0,3.0,3.0,3.0,2.0,2.0,2.0,2.0,2.0,13.0,12.0,12.0,9.0,12.0,13.0,7.0,11.0,7.0,7.0,13.0,5.0,7.0,13.0,9.0,13.0,3.0,12.0,11.0,12.0,12.0,3.0,12.0,14.0,12.0,9.0,12.0,13.0,13.0,13.0,10.0,11.0,20.0,13.0,12.0,6.0,13.0,9.0,13.0,6.0,13.0,8.0,10.0,20.0,12.0,14.0,11.0,13.0,10.0,11.0,4.0,25.0,1.0,1.0,0.0,0.0,182.0,70.0,2.0,1.0,2.0,3.0,3.0,2.0,2.0,4.0,1.0,3.0,2.0,9.0,7.0,13.0,13.0,12.0,6.0,13.0,12.0,8.0,8.0,10.0,14.0,6.0,11.0,13.0,10.0,13.0,12.0,12.0,10.0,12.0,13.0,8.0,9.0,14.0,8.0,11.0,12.0,14.0,13.0,14.0,11.0,8.0,13.0,14.0,20.0,13.0,13.0,12.0,6.0,12.0,6.0,11.0,14.0,11.0,10.0,11.0,10.0,9.0,19.0,5.0,18.0,0.0,0.0,0.0,0.0,183.0,70.0,1.0,2.0,2.0,1.0,1.0,2.0,2.0,1.0,2.0,1.0,3.0,10.0,11.0,12.0,7.0,11.0,9.0,10.0,9.0,10.0,5.0,10.0,8.0,5.0,12.0,9.0,10.0,10.0,9.0,8.0,9.0,9.0,11.0,10.0,7.0,12.0,6.0,11.0,12.0,14.0,12.0,10.0,11.0,6.0,12.0,13.0,20.0,11.0,9.0,12.0,10.0,3.0,9.0,10.0,17.0,12.0,12.0,13.0,11.0,12.0,12.0,2.0,30.0,42.0,0.0,13.0,0.0,195.0,88.0,16.0,13.0,14.0,6.0,14.0,13.0,13.0,15.0,12.0,10.0,14.0,1.0,8.0,5.0,2.0,8.0,2.0,8.0,2.0,5.0,3.0,9.0,5.0,3.0,8.0,10.0,12.0,10.0,14.0,10.0,10.0,14.0,13.0,3.0,14.0,3.0,12.0,14.0,12.0,8.0,13.0,18.0,18.0,17.0,14.0,11.0,20.0,14.0,17.0,14.0,4.0,14.0,4.0,1.0,12.0,13.0,14.0,9.0,15.0,13.0,13.0,5.0,28.0,0.0,0.0,0.0,0.0,190.0,85.0,3.0,2.0,3.0,3.0,2.0,2.0,2.0,4.0,3.0,1.0,2.0,5.0,9.0,8.0,9.0,8.0,7.0,14.0,10.0,9.0,15.0,9.0,6.0,14.0,9.0,16.0,13.0,16.0,10.0,13.0,10.0,12.0,15.0,6.0,13.0,7.0,13.0,14.0,16.0,12.0,11.0,17.0,13.0,20.0,15.0,13.0,8.0,15.0,15.0,12.0,14.0,14.0,9.0,8.0,14.0,13.0,14.0,11.0,12.0,13.0,16.0,14.0,24.0,0.0,0.0,0.0,0.0,185.0,77.0,1.0,1.0,3.0,2.0,1.0,1.0,3.0,1.0,3.0,3.0,1.0,7.0,10.0,12.0,11.0,12.0,12.0,14.0,13.0,7.0,13.0,12.0,8.0,14.0,12.0,10.0,13.0,11.0,13.0,13.0,12.0,13.0,16.0,10.0,8.0,12.0,13.0,13.0,13.0,14.0,14.0,12.0,14.0,12.0,14.0,13.0,20.0,11.0,12.0,12.0,12.0,10.0,11.0,7.0,17.0,11.0,10.0,10.0,10.0,7.0,8.0,5.0,19.0,0.0,0.0,0.0,0.0,189.0,78.0,2.0,2.0,2.0,1.0,1.0,1.0,3.0,1.0,2.0,1.0,2.0,7.0,8.0,9.0,7.0,9.0,6.0,12.0,8.0,8.0,12.0,12.0,6.0,13.0,11.0,15.0,13.0,14.0,11.0,10.0,8.0,12.0,14.0,6.0,9.0,11.0,11.0,13.0,14.0,13.0,12.0,12.0,13.0,6.0,14.0,13.0,20.0,12.0,13.0,13.0,6.0,12.0,5.0,13.0,16.0,13.0,13.0,13.0,15.0,14.0,12.0,5.0,21.0,0.0,0.0,0.0,0.0,178.0,65.0,2.0,3.0,3.0,3.0,3.0,1.0,1.0,1.0,1.0,3.0,1.0,9.0,13.0,11.0,6.0,12.0,7.0,9.0,8.0,8.0,13.0,12.0,7.0,13.0,12.0,8.0,12.0,13.0,12.0,12.0,13.0,13.0,14.0,9.0,8.0,12.0,12.0,13.0,13.0,12.0,14.0,13.0,11.0,8.0,15.0,12.0,20.0,13.0,12.0,14.0,8.0,11.0,7.0,10.0,19.0,10.0,13.0,10.0,11.0,15.0,15.0,6.0,21.0,0.0,0.0,0.0,0.0,177.0,0.0,1.0,1.0,1.0,2.0,3.0,3.0,2.0,3.0,2.0,2.0,3.0,6.0,4.0,13.0,13.0,13.0,6.0,13.0,7.0,3.0,5.0,7.0,6.0,1.0,11.0,9.0,7.0,8.0,7.0,7.0,7.0,8.0,7.0,11.0,8.0,13.0,7.0,6.0,7.0,12.0,13.0,7.0,6.0,8.0,8.0,13.0,20.0,5.0,5.0,9.0,5.0,9.0,9.0,9.0,10.0,10.0,12.0,12.0,11.0,10.0,9.0,6.0,19.0,0.0,0.0,0.0,0.0,183.0,79.0,3.0,1.0,3.0,3.0,3.0,2.0,1.0,2.0,3.0,1.0,2.0,5.0,10.0,9.0,7.0,10.0,4.0,10.0,9.0,6.0,12.0,11.0,7.0,12.0,8.0,10.0,12.0,11.0,11.0,11.0,12.0,11.0,13.0,11.0,9.0,12.0,12.0,12.0,14.0,12.0,13.0,13.0,11.0,8.0,13.0,12.0,20.0,13.0,12.0,12.0,10.0,11.0,5.0,9.0,12.0,12.0,13.0,11.0,14.0,12.0,10.0,10.0,22.0,0.0,0.0,0.0,0.0,187.0,84.0,2.0,2.0,1.0,2.0,3.0,2.0,2.0,3.0,3.0,2.0,2.0,4.0,7.0,10.0,6.0,9.0,10.0,13.0,12.0,5.0,11.0,11.0,7.0,10.0,12.0,12.0,11.0,13.0,10.0,9.0,11.0,9.0,15.0,8.0,7.0,9.0,11.0,11.0,14.0,13.0,10.0,15.0,14.0,8.0,15.0,11.0,20.0,14.0,15.0,11.0,12.0,7.0,9.0,8.0,7.0,13.0,15.0,13.0,11.0,14.0,14.0,7.0,22.0,0.0,0.0,0.0,0.0,177.0,72.0,2.0,1.0,2.0,4.0,2.0,2.0,1.0,3.0,4.0,2.0,3.0,10.0,12.0,13.0,11.0,12.0,10.0,12.0,12.0,4.0,10.0,13.0,11.0,11.0,13.0,11.0,12.0,11.0,13.0,9.0,13.0,12.0,3.0,12.0,8.0,14.0,12.0,12.0,13.0,16.0,13.0,12.0,9.0,8.0,15.0,14.0,20.0,14.0,13.0,10.0,4.0,11.0,11.0,12.0,19.0,9.0,12.0,13.0,12.0,11.0,14.0,7.0,25.0,0.0,0.0,0.0,0.0,187.0,83.0,2.0,1.0,3.0,3.0,1.0,3.0,3.0,3.0,1.0,1.0,3.0,4.0,8.0,10.0,14.0,12.0,8.0,14.0,9.0,5.0,7.0,11.0,13.0,5.0,12.0,11.0,13.0,13.0,13.0,11.0,10.0,12.0,16.0,9.0,8.0,13.0,11.0,13.0,16.0,14.0,13.0,15.0,13.0,20.0,14.0,12.0,8.0,14.0,16.0,13.0,11.0,13.0,7.0,5.0,13.0,14.0,13.0,14.0,14.0,13.0,13.0,6.0,29.0,30.0,6.0,0.0,0.0,178.0,76.0,2.0,3.0,3.0,4.0,3.0,2.0,2.0,2.0,2.0,1.0,1.0,6.0,11.0,16.0,10.0,12.0,5.0,8.0,8.0,5.0,4.0,13.0,7.0,3.0,12.0,7.0,8.0,12.0,11.0,10.0,8.0,9.0,13.0,15.0,4.0,13.0,7.0,12.0,10.0,16.0,15.0,14.0,8.0,11.0,13.0,16.0,20.0,10.0,13.0,10.0,11.0,10.0,7.0,5.0,9.0,16.0,9.0,10.0,11.0,11.0,14.0,3.0
1,1,25.0,0.0,0.0,0.0,0.0,185.0,85.0,14.0,11.0,14.0,10.0,12.0,14.0,13.0,14.0,11.0,15.0,9.0,4.0,1.0,3.0,1.0,9.0,8.0,3.0,11.0,1.0,2.0,8.0,2.0,7.0,9.0,8.0,13.0,13.0,12.0,12.0,8.0,11.0,16.0,6.0,14.0,1.0,12.0,12.0,7.0,10.0,13.0,15.0,12.0,5.0,17.0,9.0,20.0,13.0,15.0,14.0,8.0,13.0,3.0,1.0,17.0,13.0,13.0,13.0,14.0,14.0,14.0,5.0,27.0,15.0,0.0,0.0,0.0,193.0,82.0,4.0,1.0,3.0,1.0,1.0,4.0,2.0,4.0,3.0,3.0,2.0,5.0,9.0,9.0,8.0,10.0,8.0,12.0,11.0,8.0,12.0,12.0,7.0,15.0,13.0,14.0,11.0,17.0,14.0,14.0,10.0,11.0,16.0,8.0,13.0,10.0,10.0,8.0,12.0,13.0,12.0,17.0,17.0,20.0,15.0,15.0,14.0,13.0,16.0,14.0,14.0,14.0,7.0,8.0,12.0,17.0,12.0,15.0,14.0,10.0,9.0,10.0,25.0,0.0,0.0,0.0,0.0,191.0,81.0,1.0,1.0,3.0,2.0,3.0,2.0,3.0,4.0,2.0,1.0,2.0,4.0,3.0,10.0,8.0,6.0,6.0,11.0,6.0,10.0,11.0,10.0,5.0,12.0,7.0,16.0,13.0,16.0,11.0,13.0,7.0,10.0,14.0,5.0,12.0,10.0,13.0,13.0,12.0,13.0,13.0,16.0,16.0,7.0,16.0,14.0,20.0,14.0,14.0,13.0,13.0,15.0,6.0,12.0,13.0,6.0,14.0,8.0,8.0,13.0,7.0,4.0,29.0,6.0,0.0,0.0,0.0,183.0,72.0,3.0,3.0,3.0,4.0,1.0,3.0,3.0,3.0,1.0,3.0,3.0,2.0,13.0,13.0,8.0,14.0,8.0,10.0,12.0,10.0,12.0,13.0,8.0,14.0,10.0,14.0,13.0,10.0,12.0,12.0,10.0,12.0,4.0,12.0,4.0,14.0,12.0,13.0,14.0,14.0,13.0,13.0,11.0,5.0,14.0,15.0,20.0,14.0,11.0,13.0,2.0,12.0,7.0,8.0,16.0,10.0,11.0,13.0,10.0,3.0,19.0,8.0,19.0,0.0,0.0,0.0,0.0,175.0,70.0,1.0,3.0,3.0,1.0,1.0,3.0,1.0,1.0,2.0,2.0,2.0,6.0,10.0,6.0,7.0,10.0,2.0,10.0,6.0,9.0,10.0,11.0,2.0,15.0,9.0,9.0,12.0,9.0,10.0,8.0,10.0,13.0,2.0,9.0,1.0,9.0,9.0,10.0,11.0,14.0,12.0,7.0,7.0,4.0,13.0,13.0,20.0,9.0,8.0,9.0,9.0,8.0,9.0,14.0,12.0,7.0,9.0,9.0,9.0,10.0,19.0,3.0,24.0,0.0,0.0,0.0,0.0,177.0,70.0,2.0,4.0,2.0,1.0,1.0,3.0,1.0,3.0,4.0,2.0,1.0,6.0,10.0,11.0,7.0,13.0,6.0,9.0,13.0,7.0,12.0,14.0,7.0,13.0,13.0,13.0,13.0,13.0,11.0,11.0,11.0,12.0,13.0,10.0,7.0,11.0,11.0,14.0,15.0,13.0,13.0,14.0,9.0,6.0,15.0,14.0,20.0,15.0,12.0,13.0,11.0,13.0,7.0,12.0,19.0,12.0,17.0,10.0,13.0,13.0,13.0,6.0,26.0,0.0,0.0,0.0,0.0,175.0,70.0,2.0,1.0,1.0,2.0,2.0,2.0,3.0,2.0,2.0,1.0,1.0,13.0,12.0,11.0,8.0,14.0,11.0,7.0,11.0,6.0,5.0,14.0,11.0,6.0,15.0,11.0,12.0,12.0,15.0,10.0,13.0,12.0,14.0,13.0,7.0,12.0,12.0,16.0,12.0,12.0,14.0,12.0,8.0,8.0,11.0,13.0,20.0,11.0,9.0,8.0,8.0,12.0,15.0,14.0,12.0,13.0,11.0,13.0,12.0,15.0,15.0,7.0,21.0,0.0,0.0,0.0,0.0,186.0,80.0,2.0,2.0,1.0,3.0,2.0,2.0,3.0,2.0,3.0,3.0,3.0,12.0,11.0,12.0,9.0,15.0,9.0,10.0,12.0,6.0,9.0,14.0,8.0,11.0,14.0,12.0,13.0,10.0,14.0,14.0,15.0,14.0,13.0,14.0,8.0,13.0,14.0,12.0,12.0,10.0,12.0,13.0,13.0,12.0,12.0,11.0,20.0,12.0,12.0,14.0,7.0,14.0,5.0,12.0,18.0,14.0,11.0,10.0,12.0,10.0,19.0,2.0,23.0,0.0,0.0,0.0,0.0,173.0,75.0,3.0,2.0,1.0,3.0,1.0,4.0,2.0,1.0,4.0,2.0,1.0,11.0,10.0,16.0,9.0,15.0,14.0,7.0,10.0,6.0,8.0,14.0,12.0,5.0,15.0,8.0,10.0,8.0,15.0,10.0,14.0,15.0,12.0,13.0,9.0,14.0,5.0,7.0,10.0,14.0,14.0,12.0,8.0,15.0,13.0,12.0,20.0,9.0,8.0,12.0,8.0,11.0,6.0,14.0,14.0,15.0,15.0,10.0,18.0,15.0,10.0,5.0,21.0,0.0,0.0,0.0,0.0,172.0,70.0,2.0,3.0,1.0,1.0,3.0,3.0,1.0,2.0,1.0,1.0,1.0,5.0,7.0,14.0,12.0,14.0,7.0,6.0,11.0,5.0,3.0,12.0,12.0,4.0,15.0,7.0,12.0,9.0,12.0,10.0,10.0,11.0,12.0,16.0,6.0,14.0,5.0,9.0,9.0,14.0,16.0,14.0,7.0,12.0,13.0,15.0,20.0,13.0,12.0,11.0,7.0,2.0,12.0,12.0,9.0,12.0,14.0,11.0,13.0,16.0,16.0,5.0,24.0,0.0,0.0,5.0,0.0,183.0,79.0,4.0,4.0,3.0,3.0,1.0,3.0,2.0,1.0,3.0,2.0,3.0,4.0,7.0,12.0,13.0,12.0,8.0,13.0,12.0,5.0,6.0,11.0,12.0,4.0,13.0,11.0,12.0,14.0,9.0,12.0,10.0,10.0,13.0,12.0,6.0,14.0,12.0,13.0,14.0,15.0,14.0,14.0,11.0,10.0,13.0,14.0,20.0,14.0,14.0,12.0,12.0,14.0,9.0,5.0,7.0,13.0,15.0,11.0,14.0,14.0,14.0,6.0,19.0,0.0,0.0,0.0,0.0,193.0,84.0,14.0,11.0,10.0,9.0,12.0,13.0,13.0,13.0,9.0,8.0,13.0,4.0,2.0,1.0,3.0,7.0,7.0,2.0,3.0,1.0,1.0,8.0,1.0,3.0,7.0,8.0,11.0,12.0,10.0,12.0,8.0,10.0,10.0,6.0,7.0,1.0,12.0,11.0,10.0,9.0,13.0,12.0,13.0,5.0,15.0,8.0,20.0,12.0,14.0,12.0,10.0,4.0,3.0,10.0,18.0,13.0,13.0,9.0,13.0,11.0,19.0,4.0,33.0,24.0,1.0,3.0,0.0,193.0,90.0,1.0,2.0,2.0,2.0,3.0,2.0,3.0,1.0,3.0,2.0,3.0,3.0,6.0,8.0,8.0,11.0,10.0,17.0,8.0,5.0,13.0,10.0,7.0,14.0,11.0,14.0,14.0,16.0,11.0,10.0,9.0,10.0,14.0,7.0,13.0,7.0,13.0,14.0,11.0,9.0,10.0,15.0,15.0,7.0,13.0,10.0,20.0,10.0,13.0,10.0,13.0,15.0,9.0,8.0,12.0,15.0,13.0,11.0,15.0,12.0,13.0,7.0,29.0,0.0,0.0,0.0,0.0,185.0,84.0,3.0,2.0,2.0,2.0,1.0,3.0,1.0,2.0,1.0,3.0,1.0,3.0,6.0,6.0,7.0,10.0,5.0,14.0,5.0,4.0,14.0,9.0,7.0,13.0,9.0,13.0,13.0,14.0,12.0,13.0,8.0,12.0,14.0,8.0,16.0,8.0,12.0,13.0,15.0,11.0,11.0,15.0,12.0,5.0,14.0,12.0,20.0,14.0,16.0,13.0,12.0,10.0,7.0,7.0,7.0,12.0,13.0,13.0,14.0,13.0,12.0,8.0,27.0,0.0,0.0,0.0,0.0,169.0,60.0,3.0,2.0,1.0,3.0,3.0,2.0,1.0,3.0,3.0,2.0,2.0,11.0,11.0,13.0,9.0,13.0,12.0,8.0,10.0,4.0,5.0,14.0,8.0,5.0,13.0,12.0,9.0,9.0,10.0,10.0,10.0,9.0,16.0,13.0,4.0,14.0,8.0,11.0,8.0,16.0,16.0,9.0,9.0,5.0,13.0,15.0,20.0,11.0,11.0,10.0,8.0,7.0,5.0,11.0,14.0,10.0,12.0,11.0,12.0,10.0,13.0,8.0,24.0,0.0,0.0,0.0,0.0,178.0,77.0,2.0,1.0,3.0,2.0,1.0,3.0,3.0,3.0,1.0,3.0,2.0,5.0,10.0,8.0,5.0,9.0,6.0,11.0,8.0,12.0,11.0,8.0,6.0,12.0,9.0,11.0,11.0,13.0,11.0,12.0,7.0,11.0,15.0,9.0,6.0,9.0,11.0,12.0,14.0,16.0,12.0,14.0,10.0,5.0,15.0,15.0,20.0,14.0,13.0,14.0,11.0,13.0,5.0,8.0,17.0,12.0,14.0,14.0,14.0,14.0,14.0,6.0,26.0,0.0,0.0,0.0,0.0,184.0,76.0,2.0,3.0,1.0,3.0,1.0,1.0,3.0,1.0,3.0,2.0,2.0,10.0,12.0,14.0,12.0,14.0,12.0,11.0,13.0,11.0,13.0,14.0,13.0,12.0,15.0,14.0,13.0,12.0,11.0,11.0,13.0,14.0,14.0,12.0,13.0,12.0,11.0,11.0,14.0,15.0,14.0,13.0,10.0,5.0,14.0,14.0,20.0,14.0,14.0,14.0,7.0,16.0,6.0,8.0,19.0,14.0,14.0,14.0,14.0,14.0,14.0,6.0,22.0,0.0,0.0,0.0,0.0,188.0,79.0,1.0,2.0,2.0,3.0,2.0,2.0,3.0,4.0,3.0,2.0,1.0,8.0,10.0,11.0,7.0,11.0,8.0,10.0,8.0,7.0,8.0,10.0,10.0,11.0,11.0,11.0,12.0,13.0,11.0,10.0,8.0,11.0,10.0,8.0,8.0,12.0,10.0,12.0,15.0,13.0,12.0,14.0,14.0,20.0,13.0,12.0,8.0,14.0,14.0,12.0,10.0,6.0,8.0,15.0,11.0,11.0,11.0,11.0,11.0,10.0,12.0,6.0,28.0,0.0,0.0,0.0,0.0,181.0,75.0,4.0,2.0,1.0,3.0,3.0,3.0,2.0,2.0,2.0,2.0,2.0,13.0,12.0,12.0,9.0,12.0,13.0,7.0,11.0,7.0,7.0,13.0,5.0,7.0,13.0,9.0,13.0,3.0,12.0,11.0,12.0,12.0,3.0,12.0,14.0,12.0,9.0,12.0,13.0,13.0,13.0,10.0,11.0,20.0,13.0,12.0,6.0,13.0,9.0,13.0,6.0,13.0,8.0,10.0,20.0,12.0,14.0,11.0,13.0,10.0,11.0,4.0,29.0,0.0,0.0,0.0,0.0,180.0,74.0,2.0,1.0,3.0,3.0,2.0,4.0,1.0,3.0,3.0,2.0,2.0,9.0,13.0,13.0,10.0,14.0,10.0,12.0,12.0,6.0,8.0,12.0,8.0,8.0,14.0,10.0,13.0,14.0,13.0,12.0,13.0,11.0,13.0,11.0,7.0,10.0,10.0,14.0,14.0,14.0,13.0,13.0,12.0,10.0,14.0,13.0,20.0,14.0,11.0,14.0,10.0,15.0,8.0,10.0,8.0,12.0,14.0,16.0,14.0,15.0,15.0,6.0,25.0,1.0,1.0,0.0,0.0,182.0,70.0,2.0,1.0,2.0,3.0,3.0,2.0,2.0,4.0,1.0,3.0,2.0,9.0,7.0,13.0,13.0,12.0,6.0,13.0,12.0,8.0,8.0,10.0,14.0,6.0,11.0,13.0,10.0,13.0,12.0,12.0,10.0,12.0,13.0,8.0,9.0,14.0,8.0,11.0,12.0,14.0,13.0,14.0,11.0,8.0,13.0,14.0,20.0,13.0,13.0,12.0,6.0,12.0,6.0,11.0,14.0,11.0,10.0,11.0,10.0,9.0,19.0,5.0,24.0,0.0,0.0,0.0,0.0,179.0,85.0,2.0,4.0,2.0,3.0,1.0,1.0,1.0,1.0,1.0,1.0,2.0,4.0,8.0,12.0,14.0,11.0,8.0,13.0,11.0,7.0,8.0,9.0,12.0,6.0,12.0,12.0,12.0,13.0,13.0,14.0,9.0,14.0,16.0,11.0,8.0,13.0,5.0,11.0,12.0,11.0,13.0,16.0,10.0,9.0,2.0,12.0,20.0,14.0,16.0,14.0,12.0,13.0,7.0,5.0,19.0,13.0,13.0,8.0,12.0,12.0,12.0,10.0
1,0,30.0,42.0,0.0,13.0,0.0,195.0,88.0,16.0,13.0,14.0,6.0,14.0,13.0,13.0,15.0,12.0,10.0,14.0,1.0,8.0,5.0,2.0,8.0,2.0,8.0,2.0,5.0,3.0,9.0,5.0,3.0,8.0,10.0,12.0,10.0,14.0,10.0,10.0,14.0,13.0,3.0,14.0,3.0,12.0,14.0,12.0,8.0,13.0,18.0,18.0,17.0,14.0,11.0,20.0,14.0,17.0,14.0,4.0,14.0,4.0,1.0,12.0,13.0,14.0,9.0,15.0,13.0,13.0,5.0,28.0,0.0,0.0,0.0,0.0,174.0,67.0,3.0,4.0,1.0,1.0,1.0,3.0,1.0,3.0,2.0,1.0,2.0,11.0,8.0,11.0,9.0,13.0,6.0,7.0,12.0,8.0,10.0,10.0,3.0,6.0,12.0,10.0,13.0,7.0,12.0,8.0,10.0,9.0,12.0,13.0,5.0,12.0,9.0,12.0,11.0,14.0,14.0,11.0,7.0,10.0,15.0,12.0,20.0,11.0,6.0,9.0,6.0,10.0,10.0,9.0,11.0,14.0,9.0,11.0,12.0,8.0,8.0,8.0,23.0,0.0,0.0,0.0,0.0,184.0,71.0,1.0,2.0,1.0,2.0,2.0,2.0,2.0,4.0,2.0,1.0,3.0,4.0,10.0,10.0,6.0,11.0,6.0,14.0,8.0,7.0,14.0,11.0,6.0,13.0,11.0,12.0,12.0,13.0,12.0,11.0,12.0,12.0,14.0,6.0,8.0,10.0,13.0,13.0,14.0,15.0,13.0,14.0,13.0,8.0,12.0,14.0,20.0,13.0,14.0,13.0,12.0,14.0,15.0,8.0,11.0,13.0,13.0,10.0,8.0,9.0,16.0,7.0,21.0,0.0,0.0,0.0,0.0,178.0,65.0,2.0,3.0,3.0,3.0,3.0,1.0,1.0,1.0,1.0,3.0,1.0,9.0,13.0,11.0,6.0,12.0,7.0,9.0,8.0,8.0,13.0,12.0,7.0,13.0,12.0,8.0,12.0,13.0,12.0,12.0,13.0,13.0,14.0,9.0,8.0,12.0,12.0,13.0,13.0,12.0,14.0,13.0,11.0,8.0,15.0,12.0,20.0,13.0,12.0,14.0,8.0,11.0,7.0,10.0,19.0,10.0,13.0,10.0,11.0,15.0,15.0,6.0,21.0,0.0,0.0,0.0,0.0,177.0,0.0,1.0,1.0,1.0,2.0,3.0,3.0,2.0,3.0,2.0,2.0,3.0,6.0,4.0,13.0,13.0,13.0,6.0,13.0,7.0,3.0,5.0,7.0,6.0,1.0,11.0,9.0,7.0,8.0,7.0,7.0,7.0,8.0,7.0,11.0,8.0,13.0,7.0,6.0,7.0,12.0,13.0,7.0,6.0,8.0,8.0,13.0,20.0,5.0,5.0,9.0,5.0,9.0,9.0,9.0,10.0,10.0,12.0,12.0,11.0,10.0,9.0,6.0,21.0,0.0,0.0,0.0,0.0,172.0,66.0,2.0,3.0,2.0,2.0,1.0,1.0,1.0,3.0,2.0,1.0,1.0,10.0,10.0,13.0,9.0,14.0,9.0,8.0,10.0,7.0,13.0,13.0,9.0,12.0,13.0,10.0,12.0,13.0,13.0,12.0,14.0,13.0,13.0,11.0,9.0,14.0,13.0,14.0,14.0,14.0,13.0,12.0,8.0,8.0,12.0,12.0,20.0,13.0,12.0,14.0,10.0,11.0,8.0,12.0,15.0,10.0,15.0,8.0,11.0,14.0,14.0,6.0,22.0,0.0,0.0,0.0,0.0,187.0,84.0,2.0,2.0,1.0,2.0,3.0,2.0,2.0,3.0,3.0,2.0,2.0,4.0,7.0,10.0,6.0,9.0,10.0,13.0,12.0,5.0,11.0,11.0,7.0,10.0,12.0,12.0,11.0,13.0,10.0,9.0,11.0,9.0,15.0,8.0,7.0,9.0,11.0,11.0,14.0,13.0,10.0,15.0,14.0,8.0,15.0,11.0,20.0,14.0,15.0,11.0,12.0,7.0,9.0,8.0,7.0,13.0,15.0,13.0,11.0,14.0,14.0,7.0,25.0,1.0,0.0,5.0,1.0,175.0,68.0,2.0,2.0,3.0,1.0,2.0,2.0,4.0,3.0,2.0,1.0,1.0,14.0,15.0,17.0,13.0,16.0,11.0,6.0,11.0,5.0,5.0,14.0,9.0,5.0,16.0,9.0,13.0,17.0,14.0,13.0,9.0,14.0,14.0,14.0,7.0,13.0,9.0,6.0,10.0,13.0,14.0,8.0,7.0,7.0,6.0,15.0,20.0,9.0,8.0,13.0,8.0,11.0,11.0,11.0,12.0,10.0,10.0,12.0,3.0,7.0,5.0,17.0,22.0,0.0,0.0,0.0,0.0,177.0,72.0,2.0,1.0,2.0,4.0,2.0,2.0,1.0,3.0,4.0,2.0,3.0,10.0,12.0,13.0,11.0,12.0,10.0,12.0,12.0,4.0,10.0,13.0,11.0,11.0,13.0,11.0,12.0,11.0,13.0,9.0,13.0,12.0,3.0,12.0,8.0,14.0,12.0,12.0,13.0,16.0,13.0,12.0,9.0,8.0,15.0,14.0,20.0,14.0,13.0,10.0,4.0,11.0,11.0,12.0,19.0,9.0,12.0,13.0,12.0,11.0,14.0,7.0,29.0,30.0,6.0,0.0,0.0,178.0,76.0,2.0,3.0,3.0,4.0,3.0,2.0,2.0,2.0,2.0,1.0,1.0,6.0,11.0,16.0,10.0,12.0,5.0,8.0,8.0,5.0,4.0,13.0,7.0,3.0,12.0,7.0,8.0,12.0,11.0,10.0,8.0,9.0,13.0,15.0,4.0,13.0,7.0,12.0,10.0,16.0,15.0,14.0,8.0,11.0,13.0,16.0,20.0,10.0,13.0,10.0,11.0,10.0,7.0,5.0,9.0,16.0,9.0,10.0,11.0,11.0,14.0,3.0,25.0,0.0,0.0,0.0,0.0,187.0,83.0,2.0,1.0,3.0,3.0,1.0,3.0,3.0,3.0,1.0,1.0,3.0,4.0,8.0,10.0,14.0,12.0,8.0,14.0,9.0,5.0,7.0,11.0,13.0,5.0,12.0,11.0,13.0,13.0,13.0,11.0,10.0,12.0,16.0,9.0,8.0,13.0,11.0,13.0,16.0,14.0,13.0,15.0,13.0,20.0,14.0,12.0,8.0,14.0,16.0,13.0,11.0,13.0,7.0,5.0,13.0,14.0,13.0,14.0,14.0,13.0,13.0,6.0,33.0,70.0,0.0,0.0,0.0,185.0,81.0,12.0,9.0,11.0,10.0,11.0,11.0,12.0,15.0,10.0,15.0,8.0,6.0,2.0,8.0,1.0,12.0,8.0,10.0,1.0,2.0,1.0,2.0,1.0,3.0,11.0,10.0,9.0,13.0,11.0,15.0,9.0,11.0,15.0,2.0,10.0,1.0,12.0,17.0,9.0,7.0,14.0,13.0,14.0,10.0,7.0,9.0,20.0,11.0,10.0,14.0,11.0,13.0,6.0,11.0,18.0,18.0,10.0,10.0,17.0,14.0,12.0,2.0,32.0,19.0,0.0,9.0,0.0,185.0,85.0,2.0,3.0,2.0,1.0,2.0,1.0,1.0,2.0,2.0,3.0,3.0,5.0,10.0,9.0,8.0,11.0,11.0,15.0,13.0,9.0,15.0,12.0,10.0,14.0,11.0,14.0,15.0,16.0,12.0,11.0,9.0,11.0,17.0,7.0,12.0,9.0,15.0,13.0,10.0,9.0,9.0,15.0,13.0,10.0,13.0,11.0,20.0,13.0,15.0,12.0,15.0,12.0,13.0,10.0,11.0,13.0,11.0,13.0,18.0,15.0,13.0,5.0,22.0,24.0,0.0,3.0,1.0,182.0,80.0,3.0,3.0,1.0,2.0,2.0,2.0,3.0,1.0,3.0,3.0,3.0,4.0,5.0,8.0,6.0,11.0,6.0,12.0,5.0,5.0,12.0,10.0,7.0,12.0,11.0,11.0,12.0,12.0,11.0,11.0,9.0,11.0,14.0,7.0,8.0,7.0,10.0,13.0,12.0,12.0,10.0,11.0,11.0,5.0,13.0,12.0,20.0,14.0,13.0,13.0,9.0,12.0,8.0,8.0,14.0,13.0,14.0,12.0,15.0,15.0,15.0,7.0,24.0,0.0,0.0,0.0,0.0,175.0,68.0,4.0,3.0,3.0,4.0,1.0,3.0,2.0,2.0,3.0,3.0,1.0,8.0,12.0,11.0,7.0,11.0,8.0,9.0,12.0,13.0,11.0,11.0,7.0,12.0,13.0,12.0,11.0,14.0,12.0,11.0,10.0,12.0,14.0,6.0,8.0,13.0,12.0,14.0,14.0,13.0,13.0,10.0,6.0,12.0,14.0,13.0,20.0,14.0,9.0,13.0,6.0,12.0,5.0,15.0,15.0,10.0,10.0,13.0,14.0,15.0,13.0,4.0,32.0,23.0,0.0,0.0,0.0,178.0,77.0,3.0,2.0,3.0,1.0,3.0,1.0,3.0,2.0,1.0,3.0,1.0,9.0,12.0,12.0,6.0,13.0,12.0,10.0,10.0,10.0,13.0,12.0,7.0,14.0,13.0,15.0,14.0,13.0,13.0,10.0,10.0,12.0,5.0,12.0,11.0,12.0,13.0,14.0,14.0,14.0,13.0,12.0,9.0,20.0,14.0,14.0,10.0,13.0,12.0,13.0,6.0,14.0,6.0,10.0,13.0,5.0,11.0,8.0,10.0,14.0,9.0,15.0,20.0,0.0,0.0,0.0,0.0,190.0,80.0,2.0,2.0,1.0,4.0,2.0,2.0,3.0,4.0,2.0,2.0,1.0,12.0,12.0,10.0,9.0,11.0,7.0,12.0,8.0,12.0,10.0,10.0,9.0,12.0,11.0,13.0,11.0,13.0,11.0,12.0,8.0,11.0,11.0,7.0,8.0,10.0,10.0,13.0,12.0,13.0,12.0,12.0,15.0,20.0,13.0,14.0,6.0,13.0,14.0,12.0,6.0,10.0,5.0,13.0,16.0,13.0,9.0,12.0,10.0,10.0,11.0,4.0,23.0,0.0,0.0,0.0,0.0,173.0,63.0,3.0,1.0,3.0,4.0,2.0,1.0,3.0,2.0,1.0,1.0,1.0,8.0,13.0,11.0,8.0,12.0,8.0,11.0,7.0,11.0,12.0,13.0,12.0,13.0,13.0,11.0,13.0,14.0,10.0,12.0,13.0,12.0,14.0,11.0,14.0,13.0,13.0,16.0,15.0,12.0,12.0,13.0,10.0,12.0,15.0,13.0,20.0,14.0,14.0,13.0,14.0,13.0,7.0,13.0,13.0,14.0,15.0,14.0,15.0,13.0,12.0,8.0,31.0,0.0,0.0,0.0,0.0,180.0,74.0,3.0,2.0,3.0,1.0,2.0,3.0,2.0,1.0,4.0,3.0,3.0,12.0,12.0,10.0,9.0,13.0,14.0,11.0,13.0,6.0,10.0,14.0,15.0,13.0,13.0,15.0,14.0,17.0,12.0,14.0,13.0,13.0,15.0,7.0,13.0,10.0,13.0,18.0,15.0,9.0,11.0,14.0,10.0,10.0,13.0,12.0,20.0,15.0,14.0,14.0,13.0,15.0,8.0,7.0,19.0,13.0,13.0,13.0,13.0,13.0,12.0,9.0,27.0,0.0,0.0,11.0,1.0,174.0,72.0,2.0,3.0,4.0,1.0,1.0,4.0,3.0,3.0,3.0,3.0,1.0,10.0,13.0,14.0,8.0,14.0,7.0,6.0,11.0,5.0,6.0,13.0,10.0,5.0,14.0,7.0,12.0,10.0,10.0,12.0,9.0,12.0,12.0,12.0,4.0,14.0,6.0,9.0,13.0,16.0,14.0,10.0,6.0,9.0,13.0,16.0,20.0,12.0,9.0,14.0,6.0,11.0,7.0,10.0,10.0,13.0,12.0,11.0,14.0,14.0,16.0,8.0,21.0,0.0,0.0,0.0,0.0,181.0,73.0,2.0,3.0,2.0,2.0,1.0,2.0,1.0,2.0,1.0,3.0,1.0,6.0,9.0,12.0,11.0,11.0,8.0,9.0,11.0,6.0,4.0,9.0,12.0,3.0,13.0,10.0,11.0,12.0,11.0,9.0,9.0,9.0,14.0,13.0,6.0,13.0,6.0,10.0,12.0,15.0,14.0,13.0,10.0,8.0,12.0,14.0,20.0,11.0,12.0,12.0,10.0,14.0,10.0,8.0,16.0,13.0,13.0,14.0,12.0,15.0,15.0,8.0,28.0,0.0,0.0,2.0,2.0,182.0,79.0,1.0,1.0,2.0,2.0,3.0,1.0,2.0,3.0,1.0,2.0,2.0,8.0,11.0,14.0,12.0,14.0,11.0,12.0,13.0,6.0,4.0,11.0,13.0,5.0,14.0,11.0,12.0,13.0,10.0,12.0,11.0,11.0,15.0,13.0,7.0,14.0,7.0,12.0,14.0,15.0,14.0,14.0,12.0,8.0,15.0,14.0,20.0,15.0,14.0,12.0,11.0,15.0,8.0,8.0,16.0,15.0,12.0,11.0,14.0,13.0,12.0,8.0
3,3,25.0,0.0,0.0,0.0,0.0,192.0,87.0,12.0,13.0,12.0,6.0,14.0,11.0,12.0,13.0,9.0,12.0,11.0,5.0,1.0,3.0,1.0,10.0,8.0,3.0,3.0,3.0,3.0,8.0,2.0,1.0,8.0,7.0,13.0,14.0,12.0,13.0,12.0,11.0,13.0,7.0,11.0,3.0,13.0,11.0,12.0,11.0,12.0,16.0,16.0,8.0,14.0,12.0,20.0,13.0,16.0,13.0,7.0,9.0,7.0,10.0,14.0,12.0,17.0,13.0,14.0,14.0,14.0,5.0,29.0,2.0,0.0,0.0,0.0,185.0,75.0,2.0,3.0,3.0,3.0,2.0,3.0,2.0,1.0,3.0,1.0,2.0,4.0,10.0,8.0,6.0,10.0,6.0,14.0,7.0,7.0,14.0,11.0,6.0,14.0,9.0,13.0,13.0,14.0,11.0,12.0,12.0,12.0,14.0,8.0,11.0,12.0,13.0,13.0,13.0,15.0,12.0,15.0,12.0,8.0,15.0,13.0,20.0,14.0,15.0,14.0,7.0,14.0,8.0,6.0,14.0,13.0,15.0,14.0,14.0,14.0,14.0,6.0,28.0,0.0,0.0,0.0,0.0,193.0,84.0,1.0,1.0,2.0,2.0,2.0,3.0,2.0,3.0,2.0,1.0,3.0,4.0,8.0,8.0,9.0,10.0,6.0,14.0,7.0,8.0,14.0,12.0,6.0,14.0,11.0,12.0,13.0,14.0,11.0,14.0,12.0,12.0,14.0,6.0,11.0,8.0,14.0,13.0,13.0,11.0,11.0,16.0,16.0,20.0,12.0,12.0,8.0,14.0,16.0,14.0,12.0,13.0,6.0,10.0,7.0,12.0,15.0,12.0,16.0,15.0,13.0,6.0,26.0,0.0,0.0,0.0,0.0,175.0,69.0,3.0,3.0,2.0,2.0,3.0,1.0,3.0,1.0,3.0,2.0,2.0,6.0,12.0,10.0,5.0,11.0,6.0,10.0,10.0,10.0,13.0,12.0,9.0,13.0,12.0,12.0,13.0,14.0,12.0,13.0,12.0,11.0,15.0,11.0,13.0,12.0,13.0,14.0,14.0,15.0,13.0,12.0,7.0,9.0,13.0,13.0,20.0,14.0,11.0,14.0,12.0,12.0,11.0,15.0,14.0,9.0,17.0,10.0,8.0,11.0,20.0,7.0,27.0,0.0,0.0,0.0,0.0,175.0,64.0,1.0,1.0,1.0,2.0,1.0,4.0,2.0,1.0,1.0,3.0,3.0,7.0,13.0,9.0,6.0,12.0,6.0,12.0,10.0,10.0,14.0,13.0,6.0,13.0,12.0,14.0,13.0,13.0,12.0,12.0,10.0,12.0,14.0,7.0,9.0,11.0,12.0,13.0,15.0,14.0,13.0,15.0,11.0,10.0,12.0,12.0,20.0,14.0,12.0,12.0,12.0,13.0,10.0,10.0,10.0,12.0,14.0,13.0,14.0,15.0,15.0,6.0,21.0,0.0,0.0,0.0,0.0,183.0,73.0,1.0,4.0,3.0,3.0,3.0,1.0,4.0,1.0,2.0,3.0,2.0,11.0,10.0,12.0,11.0,13.0,9.0,12.0,10.0,5.0,8.0,12.0,9.0,8.0,13.0,13.0,12.0,12.0,10.0,12.0,14.0,12.0,12.0,14.0,8.0,12.0,8.0,12.0,12.0,14.0,14.0,14.0,11.0,8.0,13.0,13.0,20.0,12.0,12.0,12.0,5.0,10.0,7.0,12.0,15.0,11.0,11.0,10.0,11.0,12.0,11.0,4.0,29.0,0.0,0.0,0.0,0.0,183.0,78.0,1.0,3.0,3.0,3.0,3.0,1.0,2.0,3.0,3.0,1.0,1.0,13.0,8.0,9.0,6.0,12.0,14.0,13.0,10.0,12.0,11.0,12.0,8.0,13.0,12.0,12.0,15.0,13.0,13.0,13.0,11.0,13.0,15.0,6.0,12.0,7.0,13.0,16.0,18.0,12.0,11.0,14.0,12.0,20.0,14.0,11.0,8.0,16.0,14.0,14.0,12.0,14.0,6.0,12.0,10.0,12.0,13.0,11.0,15.0,15.0,15.0,5.0,19.0,0.0,0.0,0.0,0.0,185.0,80.0,3.0,2.0,2.0,3.0,3.0,4.0,3.0,3.0,3.0,2.0,1.0,8.0,12.0,13.0,8.0,12.0,13.0,12.0,9.0,6.0,12.0,13.0,9.0,13.0,12.0,12.0,13.0,12.0,12.0,10.0,12.0,12.0,4.0,13.0,8.0,12.0,8.0,12.0,14.0,13.0,14.0,12.0,11.0,5.0,15.0,14.0,20.0,13.0,13.0,12.0,10.0,9.0,11.0,15.0,15.0,9.0,10.0,9.0,12.0,11.0,10.0,5.0,23.0,0.0,0.0,0.0,0.0,175.0,70.0,2.0,1.0,2.0,2.0,1.0,2.0,2.0,3.0,4.0,1.0,2.0,10.0,11.0,12.0,9.0,13.0,8.0,6.0,13.0,2.0,5.0,13.0,10.0,6.0,13.0,7.0,13.0,9.0,13.0,11.0,13.0,12.0,13.0,12.0,10.0,12.0,10.0,13.0,12.0,11.0,12.0,13.0,8.0,8.0,14.0,12.0,20.0,14.0,12.0,13.0,9.0,11.0,10.0,11.0,19.0,12.0,14.0,11.0,13.0,10.0,16.0,7.0,21.0,0.0,0.0,4.0,1.0,184.0,79.0,1.0,2.0,3.0,1.0,2.0,1.0,3.0,2.0,2.0,1.0,3.0,3.0,6.0,10.0,12.0,12.0,7.0,15.0,8.0,4.0,5.0,13.0,10.0,8.0,12.0,18.0,12.0,19.0,13.0,10.0,13.0,12.0,14.0,13.0,10.0,12.0,9.0,16.0,15.0,12.0,14.0,14.0,14.0,12.0,13.0,10.0,20.0,14.0,14.0,11.0,14.0,14.0,11.0,5.0,10.0,13.0,14.0,15.0,10.0,8.0,4.0,15.0,23.0,1.0,0.0,0.0,0.0,185.0,70.0,4.0,3.0,1.0,2.0,1.0,3.0,2.0,3.0,1.0,2.0,3.0,5.0,8.0,12.0,13.0,13.0,7.0,14.0,11.0,5.0,5.0,8.0,13.0,5.0,13.0,6.0,13.0,10.0,12.0,12.0,11.0,11.0,13.0,12.0,7.0,13.0,9.0,8.0,10.0,16.0,12.0,14.0,12.0,8.0,14.0,15.0,20.0,13.0,13.0,12.0,7.0,15.0,7.0,7.0,13.0,13.0,12.0,10.0,12.0,15.0,15.0,7.0,25.0,4.0,0.0,11.0,0.0,184.0,81.0,14.0,14.0,13.0,9.0,15.0,12.0,16.0,16.0,13.0,7.0,11.0,8.0,1.0,2.0,1.0,11.0,12.0,6.0,1.0,3.0,3.0,11.0,5.0,3.0,11.0,8.0,15.0,15.0,13.0,14.0,10.0,11.0,14.0,8.0,13.0,5.0,13.0,10.0,10.0,14.0,16.0,14.0,13.0,20.0,14.0,12.0,5.0,14.0,14.0,15.0,9.0,16.0,6.0,1.0,17.0,11.0,15.0,13.0,14.0,12.0,12.0,4.0,27.0,0.0,0.0,0.0,0.0,184.0,81.0,1.0,1.0,1.0,3.0,3.0,2.0,2.0,2.0,1.0,2.0,3.0,8.0,6.0,8.0,12.0,10.0,8.0,12.0,9.0,1.0,3.0,8.0,14.0,4.0,9.0,4.0,11.0,12.0,11.0,8.0,8.0,11.0,10.0,9.0,8.0,11.0,9.0,8.0,11.0,10.0,8.0,13.0,13.0,9.0,13.0,9.0,20.0,12.0,13.0,13.0,9.0,2.0,9.0,9.0,15.0,10.0,12.0,10.0,11.0,6.0,4.0,6.0,19.0,0.0,0.0,0.0,0.0,193.0,89.0,3.0,2.0,2.0,3.0,1.0,3.0,1.0,4.0,2.0,2.0,3.0,8.0,10.0,5.0,4.0,10.0,10.0,14.0,12.0,6.0,12.0,10.0,4.0,12.0,9.0,11.0,11.0,14.0,11.0,12.0,8.0,14.0,13.0,8.0,8.0,11.0,11.0,13.0,13.0,10.0,9.0,14.0,16.0,6.0,14.0,10.0,20.0,12.0,14.0,11.0,7.0,6.0,6.0,8.0,16.0,10.0,10.0,12.0,13.0,16.0,16.0,5.0,37.0,0.0,0.0,0.0,0.0,185.0,83.0,1.0,1.0,2.0,1.0,3.0,2.0,3.0,1.0,1.0,3.0,1.0,6.0,8.0,9.0,12.0,10.0,8.0,13.0,9.0,4.0,5.0,10.0,14.0,4.0,11.0,11.0,10.0,11.0,13.0,12.0,12.0,13.0,15.0,14.0,12.0,11.0,7.0,12.0,8.0,7.0,7.0,12.0,12.0,11.0,11.0,7.0,20.0,8.0,14.0,12.0,8.0,13.0,9.0,12.0,12.0,12.0,19.0,14.0,15.0,14.0,8.0,8.0,21.0,0.0,0.0,0.0,0.0,179.0,68.0,2.0,3.0,2.0,1.0,2.0,1.0,2.0,3.0,2.0,1.0,1.0,6.0,13.0,12.0,6.0,13.0,6.0,8.0,7.0,12.0,10.0,12.0,8.0,12.0,13.0,10.0,11.0,11.0,12.0,10.0,11.0,11.0,12.0,11.0,7.0,13.0,10.0,12.0,14.0,15.0,13.0,12.0,10.0,20.0,14.0,14.0,8.0,14.0,10.0,13.0,8.0,13.0,8.0,12.0,13.0,14.0,10.0,12.0,10.0,10.0,12.0,10.0,19.0,0.0,0.0,0.0,0.0,185.0,82.0,4.0,2.0,3.0,1.0,3.0,2.0,1.0,2.0,1.0,2.0,3.0,7.0,7.0,10.0,6.0,13.0,7.0,14.0,7.0,6.0,12.0,13.0,7.0,13.0,13.0,13.0,13.0,13.0,11.0,12.0,11.0,12.0,14.0,9.0,14.0,11.0,11.0,15.0,15.0,12.0,12.0,14.0,13.0,5.0,14.0,12.0,20.0,14.0,13.0,10.0,11.0,11.0,6.0,10.0,10.0,12.0,12.0,14.0,14.0,11.0,16.0,6.0,19.0,0.0,0.0,0.0,0.0,175.0,67.0,3.0,2.0,1.0,3.0,3.0,1.0,1.0,1.0,2.0,1.0,3.0,7.0,8.0,12.0,8.0,10.0,6.0,12.0,9.0,8.0,10.0,10.0,8.0,12.0,11.0,14.0,10.0,12.0,9.0,10.0,11.0,10.0,12.0,12.0,10.0,12.0,12.0,13.0,14.0,13.0,11.0,14.0,8.0,6.0,14.0,12.0,20.0,14.0,12.0,12.0,8.0,11.0,6.0,12.0,17.0,13.0,10.0,11.0,12.0,11.0,17.0,5.0,20.0,29.0,2.0,0.0,0.0,181.0,75.0,1.0,1.0,2.0,2.0,2.0,3.0,2.0,1.0,1.0,3.0,2.0,5.0,9.0,15.0,10.0,11.0,9.0,10.0,8.0,7.0,3.0,10.0,10.0,5.0,15.0,7.0,10.0,9.0,12.0,10.0,8.0,11.0,14.0,12.0,5.0,13.0,5.0,11.0,12.0,16.0,12.0,9.0,12.0,20.0,14.0,16.0,7.0,12.0,10.0,9.0,10.0,10.0,11.0,6.0,10.0,15.0,9.0,13.0,11.0,14.0,18.0,7.0,22.0,0.0,0.0,0.0,0.0,186.0,0.0,1.0,2.0,3.0,3.0,1.0,3.0,1.0,2.0,1.0,2.0,1.0,4.0,1.0,12.0,12.0,12.0,1.0,7.0,5.0,1.0,3.0,5.0,1.0,1.0,8.0,8.0,6.0,6.0,4.0,5.0,4.0,11.0,6.0,9.0,12.0,12.0,5.0,4.0,5.0,12.0,12.0,5.0,11.0,12.0,10.0,12.0,20.0,6.0,8.0,8.0,8.0,8.0,7.0,8.0,13.0,11.0,12.0,13.0,12.0,5.0,14.0,5.0,22.0,24.0,3.0,7.0,0.0,177.0,78.0,2.0,1.0,2.0,3.0,2.0,2.0,4.0,3.0,3.0,2.0,1.0,10.0,13.0,16.0,14.0,16.0,16.0,8.0,16.0,4.0,4.0,15.0,12.0,4.0,16.0,12.0,11.0,12.0,13.0,10.0,11.0,8.0,13.0,17.0,5.0,14.0,5.0,10.0,12.0,15.0,14.0,13.0,9.0,10.0,17.0,16.0,20.0,15.0,14.0,12.0,11.0,15.0,4.0,12.0,19.0,16.0,14.0,14.0,11.0,13.0,10.0,12.0,22.0,5.0,1.0,1.0,0.0,173.0,72.0,1.0,3.0,1.0,3.0,3.0,3.0,3.0,3.0,3.0,2.0,2.0,14.0,13.0,16.0,14.0,16.0,14.0,5.0,11.0,5.0,5.0,15.0,11.0,5.0,16.0,8.0,13.0,9.0,14.0,13.0,15.0,13.0,15.0,16.0,5.0,13.0,5.0,9.0,10.0,15.0,16.0,14.0,5.0,20.0,14.0,15.0,5.0,12.0,14.0,13.0,11.0,13.0,8.0,14.0,10.0,15.0,14.0,10.0,13.0,10.0,10.0,13.0
2,1,30.0,42.0,0.0,13.0,0.0,195.0,88.0,16.0,13.0,14.0,6.0,14.0,13.0,13.0,15.0,12.0,10.0,14.0,1.0,8.0,5.0,2.0,8.0,2.0,8.0,2.0,5.0,3.0,9.0,5.0,3.0,8.0,10.0,12.0,10.0,14.0,10.0,10.0,14.0,13.0,3.0,14.0,3.0,12.0,14.0,12.0,8.0,13.0,18.0,18.0,17.0,14.0,11.0,20.0,14.0,17.0,14.0,4.0,14.0,4.0,1.0,12.0,13.0,14.0,9.0,15.0,13.0,13.0,5.0,28.0,0.0,0.0,0.0,0.0,174.0,67.0,3.0,4.0,1.0,1.0,1.0,3.0,1.0,3.0,2.0,1.0,2.0,11.0,8.0,11.0,9.0,13.0,6.0,7.0,12.0,8.0,10.0,10.0,3.0,6.0,12.0,10.0,13.0,7.0,12.0,8.0,10.0,9.0,12.0,13.0,5.0,12.0,9.0,12.0,11.0,14.0,14.0,11.0,7.0,10.0,15.0,12.0,20.0,11.0,6.0,9.0,6.0,10.0,10.0,9.0,11.0,14.0,9.0,11.0,12.0,8.0,8.0,8.0,23.0,0.0,0.0,0.0,0.0,184.0,71.0,1.0,2.0,1.0,2.0,2.0,2.0,2.0,4.0,2.0,1.0,3.0,4.0,10.0,10.0,6.0,11.0,6.0,14.0,8.0,7.0,14.0,11.0,6.0,13.0,11.0,12.0,12.0,13.0,12.0,11.0,12.0,12.0,14.0,6.0,8.0,10.0,13.0,13.0,14.0,15.0,13.0,14.0,13.0,8.0,12.0,14.0,20.0,13.0,14.0,13.0,12.0,14.0,15.0,8.0,11.0,13.0,13.0,10.0,8.0,9.0,16.0,7.0,19.0,0.0,0.0,0.0,0.0,189.0,78.0,2.0,2.0,2.0,1.0,1.0,1.0,3.0,1.0,2.0,1.0,2.0,7.0,8.0,9.0,7.0,9.0,6.0,12.0,8.0,8.0,12.0,12.0,6.0,13.0,11.0,15.0,13.0,14.0,11.0,10.0,8.0,12.0,14.0,6.0,9.0,11.0,11.0,13.0,14.0,13.0,12.0,12.0,13.0,6.0,14.0,13.0,20.0,12.0,13.0,13.0,6.0,12.0,5.0,13.0,16.0,13.0,13.0,13.0,15.0,14.0,12.0,5.0,21.0,0.0,0.0,0.0,0.0,177.0,0.0,1.0,1.0,1.0,2.0,3.0,3.0,2.0,3.0,2.0,2.0,3.0,6.0,4.0,13.0,13.0,13.0,6.0,13.0,7.0,3.0,5.0,7.0,6.0,1.0,11.0,9.0,7.0,8.0,7.0,7.0,7.0,8.0,7.0,11.0,8.0,13.0,7.0,6.0,7.0,12.0,13.0,7.0,6.0,8.0,8.0,13.0,20.0,5.0,5.0,9.0,5.0,9.0,9.0,9.0,10.0,10.0,12.0,12.0,11.0,10.0,9.0,6.0,21.0,0.0,0.0,0.0,0.0,178.0,65.0,2.0,3.0,3.0,3.0,3.0,1.0,1.0,1.0,1.0,3.0,1.0,9.0,13.0,11.0,6.0,12.0,7.0,9.0,8.0,8.0,13.0,12.0,7.0,13.0,12.0,8.0,12.0,13.0,12.0,12.0,13.0,13.0,14.0,9.0,8.0,12.0,12.0,13.0,13.0,12.0,14.0,13.0,11.0,8.0,15.0,12.0,20.0,13.0,12.0,14.0,8.0,11.0,7.0,10.0,19.0,10.0,13.0,10.0,11.0,15.0,15.0,6.0,26.0,25.0,1.0,7.0,0.0,189.0,78.0,1.0,1.0,1.0,1.0,1.0,1.0,1.0,1.0,1.0,1.0,1.0,8.0,9.0,10.0,6.0,12.0,8.0,13.0,14.0,7.0,11.0,14.0,11.0,13.0,13.0,13.0,13.0,16.0,13.0,13.0,12.0,13.0,14.0,10.0,10.0,12.0,13.0,15.0,15.0,12.0,11.0,9.0,15.0,10.0,14.0,13.0,20.0,14.0,14.0,12.0,13.0,11.0,14.0,12.0,14.0,11.0,14.0,12.0,16.0,15.0,13.0,5.0,21.0,0.0,0.0,0.0,0.0,172.0,66.0,2.0,3.0,2.0,2.0,1.0,1.0,1.0,3.0,2.0,1.0,1.0,10.0,10.0,13.0,9.0,14.0,9.0,8.0,10.0,7.0,13.0,13.0,9.0,12.0,13.0,10.0,12.0,13.0,13.0,12.0,14.0,13.0,13.0,11.0,9.0,14.0,13.0,14.0,14.0,14.0,13.0,12.0,8.0,8.0,12.0,12.0,20.0,13.0,12.0,14.0,10.0,11.0,8.0,12.0,15.0,10.0,15.0,8.0,11.0,14.0,14.0,6.0,22.0,0.0,0.0,0.0,0.0,187.0,84.0,2.0,2.0,1.0,2.0,3.0,2.0,2.0,3.0,3.0,2.0,2.0,4.0,7.0,10.0,6.0,9.0,10.0,13.0,12.0,5.0,11.0,11.0,7.0,10.0,12.0,12.0,11.0,13.0,10.0,9.0,11.0,9.0,15.0,8.0,7.0,9.0,11.0,11.0,14.0,13.0,10.0,15.0,14.0,8.0,15.0,11.0,20.0,14.0,15.0,11.0,12.0,7.0,9.0,8.0,7.0,13.0,15.0,13.0,11.0,14.0,14.0,7.0,22.0,0.0,0.0,0.0,0.0,177.0,72.0,2.0,1.0,2.0,4.0,2.0,2.0,1.0,3.0,4.0,2.0,3.0,10.0,12.0,13.0,11.0,12.0,10.0,12.0,12.0,4.0,10.0,13.0,11.0,11.0,13.0,11.0,12.0,11.0,13.0,9.0,13.0,12.0,3.0,12.0,8.0,14.0,12.0,12.0,13.0,16.0,13.0,12.0,9.0,8.0,15.0,14.0,20.0,14.0,13.0,10.0,4.0,11.0,11.0,12.0,19.0,9.0,12.0,13.0,12.0,11.0,14.0,7.0,29.0,30.0,6.0,0.0,0.0,178.0,76.0,2.0,3.0,3.0,4.0,3.0,2.0,2.0,2.0,2.0,1.0,1.0,6.0,11.0,16.0,10.0,12.0,5.0,8.0,8.0,5.0,4.0,13.0,7.0,3.0,12.0,7.0,8.0,12.0,11.0,10.0,8.0,9.0,13.0,15.0,4.0,13.0,7.0,12.0,10.0,16.0,15.0,14.0,8.0,11.0,13.0,16.0,20.0,10.0,13.0,10.0,11.0,10.0,7.0,5.0,9.0,16.0,9.0,10.0,11.0,11.0,14.0,3.0,26.0,2.0,0.0,1.0,0.0,188.0,84.0,12.0,13.0,15.0,9.0,15.0,13.0,13.0,15.0,10.0,11.0,14.0,9.0,2.0,1.0,2.0,12.0,11.0,3.0,2.0,3.0,3.0,11.0,3.0,1.0,10.0,14.0,13.0,14.0,10.0,13.0,11.0,11.0,14.0,3.0,11.0,5.0,12.0,15.0,13.0,10.0,12.0,13.0,14.0,5.0,14.0,9.0,20.0,12.0,14.0,12.0,10.0,15.0,3.0,11.0,12.0,11.0,16.0,13.0,15.0,16.0,16.0,4.0,32.0,0.0,0.0,0.0,0.0,183.0,79.0,1.0,1.0,1.0,3.0,1.0,3.0,1.0,1.0,2.0,1.0,1.0,5.0,10.0,6.0,6.0,9.0,6.0,15.0,7.0,11.0,14.0,10.0,7.0,13.0,10.0,13.0,15.0,15.0,15.0,14.0,9.0,13.0,16.0,6.0,14.0,8.0,12.0,13.0,16.0,11.0,12.0,16.0,11.0,8.0,16.0,12.0,20.0,15.0,14.0,14.0,11.0,12.0,5.0,15.0,18.0,15.0,14.0,13.0,17.0,14.0,14.0,5.0,29.0,0.0,0.0,0.0,0.0,183.0,74.0,3.0,3.0,3.0,3.0,3.0,2.0,2.0,2.0,1.0,3.0,1.0,5.0,12.0,7.0,6.0,10.0,7.0,14.0,12.0,5.0,14.0,12.0,6.0,13.0,11.0,14.0,13.0,17.0,13.0,16.0,12.0,12.0,13.0,9.0,8.0,9.0,14.0,14.0,15.0,13.0,12.0,15.0,12.0,6.0,17.0,11.0,20.0,17.0,13.0,14.0,14.0,15.0,5.0,13.0,9.0,14.0,19.0,15.0,14.0,11.0,11.0,6.0,22.0,0.0,0.0,0.0,0.0,178.0,73.0,3.0,2.0,2.0,1.0,2.0,4.0,3.0,1.0,3.0,1.0,2.0,6.0,12.0,12.0,6.0,11.0,7.0,8.0,8.0,11.0,12.0,10.0,8.0,13.0,11.0,12.0,12.0,13.0,11.0,10.0,11.0,11.0,13.0,6.0,7.0,12.0,9.0,13.0,14.0,16.0,14.0,13.0,9.0,6.0,14.0,15.0,20.0,15.0,14.0,12.0,12.0,13.0,6.0,14.0,12.0,15.0,13.0,13.0,14.0,14.0,14.0,6.0,27.0,0.0,0.0,10.0,0.0,178.0,77.0,1.0,3.0,2.0,1.0,2.0,2.0,3.0,2.0,3.0,3.0,3.0,13.0,14.0,15.0,8.0,15.0,13.0,10.0,12.0,10.0,9.0,13.0,8.0,10.0,15.0,10.0,12.0,13.0,13.0,14.0,13.0,12.0,13.0,13.0,6.0,14.0,10.0,11.0,15.0,14.0,14.0,13.0,9.0,20.0,10.0,14.0,7.0,13.0,12.0,12.0,9.0,15.0,8.0,10.0,8.0,16.0,13.0,14.0,11.0,13.0,13.0,13.0,32.0,0.0,0.0,13.0,0.0,175.0,65.0,2.0,1.0,1.0,2.0,3.0,3.0,1.0,2.0,3.0,2.0,3.0,15.0,13.0,11.0,6.0,14.0,13.0,10.0,12.0,8.0,8.0,16.0,8.0,12.0,13.0,11.0,14.0,15.0,14.0,15.0,14.0,14.0,14.0,6.0,13.0,9.0,15.0,18.0,13.0,12.0,13.0,13.0,8.0,8.0,13.0,10.0,20.0,13.0,13.0,12.0,11.0,15.0,12.0,10.0,17.0,14.0,15.0,14.0,16.0,14.0,14.0,6.0,27.0,0.0,0.0,0.0,0.0,188.0,77.0,1.0,4.0,1.0,1.0,3.0,1.0,2.0,1.0,2.0,2.0,2.0,4.0,7.0,8.0,7.0,13.0,6.0,15.0,9.0,6.0,13.0,12.0,6.0,12.0,11.0,14.0,14.0,15.0,10.0,12.0,11.0,13.0,16.0,7.0,12.0,9.0,12.0,15.0,16.0,14.0,10.0,14.0,15.0,9.0,13.0,12.0,20.0,14.0,16.0,12.0,14.0,13.0,6.0,12.0,4.0,13.0,18.0,13.0,14.0,14.0,13.0,7.0,25.0,0.0,0.0,3.0,2.0,170.0,61.0,2.0,3.0,2.0,2.0,1.0,3.0,2.0,2.0,1.0,2.0,1.0,11.0,12.0,13.0,10.0,13.0,8.0,5.0,8.0,7.0,4.0,14.0,10.0,4.0,15.0,11.0,10.0,9.0,7.0,10.0,14.0,8.0,13.0,13.0,6.0,12.0,8.0,8.0,12.0,16.0,14.0,7.0,5.0,12.0,15.0,16.0,20.0,14.0,6.0,12.0,11.0,13.0,8.0,8.0,8.0,13.0,15.0,10.0,10.0,14.0,14.0,8.0,18.0,0.0,0.0,0.0,0.0,179.0,67.0,3.0,3.0,2.0,4.0,2.0,4.0,3.0,1.0,3.0,4.0,1.0,5.0,7.0,12.0,9.0,12.0,12.0,10.0,12.0,6.0,4.0,12.0,12.0,3.0,14.0,11.0,12.0,11.0,11.0,8.0,13.0,12.0,12.0,12.0,6.0,12.0,5.0,10.0,12.0,15.0,11.0,12.0,10.0,20.0,13.0,14.0,8.0,14.0,8.0,9.0,6.0,14.0,5.0,10.0,16.0,13.0,12.0,12.0,13.0,9.0,15.0,2.0,26.0,16.0,4.0,0.0,0.0,177.0,71.0,1.0,2.0,1.0,3.0,3.0,2.0,1.0,1.0,3.0,3.0,1.0,10.0,12.0,13.0,9.0,12.0,10.0,7.0,12.0,7.0,5.0,12.0,10.0,6.0,12.0,6.0,9.0,7.0,8.0,8.0,12.0,8.0,16.0,12.0,8.0,11.0,6.0,8.0,9.0,17.0,14.0,8.0,8.0,20.0,14.0,17.0,7.0,12.0,14.0,11.0,6.0,11.0,6.0,8.0,15.0,15.0,14.0,10.0,11.0,14.0,12.0,11.0,30.0,5.0,0.0,22.0,9.0,181.0,84.0,2.0,3.0,3.0,1.0,2.0,3.0,3.0,1.0,3.0,1.0,3.0,7.0,10.0,12.0,13.0,11.0,7.0,13.0,10.0,12.0,6.0,11.0,13.0,6.0,13.0,17.0,13.0,16.0,11.0,13.0,11.0,11.0,17.0,14.0,8.0,14.0,9.0,13.0,17.0,15.0,12.0,15.0,11.0,8.0,14.0,15.0,20.0,14.0,14.0,13.0,9.0,13.0,7.0,10.0,7.0,16.0,13.0,14.0,13.0,15.0,15.0,10.0
1,2,22.0,0.0,0.0,0.0,0.0,181.0,84.0,9.0,10.0,12.0,13.0,14.0,13.0,13.0,14.0,12.0,8.0,11.0,5.0,2.0,1.0,3.0,7.0,7.0,3.0,2.0,3.0,3.0,13.0,4.0,2.0,10.0,9.0,14.0,15.0,12.0,13.0,11.0,12.0,14.0,1.0,9.0,3.0,13.0,9.0,11.0,11.0,12.0,14.0,11.0,5.0,15.0,12.0,20.0,13.0,13.0,13.0,7.0,5.0,5.0,11.0,19.0,13.0,12.0,10.0,13.0,11.0,13.0,4.0,32.0,13.0,2.0,0.0,0.0,187.0,82.0,4.0,3.0,3.0,1.0,3.0,3.0,3.0,3.0,3.0,3.0,2.0,6.0,10.0,12.0,8.0,14.0,7.0,15.0,7.0,12.0,17.0,15.0,10.0,18.0,13.0,12.0,16.0,18.0,17.0,12.0,14.0,12.0,18.0,16.0,15.0,6.0,16.0,10.0,9.0,8.0,11.0,17.0,14.0,20.0,15.0,10.0,12.0,13.0,15.0,16.0,14.0,15.0,7.0,10.0,16.0,14.0,9.0,17.0,14.0,7.0,8.0,13.0,30.0,0.0,0.0,0.0,0.0,182.0,78.0,2.0,3.0,2.0,4.0,3.0,1.0,3.0,1.0,1.0,2.0,1.0,11.0,12.0,12.0,11.0,12.0,12.0,10.0,8.0,14.0,11.0,12.0,12.0,12.0,12.0,12.0,12.0,12.0,12.0,10.0,11.0,10.0,6.0,11.0,13.0,11.0,11.0,13.0,13.0,13.0,11.0,13.0,11.0,20.0,14.0,13.0,7.0,14.0,12.0,10.0,14.0,12.0,6.0,11.0,12.0,9.0,12.0,11.0,12.0,9.0,3.0,5.0,32.0,11.0,1.0,0.0,0.0,176.0,68.0,2.0,1.0,3.0,2.0,2.0,2.0,2.0,3.0,3.0,2.0,2.0,8.0,10.0,10.0,7.0,11.0,8.0,10.0,11.0,12.0,11.0,13.0,12.0,14.0,12.0,9.0,14.0,15.0,13.0,12.0,11.0,12.0,17.0,8.0,14.0,14.0,11.0,18.0,18.0,14.0,14.0,12.0,10.0,10.0,14.0,13.0,20.0,17.0,13.0,15.0,9.0,13.0,8.0,13.0,17.0,13.0,15.0,16.0,16.0,16.0,18.0,5.0,24.0,0.0,0.0,2.0,0.0,179.0,72.0,2.0,2.0,3.0,3.0,3.0,3.0,1.0,1.0,1.0,2.0,1.0,12.0,14.0,12.0,7.0,13.0,12.0,6.0,10.0,5.0,10.0,13.0,10.0,12.0,13.0,12.0,13.0,11.0,12.0,12.0,12.0,12.0,17.0,8.0,9.0,13.0,11.0,14.0,15.0,14.0,13.0,12.0,7.0,8.0,14.0,13.0,20.0,15.0,10.0,14.0,12.0,14.0,8.0,15.0,11.0,14.0,13.0,9.0,14.0,15.0,15.0,7.0,24.0,0.0,0.0,5.0,0.0,168.0,68.0,4.0,2.0,2.0,1.0,1.0,2.0,2.0,3.0,4.0,4.0,2.0,8.0,12.0,12.0,8.0,14.0,7.0,7.0,7.0,6.0,14.0,13.0,11.0,14.0,11.0,14.0,13.0,14.0,12.0,12.0,13.0,14.0,14.0,8.0,7.0,8.0,10.0,15.0,18.0,16.0,14.0,14.0,5.0,8.0,15.0,13.0,20.0,17.0,12.0,12.0,11.0,14.0,7.0,12.0,8.0,14.0,14.0,13.0,14.0,14.0,14.0,6.0,20.0,0.0,0.0,1.0,0.0,168.0,58.0,2.0,3.0,2.0,1.0,2.0,1.0,2.0,3.0,1.0,3.0,3.0,10.0,13.0,13.0,10.0,14.0,10.0,8.0,8.0,5.0,12.0,14.0,10.0,12.0,13.0,14.0,13.0,12.0,13.0,14.0,13.0,13.0,13.0,12.0,8.0,12.0,12.0,14.0,14.0,14.0,15.0,14.0,6.0,12.0,14.0,13.0,20.0,14.0,7.0,14.0,6.0,12.0,5.0,10.0,9.0,13.0,14.0,13.0,14.0,13.0,15.0,7.0,23.0,0.0,0.0,0.0,0.0,185.0,67.0,3.0,1.0,3.0,1.0,2.0,2.0,3.0,1.0,2.0,2.0,1.0,13.0,11.0,14.0,13.0,13.0,12.0,3.0,14.0,5.0,5.0,15.0,11.0,5.0,14.0,6.0,12.0,11.0,13.0,13.0,12.0,12.0,15.0,11.0,2.0,12.0,12.0,14.0,13.0,11.0,13.0,12.0,7.0,10.0,7.0,13.0,20.0,14.0,8.0,13.0,10.0,13.0,10.0,9.0,9.0,11.0,12.0,10.0,12.0,10.0,17.0,3.0,19.0,0.0,0.0,0.0,0.0,167.0,64.0,3.0,1.0,3.0,1.0,3.0,2.0,3.0,1.0,3.0,2.0,2.0,10.0,9.0,14.0,10.0,13.0,10.0,6.0,9.0,5.0,5.0,10.0,12.0,5.0,15.0,7.0,12.0,8.0,11.0,10.0,12.0,10.0,11.0,14.0,7.0,13.0,6.0,11.0,10.0,14.0,13.0,12.0,6.0,20.0,13.0,13.0,8.0,10.0,9.0,10.0,10.0,4.0,8.0,11.0,10.0,12.0,11.0,11.0,12.0,3.0,18.0,6.0,19.0,0.0,0.0,0.0,0.0,173.0,67.0,3.0,2.0,4.0,2.0,1.0,1.0,3.0,1.0,1.0,1.0,2.0,13.0,13.0,15.0,10.0,14.0,11.0,6.0,12.0,4.0,4.0,12.0,11.0,5.0,14.0,10.0,12.0,9.0,10.0,8.0,12.0,8.0,11.0,15.0,5.0,12.0,6.0,8.0,10.0,16.0,15.0,13.0,7.0,8.0,13.0,15.0,20.0,11.0,9.0,12.0,6.0,12.0,6.0,15.0,8.0,13.0,8.0,12.0,9.0,14.0,13.0,9.0,23.0,0.0,0.0,1.0,0.0,181.0,78.0,1.0,2.0,2.0,3.0,1.0,3.0,1.0,1.0,1.0,2.0,2.0,5.0,12.0,14.0,13.0,14.0,8.0,14.0,12.0,7.0,5.0,12.0,12.0,6.0,14.0,10.0,13.0,10.0,13.0,13.0,11.0,12.0,13.0,11.0,6.0,13.0,10.0,9.0,12.0,16.0,14.0,13.0,10.0,8.0,14.0,15.0,20.0,13.0,14.0,13.0,8.0,7.0,9.0,8.0,16.0,14.0,13.0,12.0,13.0,15.0,15.0,7.0,19.0,0.0,0.0,0.0,0.0,193.0,84.0,14.0,11.0,10.0,9.0,12.0,13.0,13.0,13.0,9.0,8.0,13.0,4.0,2.0,1.0,3.0,7.0,7.0,2.0,3.0,1.0,1.0,8.0,1.0,3.0,7.0,8.0,11.0,12.0,10.0,12.0,8.0,10.0,10.0,6.0,7.0,1.0,12.0,11.0,10.0,9.0,13.0,12.0,13.0,5.0,15.0,8.0,20.0,12.0,14.0,12.0,10.0,4.0,3.0,10.0,18.0,13.0,13.0,9.0,13.0,11.0,19.0,4.0,29.0,0.0,0.0,0.0,0.0,185.0,84.0,3.0,2.0,2.0,2.0,1.0,3.0,1.0,2.0,1.0,3.0,1.0,3.0,6.0,6.0,7.0,10.0,5.0,14.0,5.0,4.0,14.0,9.0,7.0,13.0,9.0,13.0,13.0,14.0,12.0,13.0,8.0,12.0,14.0,8.0,16.0,8.0,12.0,13.0,15.0,11.0,11.0,15.0,12.0,5.0,14.0,12.0,20.0,14.0,16.0,13.0,12.0,10.0,7.0,7.0,7.0,12.0,13.0,13.0,14.0,13.0,12.0,8.0,23.0,2.0,0.0,0.0,0.0,188.0,85.0,1.0,3.0,2.0,2.0,1.0,3.0,3.0,2.0,3.0,2.0,1.0,7.0,8.0,7.0,5.0,12.0,5.0,14.0,9.0,7.0,13.0,11.0,6.0,13.0,12.0,14.0,13.0,13.0,11.0,12.0,6.0,12.0,5.0,1.0,6.0,8.0,12.0,14.0,13.0,12.0,11.0,14.0,15.0,6.0,13.0,11.0,20.0,14.0,15.0,13.0,9.0,7.0,10.0,10.0,12.0,12.0,13.0,10.0,9.0,8.0,8.0,2.0,27.0,0.0,0.0,0.0,0.0,169.0,60.0,3.0,2.0,1.0,3.0,3.0,2.0,1.0,3.0,3.0,2.0,2.0,11.0,11.0,13.0,9.0,13.0,12.0,8.0,10.0,4.0,5.0,14.0,8.0,5.0,13.0,12.0,9.0,9.0,10.0,10.0,10.0,9.0,16.0,13.0,4.0,14.0,8.0,11.0,8.0,16.0,16.0,9.0,9.0,5.0,13.0,15.0,20.0,11.0,11.0,10.0,8.0,7.0,5.0,11.0,14.0,10.0,12.0,11.0,12.0,10.0,13.0,8.0,24.0,0.0,0.0,0.0,0.0,178.0,77.0,2.0,1.0,3.0,2.0,1.0,3.0,3.0,3.0,1.0,3.0,2.0,5.0,10.0,8.0,5.0,9.0,6.0,11.0,8.0,12.0,11.0,8.0,6.0,12.0,9.0,11.0,11.0,13.0,11.0,12.0,7.0,11.0,15.0,9.0,6.0,9.0,11.0,12.0,14.0,16.0,12.0,14.0,10.0,5.0,15.0,15.0,20.0,14.0,13.0,14.0,11.0,13.0,5.0,8.0,17.0,12.0,14.0,14.0,14.0,14.0,14.0,6.0,30.0,0.0,0.0,0.0,0.0,178.0,79.0,1.0,2.0,2.0,3.0,2.0,2.0,1.0,2.0,1.0,2.0,1.0,11.0,13.0,9.0,6.0,11.0,11.0,12.0,11.0,10.0,12.0,12.0,7.0,13.0,11.0,15.0,13.0,15.0,11.0,12.0,10.0,12.0,13.0,12.0,15.0,10.0,12.0,16.0,15.0,14.0,12.0,13.0,9.0,5.0,13.0,12.0,20.0,15.0,14.0,14.0,14.0,13.0,9.0,14.0,18.0,12.0,15.0,14.0,14.0,14.0,14.0,6.0,26.0,0.0,0.0,0.0,0.0,184.0,76.0,2.0,3.0,1.0,3.0,1.0,1.0,3.0,1.0,3.0,2.0,2.0,10.0,12.0,14.0,12.0,14.0,12.0,11.0,13.0,11.0,13.0,14.0,13.0,12.0,15.0,14.0,13.0,12.0,11.0,11.0,13.0,14.0,14.0,12.0,13.0,12.0,11.0,11.0,14.0,15.0,14.0,13.0,10.0,5.0,14.0,14.0,20.0,14.0,14.0,14.0,7.0,16.0,6.0,8.0,19.0,14.0,14.0,14.0,14.0,14.0,14.0,6.0,22.0,0.0,0.0,0.0,0.0,188.0,79.0,1.0,2.0,2.0,3.0,2.0,2.0,3.0,4.0,3.0,2.0,1.0,8.0,10.0,11.0,7.0,11.0,8.0,10.0,8.0,7.0,8.0,10.0,10.0,11.0,11.0,11.0,12.0,13.0,11.0,10.0,8.0,11.0,10.0,8.0,8.0,12.0,10.0,12.0,15.0,13.0,12.0,14.0,14.0,20.0,13.0,12.0,8.0,14.0,14.0,12.0,10.0,6.0,8.0,15.0,11.0,11.0,11.0,11.0,11.0,10.0,12.0,6.0,28.0,0.0,0.0,0.0,0.0,181.0,75.0,4.0,2.0,1.0,3.0,3.0,3.0,2.0,2.0,2.0,2.0,2.0,13.0,12.0,12.0,9.0,12.0,13.0,7.0,11.0,7.0,7.0,13.0,5.0,7.0,13.0,9.0,13.0,3.0,12.0,11.0,12.0,12.0,3.0,12.0,14.0,12.0,9.0,12.0,13.0,13.0,13.0,10.0,11.0,20.0,13.0,12.0,6.0,13.0,9.0,13.0,6.0,13.0,8.0,10.0,20.0,12.0,14.0,11.0,13.0,10.0,11.0,4.0,25.0,1.0,1.0,0.0,0.0,182.0,70.0,2.0,1.0,2.0,3.0,3.0,2.0,2.0,4.0,1.0,3.0,2.0,9.0,7.0,13.0,13.0,12.0,6.0,13.0,12.0,8.0,8.0,10.0,14.0,6.0,11.0,13.0,10.0,13.0,12.0,12.0,10.0,12.0,13.0,8.0,9.0,14.0,8.0,11.0,12.0,14.0,13.0,14.0,11.0,8.0,13.0,14.0,20.0,13.0,13.0,12.0,6.0,12.0,6.0,11.0,14.0,11.0,10.0,11.0,10.0,9.0,19.0,5.0,18.0,0.0,0.0,0.0,0.0,184.0,71.0,2.0,3.0,2.0,3.0,1.0,2.0,1.0,3.0,2.0,1.0,3.0,8.0,10.0,14.0,10.0,12.0,8.0,5.0,10.0,3.0,5.0,12.0,7.0,6.0,13.0,8.0,8.0,8.0,11.0,8.0,11.0,14.0,12.0,10.0,11.0,10.0,9.0,9.0,13.0,14.0,13.0,5.0,10.0,10.0,13.0,14.0,20.0,12.0,8.0,10.0,8.0,10.0,4.0,10.0,11.0,12.0,11.0,12.0,13.0,11.0,13.0,6.0
0,5,26.0,11.0,0.0,0.0,0.0,198.0,88.0,13.0,11.0,10.0,8.0,12.0,10.0,14.0,15.0,11.0,13.0,9.0,3.0,3.0,3.0,6.0,6.0,6.0,12.0,12.0,2.0,1.0,8.0,6.0,1.0,6.0,9.0,12.0,14.0,12.0,12.0,11.0,11.0,12.0,6.0,9.0,2.0,13.0,12.0,8.0,12.0,13.0,18.0,17.0,5.0,16.0,9.0,20.0,15.0,15.0,11.0,9.0,12.0,5.0,1.0,16.0,14.0,16.0,13.0,12.0,15.0,15.0,7.0,32.0,67.0,9.0,7.0,0.0,191.0,85.0,1.0,1.0,1.0,3.0,2.0,2.0,4.0,3.0,3.0,2.0,3.0,7.0,7.0,6.0,9.0,12.0,3.0,16.0,7.0,3.0,15.0,11.0,7.0,13.0,12.0,14.0,11.0,14.0,10.0,11.0,10.0,14.0,11.0,8.0,13.0,13.0,13.0,13.0,15.0,9.0,7.0,14.0,16.0,8.0,7.0,10.0,20.0,12.0,15.0,13.0,14.0,5.0,6.0,11.0,8.0,11.0,9.0,12.0,11.0,6.0,9.0,11.0,23.0,0.0,0.0,0.0,0.0,188.0,75.0,2.0,2.0,2.0,2.0,3.0,4.0,2.0,2.0,2.0,3.0,3.0,4.0,10.0,7.0,5.0,10.0,7.0,13.0,10.0,5.0,13.0,11.0,6.0,13.0,12.0,13.0,13.0,14.0,11.0,11.0,8.0,11.0,12.0,5.0,6.0,10.0,12.0,13.0,14.0,13.0,11.0,15.0,14.0,5.0,14.0,12.0,20.0,14.0,14.0,12.0,13.0,11.0,7.0,12.0,9.0,12.0,11.0,7.0,12.0,10.0,10.0,8.0,26.0,0.0,0.0,0.0,0.0,167.0,67.0,3.0,1.0,3.0,1.0,2.0,2.0,3.0,1.0,3.0,1.0,3.0,7.0,11.0,11.0,5.0,12.0,6.0,6.0,7.0,10.0,12.0,12.0,6.0,12.0,13.0,11.0,11.0,10.0,13.0,12.0,9.0,12.0,13.0,7.0,5.0,8.0,11.0,13.0,13.0,15.0,14.0,10.0,6.0,7.0,15.0,15.0,20.0,14.0,8.0,14.0,8.0,13.0,7.0,10.0,14.0,13.0,13.0,14.0,14.0,16.0,16.0,6.0,24.0,0.0,0.0,0.0,0.0,175.0,72.0,3.0,2.0,4.0,3.0,2.0,4.0,1.0,1.0,1.0,2.0,2.0,8.0,12.0,12.0,6.0,11.0,7.0,10.0,9.0,12.0,11.0,12.0,8.0,12.0,11.0,11.0,12.0,13.0,10.0,10.0,9.0,9.0,3.0,9.0,9.0,11.0,12.0,11.0,11.0,14.0,13.0,11.0,8.0,20.0,12.0,13.0,6.0,12.0,11.0,10.0,10.0,10.0,9.0,10.0,10.0,13.0,10.0,11.0,10.0,13.0,18.0,1.0,29.0,0.0,0.0,0.0,0.0,188.0,74.0,1.0,2.0,3.0,3.0,2.0,3.0,1.0,3.0,2.0,1.0,1.0,4.0,8.0,10.0,6.0,13.0,7.0,14.0,9.0,6.0,13.0,12.0,8.0,13.0,13.0,12.0,14.0,13.0,14.0,11.0,13.0,12.0,14.0,6.0,13.0,8.0,14.0,15.0,15.0,9.0,12.0,14.0,14.0,10.0,13.0,10.0,20.0,16.0,12.0,13.0,12.0,15.0,9.0,11.0,11.0,14.0,14.0,12.0,15.0,13.0,13.0,6.0,25.0,0.0,0.0,0.0,0.0,174.0,73.0,1.0,1.0,3.0,2.0,1.0,1.0,1.0,2.0,3.0,3.0,3.0,11.0,12.0,12.0,6.0,13.0,11.0,7.0,11.0,10.0,9.0,13.0,9.0,10.0,14.0,11.0,13.0,13.0,12.0,11.0,15.0,11.0,14.0,13.0,7.0,11.0,12.0,15.0,16.0,12.0,14.0,12.0,8.0,20.0,14.0,13.0,7.0,12.0,11.0,12.0,11.0,13.0,9.0,12.0,8.0,13.0,13.0,12.0,15.0,15.0,15.0,6.0,19.0,0.0,0.0,0.0,0.0,168.0,64.0,3.0,2.0,4.0,1.0,2.0,2.0,1.0,1.0,1.0,1.0,3.0,9.0,11.0,13.0,10.0,11.0,8.0,4.0,10.0,3.0,4.0,11.0,10.0,4.0,12.0,8.0,11.0,11.0,9.0,8.0,10.0,10.0,12.0,11.0,6.0,9.0,9.0,10.0,9.0,14.0,11.0,10.0,7.0,11.0,12.0,14.0,20.0,11.0,10.0,11.0,12.0,9.0,8.0,11.0,10.0,11.0,9.0,11.0,8.0,7.0,8.0,10.0,21.0,0.0,0.0,0.0,0.0,180.0,68.0,4.0,1.0,1.0,1.0,1.0,3.0,1.0,2.0,2.0,2.0,3.0,10.0,10.0,13.0,9.0,13.0,9.0,8.0,8.0,6.0,11.0,13.0,10.0,10.0,12.0,8.0,8.0,8.0,11.0,10.0,13.0,10.0,20.0,13.0,6.0,9.0,9.0,7.0,10.0,14.0,14.0,13.0,10.0,10.0,10.0,14.0,20.0,12.0,11.0,10.0,10.0,7.0,6.0,13.0,17.0,12.0,10.0,12.0,12.0,8.0,10.0,2.0,24.0,0.0,0.0,0.0,0.0,169.0,65.0,3.0,3.0,2.0,1.0,2.0,4.0,1.0,3.0,4.0,3.0,2.0,11.0,12.0,12.0,7.0,12.0,9.0,5.0,10.0,7.0,3.0,11.0,12.0,5.0,13.0,7.0,10.0,9.0,12.0,9.0,12.0,10.0,4.0,11.0,6.0,12.0,6.0,12.0,14.0,16.0,14.0,11.0,6.0,20.0,14.0,15.0,5.0,14.0,7.0,12.0,7.0,14.0,6.0,8.0,16.0,13.0,16.0,12.0,12.0,10.0,15.0,6.0,23.0,0.0,0.0,7.0,3.0,181.0,71.0,2.0,2.0,2.0,2.0,2.0,2.0,4.0,2.0,3.0,3.0,2.0,7.0,12.0,12.0,14.0,13.0,7.0,11.0,11.0,7.0,6.0,11.0,15.0,7.0,12.0,12.0,13.0,16.0,12.0,12.0,10.0,11.0,6.0,12.0,7.0,14.0,9.0,12.0,16.0,13.0,14.0,13.0,9.0,8.0,14.0,12.0,20.0,12.0,12.0,12.0,10.0,12.0,8.0,10.0,19.0,10.0,10.0,10.0,11.0,11.0,12.0,6.0,25.0,4.0,0.0,11.0,0.0,184.0,81.0,14.0,14.0,13.0,9.0,15.0,12.0,16.0,16.0,13.0,7.0,11.0,8.0,1.0,2.0,1.0,11.0,12.0,6.0,1.0,3.0,3.0,11.0,5.0,3.0,11.0,8.0,15.0,15.0,13.0,14.0,10.0,11.0,14.0,8.0,13.0,5.0,13.0,10.0,10.0,14.0,16.0,14.0,13.0,20.0,14.0,12.0,5.0,14.0,14.0,15.0,9.0,16.0,6.0,1.0,17.0,11.0,15.0,13.0,14.0,12.0,12.0,4.0,32.0,0.0,0.0,0.0,0.0,172.0,71.0,2.0,1.0,3.0,1.0,2.0,3.0,2.0,3.0,2.0,2.0,2.0,8.0,9.0,7.0,6.0,10.0,6.0,10.0,9.0,10.0,14.0,11.0,6.0,14.0,11.0,10.0,16.0,15.0,12.0,12.0,7.0,12.0,15.0,9.0,13.0,8.0,14.0,15.0,15.0,14.0,14.0,14.0,10.0,20.0,14.0,14.0,8.0,15.0,13.0,13.0,11.0,13.0,7.0,13.0,17.0,14.0,17.0,8.0,13.0,15.0,15.0,6.0,27.0,0.0,0.0,0.0,0.0,184.0,81.0,1.0,1.0,1.0,3.0,3.0,2.0,2.0,2.0,1.0,2.0,3.0,8.0,6.0,8.0,12.0,10.0,8.0,12.0,9.0,1.0,3.0,8.0,14.0,4.0,9.0,4.0,11.0,12.0,11.0,8.0,8.0,11.0,10.0,9.0,8.0,11.0,9.0,8.0,11.0,10.0,8.0,13.0,13.0,9.0,13.0,9.0,20.0,12.0,13.0,13.0,9.0,2.0,9.0,9.0,15.0,10.0,12.0,10.0,11.0,6.0,4.0,6.0,27.0,0.0,0.0,0.0,0.0,178.0,72.0,2.0,3.0,2.0,3.0,2.0,3.0,3.0,1.0,1.0,2.0,1.0,13.0,14.0,11.0,7.0,12.0,10.0,9.0,10.0,13.0,13.0,12.0,10.0,14.0,13.0,12.0,14.0,14.0,13.0,14.0,11.0,12.0,14.0,13.0,8.0,14.0,13.0,13.0,15.0,15.0,13.0,10.0,10.0,20.0,13.0,15.0,6.0,14.0,10.0,13.0,13.0,12.0,8.0,12.0,15.0,14.0,13.0,14.0,13.0,13.0,12.0,6.0,37.0,0.0,0.0,0.0,0.0,185.0,83.0,1.0,1.0,2.0,1.0,3.0,2.0,3.0,1.0,1.0,3.0,1.0,6.0,8.0,9.0,12.0,10.0,8.0,13.0,9.0,4.0,5.0,10.0,14.0,4.0,11.0,11.0,10.0,11.0,13.0,12.0,12.0,13.0,15.0,14.0,12.0,11.0,7.0,12.0,8.0,7.0,7.0,12.0,12.0,11.0,11.0,7.0,20.0,8.0,14.0,12.0,8.0,13.0,9.0,12.0,12.0,12.0,19.0,14.0,15.0,14.0,8.0,8.0,19.0,0.0,0.0,0.0,0.0,185.0,82.0,4.0,2.0,3.0,1.0,3.0,2.0,1.0,2.0,1.0,2.0,3.0,7.0,7.0,10.0,6.0,13.0,7.0,14.0,7.0,6.0,12.0,13.0,7.0,13.0,13.0,13.0,13.0,13.0,11.0,12.0,11.0,12.0,14.0,9.0,14.0,11.0,11.0,15.0,15.0,12.0,12.0,14.0,13.0,5.0,14.0,12.0,20.0,14.0,13.0,10.0,11.0,11.0,6.0,10.0,10.0,12.0,12.0,14.0,14.0,11.0,16.0,6.0,18.0,0.0,0.0,0.0,0.0,170.0,67.0,3.0,1.0,3.0,3.0,3.0,4.0,1.0,2.0,1.0,2.0,2.0,11.0,11.0,12.0,13.0,12.0,11.0,6.0,10.0,8.0,7.0,12.0,10.0,7.0,13.0,9.0,11.0,8.0,10.0,10.0,12.0,12.0,15.0,12.0,12.0,11.0,12.0,11.0,12.0,12.0,12.0,10.0,6.0,5.0,14.0,12.0,20.0,10.0,9.0,10.0,8.0,2.0,6.0,12.0,11.0,11.0,12.0,13.0,14.0,11.0,13.0,4.0,19.0,0.0,0.0,0.0,0.0,175.0,67.0,3.0,2.0,1.0,3.0,3.0,1.0,1.0,1.0,2.0,1.0,3.0,7.0,8.0,12.0,8.0,10.0,6.0,12.0,9.0,8.0,10.0,10.0,8.0,12.0,11.0,14.0,10.0,12.0,9.0,10.0,11.0,10.0,12.0,12.0,10.0,12.0,12.0,13.0,14.0,13.0,11.0,14.0,8.0,6.0,14.0,12.0,20.0,14.0,12.0,12.0,8.0,11.0,6.0,12.0,17.0,13.0,10.0,11.0,12.0,11.0,17.0,5.0,20.0,29.0,2.0,0.0,0.0,181.0,75.0,1.0,1.0,2.0,2.0,2.0,3.0,2.0,1.0,1.0,3.0,2.0,5.0,9.0,15.0,10.0,11.0,9.0,10.0,8.0,7.0,3.0,10.0,10.0,5.0,15.0,7.0,10.0,9.0,12.0,10.0,8.0,11.0,14.0,12.0,5.0,13.0,5.0,11.0,12.0,16.0,12.0,9.0,12.0,20.0,14.0,16.0,7.0,12.0,10.0,9.0,10.0,10.0,11.0,6.0,10.0,15.0,9.0,13.0,11.0,14.0,18.0,7.0,22.0,24.0,3.0,7.0,0.0,177.0,78.0,2.0,1.0,2.0,3.0,2.0,2.0,4.0,3.0,3.0,2.0,1.0,10.0,13.0,16.0,14.0,16.0,16.0,8.0,16.0,4.0,4.0,15.0,12.0,4.0,16.0,12.0,11.0,12.0,13.0,10.0,11.0,8.0,13.0,17.0,5.0,14.0,5.0,10.0,12.0,15.0,14.0,13.0,9.0,10.0,17.0,16.0,20.0,15.0,14.0,12.0,11.0,15.0,4.0,12.0,19.0,16.0,14.0,14.0,11.0,13.0,10.0,12.0,22.0,0.0,0.0,0.0,0.0,186.0,0.0,1.0,2.0,3.0,3.0,1.0,3.0,1.0,2.0,1.0,2.0,1.0,4.0,1.0,12.0,12.0,12.0,1.0,7.0,5.0,1.0,3.0,5.0,1.0,1.0,8.0,8.0,6.0,6.0,4.0,5.0,4.0,11.0,6.0,9.0,12.0,12.0,5.0,4.0,5.0,12.0,12.0,5.0,11.0,12.0,10.0,12.0,20.0,6.0,8.0,8.0,8.0,8.0,7.0,8.0,13.0,11.0,12.0,13.0,12.0,5.0,14.0,5.0
6,0,31.0,25.0,0.0,6.0,0.0,191.0,84.0,11.0,14.0,13.0,12.0,15.0,14.0,15.0,16.0,13.0,14.0,14.0,8.0,2.0,10.0,5.0,11.0,11.0,7.0,10.0,2.0,5.0,10.0,11.0,11.0,9.0,12.0,13.0,15.0,13.0,13.0,8.0,13.0,16.0,12.0,14.0,1.0,16.0,13.0,11.0,12.0,13.0,16.0,16.0,8.0,16.0,13.0,20.0,15.0,15.0,17.0,8.0,15.0,7.0,2.0,15.0,15.0,17.0,15.0,17.0,16.0,15.0,6.0,32.0,0.0,0.0,3.0,0.0,187.0,82.0,1.0,2.0,2.0,3.0,2.0,1.0,1.0,2.0,2.0,3.0,1.0,5.0,11.0,8.0,7.0,10.0,6.0,15.0,9.0,13.0,15.0,10.0,8.0,16.0,9.0,16.0,14.0,17.0,12.0,15.0,8.0,12.0,17.0,9.0,14.0,11.0,13.0,15.0,13.0,12.0,11.0,16.0,14.0,6.0,13.0,14.0,20.0,13.0,16.0,15.0,14.0,14.0,8.0,14.0,14.0,14.0,15.0,16.0,15.0,12.0,10.0,7.0,28.0,46.0,3.0,14.0,3.0,190.0,80.0,2.0,3.0,3.0,2.0,2.0,1.0,1.0,3.0,1.0,3.0,1.0,4.0,6.0,7.0,9.0,11.0,7.0,17.0,11.0,10.0,15.0,12.0,11.0,16.0,10.0,17.0,15.0,18.0,13.0,14.0,12.0,14.0,18.0,6.0,17.0,8.0,15.0,15.0,14.0,11.0,10.0,17.0,16.0,7.0,17.0,13.0,20.0,15.0,18.0,17.0,14.0,16.0,4.0,6.0,14.0,15.0,16.0,17.0,18.0,14.0,15.0,6.0,32.0,0.0,0.0,0.0,0.0,185.0,79.0,2.0,1.0,1.0,1.0,1.0,1.0,3.0,3.0,3.0,3.0,3.0,7.0,8.0,7.0,8.0,12.0,5.0,16.0,8.0,10.0,12.0,12.0,8.0,12.0,8.0,12.0,12.0,14.0,11.0,12.0,11.0,12.0,10.0,7.0,12.0,7.0,15.0,13.0,17.0,9.0,10.0,10.0,14.0,20.0,14.0,10.0,5.0,13.0,12.0,12.0,11.0,10.0,7.0,9.0,7.0,10.0,9.0,11.0,10.0,10.0,15.0,8.0,20.0,0.0,0.0,0.0,0.0,184.0,80.0,1.0,4.0,4.0,1.0,3.0,1.0,4.0,3.0,3.0,3.0,2.0,7.0,14.0,13.0,8.0,12.0,7.0,16.0,7.0,12.0,13.0,13.0,11.0,12.0,13.0,12.0,13.0,14.0,13.0,12.0,12.0,12.0,15.0,12.0,10.0,14.0,13.0,14.0,13.0,14.0,12.0,14.0,12.0,6.0,13.0,14.0,20.0,13.0,14.0,14.0,8.0,15.0,10.0,13.0,9.0,16.0,15.0,14.0,16.0,16.0,17.0,5.0,19.0,0.0,0.0,12.0,4.0,177.0,75.0,2.0,1.0,1.0,1.0,2.0,2.0,3.0,1.0,1.0,3.0,3.0,11.0,12.0,13.0,8.0,15.0,11.0,5.0,12.0,8.0,5.0,15.0,16.0,8.0,16.0,10.0,12.0,14.0,13.0,13.0,13.0,11.0,10.0,15.0,9.0,12.0,5.0,10.0,7.0,13.0,15.0,7.0,9.0,14.0,13.0,13.0,20.0,11.0,6.0,12.0,11.0,13.0,5.0,11.0,12.0,15.0,16.0,14.0,12.0,15.0,15.0,5.0,31.0,0.0,0.0,6.0,0.0,174.0,80.0,1.0,1.0,1.0,1.0,1.0,5.0,1.0,1.0,1.0,1.0,1.0,14.0,12.0,11.0,7.0,12.0,13.0,9.0,7.0,10.0,11.0,11.0,10.0,10.0,12.0,11.0,11.0,11.0,10.0,6.0,10.0,9.0,12.0,12.0,12.0,10.0,12.0,12.0,14.0,12.0,15.0,10.0,9.0,20.0,12.0,12.0,7.0,12.0,9.0,9.0,10.0,12.0,7.0,9.0,11.0,14.0,9.0,7.0,14.0,8.0,9.0,9.0,20.0,0.0,0.0,10.0,1.0,174.0,68.0,1.0,3.0,3.0,3.0,2.0,3.0,3.0,2.0,1.0,2.0,2.0,11.0,12.0,15.0,11.0,14.0,12.0,6.0,12.0,2.0,4.0,14.0,11.0,4.0,15.0,9.0,11.0,10.0,12.0,11.0,14.0,12.0,14.0,14.0,7.0,13.0,7.0,11.0,13.0,14.0,15.0,13.0,7.0,20.0,12.0,14.0,10.0,13.0,9.0,12.0,7.0,12.0,10.0,12.0,15.0,16.0,12.0,14.0,13.0,15.0,15.0,5.0,27.0,0.0,0.0,0.0,0.0,186.0,0.0,2.0,3.0,3.0,1.0,2.0,1.0,2.0,3.0,4.0,3.0,3.0,7.0,4.0,13.0,13.0,11.0,7.0,11.0,8.0,1.0,6.0,5.0,9.0,4.0,11.0,7.0,12.0,7.0,10.0,5.0,6.0,13.0,4.0,11.0,10.0,12.0,6.0,7.0,8.0,13.0,13.0,8.0,13.0,9.0,12.0,13.0,20.0,13.0,10.0,10.0,5.0,10.0,10.0,9.0,13.0,10.0,14.0,12.0,11.0,10.0,12.0,2.0,21.0,3.0,0.0,0.0,0.0,181.0,77.0,2.0,2.0,2.0,1.0,1.0,1.0,3.0,2.0,4.0,3.0,3.0,6.0,13.0,16.0,12.0,15.0,7.0,6.0,10.0,5.0,5.0,13.0,10.0,6.0,16.0,13.0,13.0,13.0,9.0,10.0,11.0,13.0,15.0,17.0,10.0,14.0,5.0,12.0,11.0,16.0,15.0,13.0,10.0,15.0,16.0,15.0,20.0,13.0,14.0,14.0,10.0,13.0,8.0,16.0,17.0,17.0,11.0,14.0,10.0,9.0,11.0,9.0,25.0,0.0,0.0,0.0,0.0,191.0,87.0,2.0,1.0,2.0,2.0,3.0,1.0,1.0,3.0,2.0,3.0,1.0,5.0,8.0,10.0,14.0,13.0,8.0,17.0,12.0,4.0,6.0,13.0,14.0,6.0,13.0,12.0,13.0,16.0,13.0,14.0,11.0,13.0,15.0,9.0,12.0,15.0,9.0,15.0,14.0,11.0,12.0,15.0,17.0,10.0,14.0,13.0,20.0,14.0,15.0,12.0,6.0,13.0,7.0,6.0,11.0,13.0,14.0,12.0,16.0,15.0,14.0,7.0,26.0,2.0,0.0,1.0,0.0,188.0,84.0,12.0,13.0,15.0,9.0,15.0,13.0,13.0,15.0,10.0,11.0,14.0,9.0,2.0,1.0,2.0,12.0,11.0,3.0,2.0,3.0,3.0,11.0,3.0,1.0,10.0,14.0,13.0,14.0,10.0,13.0,11.0,11.0,14.0,3.0,11.0,5.0,12.0,15.0,13.0,10.0,12.0,13.0,14.0,5.0,14.0,9.0,20.0,12.0,14.0,12.0,10.0,15.0,3.0,11.0,12.0,11.0,16.0,13.0,15.0,16.0,16.0,4.0,29.0,0.0,0.0,0.0,0.0,183.0,74.0,3.0,3.0,3.0,3.0,3.0,2.0,2.0,2.0,1.0,3.0,1.0,5.0,12.0,7.0,6.0,10.0,7.0,14.0,12.0,5.0,14.0,12.0,6.0,13.0,11.0,14.0,13.0,17.0,13.0,16.0,12.0,12.0,13.0,9.0,8.0,9.0,14.0,14.0,15.0,13.0,12.0,15.0,12.0,6.0,17.0,11.0,20.0,17.0,13.0,14.0,14.0,15.0,5.0,13.0,9.0,14.0,19.0,15.0,14.0,11.0,11.0,6.0,19.0,1.0,0.0,0.0,0.0,182.0,67.0,1.0,3.0,2.0,1.0,2.0,3.0,1.0,1.0,2.0,1.0,1.0,7.0,7.0,8.0,4.0,10.0,7.0,9.0,9.0,7.0,14.0,9.0,7.0,13.0,9.0,9.0,10.0,8.0,9.0,8.0,9.0,14.0,2.0,7.0,12.0,7.0,8.0,8.0,12.0,12.0,10.0,9.0,11.0,5.0,13.0,8.0,20.0,11.0,8.0,9.0,5.0,4.0,9.0,9.0,10.0,12.0,13.0,9.0,10.0,13.0,12.0,3.0,27.0,0.0,0.0,10.0,0.0,178.0,77.0,1.0,3.0,2.0,1.0,2.0,2.0,3.0,2.0,3.0,3.0,3.0,13.0,14.0,15.0,8.0,15.0,13.0,10.0,12.0,10.0,9.0,13.0,8.0,10.0,15.0,10.0,12.0,13.0,13.0,14.0,13.0,12.0,13.0,13.0,6.0,14.0,10.0,11.0,15.0,14.0,14.0,13.0,9.0,20.0,10.0,14.0,7.0,13.0,12.0,12.0,9.0,15.0,8.0,10.0,8.0,16.0,13.0,14.0,11.0,13.0,13.0,13.0,30.0,0.0,0.0,0.0,0.0,182.0,71.0,3.0,2.0,1.0,3.0,3.0,2.0,3.0,2.0,1.0,2.0,1.0,5.0,12.0,12.0,7.0,12.0,7.0,13.0,7.0,11.0,12.0,11.0,6.0,13.0,13.0,14.0,13.0,14.0,8.0,12.0,9.0,11.0,14.0,11.0,9.0,11.0,10.0,13.0,15.0,14.0,13.0,14.0,11.0,8.0,13.0,13.0,20.0,14.0,14.0,13.0,14.0,14.0,10.0,8.0,12.0,13.0,13.0,12.0,14.0,11.0,11.0,7.0,30.0,4.0,0.0,0.0,0.0,192.0,78.0,1.0,3.0,1.0,2.0,2.0,3.0,1.0,3.0,1.0,1.0,3.0,4.0,6.0,7.0,8.0,11.0,6.0,15.0,8.0,6.0,13.0,11.0,6.0,14.0,11.0,17.0,14.0,16.0,12.0,14.0,10.0,12.0,17.0,8.0,8.0,11.0,13.0,15.0,16.0,14.0,12.0,18.0,14.0,6.0,14.0,12.0,20.0,17.0,16.0,14.0,17.0,13.0,9.0,11.0,8.0,13.0,10.0,13.0,12.0,10.0,10.0,5.0,27.0,0.0,0.0,0.0,0.0,188.0,77.0,1.0,4.0,1.0,1.0,3.0,1.0,2.0,1.0,2.0,2.0,2.0,4.0,7.0,8.0,7.0,13.0,6.0,15.0,9.0,6.0,13.0,12.0,6.0,12.0,11.0,14.0,14.0,15.0,10.0,12.0,11.0,13.0,16.0,7.0,12.0,9.0,12.0,15.0,16.0,14.0,10.0,14.0,15.0,9.0,13.0,12.0,20.0,14.0,16.0,12.0,14.0,13.0,6.0,12.0,4.0,13.0,18.0,13.0,14.0,14.0,13.0,7.0,20.0,0.0,0.0,2.0,0.0,180.0,75.0,3.0,1.0,2.0,2.0,3.0,2.0,1.0,1.0,3.0,3.0,1.0,8.0,13.0,14.0,9.0,13.0,8.0,10.0,9.0,6.0,5.0,12.0,6.0,5.0,14.0,8.0,13.0,12.0,13.0,12.0,12.0,12.0,7.0,13.0,8.0,14.0,7.0,12.0,13.0,15.0,13.0,14.0,10.0,8.0,14.0,15.0,20.0,13.0,12.0,13.0,11.0,9.0,7.0,13.0,9.0,11.0,11.0,11.0,12.0,11.0,10.0,1.0,26.0,16.0,4.0,0.0,0.0,177.0,71.0,1.0,2.0,1.0,3.0,3.0,2.0,1.0,1.0,3.0,3.0,1.0,10.0,12.0,13.0,9.0,12.0,10.0,7.0,12.0,7.0,5.0,12.0,10.0,6.0,12.0,6.0,9.0,7.0,8.0,8.0,12.0,8.0,16.0,12.0,8.0,11.0,6.0,8.0,9.0,17.0,14.0,8.0,8.0,20.0,14.0,17.0,7.0,12.0,14.0,11.0,6.0,11.0,6.0,8.0,15.0,15.0,14.0,10.0,11.0,14.0,12.0,11.0,18.0,0.0,0.0,0.0,0.0,179.0,67.0,3.0,3.0,2.0,4.0,2.0,4.0,3.0,1.0,3.0,4.0,1.0,5.0,7.0,12.0,9.0,12.0,12.0,10.0,12.0,6.0,4.0,12.0,12.0,3.0,14.0,11.0,12.0,11.0,11.0,8.0,13.0,12.0,12.0,12.0,6.0,12.0,5.0,10.0,12.0,15.0,11.0,12.0,10.0,20.0,13.0,14.0,8.0,14.0,8.0,9.0,6.0,14.0,5.0,10.0,16.0,13.0,12.0,12.0,13.0,9.0,15.0,2.0,18.0,0.0,0.0,0.0,0.0,188.0,80.0,1.0,3.0,1.0,3.0,2.0,3.0,3.0,1.0,2.0,2.0,4.0,6.0,8.0,12.0,11.0,12.0,7.0,13.0,10.0,4.0,4.0,8.0,10.0,5.0,12.0,11.0,11.0,13.0,10.0,11.0,11.0,12.0,11.0,13.0,7.0,13.0,8.0,13.0,13.0,11.0,12.0,12.0,12.0,10.0,12.0,11.0,20.0,10.0,12.0,12.0,8.0,11.0,7.0,13.0,8.0,13.0,13.0,11.0,12.0,12.0,13.0,7.0
0,0,26.0,2.0,0.0,1.0,0.0,188.0,84.0,12.0,13.0,15.0,9.0,15.0,13.0,13.0,15.0,10.0,11.0,14.0,9.0,2.0,1.0,2.0,12.0,11.0,3.0,2.0,3.0,3.0,11.0,3.0,1.0,10.0,14.0,13.0,14.0,10.0,13.0,11.0,11.0,14.0,3.0,11.0,5.0,12.0,15.0,13.0,10.0,12.0,13.0,14.0,5.0,14.0,9.0,20.0,12.0,14.0,12.0,10.0,15.0,3.0,11.0,12.0,11.0,16.0,13.0,15.0,16.0,16.0,4.0,32.0,0.0,0.0,0.0,0.0,183.0,79.0,1.0,1.0,1.0,3.0,1.0,3.0,1.0,1.0,2.0,1.0,1.0,5.0,10.0,6.0,6.0,9.0,6.0,15.0,7.0,11.0,14.0,10.0,7.0,13.0,10.0,13.0,15.0,15.0,15.0,14.0,9.0,13.0,16.0,6.0,14.0,8.0,12.0,13.0,16.0,11.0,12.0,16.0,11.0,8.0,16.0,12.0,20.0,15.0,14.0,14.0,11.0,12.0,5.0,15.0,18.0,15.0,14.0,13.0,17.0,14.0,14.0,5.0,29.0,0.0,0.0,0.0,0.0,183.0,74.0,3.0,3.0,3.0,3.0,3.0,2.0,2.0,2.0,1.0,3.0,1.0,5.0,12.0,7.0,6.0,10.0,7.0,14.0,12.0,5.0,14.0,12.0,6.0,13.0,11.0,14.0,13.0,17.0,13.0,16.0,12.0,12.0,13.0,9.0,8.0,9.0,14.0,14.0,15.0,13.0,12.0,15.0,12.0,6.0,17.0,11.0,20.0,17.0,13.0,14.0,14.0,15.0,5.0,13.0,9.0,14.0,19.0,15.0,14.0,11.0,11.0,6.0,30.0,0.0,0.0,0.0,0.0,182.0,71.0,3.0,2.0,1.0,3.0,3.0,2.0,3.0,2.0,1.0,2.0,1.0,5.0,12.0,12.0,7.0,12.0,7.0,13.0,7.0,11.0,12.0,11.0,6.0,13.0,13.0,14.0,13.0,14.0,8.0,12.0,9.0,11.0,14.0,11.0,9.0,11.0,10.0,13.0,15.0,14.0,13.0,14.0,11.0,8.0,13.0,13.0,20.0,14.0,14.0,13.0,14.0,14.0,10.0,8.0,12.0,13.0,13.0,12.0,14.0,11.0,11.0,7.0,22.0,0.0,0.0,0.0,0.0,178.0,73.0,3.0,2.0,2.0,1.0,2.0,4.0,3.0,1.0,3.0,1.0,2.0,6.0,12.0,12.0,6.0,11.0,7.0,8.0,8.0,11.0,12.0,10.0,8.0,13.0,11.0,12.0,12.0,13.0,11.0,10.0,11.0,11.0,13.0,6.0,7.0,12.0,9.0,13.0,14.0,16.0,14.0,13.0,9.0,6.0,14.0,15.0,20.0,15.0,14.0,12.0,12.0,13.0,6.0,14.0,12.0,15.0,13.0,13.0,14.0,14.0,14.0,6.0,27.0,0.0,0.0,0.0,0.0,188.0,77.0,1.0,4.0,1.0,1.0,3.0,1.0,2.0,1.0,2.0,2.0,2.0,4.0,7.0,8.0,7.0,13.0,6.0,15.0,9.0,6.0,13.0,12.0,6.0,12.0,11.0,14.0,14.0,15.0,10.0,12.0,11.0,13.0,16.0,7.0,12.0,9.0,12.0,15.0,16.0,14.0,10.0,14.0,15.0,9.0,13.0,12.0,20.0,14.0,16.0,12.0,14.0,13.0,6.0,12.0,4.0,13.0,18.0,13.0,14.0,14.0,13.0,7.0,30.0,4.0,0.0,0.0,0.0,192.0,78.0,1.0,3.0,1.0,2.0,2.0,3.0,1.0,3.0,1.0,1.0,3.0,4.0,6.0,7.0,8.0,11.0,6.0,15.0,8.0,6.0,13.0,11.0,6.0,14.0,11.0,17.0,14.0,16.0,12.0,14.0,10.0,12.0,17.0,8.0,8.0,11.0,13.0,15.0,16.0,14.0,12.0,18.0,14.0,6.0,14.0,12.0,20.0,17.0,16.0,14.0,17.0,13.0,9.0,11.0,8.0,13.0,10.0,13.0,12.0,10.0,10.0,5.0,26.0,16.0,4.0,0.0,0.0,177.0,71.0,1.0,2.0,1.0,3.0,3.0,2.0,1.0,1.0,3.0,3.0,1.0,10.0,12.0,13.0,9.0,12.0,10.0,7.0,12.0,7.0,5.0,12.0,10.0,6.0,12.0,6.0,9.0,7.0,8.0,8.0,12.0,8.0,16.0,12.0,8.0,11.0,6.0,8.0,9.0,17.0,14.0,8.0,8.0,20.0,14.0,17.0,7.0,12.0,14.0,11.0,6.0,11.0,6.0,8.0,15.0,15.0,14.0,10.0,11.0,14.0,12.0,11.0,25.0,0.0,0.0,3.0,2.0,170.0,61.0,2.0,3.0,2.0,2.0,1.0,3.0,2.0,2.0,1.0,2.0,1.0,11.0,12.0,13.0,10.0,13.0,8.0,5.0,8.0,7.0,4.0,14.0,10.0,4.0,15.0,11.0,10.0,9.0,7.0,10.0,14.0,8.0,13.0,13.0,6.0,12.0,8.0,8.0,12.0,16.0,14.0,7.0,5.0,12.0,15.0,16.0,20.0,14.0,6.0,12.0,11.0,13.0,8.0,8.0,8.0,13.0,15.0,10.0,10.0,14.0,14.0,8.0,18.0,0.0,0.0,0.0,0.0,188.0,80.0,1.0,3.0,1.0,3.0,2.0,3.0,3.0,1.0,2.0,2.0,4.0,6.0,8.0,12.0,11.0,12.0,7.0,13.0,10.0,4.0,4.0,8.0,10.0,5.0,12.0,11.0,11.0,13.0,10.0,11.0,11.0,12.0,11.0,13.0,7.0,13.0,8.0,13.0,13.0,11.0,12.0,12.0,12.0,10.0,12.0,11.0,20.0,10.0,12.0,12.0,8.0,11.0,7.0,13.0,8.0,13.0,13.0,11.0,12.0,12.0,13.0,7.0,30.0,5.0,0.0,22.0,9.0,181.0,84.0,2.0,3.0,3.0,1.0,2.0,3.0,3.0,1.0,3.0,1.0,3.0,7.0,10.0,12.0,13.0,11.0,7.0,13.0,10.0,12.0,6.0,11.0,13.0,6.0,13.0,17.0,13.0,16.0,11.0,13.0,11.0,11.0,17.0,14.0,8.0,14.0,9.0,13.0,17.0,15.0,12.0,15.0,11.0,8.0,14.0,15.0,20.0,14.0,14.0,13.0,9.0,13.0,7.0,10.0,7.0,16.0,13.0,14.0,13.0,15.0,15.0,10.0,25.0,0.0,0.0,0.0,0.0,187.0,83.0,11.0,14.0,12.0,8.0,13.0,11.0,14.0,15.0,13.0,13.0,9.0,8.0,1.0,1.0,1.0,11.0,11.0,1.0,2.0,2.0,1.0,10.0,3.0,2.0,11.0,8.0,12.0,14.0,12.0,12.0,10.0,12.0,14.0,6.0,14.0,2.0,12.0,12.0,8.0,13.0,15.0,14.0,13.0,20.0,15.0,11.0,5.0,14.0,13.0,13.0,8.0,8.0,10.0,1.0,9.0,13.0,14.0,12.0,15.0,15.0,15.0,5.0,26.0,0.0,0.0,0.0,0.0,183.0,79.0,1.0,1.0,3.0,4.0,3.0,2.0,2.0,1.0,2.0,1.0,1.0,9.0,8.0,12.0,11.0,10.0,11.0,10.0,9.0,7.0,6.0,8.0,9.0,5.0,12.0,10.0,9.0,8.0,11.0,11.0,9.0,8.0,11.0,14.0,6.0,12.0,8.0,10.0,11.0,11.0,12.0,11.0,10.0,10.0,10.0,12.0,20.0,11.0,11.0,9.0,9.0,9.0,6.0,13.0,17.0,11.0,10.0,11.0,12.0,10.0,10.0,4.0,31.0,0.0,0.0,7.0,2.0,185.0,80.0,3.0,3.0,1.0,1.0,4.0,1.0,4.0,3.0,3.0,3.0,1.0,5.0,10.0,9.0,6.0,11.0,7.0,15.0,8.0,8.0,14.0,12.0,6.0,13.0,11.0,12.0,14.0,16.0,12.0,13.0,8.0,11.0,17.0,5.0,14.0,6.0,15.0,14.0,14.0,12.0,11.0,15.0,14.0,10.0,16.0,11.0,20.0,14.0,15.0,14.0,12.0,15.0,8.0,13.0,8.0,15.0,17.0,14.0,16.0,15.0,15.0,7.0,19.0,0.0,0.0,0.0,0.0,181.0,68.0,2.0,3.0,1.0,1.0,2.0,3.0,2.0,3.0,2.0,1.0,2.0,8.0,11.0,12.0,9.0,11.0,11.0,8.0,11.0,6.0,9.0,12.0,7.0,12.0,12.0,12.0,10.0,7.0,10.0,10.0,12.0,8.0,3.0,13.0,7.0,11.0,12.0,13.0,13.0,12.0,13.0,14.0,10.0,12.0,15.0,14.0,20.0,14.0,11.0,10.0,12.0,8.0,11.0,14.0,18.0,13.0,9.0,12.0,12.0,12.0,19.0,1.0,23.0,0.0,0.0,0.0,0.0,175.0,80.0,1.0,2.0,3.0,1.0,3.0,1.0,2.0,2.0,2.0,2.0,1.0,7.0,13.0,10.0,13.0,10.0,7.0,6.0,11.0,10.0,12.0,12.0,8.0,12.0,11.0,11.0,10.0,13.0,11.0,11.0,11.0,12.0,14.0,13.0,6.0,13.0,13.0,12.0,12.0,17.0,13.0,13.0,7.0,20.0,13.0,16.0,5.0,14.0,13.0,14.0,11.0,14.0,10.0,15.0,20.0,15.0,14.0,12.0,14.0,14.0,14.0,7.0,23.0,0.0,0.0,0.0,0.0,172.0,70.0,3.0,3.0,3.0,1.0,1.0,2.0,4.0,2.0,4.0,2.0,1.0,5.0,12.0,11.0,7.0,12.0,6.0,9.0,7.0,11.0,12.0,12.0,8.0,13.0,12.0,12.0,12.0,14.0,11.0,12.0,9.0,11.0,14.0,8.0,7.0,12.0,10.0,14.0,15.0,13.0,13.0,11.0,7.0,6.0,14.0,14.0,20.0,15.0,11.0,12.0,10.0,12.0,10.0,11.0,16.0,12.0,14.0,10.0,14.0,12.0,10.0,6.0,18.0,0.0,0.0,0.0,0.0,185.0,74.0,2.0,2.0,1.0,3.0,3.0,1.0,4.0,2.0,2.0,3.0,2.0,8.0,6.0,8.0,6.0,10.0,6.0,13.0,5.0,9.0,12.0,10.0,9.0,13.0,10.0,12.0,12.0,13.0,11.0,12.0,8.0,11.0,12.0,3.0,8.0,8.0,11.0,10.0,13.0,13.0,11.0,12.0,12.0,6.0,12.0,12.0,20.0,13.0,14.0,11.0,7.0,10.0,5.0,10.0,7.0,13.0,12.0,12.0,13.0,9.0,15.0,7.0,21.0,0.0,0.0,0.0,0.0,185.0,69.0,2.0,3.0,2.0,1.0,3.0,3.0,3.0,3.0,3.0,2.0,2.0,5.0,9.0,12.0,9.0,16.0,10.0,11.0,15.0,5.0,13.0,13.0,8.0,14.0,13.0,11.0,16.0,13.0,13.0,14.0,12.0,11.0,15.0,10.0,7.0,8.0,13.0,14.0,13.0,13.0,13.0,14.0,12.0,6.0,13.0,12.0,20.0,13.0,11.0,12.0,10.0,12.0,7.0,13.0,10.0,14.0,14.0,11.0,14.0,14.0,14.0,6.0,27.0,0.0,0.0,0.0,0.0,186.0,77.0,2.0,4.0,2.0,2.0,1.0,1.0,1.0,3.0,2.0,2.0,1.0,10.0,11.0,12.0,10.0,13.0,11.0,12.0,14.0,8.0,10.0,14.0,6.0,12.0,13.0,13.0,12.0,13.0,12.0,12.0,12.0,12.0,14.0,9.0,10.0,12.0,11.0,14.0,15.0,12.0,13.0,14.0,12.0,20.0,12.0,11.0,9.0,16.0,13.0,13.0,13.0,13.0,15.0,12.0,14.0,13.0,14.0,13.0,15.0,15.0,15.0,5.0,23.0,15.0,5.0,0.0,0.0,186.0,81.0,3.0,1.0,1.0,4.0,1.0,1.0,2.0,2.0,3.0,3.0,4.0,5.0,10.0,13.0,14.0,10.0,5.0,11.0,13.0,5.0,4.0,9.0,10.0,4.0,10.0,13.0,11.0,14.0,12.0,9.0,8.0,8.0,15.0,13.0,7.0,8.0,7.0,10.0,10.0,15.0,12.0,15.0,12.0,7.0,10.0,18.0,20.0,17.0,15.0,8.0,8.0,11.0,12.0,12.0,12.0,15.0,13.0,12.0,15.0,13.0,13.0,6.0,27.0,17.0,2.0,0.0,0.0,180.0,78.0,2.0,3.0,2.0,1.0,1.0,2.0,1.0,1.0,2.0,3.0,2.0,7.0,10.0,13.0,12.0,13.0,11.0,12.0,12.0,7.0,5.0,12.0,9.0,4.0,12.0,12.0,13.0,14.0,10.0,11.0,11.0,10.0,12.0,14.0,5.0,13.0,7.0,10.0,14.0,16.0,15.0,14.0,11.0,20.0,12.0,15.0,8.0,14.0,14.0,11.0,12.0,15.0,9.0,10.0,6.0,14.0,12.0,11.0,13.0,13.0,13.0,10.0
2,0,25.0,0.0,0.0,11.0,0.0,189.0,83.0,12.0,12.0,11.0,7.0,13.0,12.0,17.0,17.0,16.0,12.0,13.0,6.0,2.0,1.0,1.0,10.0,10.0,7.0,1.0,1.0,1.0,9.0,5.0,1.0,10.0,8.0,15.0,14.0,14.0,12.0,7.0,13.0,12.0,6.0,9.0,3.0,16.0,17.0,10.0,13.0,16.0,14.0,12.0,8.0,15.0,10.0,20.0,13.0,14.0,14.0,5.0,14.0,4.0,12.0,15.0,15.0,13.0,13.0,17.0,15.0,17.0,4.0,31.0,0.0,0.0,0.0,0.0,171.0,65.0,1.0,3.0,1.0,3.0,2.0,2.0,3.0,1.0,2.0,2.0,3.0,8.0,9.0,11.0,7.0,5.0,6.0,5.0,6.0,7.0,14.0,14.0,6.0,14.0,13.0,14.0,12.0,13.0,12.0,11.0,11.0,12.0,12.0,11.0,7.0,12.0,12.0,12.0,10.0,15.0,15.0,7.0,9.0,9.0,12.0,14.0,20.0,12.0,13.0,11.0,13.0,11.0,9.0,10.0,15.0,14.0,12.0,11.0,14.0,13.0,12.0,7.0,20.0,0.0,0.0,7.0,0.0,186.0,72.0,3.0,3.0,2.0,3.0,3.0,4.0,3.0,3.0,2.0,2.0,2.0,4.0,9.0,8.0,6.0,13.0,6.0,14.0,6.0,7.0,14.0,12.0,8.0,13.0,13.0,11.0,13.0,14.0,14.0,14.0,9.0,13.0,13.0,8.0,8.0,8.0,13.0,14.0,14.0,13.0,13.0,15.0,13.0,20.0,15.0,14.0,8.0,14.0,13.0,12.0,8.0,12.0,4.0,10.0,8.0,15.0,14.0,12.0,14.0,15.0,14.0,7.0,23.0,2.0,0.0,5.0,3.0,182.0,73.0,3.0,1.0,1.0,1.0,2.0,1.0,2.0,1.0,3.0,4.0,2.0,12.0,14.0,14.0,10.0,13.0,12.0,16.0,11.0,13.0,12.0,13.0,13.0,14.0,14.0,12.0,11.0,14.0,13.0,11.0,13.0,11.0,15.0,15.0,9.0,15.0,10.0,14.0,15.0,16.0,15.0,13.0,13.0,20.0,14.0,15.0,6.0,15.0,12.0,13.0,9.0,13.0,14.0,15.0,17.0,15.0,13.0,12.0,12.0,15.0,13.0,9.0,24.0,9.0,0.0,7.0,1.0,190.0,82.0,2.0,2.0,3.0,3.0,1.0,2.0,2.0,1.0,1.0,3.0,1.0,8.0,14.0,13.0,11.0,12.0,10.0,12.0,11.0,9.0,11.0,13.0,8.0,13.0,13.0,10.0,14.0,14.0,13.0,13.0,14.0,14.0,16.0,11.0,6.0,12.0,12.0,16.0,16.0,12.0,11.0,11.0,14.0,8.0,14.0,14.0,20.0,15.0,13.0,14.0,9.0,13.0,8.0,14.0,13.0,14.0,12.0,14.0,16.0,12.0,15.0,2.0,20.0,0.0,0.0,0.0,0.0,176.0,69.0,1.0,2.0,1.0,2.0,2.0,3.0,2.0,1.0,3.0,3.0,3.0,11.0,15.0,13.0,9.0,16.0,13.0,10.0,12.0,8.0,9.0,15.0,14.0,9.0,15.0,11.0,11.0,12.0,13.0,13.0,15.0,14.0,15.0,15.0,11.0,12.0,12.0,12.0,11.0,13.0,12.0,13.0,11.0,20.0,12.0,13.0,8.0,13.0,11.0,12.0,11.0,11.0,11.0,10.0,8.0,13.0,15.0,11.0,15.0,12.0,10.0,8.0,23.0,15.0,1.0,7.0,0.0,165.0,60.0,2.0,3.0,2.0,1.0,1.0,1.0,3.0,3.0,2.0,1.0,3.0,14.0,14.0,16.0,8.0,16.0,13.0,6.0,10.0,6.0,11.0,18.0,15.0,12.0,18.0,16.0,15.0,15.0,17.0,13.0,17.0,15.0,14.0,18.0,12.0,10.0,12.0,15.0,16.0,14.0,16.0,16.0,6.0,12.0,13.0,14.0,20.0,15.0,11.0,16.0,14.0,15.0,10.0,12.0,14.0,15.0,16.0,14.0,14.0,13.0,10.0,6.0,27.0,10.0,0.0,0.0,0.0,187.0,75.0,2.0,2.0,4.0,3.0,3.0,3.0,2.0,3.0,4.0,2.0,1.0,13.0,13.0,15.0,11.0,18.0,13.0,8.0,13.0,4.0,3.0,17.0,14.0,4.0,17.0,10.0,13.0,9.0,14.0,12.0,17.0,13.0,12.0,18.0,8.0,14.0,6.0,14.0,9.0,15.0,16.0,12.0,12.0,14.0,12.0,14.0,20.0,12.0,11.0,13.0,8.0,13.0,13.0,10.0,11.0,17.0,13.0,12.0,14.0,15.0,15.0,8.0,28.0,66.0,15.0,13.0,3.0,180.0,70.0,2.0,2.0,1.0,2.0,1.0,1.0,3.0,2.0,3.0,3.0,1.0,14.0,15.0,16.0,13.0,17.0,15.0,6.0,15.0,4.0,5.0,16.0,14.0,8.0,17.0,13.0,16.0,11.0,15.0,13.0,16.0,14.0,13.0,17.0,10.0,14.0,9.0,13.0,13.0,16.0,18.0,12.0,10.0,20.0,14.0,15.0,8.0,16.0,9.0,13.0,14.0,12.0,10.0,15.0,14.0,15.0,10.0,16.0,14.0,6.0,12.0,10.0,24.0,70.0,46.0,7.0,9.0,174.0,68.0,2.0,3.0,2.0,1.0,3.0,1.0,2.0,3.0,1.0,1.0,3.0,16.0,16.0,20.0,16.0,17.0,16.0,9.0,13.0,3.0,4.0,16.0,16.0,4.0,20.0,10.0,17.0,14.0,15.0,15.0,16.0,15.0,15.0,19.0,13.0,19.0,4.0,13.0,12.0,18.0,19.0,14.0,6.0,15.0,16.0,16.0,20.0,13.0,10.0,14.0,11.0,15.0,6.0,12.0,15.0,16.0,19.0,14.0,15.0,8.0,8.0,17.0,29.0,76.0,27.0,13.0,9.0,188.0,72.0,2.0,3.0,1.0,2.0,3.0,3.0,1.0,3.0,3.0,3.0,3.0,5.0,10.0,13.0,16.0,13.0,11.0,17.0,13.0,5.0,10.0,13.0,14.0,10.0,13.0,15.0,16.0,18.0,14.0,15.0,10.0,13.0,14.0,13.0,10.0,18.0,12.0,14.0,19.0,15.0,14.0,16.0,14.0,10.0,18.0,16.0,20.0,18.0,14.0,14.0,8.0,15.0,5.0,16.0,10.0,16.0,12.0,14.0,16.0,14.0,10.0,10.0,26.0,11.0,0.0,0.0,0.0,198.0,88.0,13.0,11.0,10.0,8.0,12.0,10.0,14.0,15.0,11.0,13.0,9.0,3.0,3.0,3.0,6.0,6.0,6.0,12.0,12.0,2.0,1.0,8.0,6.0,1.0,6.0,9.0,12.0,14.0,12.0,12.0,11.0,11.0,12.0,6.0,9.0,2.0,13.0,12.0,8.0,12.0,13.0,18.0,17.0,5.0,16.0,9.0,20.0,15.0,15.0,11.0,9.0,12.0,5.0,1.0,16.0,14.0,16.0,13.0,12.0,15.0,15.0,7.0,23.0,0.0,0.0,0.0,0.0,188.0,75.0,2.0,2.0,2.0,2.0,3.0,4.0,2.0,2.0,2.0,3.0,3.0,4.0,10.0,7.0,5.0,10.0,7.0,13.0,10.0,5.0,13.0,11.0,6.0,13.0,12.0,13.0,13.0,14.0,11.0,11.0,8.0,11.0,12.0,5.0,6.0,10.0,12.0,13.0,14.0,13.0,11.0,15.0,14.0,5.0,14.0,12.0,20.0,14.0,14.0,12.0,13.0,11.0,7.0,12.0,9.0,12.0,11.0,7.0,12.0,10.0,10.0,8.0,24.0,0.0,0.0,0.0,0.0,185.0,70.0,3.0,2.0,3.0,2.0,2.0,1.0,2.0,1.0,1.0,2.0,3.0,5.0,6.0,9.0,7.0,11.0,8.0,15.0,12.0,7.0,14.0,13.0,7.0,11.0,11.0,11.0,14.0,14.0,13.0,9.0,9.0,12.0,4.0,8.0,5.0,10.0,12.0,15.0,12.0,11.0,11.0,14.0,13.0,6.0,15.0,11.0,20.0,13.0,14.0,13.0,9.0,11.0,7.0,10.0,15.0,11.0,13.0,11.0,10.0,9.0,14.0,4.0,24.0,0.0,0.0,0.0,0.0,183.0,78.0,2.0,3.0,1.0,3.0,2.0,1.0,1.0,1.0,1.0,3.0,3.0,5.0,10.0,9.0,5.0,12.0,11.0,12.0,11.0,8.0,13.0,13.0,11.0,14.0,10.0,15.0,14.0,14.0,13.0,15.0,10.0,14.0,14.0,6.0,6.0,9.0,14.0,13.0,14.0,12.0,12.0,14.0,11.0,5.0,15.0,11.0,20.0,14.0,14.0,14.0,13.0,12.0,7.0,10.0,12.0,13.0,16.0,13.0,15.0,15.0,15.0,5.0,24.0,0.0,0.0,0.0,0.0,175.0,72.0,3.0,2.0,4.0,3.0,2.0,4.0,1.0,1.0,1.0,2.0,2.0,8.0,12.0,12.0,6.0,11.0,7.0,10.0,9.0,12.0,11.0,12.0,8.0,12.0,11.0,11.0,12.0,13.0,10.0,10.0,9.0,9.0,3.0,9.0,9.0,11.0,12.0,11.0,11.0,14.0,13.0,11.0,8.0,20.0,12.0,13.0,6.0,12.0,11.0,10.0,10.0,10.0,9.0,10.0,10.0,13.0,10.0,11.0,10.0,13.0,18.0,1.0,29.0,0.0,0.0,0.0,0.0,188.0,74.0,1.0,2.0,3.0,3.0,2.0,3.0,1.0,3.0,2.0,1.0,1.0,4.0,8.0,10.0,6.0,13.0,7.0,14.0,9.0,6.0,13.0,12.0,8.0,13.0,13.0,12.0,14.0,13.0,14.0,11.0,13.0,12.0,14.0,6.0,13.0,8.0,14.0,15.0,15.0,9.0,12.0,14.0,14.0,10.0,13.0,10.0,20.0,16.0,12.0,13.0,12.0,15.0,9.0,11.0,11.0,14.0,14.0,12.0,15.0,13.0,13.0,6.0,26.0,0.0,0.0,0.0,0.0,178.0,74.0,2.0,3.0,1.0,3.0,3.0,3.0,2.0,2.0,3.0,1.0,3.0,14.0,12.0,12.0,10.0,13.0,14.0,9.0,12.0,5.0,6.0,12.0,8.0,8.0,13.0,11.0,11.0,12.0,10.0,11.0,12.0,13.0,15.0,12.0,8.0,11.0,12.0,12.0,15.0,14.0,15.0,15.0,10.0,5.0,13.0,13.0,20.0,14.0,13.0,13.0,13.0,14.0,8.0,6.0,14.0,13.0,12.0,11.0,13.0,12.0,16.0,7.0,21.0,0.0,0.0,0.0,0.0,180.0,68.0,4.0,1.0,1.0,1.0,1.0,3.0,1.0,2.0,2.0,2.0,3.0,10.0,10.0,13.0,9.0,13.0,9.0,8.0,8.0,6.0,11.0,13.0,10.0,10.0,12.0,8.0,8.0,8.0,11.0,10.0,13.0,10.0,20.0,13.0,6.0,9.0,9.0,7.0,10.0,14.0,14.0,13.0,10.0,10.0,10.0,14.0,20.0,12.0,11.0,10.0,10.0,7.0,6.0,13.0,17.0,12.0,10.0,12.0,12.0,8.0,10.0,2.0,19.0,0.0,0.0,0.0,0.0,168.0,64.0,3.0,2.0,4.0,1.0,2.0,2.0,1.0,1.0,1.0,1.0,3.0,9.0,11.0,13.0,10.0,11.0,8.0,4.0,10.0,3.0,4.0,11.0,10.0,4.0,12.0,8.0,11.0,11.0,9.0,8.0,10.0,10.0,12.0,11.0,6.0,9.0,9.0,10.0,9.0,14.0,11.0,10.0,7.0,11.0,12.0,14.0,20.0,11.0,10.0,11.0,12.0,9.0,8.0,11.0,10.0,11.0,9.0,11.0,8.0,7.0,8.0,10.0,32.0,0.0,0.0,0.0,0.0,183.0,77.0,2.0,2.0,3.0,2.0,1.0,2.0,2.0,1.0,2.0,2.0,3.0,13.0,14.0,12.0,11.0,14.0,14.0,10.0,13.0,8.0,6.0,13.0,14.0,5.0,14.0,7.0,12.0,11.0,13.0,13.0,13.0,13.0,12.0,12.0,9.0,12.0,8.0,14.0,13.0,11.0,12.0,13.0,11.0,20.0,11.0,11.0,8.0,14.0,13.0,13.0,7.0,12.0,8.0,8.0,6.0,14.0,12.0,12.0,14.0,13.0,13.0,7.0,23.0,0.0,0.0,7.0,3.0,181.0,71.0,2.0,2.0,2.0,2.0,2.0,2.0,4.0,2.0,3.0,3.0,2.0,7.0,12.0,12.0,14.0,13.0,7.0,11.0,11.0,7.0,6.0,11.0,15.0,7.0,12.0,12.0,13.0,16.0,12.0,12.0,10.0,11.0,6.0,12.0,7.0,14.0,9.0,12.0,16.0,13.0,14.0,13.0,9.0,8.0,14.0,12.0,20.0,12.0,12.0,12.0,10.0,12.0,8.0,10.0,19.0,10.0,10.0,10.0,11.0,11.0,12.0,6.0
3,0,20.0,0.0,0.0,3.0,0.0,193.0,80.0,10.0,12.0,12.0,9.0,11.0,11.0,13.0,15.0,13.0,7.0,12.0,7.0,1.0,1.0,2.0,8.0,11.0,1.0,2.0,1.0,2.0,11.0,2.0,1.0,8.0,4.0,14.0,14.0,11.0,9.0,11.0,12.0,12.0,2.0,15.0,1.0,13.0,11.0,6.0,12.0,13.0,15.0,16.0,20.0,15.0,10.0,6.0,13.0,14.0,12.0,11.0,11.0,10.0,1.0,11.0,9.0,12.0,12.0,13.0,10.0,10.0,1.0,26.0,1.0,0.0,0.0,0.0,185.0,80.0,3.0,1.0,3.0,3.0,3.0,3.0,2.0,3.0,4.0,2.0,1.0,5.0,9.0,11.0,8.0,11.0,6.0,12.0,8.0,10.0,15.0,11.0,12.0,14.0,12.0,16.0,12.0,17.0,14.0,9.0,9.0,10.0,15.0,13.0,9.0,7.0,10.0,8.0,12.0,15.0,13.0,17.0,14.0,8.0,13.0,18.0,20.0,13.0,14.0,11.0,12.0,11.0,4.0,10.0,12.0,12.0,13.0,10.0,10.0,8.0,7.0,14.0,19.0,0.0,0.0,0.0,0.0,190.0,75.0,2.0,1.0,1.0,3.0,4.0,3.0,3.0,1.0,2.0,1.0,2.0,4.0,6.0,6.0,6.0,9.0,5.0,11.0,9.0,6.0,11.0,7.0,4.0,11.0,8.0,13.0,11.0,11.0,7.0,7.0,12.0,7.0,18.0,4.0,10.0,5.0,9.0,9.0,11.0,14.0,15.0,13.0,13.0,12.0,15.0,13.0,20.0,11.0,10.0,10.0,13.0,9.0,10.0,10.0,19.0,10.0,13.0,10.0,11.0,7.0,17.0,6.0,27.0,0.0,0.0,0.0,0.0,181.0,79.0,3.0,1.0,3.0,1.0,3.0,1.0,1.0,2.0,3.0,3.0,3.0,5.0,12.0,10.0,5.0,10.0,6.0,11.0,7.0,8.0,12.0,9.0,7.0,12.0,11.0,13.0,13.0,14.0,13.0,12.0,9.0,9.0,13.0,9.0,7.0,8.0,13.0,13.0,13.0,15.0,12.0,13.0,10.0,5.0,13.0,13.0,20.0,15.0,14.0,15.0,13.0,7.0,6.0,10.0,8.0,13.0,13.0,13.0,14.0,14.0,14.0,5.0,32.0,23.0,0.0,0.0,0.0,178.0,77.0,3.0,2.0,3.0,1.0,3.0,1.0,3.0,2.0,1.0,3.0,1.0,9.0,12.0,12.0,6.0,13.0,12.0,10.0,10.0,10.0,13.0,12.0,7.0,14.0,13.0,15.0,14.0,13.0,13.0,10.0,10.0,12.0,5.0,12.0,11.0,12.0,13.0,14.0,14.0,14.0,13.0,12.0,9.0,20.0,14.0,14.0,10.0,13.0,12.0,13.0,6.0,14.0,6.0,10.0,13.0,5.0,11.0,8.0,10.0,14.0,9.0,15.0,20.0,0.0,0.0,0.0,0.0,190.0,80.0,2.0,2.0,1.0,4.0,2.0,2.0,3.0,4.0,2.0,2.0,1.0,12.0,12.0,10.0,9.0,11.0,7.0,12.0,8.0,12.0,10.0,10.0,9.0,12.0,11.0,13.0,11.0,13.0,11.0,12.0,8.0,11.0,11.0,7.0,8.0,10.0,10.0,13.0,12.0,13.0,12.0,12.0,15.0,20.0,13.0,14.0,6.0,13.0,14.0,12.0,6.0,10.0,5.0,13.0,16.0,13.0,9.0,12.0,10.0,10.0,11.0,4.0,24.0,0.0,0.0,0.0,0.0,174.0,68.0,3.0,1.0,3.0,1.0,1.0,2.0,1.0,3.0,1.0,1.0,1.0,13.0,12.0,12.0,10.0,13.0,13.0,8.0,13.0,10.0,6.0,14.0,12.0,7.0,13.0,9.0,13.0,11.0,13.0,11.0,13.0,13.0,12.0,11.0,7.0,12.0,9.0,12.0,12.0,14.0,13.0,12.0,8.0,8.0,14.0,12.0,20.0,13.0,10.0,13.0,10.0,13.0,7.0,12.0,14.0,14.0,15.0,9.0,11.0,13.0,12.0,8.0,31.0,0.0,0.0,0.0,0.0,180.0,74.0,3.0,2.0,3.0,1.0,2.0,3.0,2.0,1.0,4.0,3.0,3.0,12.0,12.0,10.0,9.0,13.0,14.0,11.0,13.0,6.0,10.0,14.0,15.0,13.0,13.0,15.0,14.0,17.0,12.0,14.0,13.0,13.0,15.0,7.0,13.0,10.0,13.0,18.0,15.0,9.0,11.0,14.0,10.0,10.0,13.0,12.0,20.0,15.0,14.0,14.0,13.0,15.0,8.0,7.0,19.0,13.0,13.0,13.0,13.0,13.0,12.0,9.0,27.0,0.0,0.0,11.0,1.0,174.0,72.0,2.0,3.0,4.0,1.0,1.0,4.0,3.0,3.0,3.0,3.0,1.0,10.0,13.0,14.0,8.0,14.0,7.0,6.0,11.0,5.0,6.0,13.0,10.0,5.0,14.0,7.0,12.0,10.0,10.0,12.0,9.0,12.0,12.0,12.0,4.0,14.0,6.0,9.0,13.0,16.0,14.0,10.0,6.0,9.0,13.0,16.0,20.0,12.0,9.0,14.0,6.0,11.0,7.0,10.0,10.0,13.0,12.0,11.0,14.0,14.0,16.0,8.0,26.0,0.0,0.0,15.0,6.0,182.0,80.0,1.0,4.0,1.0,3.0,1.0,3.0,3.0,1.0,2.0,1.0,3.0,5.0,9.0,11.0,12.0,10.0,9.0,13.0,10.0,5.0,4.0,9.0,13.0,6.0,12.0,9.0,12.0,12.0,12.0,12.0,11.0,12.0,12.0,13.0,8.0,13.0,10.0,12.0,12.0,16.0,15.0,12.0,12.0,7.0,14.0,16.0,20.0,12.0,15.0,12.0,6.0,12.0,7.0,10.0,11.0,11.0,13.0,8.0,12.0,14.0,14.0,7.0,28.0,0.0,0.0,2.0,2.0,182.0,79.0,1.0,1.0,2.0,2.0,3.0,1.0,2.0,3.0,1.0,2.0,2.0,8.0,11.0,14.0,12.0,14.0,11.0,12.0,13.0,6.0,4.0,11.0,13.0,5.0,14.0,11.0,12.0,13.0,10.0,12.0,11.0,11.0,15.0,13.0,7.0,14.0,7.0,12.0,14.0,15.0,14.0,14.0,12.0,8.0,15.0,14.0,20.0,15.0,14.0,12.0,11.0,15.0,8.0,8.0,16.0,15.0,12.0,11.0,14.0,13.0,12.0,8.0,32.0,0.0,0.0,1.0,0.0,184.0,72.0,11.0,11.0,13.0,10.0,13.0,8.0,12.0,14.0,10.0,15.0,10.0,3.0,3.0,3.0,6.0,8.0,7.0,12.0,2.0,2.0,3.0,7.0,3.0,6.0,8.0,10.0,13.0,14.0,11.0,13.0,7.0,11.0,14.0,6.0,11.0,1.0,11.0,12.0,8.0,10.0,12.0,14.0,12.0,20.0,16.0,9.0,5.0,12.0,11.0,14.0,10.0,14.0,8.0,1.0,11.0,15.0,12.0,12.0,13.0,11.0,11.0,9.0,33.0,24.0,1.0,3.0,0.0,193.0,90.0,1.0,2.0,2.0,2.0,3.0,2.0,3.0,1.0,3.0,2.0,3.0,3.0,6.0,8.0,8.0,11.0,10.0,17.0,8.0,5.0,13.0,10.0,7.0,14.0,11.0,14.0,14.0,16.0,11.0,10.0,9.0,10.0,14.0,7.0,13.0,7.0,13.0,14.0,11.0,9.0,10.0,15.0,15.0,7.0,13.0,10.0,20.0,10.0,13.0,10.0,13.0,15.0,9.0,8.0,12.0,15.0,13.0,11.0,15.0,12.0,13.0,7.0,27.0,0.0,0.0,0.0,0.0,169.0,60.0,3.0,2.0,1.0,3.0,3.0,2.0,1.0,3.0,3.0,2.0,2.0,11.0,11.0,13.0,9.0,13.0,12.0,8.0,10.0,4.0,5.0,14.0,8.0,5.0,13.0,12.0,9.0,9.0,10.0,10.0,10.0,9.0,16.0,13.0,4.0,14.0,8.0,11.0,8.0,16.0,16.0,9.0,9.0,5.0,13.0,15.0,20.0,11.0,11.0,10.0,8.0,7.0,5.0,11.0,14.0,10.0,12.0,11.0,12.0,10.0,13.0,8.0,16.0,0.0,0.0,0.0,0.0,177.0,0.0,3.0,2.0,1.0,1.0,3.0,3.0,2.0,2.0,2.0,1.0,3.0,1.0,3.0,2.0,2.0,4.0,1.0,3.0,1.0,6.0,9.0,2.0,1.0,9.0,6.0,14.0,4.0,5.0,5.0,3.0,2.0,5.0,4.0,5.0,7.0,4.0,8.0,4.0,3.0,10.0,7.0,13.0,7.0,15.0,13.0,9.0,20.0,5.0,8.0,7.0,11.0,5.0,8.0,8.0,11.0,11.0,5.0,14.0,20.0,7.0,12.0,5.0,24.0,0.0,0.0,0.0,0.0,178.0,77.0,2.0,1.0,3.0,2.0,1.0,3.0,3.0,3.0,1.0,3.0,2.0,5.0,10.0,8.0,5.0,9.0,6.0,11.0,8.0,12.0,11.0,8.0,6.0,12.0,9.0,11.0,11.0,13.0,11.0,12.0,7.0,11.0,15.0,9.0,6.0,9.0,11.0,12.0,14.0,16.0,12.0,14.0,10.0,5.0,15.0,15.0,20.0,14.0,13.0,14.0,11.0,13.0,5.0,8.0,17.0,12.0,14.0,14.0,14.0,14.0,14.0,6.0,26.0,0.0,0.0,0.0,0.0,184.0,76.0,2.0,3.0,1.0,3.0,1.0,1.0,3.0,1.0,3.0,2.0,2.0,10.0,12.0,14.0,12.0,14.0,12.0,11.0,13.0,11.0,13.0,14.0,13.0,12.0,15.0,14.0,13.0,12.0,11.0,11.0,13.0,14.0,14.0,12.0,13.0,12.0,11.0,11.0,14.0,15.0,14.0,13.0,10.0,5.0,14.0,14.0,20.0,14.0,14.0,14.0,7.0,16.0,6.0,8.0,19.0,14.0,14.0,14.0,14.0,14.0,14.0,6.0,22.0,0.0,0.0,0.0,0.0,188.0,79.0,1.0,2.0,2.0,3.0,2.0,2.0,3.0,4.0,3.0,2.0,1.0,8.0,10.0,11.0,7.0,11.0,8.0,10.0,8.0,7.0,8.0,10.0,10.0,11.0,11.0,11.0,12.0,13.0,11.0,10.0,8.0,11.0,10.0,8.0,8.0,12.0,10.0,12.0,15.0,13.0,12.0,14.0,14.0,20.0,13.0,12.0,8.0,14.0,14.0,12.0,10.0,6.0,8.0,15.0,11.0,11.0,11.0,11.0,11.0,10.0,12.0,6.0,28.0,0.0,0.0,0.0,0.0,181.0,75.0,4.0,2.0,1.0,3.0,3.0,3.0,2.0,2.0,2.0,2.0,2.0,13.0,12.0,12.0,9.0,12.0,13.0,7.0,11.0,7.0,7.0,13.0,5.0,7.0,13.0,9.0,13.0,3.0,12.0,11.0,12.0,12.0,3.0,12.0,14.0,12.0,9.0,12.0,13.0,13.0,13.0,10.0,11.0,20.0,13.0,12.0,6.0,13.0,9.0,13.0,6.0,13.0,8.0,10.0,20.0,12.0,14.0,11.0,13.0,10.0,11.0,4.0,25.0,1.0,1.0,0.0,0.0,182.0,70.0,2.0,1.0,2.0,3.0,3.0,2.0,2.0,4.0,1.0,3.0,2.0,9.0,7.0,13.0,13.0,12.0,6.0,13.0,12.0,8.0,8.0,10.0,14.0,6.0,11.0,13.0,10.0,13.0,12.0,12.0,10.0,12.0,13.0,8.0,9.0,14.0,8.0,11.0,12.0,14.0,13.0,14.0,11.0,8.0,13.0,14.0,20.0,13.0,13.0,12.0,6.0,12.0,6.0,11.0,14.0,11.0,10.0,11.0,10.0,9.0,19.0,5.0,18.0,0.0,0.0,0.0,0.0,184.0,71.0,2.0,3.0,2.0,3.0,1.0,2.0,1.0,3.0,2.0,1.0,3.0,8.0,10.0,14.0,10.0,12.0,8.0,5.0,10.0,3.0,5.0,12.0,7.0,6.0,13.0,8.0,8.0,8.0,11.0,8.0,11.0,14.0,12.0,10.0,11.0,10.0,9.0,9.0,13.0,14.0,13.0,5.0,10.0,10.0,13.0,14.0,20.0,12.0,8.0,10.0,8.0,10.0,4.0,10.0,11.0,12.0,11.0,12.0,13.0,11.0,13.0,6.0,24.0,0.0,0.0,4.0,0.0,181.0,79.0,1.0,3.0,2.0,2.0,1.0,1.0,1.0,2.0,2.0,2.0,1.0,4.0,6.0,10.0,11.0,11.0,7.0,12.0,10.0,5.0,5.0,7.0,13.0,3.0,10.0,9.0,12.0,12.0,11.0,10.0,6.0,10.0,8.0,9.0,5.0,11.0,5.0,9.0,12.0,15.0,13.0,13.0,11.0,5.0,11.0,14.0,20.0,13.0,14.0,11.0,9.0,12.0,13.0,5.0,19.0,11.0,9.0,9.0,7.0,14.0,14.0,13.0
0,2,27.0,0.0,0.0,0.0,0.0,185.0,81.0,13.0,11.0,11.0,9.0,11.0,11.0,12.0,13.0,11.0,14.0,8.0,4.0,1.0,1.0,2.0,9.0,8.0,7.0,2.0,2.0,1.0,8.0,5.0,1.0,8.0,10.0,12.0,15.0,12.0,12.0,8.0,11.0,14.0,6.0,11.0,2.0,11.0,12.0,6.0,12.0,13.0,14.0,13.0,5.0,14.0,10.0,20.0,12.0,13.0,12.0,10.0,13.0,10.0,1.0,10.0,14.0,14.0,12.0,13.0,14.0,11.0,7.0,29.0,0.0,0.0,0.0,0.0,185.0,84.0,3.0,2.0,2.0,2.0,1.0,3.0,1.0,2.0,1.0,3.0,1.0,3.0,6.0,6.0,7.0,10.0,5.0,14.0,5.0,4.0,14.0,9.0,7.0,13.0,9.0,13.0,13.0,14.0,12.0,13.0,8.0,12.0,14.0,8.0,16.0,8.0,12.0,13.0,15.0,11.0,11.0,15.0,12.0,5.0,14.0,12.0,20.0,14.0,16.0,13.0,12.0,10.0,7.0,7.0,7.0,12.0,13.0,13.0,14.0,13.0,12.0,8.0,33.0,24.0,1.0,3.0,0.0,193.0,90.0,1.0,2.0,2.0,2.0,3.0,2.0,3.0,1.0,3.0,2.0,3.0,3.0,6.0,8.0,8.0,11.0,10.0,17.0,8.0,5.0,13.0,10.0,7.0,14.0,11.0,14.0,14.0,16.0,11.0,10.0,9.0,10.0,14.0,7.0,13.0,7.0,13.0,14.0,11.0,9.0,10.0,15.0,15.0,7.0,13.0,10.0,20.0,10.0,13.0,10.0,13.0,15.0,9.0,8.0,12.0,15.0,13.0,11.0,15.0,12.0,13.0,7.0,27.0,0.0,0.0,0.0,0.0,169.0,60.0,3.0,2.0,1.0,3.0,3.0,2.0,1.0,3.0,3.0,2.0,2.0,11.0,11.0,13.0,9.0,13.0,12.0,8.0,10.0,4.0,5.0,14.0,8.0,5.0,13.0,12.0,9.0,9.0,10.0,10.0,10.0,9.0,16.0,13.0,4.0,14.0,8.0,11.0,8.0,16.0,16.0,9.0,9.0,5.0,13.0,15.0,20.0,11.0,11.0,10.0,8.0,7.0,5.0,11.0,14.0,10.0,12.0,11.0,12.0,10.0,13.0,8.0,24.0,0.0,0.0,0.0,0.0,178.0,77.0,2.0,1.0,3.0,2.0,1.0,3.0,3.0,3.0,1.0,3.0,2.0,5.0,10.0,8.0,5.0,9.0,6.0,11.0,8.0,12.0,11.0,8.0,6.0,12.0,9.0,11.0,11.0,13.0,11.0,12.0,7.0,11.0,15.0,9.0,6.0,9.0,11.0,12.0,14.0,16.0,12.0,14.0,10.0,5.0,15.0,15.0,20.0,14.0,13.0,14.0,11.0,13.0,5.0,8.0,17.0,12.0,14.0,14.0,14.0,14.0,14.0,6.0,30.0,0.0,0.0,0.0,0.0,178.0,79.0,1.0,2.0,2.0,3.0,2.0,2.0,1.0,2.0,1.0,2.0,1.0,11.0,13.0,9.0,6.0,11.0,11.0,12.0,11.0,10.0,12.0,12.0,7.0,13.0,11.0,15.0,13.0,15.0,11.0,12.0,10.0,12.0,13.0,12.0,15.0,10.0,12.0,16.0,15.0,14.0,12.0,13.0,9.0,5.0,13.0,12.0,20.0,15.0,14.0,14.0,14.0,13.0,9.0,14.0,18.0,12.0,15.0,14.0,14.0,14.0,14.0,6.0,29.0,0.0,0.0,0.0,0.0,181.0,69.0,1.0,3.0,1.0,4.0,1.0,2.0,2.0,3.0,4.0,3.0,2.0,4.0,6.0,7.0,8.0,12.0,8.0,12.0,12.0,7.0,11.0,12.0,13.0,13.0,11.0,15.0,13.0,14.0,13.0,14.0,8.0,12.0,15.0,7.0,10.0,7.0,13.0,15.0,17.0,12.0,12.0,14.0,10.0,8.0,13.0,11.0,20.0,14.0,11.0,14.0,15.0,14.0,9.0,8.0,9.0,13.0,14.0,12.0,13.0,10.0,10.0,6.0,26.0,0.0,0.0,0.0,0.0,184.0,76.0,2.0,3.0,1.0,3.0,1.0,1.0,3.0,1.0,3.0,2.0,2.0,10.0,12.0,14.0,12.0,14.0,12.0,11.0,13.0,11.0,13.0,14.0,13.0,12.0,15.0,14.0,13.0,12.0,11.0,11.0,13.0,14.0,14.0,12.0,13.0,12.0,11.0,11.0,14.0,15.0,14.0,13.0,10.0,5.0,14.0,14.0,20.0,14.0,14.0,14.0,7.0,16.0,6.0,8.0,19.0,14.0,14.0,14.0,14.0,14.0,14.0,6.0,24.0,0.0,0.0,4.0,0.0,181.0,79.0,1.0,3.0,2.0,2.0,1.0,1.0,1.0,2.0,2.0,2.0,1.0,4.0,6.0,10.0,11.0,11.0,7.0,12.0,10.0,5.0,5.0,7.0,13.0,3.0,10.0,9.0,12.0,12.0,11.0,10.0,6.0,10.0,8.0,9.0,5.0,11.0,5.0,9.0,12.0,15.0,13.0,13.0,11.0,5.0,11.0,14.0,20.0,13.0,14.0,11.0,9.0,12.0,13.0,5.0,19.0,11.0,9.0,9.0,7.0,14.0,14.0,13.0,18.0,0.0,0.0,0.0,0.0,183.0,70.0,1.0,2.0,2.0,1.0,1.0,2.0,2.0,1.0,2.0,1.0,3.0,10.0,11.0,12.0,7.0,11.0,9.0,10.0,9.0,10.0,5.0,10.0,8.0,5.0,12.0,9.0,10.0,10.0,9.0,8.0,9.0,9.0,11.0,10.0,7.0,12.0,6.0,11.0,12.0,14.0,12.0,10.0,11.0,6.0,12.0,13.0,20.0,11.0,9.0,12.0,10.0,3.0,9.0,10.0,17.0,12.0,12.0,13.0,11.0,12.0,12.0,2.0,25.0,1.0,1.0,0.0,0.0,182.0,70.0,2.0,1.0,2.0,3.0,3.0,2.0,2.0,4.0,1.0,3.0,2.0,9.0,7.0,13.0,13.0,12.0,6.0,13.0,12.0,8.0,8.0,10.0,14.0,6.0,11.0,13.0,10.0,13.0,12.0,12.0,10.0,12.0,13.0,8.0,9.0,14.0,8.0,11.0,12.0,14.0,13.0,14.0,11.0,8.0,13.0,14.0,20.0,13.0,13.0,12.0,6.0,12.0,6.0,11.0,14.0,11.0,10.0,11.0,10.0,9.0,19.0,5.0,26.0,2.0,0.0,1.0,0.0,188.0,84.0,12.0,13.0,15.0,9.0,15.0,13.0,13.0,15.0,10.0,11.0,14.0,9.0,2.0,1.0,2.0,12.0,11.0,3.0,2.0,3.0,3.0,11.0,3.0,1.0,10.0,14.0,13.0,14.0,10.0,13.0,11.0,11.0,14.0,3.0,11.0,5.0,12.0,15.0,13.0,10.0,12.0,13.0,14.0,5.0,14.0,9.0,20.0,12.0,14.0,12.0,10.0,15.0,3.0,11.0,12.0,11.0,16.0,13.0,15.0,16.0,16.0,4.0,29.0,0.0,0.0,0.0,0.0,183.0,74.0,3.0,3.0,3.0,3.0,3.0,2.0,2.0,2.0,1.0,3.0,1.0,5.0,12.0,7.0,6.0,10.0,7.0,14.0,12.0,5.0,14.0,12.0,6.0,13.0,11.0,14.0,13.0,17.0,13.0,16.0,12.0,12.0,13.0,9.0,8.0,9.0,14.0,14.0,15.0,13.0,12.0,15.0,12.0,6.0,17.0,11.0,20.0,17.0,13.0,14.0,14.0,15.0,5.0,13.0,9.0,14.0,19.0,15.0,14.0,11.0,11.0,6.0,32.0,0.0,0.0,0.0,0.0,183.0,79.0,1.0,1.0,1.0,3.0,1.0,3.0,1.0,1.0,2.0,1.0,1.0,5.0,10.0,6.0,6.0,9.0,6.0,15.0,7.0,11.0,14.0,10.0,7.0,13.0,10.0,13.0,15.0,15.0,15.0,14.0,9.0,13.0,16.0,6.0,14.0,8.0,12.0,13.0,16.0,11.0,12.0,16.0,11.0,8.0,16.0,12.0,20.0,15.0,14.0,14.0,11.0,12.0,5.0,15.0,18.0,15.0,14.0,13.0,17.0,14.0,14.0,5.0,19.0,1.0,0.0,0.0,0.0,182.0,67.0,1.0,3.0,2.0,1.0,2.0,3.0,1.0,1.0,2.0,1.0,1.0,7.0,7.0,8.0,4.0,10.0,7.0,9.0,9.0,7.0,14.0,9.0,7.0,13.0,9.0,9.0,10.0,8.0,9.0,8.0,9.0,14.0,2.0,7.0,12.0,7.0,8.0,8.0,12.0,12.0,10.0,9.0,11.0,5.0,13.0,8.0,20.0,11.0,8.0,9.0,5.0,4.0,9.0,9.0,10.0,12.0,13.0,9.0,10.0,13.0,12.0,3.0,21.0,0.0,0.0,0.0,0.0,172.0,68.0,3.0,3.0,1.0,2.0,1.0,2.0,3.0,2.0,2.0,3.0,2.0,12.0,13.0,12.0,8.0,12.0,12.0,5.0,8.0,12.0,11.0,13.0,8.0,13.0,12.0,14.0,13.0,14.0,13.0,13.0,10.0,11.0,15.0,9.0,13.0,13.0,12.0,13.0,14.0,12.0,12.0,12.0,6.0,20.0,13.0,13.0,13.0,13.0,11.0,12.0,10.0,10.0,11.0,9.0,20.0,13.0,15.0,12.0,16.0,13.0,13.0,8.0,27.0,0.0,0.0,0.0,0.0,188.0,77.0,1.0,4.0,1.0,1.0,3.0,1.0,2.0,1.0,2.0,2.0,2.0,4.0,7.0,8.0,7.0,13.0,6.0,15.0,9.0,6.0,13.0,12.0,6.0,12.0,11.0,14.0,14.0,15.0,10.0,12.0,11.0,13.0,16.0,7.0,12.0,9.0,12.0,15.0,16.0,14.0,10.0,14.0,15.0,9.0,13.0,12.0,20.0,14.0,16.0,12.0,14.0,13.0,6.0,12.0,4.0,13.0,18.0,13.0,14.0,14.0,13.0,7.0,30.0,4.0,0.0,0.0,0.0,192.0,78.0,1.0,3.0,1.0,2.0,2.0,3.0,1.0,3.0,1.0,1.0,3.0,4.0,6.0,7.0,8.0,11.0,6.0,15.0,8.0,6.0,13.0,11.0,6.0,14.0,11.0,17.0,14.0,16.0,12.0,14.0,10.0,12.0,17.0,8.0,8.0,11.0,13.0,15.0,16.0,14.0,12.0,18.0,14.0,6.0,14.0,12.0,20.0,17.0,16.0,14.0,17.0,13.0,9.0,11.0,8.0,13.0,10.0,13.0,12.0,10.0,10.0,5.0,25.0,0.0,0.0,3.0,2.0,170.0,61.0,2.0,3.0,2.0,2.0,1.0,3.0,2.0,2.0,1.0,2.0,1.0,11.0,12.0,13.0,10.0,13.0,8.0,5.0,8.0,7.0,4.0,14.0,10.0,4.0,15.0,11.0,10.0,9.0,7.0,10.0,14.0,8.0,13.0,13.0,6.0,12.0,8.0,8.0,12.0,16.0,14.0,7.0,5.0,12.0,15.0,16.0,20.0,14.0,6.0,12.0,11.0,13.0,8.0,8.0,8.0,13.0,15.0,10.0,10.0,14.0,14.0,8.0,20.0,0.0,0.0,2.0,0.0,180.0,75.0,3.0,1.0,2.0,2.0,3.0,2.0,1.0,1.0,3.0,3.0,1.0,8.0,13.0,14.0,9.0,13.0,8.0,10.0,9.0,6.0,5.0,12.0,6.0,5.0,14.0,8.0,13.0,12.0,13.0,12.0,12.0,12.0,7.0,13.0,8.0,14.0,7.0,12.0,13.0,15.0,13.0,14.0,10.0,8.0,14.0,15.0,20.0,13.0,12.0,13.0,11.0,9.0,7.0,13.0,9.0,11.0,11.0,11.0,12.0,11.0,10.0,1.0,30.0,5.0,0.0,22.0,9.0,181.0,84.0,2.0,3.0,3.0,1.0,2.0,3.0,3.0,1.0,3.0,1.0,3.0,7.0,10.0,12.0,13.0,11.0,7.0,13.0,10.0,12.0,6.0,11.0,13.0,6.0,13.0,17.0,13.0,16.0,11.0,13.0,11.0,11.0,17.0,14.0,8.0,14.0,9.0,13.0,17.0,15.0,12.0,15.0,11.0,8.0,14.0,15.0,20.0,14.0,14.0,13.0,9.0,13.0,7.0,10.0,7.0,16.0,13.0,14.0,13.0,15.0,15.0,10.0,25.0,0.0,0.0,0.0,0.0,176.0,74.0,2.0,2.0,1.0,3.0,2.0,2.0,2.0,4.0,3.0,3.0,3.0,12.0,12.0,14.0,12.0,14.0,13.0,7.0,12.0,6.0,3.0,12.0,12.0,3.0,15.0,9.0,10.0,8.0,12.0,11.0,12.0,10.0,10.0,14.0,5.0,13.0,4.0,6.0,8.0,17.0,15.0,12.0,8.0,20.0,12.0,14.0,8.0,13.0,12.0,11.0,9.0,14.0,10.0,8.0,8.0,14.0,12.0,7.0,10.0,11.0,11.0,9.0
1,1,25.0,4.0,0.0,11.0,0.0,184.0,81.0,14.0,14.0,13.0,9.0,15.0,12.0,16.0,16.0,13.0,7.0,11.0,8.0,1.0,2.0,1.0,11.0,12.0,6.0,1.0,3.0,3.0,11.0,5.0,3.0,11.0,8.0,15.0,15.0,13.0,14.0,10.0,11.0,14.0,8.0,13.0,5.0,13.0,10.0,10.0,14.0,16.0,14.0,13.0,20.0,14.0,12.0,5.0,14.0,14.0,15.0,9.0,16.0,6.0,1.0,17.0,11.0,15.0,13.0,14.0,12.0,12.0,4.0,27.0,0.0,0.0,0.0,0.0,184.0,81.0,1.0,1.0,1.0,3.0,3.0,2.0,2.0,2.0,1.0,2.0,3.0,8.0,6.0,8.0,12.0,10.0,8.0,12.0,9.0,1.0,3.0,8.0,14.0,4.0,9.0,4.0,11.0,12.0,11.0,8.0,8.0,11.0,10.0,9.0,8.0,11.0,9.0,8.0,11.0,10.0,8.0,13.0,13.0,9.0,13.0,9.0,20.0,12.0,13.0,13.0,9.0,2.0,9.0,9.0,15.0,10.0,12.0,10.0,11.0,6.0,4.0,6.0,32.0,0.0,0.0,0.0,0.0,172.0,71.0,2.0,1.0,3.0,1.0,2.0,3.0,2.0,3.0,2.0,2.0,2.0,8.0,9.0,7.0,6.0,10.0,6.0,10.0,9.0,10.0,14.0,11.0,6.0,14.0,11.0,10.0,16.0,15.0,12.0,12.0,7.0,12.0,15.0,9.0,13.0,8.0,14.0,15.0,15.0,14.0,14.0,14.0,10.0,20.0,14.0,14.0,8.0,15.0,13.0,13.0,11.0,13.0,7.0,13.0,17.0,14.0,17.0,8.0,13.0,15.0,15.0,6.0,19.0,0.0,0.0,3.0,1.0,181.0,69.0,3.0,2.0,3.0,3.0,2.0,1.0,1.0,1.0,3.0,3.0,4.0,10.0,10.0,12.0,12.0,12.0,7.0,8.0,11.0,5.0,7.0,10.0,10.0,7.0,11.0,8.0,10.0,10.0,12.0,8.0,11.0,8.0,14.0,13.0,6.0,14.0,8.0,13.0,13.0,16.0,14.0,13.0,9.0,20.0,15.0,16.0,10.0,15.0,13.0,12.0,8.0,11.0,7.0,12.0,11.0,11.0,15.0,10.0,12.0,14.0,14.0,1.0,37.0,0.0,0.0,0.0,0.0,185.0,83.0,1.0,1.0,2.0,1.0,3.0,2.0,3.0,1.0,1.0,3.0,1.0,6.0,8.0,9.0,12.0,10.0,8.0,13.0,9.0,4.0,5.0,10.0,14.0,4.0,11.0,11.0,10.0,11.0,13.0,12.0,12.0,13.0,15.0,14.0,12.0,11.0,7.0,12.0,8.0,7.0,7.0,12.0,12.0,11.0,11.0,7.0,20.0,8.0,14.0,12.0,8.0,13.0,9.0,12.0,12.0,12.0,19.0,14.0,15.0,14.0,8.0,8.0,27.0,0.0,0.0,0.0,0.0,178.0,72.0,2.0,3.0,2.0,3.0,2.0,3.0,3.0,1.0,1.0,2.0,1.0,13.0,14.0,11.0,7.0,12.0,10.0,9.0,10.0,13.0,13.0,12.0,10.0,14.0,13.0,12.0,14.0,14.0,13.0,14.0,11.0,12.0,14.0,13.0,8.0,14.0,13.0,13.0,15.0,15.0,13.0,10.0,10.0,20.0,13.0,15.0,6.0,14.0,10.0,13.0,13.0,12.0,8.0,12.0,15.0,14.0,13.0,14.0,13.0,13.0,12.0,6.0,19.0,0.0,0.0,0.0,0.0,185.0,82.0,4.0,2.0,3.0,1.0,3.0,2.0,1.0,2.0,1.0,2.0,3.0,7.0,7.0,10.0,6.0,13.0,7.0,14.0,7.0,6.0,12.0,13.0,7.0,13.0,13.0,13.0,13.0,13.0,11.0,12.0,11.0,12.0,14.0,9.0,14.0,11.0,11.0,15.0,15.0,12.0,12.0,14.0,13.0,5.0,14.0,12.0,20.0,14.0,13.0,10.0,11.0,11.0,6.0,10.0,10.0,12.0,12.0,14.0,14.0,11.0,16.0,6.0,18.0,0.0,0.0,0.0,0.0,170.0,67.0,3.0,1.0,3.0,3.0,3.0,4.0,1.0,2.0,1.0,2.0,2.0,11.0,11.0,12.0,13.0,12.0,11.0,6.0,10.0,8.0,7.0,12.0,10.0,7.0,13.0,9.0,11.0,8.0,10.0,10.0,12.0,12.0,15.0,12.0,12.0,11.0,12.0,11.0,12.0,12.0,12.0,10.0,6.0,5.0,14.0,12.0,20.0,10.0,9.0,10.0,8.0,2.0,6.0,12.0,11.0,11.0,12.0,13.0,14.0,11.0,13.0,4.0,22.0,24.0,3.0,7.0,0.0,177.0,78.0,2.0,1.0,2.0,3.0,2.0,2.0,4.0,3.0,3.0,2.0,1.0,10.0,13.0,16.0,14.0,16.0,16.0,8.0,16.0,4.0,4.0,15.0,12.0,4.0,16.0,12.0,11.0,12.0,13.0,10.0,11.0,8.0,13.0,17.0,5.0,14.0,5.0,10.0,12.0,15.0,14.0,13.0,9.0,10.0,17.0,16.0,20.0,15.0,14.0,12.0,11.0,15.0,4.0,12.0,19.0,16.0,14.0,14.0,11.0,13.0,10.0,12.0,17.0,0.0,0.0,0.0,0.0,175.0,0.0,1.0,1.0,2.0,2.0,3.0,3.0,2.0,3.0,4.0,1.0,1.0,8.0,8.0,11.0,11.0,10.0,8.0,15.0,9.0,5.0,8.0,9.0,5.0,3.0,11.0,8.0,11.0,9.0,8.0,7.0,11.0,10.0,13.0,9.0,11.0,11.0,5.0,8.0,9.0,15.0,11.0,9.0,5.0,8.0,12.0,12.0,20.0,9.0,7.0,8.0,6.0,5.0,9.0,8.0,14.0,10.0,10.0,11.0,11.0,9.0,15.0,8.0,22.0,5.0,1.0,1.0,0.0,173.0,72.0,1.0,3.0,1.0,3.0,3.0,3.0,3.0,3.0,3.0,2.0,2.0,14.0,13.0,16.0,14.0,16.0,14.0,5.0,11.0,5.0,5.0,15.0,11.0,5.0,16.0,8.0,13.0,9.0,14.0,13.0,15.0,13.0,15.0,16.0,5.0,13.0,5.0,9.0,10.0,15.0,16.0,14.0,5.0,20.0,14.0,15.0,5.0,12.0,14.0,13.0,11.0,13.0,8.0,14.0,10.0,15.0,14.0,10.0,13.0,10.0,10.0,13.0,33.0,0.0,0.0,3.0,0.0,188.0,84.0,14.0,13.0,13.0,9.0,13.0,13.0,15.0,15.0,11.0,11.0,9.0,7.0,3.0,3.0,1.0,7.0,10.0,2.0,1.0,1.0,2.0,6.0,4.0,1.0,7.0,8.0,13.0,14.0,14.0,14.0,8.0,11.0,15.0,6.0,13.0,3.0,13.0,12.0,8.0,12.0,14.0,15.0,14.0,8.0,13.0,11.0,20.0,13.0,15.0,16.0,8.0,13.0,6.0,1.0,11.0,14.0,13.0,11.0,16.0,14.0,11.0,6.0,28.0,0.0,0.0,0.0,0.0,193.0,84.0,1.0,1.0,2.0,2.0,2.0,3.0,2.0,3.0,2.0,1.0,3.0,4.0,8.0,8.0,9.0,10.0,6.0,14.0,7.0,8.0,14.0,12.0,6.0,14.0,11.0,12.0,13.0,14.0,11.0,14.0,12.0,12.0,14.0,6.0,11.0,8.0,14.0,13.0,13.0,11.0,11.0,16.0,16.0,20.0,12.0,12.0,8.0,14.0,16.0,14.0,12.0,13.0,6.0,10.0,7.0,12.0,15.0,12.0,16.0,15.0,13.0,6.0,29.0,2.0,0.0,0.0,0.0,185.0,75.0,2.0,3.0,3.0,3.0,2.0,3.0,2.0,1.0,3.0,1.0,2.0,4.0,10.0,8.0,6.0,10.0,6.0,14.0,7.0,7.0,14.0,11.0,6.0,14.0,9.0,13.0,13.0,14.0,11.0,12.0,12.0,12.0,14.0,8.0,11.0,12.0,13.0,13.0,13.0,15.0,12.0,15.0,12.0,8.0,15.0,13.0,20.0,14.0,15.0,14.0,7.0,14.0,8.0,6.0,14.0,13.0,15.0,14.0,14.0,14.0,14.0,6.0,26.0,0.0,0.0,0.0,0.0,182.0,68.0,1.0,4.0,3.0,2.0,3.0,1.0,2.0,1.0,2.0,4.0,1.0,7.0,12.0,9.0,5.0,10.0,6.0,12.0,7.0,15.0,12.0,9.0,6.0,12.0,10.0,12.0,13.0,14.0,11.0,10.0,9.0,9.0,13.0,7.0,6.0,10.0,10.0,14.0,15.0,16.0,13.0,13.0,11.0,5.0,15.0,15.0,20.0,14.0,10.0,12.0,12.0,13.0,7.0,12.0,12.0,14.0,14.0,15.0,13.0,14.0,14.0,7.0,26.0,0.0,0.0,0.0,0.0,175.0,69.0,3.0,3.0,2.0,2.0,3.0,1.0,3.0,1.0,3.0,2.0,2.0,6.0,12.0,10.0,5.0,11.0,6.0,10.0,10.0,10.0,13.0,12.0,9.0,13.0,12.0,12.0,13.0,14.0,12.0,13.0,12.0,11.0,15.0,11.0,13.0,12.0,13.0,14.0,14.0,15.0,13.0,12.0,7.0,9.0,13.0,13.0,20.0,14.0,11.0,14.0,12.0,12.0,11.0,15.0,14.0,9.0,17.0,10.0,8.0,11.0,20.0,7.0,29.0,0.0,0.0,0.0,0.0,183.0,78.0,1.0,3.0,3.0,3.0,3.0,1.0,2.0,3.0,3.0,1.0,1.0,13.0,8.0,9.0,6.0,12.0,14.0,13.0,10.0,12.0,11.0,12.0,8.0,13.0,12.0,12.0,15.0,13.0,13.0,13.0,11.0,13.0,15.0,6.0,12.0,7.0,13.0,16.0,18.0,12.0,11.0,14.0,12.0,20.0,14.0,11.0,8.0,16.0,14.0,14.0,12.0,14.0,6.0,12.0,10.0,12.0,13.0,11.0,15.0,15.0,15.0,5.0,21.0,0.0,0.0,0.0,0.0,183.0,73.0,1.0,4.0,3.0,3.0,3.0,1.0,4.0,1.0,2.0,3.0,2.0,11.0,10.0,12.0,11.0,13.0,9.0,12.0,10.0,5.0,8.0,12.0,9.0,8.0,13.0,13.0,12.0,12.0,10.0,12.0,14.0,12.0,12.0,14.0,8.0,12.0,8.0,12.0,12.0,14.0,14.0,14.0,11.0,8.0,13.0,13.0,20.0,12.0,12.0,12.0,5.0,10.0,7.0,12.0,15.0,11.0,11.0,10.0,11.0,12.0,11.0,4.0,19.0,0.0,0.0,0.0,0.0,185.0,80.0,3.0,2.0,2.0,3.0,3.0,4.0,3.0,3.0,3.0,2.0,1.0,8.0,12.0,13.0,8.0,12.0,13.0,12.0,9.0,6.0,12.0,13.0,9.0,13.0,12.0,12.0,13.0,12.0,12.0,10.0,12.0,12.0,4.0,13.0,8.0,12.0,8.0,12.0,14.0,13.0,14.0,12.0,11.0,5.0,15.0,14.0,20.0,13.0,13.0,12.0,10.0,9.0,11.0,15.0,15.0,9.0,10.0,9.0,12.0,11.0,10.0,5.0,29.0,0.0,0.0,0.0,0.0,180.0,71.0,1.0,3.0,1.0,1.0,1.0,4.0,4.0,1.0,1.0,2.0,3.0,10.0,11.0,12.0,9.0,13.0,11.0,8.0,14.0,6.0,8.0,11.0,10.0,8.0,12.0,10.0,11.0,12.0,12.0,9.0,12.0,11.0,14.0,12.0,7.0,12.0,10.0,12.0,14.0,15.0,14.0,12.0,10.0,20.0,16.0,13.0,12.0,15.0,10.0,13.0,10.0,15.0,7.0,8.0,16.0,12.0,12.0,13.0,14.0,15.0,15.0,6.0,23.0,0.0,0.0,0.0,0.0,175.0,70.0,2.0,1.0,2.0,2.0,1.0,2.0,2.0,3.0,4.0,1.0,2.0,10.0,11.0,12.0,9.0,13.0,8.0,6.0,13.0,2.0,5.0,13.0,10.0,6.0,13.0,7.0,13.0,9.0,13.0,11.0,13.0,12.0,13.0,12.0,10.0,12.0,10.0,13.0,12.0,11.0,12.0,13.0,8.0,8.0,14.0,12.0,20.0,14.0,12.0,13.0,9.0,11.0,10.0,11.0,19.0,12.0,14.0,11.0,13.0,10.0,16.0,7.0,23.0,1.0,0.0,0.0,0.0,185.0,70.0,4.0,3.0,1.0,2.0,1.0,3.0,2.0,3.0,1.0,2.0,3.0,5.0,8.0,12.0,13.0,13.0,7.0,14.0,11.0,5.0,5.0,8.0,13.0,5.0,13.0,6.0,13.0,10.0,12.0,12.0,11.0,11.0,13.0,12.0,7.0,13.0,9.0,8.0,10.0,16.0,12.0,14.0,12.0,8.0,14.0,15.0,20.0,13.0,13.0,12.0,7.0,15.0,7.0,7.0,13.0,13.0,12.0,10.0,12.0,15.0,15.0,7.0
3,1,33.0,0.0,0.0,3.0,0.0,188.0,84.0,14.0,13.0,13.0,9.0,13.0,13.0,15.0,15.0,11.0,11.0,9.0,7.0,3.0,3.0,1.0,7.0,10.0,2.0,1.0,1.0,2.0,6.0,4.0,1.0,7.0,8.0,13.0,14.0,14.0,14.0,8.0,11.0,15.0,6.0,13.0,3.0,13.0,12.0,8.0,12.0,14.0,15.0,14.0,8.0,13.0,11.0,20.0,13.0,15.0,16.0,8.0,13.0,6.0,1.0,11.0,14.0,13.0,11.0,16.0,14.0,11.0,6.0,28.0,0.0,0.0,0.0,0.0,193.0,84.0,1.0,1.0,2.0,2.0,2.0,3.0,2.0,3.0,2.0,1.0,3.0,4.0,8.0,8.0,9.0,10.0,6.0,14.0,7.0,8.0,14.0,12.0,6.0,14.0,11.0,12.0,13.0,14.0,11.0,14.0,12.0,12.0,14.0,6.0,11.0,8.0,14.0,13.0,13.0,11.0,11.0,16.0,16.0,20.0,12.0,12.0,8.0,14.0,16.0,14.0,12.0,13.0,6.0,10.0,7.0,12.0,15.0,12.0,16.0,15.0,13.0,6.0,29.0,2.0,0.0,0.0,0.0,185.0,75.0,2.0,3.0,3.0,3.0,2.0,3.0,2.0,1.0,3.0,1.0,2.0,4.0,10.0,8.0,6.0,10.0,6.0,14.0,7.0,7.0,14.0,11.0,6.0,14.0,9.0,13.0,13.0,14.0,11.0,12.0,12.0,12.0,14.0,8.0,11.0,12.0,13.0,13.0,13.0,15.0,12.0,15.0,12.0,8.0,15.0,13.0,20.0,14.0,15.0,14.0,7.0,14.0,8.0,6.0,14.0,13.0,15.0,14.0,14.0,14.0,14.0,6.0,26.0,0.0,0.0,0.0,0.0,182.0,68.0,1.0,4.0,3.0,2.0,3.0,1.0,2.0,1.0,2.0,4.0,1.0,7.0,12.0,9.0,5.0,10.0,6.0,12.0,7.0,15.0,12.0,9.0,6.0,12.0,10.0,12.0,13.0,14.0,11.0,10.0,9.0,9.0,13.0,7.0,6.0,10.0,10.0,14.0,15.0,16.0,13.0,13.0,11.0,5.0,15.0,15.0,20.0,14.0,10.0,12.0,12.0,13.0,7.0,12.0,12.0,14.0,14.0,15.0,13.0,14.0,14.0,7.0,26.0,0.0,0.0,0.0,0.0,175.0,69.0,3.0,3.0,2.0,2.0,3.0,1.0,3.0,1.0,3.0,2.0,2.0,6.0,12.0,10.0,5.0,11.0,6.0,10.0,10.0,10.0,13.0,12.0,9.0,13.0,12.0,12.0,13.0,14.0,12.0,13.0,12.0,11.0,15.0,11.0,13.0,12.0,13.0,14.0,14.0,15.0,13.0,12.0,7.0,9.0,13.0,13.0,20.0,14.0,11.0,14.0,12.0,12.0,11.0,15.0,14.0,9.0,17.0,10.0,8.0,11.0,20.0,7.0,27.0,32.0,6.0,0.0,0.0,188.0,78.0,3.0,2.0,3.0,2.0,1.0,3.0,3.0,3.0,2.0,2.0,2.0,4.0,8.0,11.0,12.0,12.0,6.0,16.0,13.0,8.0,13.0,14.0,7.0,12.0,12.0,12.0,10.0,14.0,13.0,12.0,11.0,12.0,15.0,9.0,11.0,12.0,6.0,13.0,12.0,14.0,13.0,15.0,15.0,5.0,13.0,12.0,20.0,16.0,15.0,14.0,12.0,15.0,11.0,10.0,9.0,15.0,12.0,12.0,13.0,13.0,13.0,7.0,21.0,0.0,0.0,0.0,0.0,183.0,73.0,1.0,4.0,3.0,3.0,3.0,1.0,4.0,1.0,2.0,3.0,2.0,11.0,10.0,12.0,11.0,13.0,9.0,12.0,10.0,5.0,8.0,12.0,9.0,8.0,13.0,13.0,12.0,12.0,10.0,12.0,14.0,12.0,12.0,14.0,8.0,12.0,8.0,12.0,12.0,14.0,14.0,14.0,11.0,8.0,13.0,13.0,20.0,12.0,12.0,12.0,5.0,10.0,7.0,12.0,15.0,11.0,11.0,10.0,11.0,12.0,11.0,4.0,29.0,0.0,0.0,0.0,0.0,183.0,78.0,1.0,3.0,3.0,3.0,3.0,1.0,2.0,3.0,3.0,1.0,1.0,13.0,8.0,9.0,6.0,12.0,14.0,13.0,10.0,12.0,11.0,12.0,8.0,13.0,12.0,12.0,15.0,13.0,13.0,13.0,11.0,13.0,15.0,6.0,12.0,7.0,13.0,16.0,18.0,12.0,11.0,14.0,12.0,20.0,14.0,11.0,8.0,16.0,14.0,14.0,12.0,14.0,6.0,12.0,10.0,12.0,13.0,11.0,15.0,15.0,15.0,5.0,19.0,0.0,0.0,0.0,0.0,185.0,80.0,3.0,2.0,2.0,3.0,3.0,4.0,3.0,3.0,3.0,2.0,1.0,8.0,12.0,13.0,8.0,12.0,13.0,12.0,9.0,6.0,12.0,13.0,9.0,13.0,12.0,12.0,13.0,12.0,12.0,10.0,12.0,12.0,4.0,13.0,8.0,12.0,8.0,12.0,14.0,13.0,14.0,12.0,11.0,5.0,15.0,14.0,20.0,13.0,13.0,12.0,10.0,9.0,11.0,15.0,15.0,9.0,10.0,9.0,12.0,11.0,10.0,5.0,29.0,0.0,0.0,0.0,0.0,180.0,71.0,1.0,3.0,1.0,1.0,1.0,4.0,4.0,1.0,1.0,2.0,3.0,10.0,11.0,12.0,9.0,13.0,11.0,8.0,14.0,6.0,8.0,11.0,10.0,8.0,12.0,10.0,11.0,12.0,12.0,9.0,12.0,11.0,14.0,12.0,7.0,12.0,10.0,12.0,14.0,15.0,14.0,12.0,10.0,20.0,16.0,13.0,12.0,15.0,10.0,13.0,10.0,15.0,7.0,8.0,16.0,12.0,12.0,13.0,14.0,15.0,15.0,6.0,23.0,1.0,0.0,0.0,0.0,185.0,70.0,4.0,3.0,1.0,2.0,1.0,3.0,2.0,3.0,1.0,2.0,3.0,5.0,8.0,12.0,13.0,13.0,7.0,14.0,11.0,5.0,5.0,8.0,13.0,5.0,13.0,6.0,13.0,10.0,12.0,12.0,11.0,11.0,13.0,12.0,7.0,13.0,9.0,8.0,10.0,16.0,12.0,14.0,12.0,8.0,14.0,15.0,20.0,13.0,13.0,12.0,7.0,15.0,7.0,7.0,13.0,13.0,12.0,10.0,12.0,15.0,15.0,7.0,26.0,11.0,0.0,0.0,0.0,198.0,88.0,13.0,11.0,10.0,8.0,12.0,10.0,14.0,15.0,11.0,13.0,9.0,3.0,3.0,3.0,6.0,6.0,6.0,12.0,12.0,2.0,1.0,8.0,6.0,1.0,6.0,9.0,12.0,14.0,12.0,12.0,11.0,11.0,12.0,6.0,9.0,2.0,13.0,12.0,8.0,12.0,13.0,18.0,17.0,5.0,16.0,9.0,20.0,15.0,15.0,11.0,9.0,12.0,5.0,1.0,16.0,14.0,16.0,13.0,12.0,15.0,15.0,7.0,32.0,67.0,9.0,7.0,0.0,191.0,85.0,1.0,1.0,1.0,3.0,2.0,2.0,4.0,3.0,3.0,2.0,3.0,7.0,7.0,6.0,9.0,12.0,3.0,16.0,7.0,3.0,15.0,11.0,7.0,13.0,12.0,14.0,11.0,14.0,10.0,11.0,10.0,14.0,11.0,8.0,13.0,13.0,13.0,13.0,15.0,9.0,7.0,14.0,16.0,8.0,7.0,10.0,20.0,12.0,15.0,13.0,14.0,5.0,6.0,11.0,8.0,11.0,9.0,12.0,11.0,6.0,9.0,11.0,24.0,0.0,0.0,0.0,0.0,185.0,70.0,3.0,2.0,3.0,2.0,2.0,1.0,2.0,1.0,1.0,2.0,3.0,5.0,6.0,9.0,7.0,11.0,8.0,15.0,12.0,7.0,14.0,13.0,7.0,11.0,11.0,11.0,14.0,14.0,13.0,9.0,9.0,12.0,4.0,8.0,5.0,10.0,12.0,15.0,12.0,11.0,11.0,14.0,13.0,6.0,15.0,11.0,20.0,13.0,14.0,13.0,9.0,11.0,7.0,10.0,15.0,11.0,13.0,11.0,10.0,9.0,14.0,4.0,24.0,0.0,0.0,0.0,0.0,175.0,72.0,3.0,2.0,4.0,3.0,2.0,4.0,1.0,1.0,1.0,2.0,2.0,8.0,12.0,12.0,6.0,11.0,7.0,10.0,9.0,12.0,11.0,12.0,8.0,12.0,11.0,11.0,12.0,13.0,10.0,10.0,9.0,9.0,3.0,9.0,9.0,11.0,12.0,11.0,11.0,14.0,13.0,11.0,8.0,20.0,12.0,13.0,6.0,12.0,11.0,10.0,10.0,10.0,9.0,10.0,10.0,13.0,10.0,11.0,10.0,13.0,18.0,1.0,24.0,0.0,0.0,0.0,0.0,183.0,78.0,2.0,3.0,1.0,3.0,2.0,1.0,1.0,1.0,1.0,3.0,3.0,5.0,10.0,9.0,5.0,12.0,11.0,12.0,11.0,8.0,13.0,13.0,11.0,14.0,10.0,15.0,14.0,14.0,13.0,15.0,10.0,14.0,14.0,6.0,6.0,9.0,14.0,13.0,14.0,12.0,12.0,14.0,11.0,5.0,15.0,11.0,20.0,14.0,14.0,14.0,13.0,12.0,7.0,10.0,12.0,13.0,16.0,13.0,15.0,15.0,15.0,5.0,29.0,0.0,0.0,0.0,0.0,188.0,74.0,1.0,2.0,3.0,3.0,2.0,3.0,1.0,3.0,2.0,1.0,1.0,4.0,8.0,10.0,6.0,13.0,7.0,14.0,9.0,6.0,13.0,12.0,8.0,13.0,13.0,12.0,14.0,13.0,14.0,11.0,13.0,12.0,14.0,6.0,13.0,8.0,14.0,15.0,15.0,9.0,12.0,14.0,14.0,10.0,13.0,10.0,20.0,16.0,12.0,13.0,12.0,15.0,9.0,11.0,11.0,14.0,14.0,12.0,15.0,13.0,13.0,6.0,26.0,0.0,0.0,0.0,0.0,178.0,74.0,2.0,3.0,1.0,3.0,3.0,3.0,2.0,2.0,3.0,1.0,3.0,14.0,12.0,12.0,10.0,13.0,14.0,9.0,12.0,5.0,6.0,12.0,8.0,8.0,13.0,11.0,11.0,12.0,10.0,11.0,12.0,13.0,15.0,12.0,8.0,11.0,12.0,12.0,15.0,14.0,15.0,15.0,10.0,5.0,13.0,13.0,20.0,14.0,13.0,13.0,13.0,14.0,8.0,6.0,14.0,13.0,12.0,11.0,13.0,12.0,16.0,7.0,19.0,0.0,0.0,0.0,0.0,168.0,64.0,3.0,2.0,4.0,1.0,2.0,2.0,1.0,1.0,1.0,1.0,3.0,9.0,11.0,13.0,10.0,11.0,8.0,4.0,10.0,3.0,4.0,11.0,10.0,4.0,12.0,8.0,11.0,11.0,9.0,8.0,10.0,10.0,12.0,11.0,6.0,9.0,9.0,10.0,9.0,14.0,11.0,10.0,7.0,11.0,12.0,14.0,20.0,11.0,10.0,11.0,12.0,9.0,8.0,11.0,10.0,11.0,9.0,11.0,8.0,7.0,8.0,10.0,24.0,0.0,0.0,0.0,0.0,169.0,65.0,3.0,3.0,2.0,1.0,2.0,4.0,1.0,3.0,4.0,3.0,2.0,11.0,12.0,12.0,7.0,12.0,9.0,5.0,10.0,7.0,3.0,11.0,12.0,5.0,13.0,7.0,10.0,9.0,12.0,9.0,12.0,10.0,4.0,11.0,6.0,12.0,6.0,12.0,14.0,16.0,14.0,11.0,6.0,20.0,14.0,15.0,5.0,14.0,7.0,12.0,7.0,14.0,6.0,8.0,16.0,13.0,16.0,12.0,12.0,10.0,15.0,6.0,21.0,0.0,0.0,0.0,0.0,180.0,68.0,4.0,1.0,1.0,1.0,1.0,3.0,1.0,2.0,2.0,2.0,3.0,10.0,10.0,13.0,9.0,13.0,9.0,8.0,8.0,6.0,11.0,13.0,10.0,10.0,12.0,8.0,8.0,8.0,11.0,10.0,13.0,10.0,20.0,13.0,6.0,9.0,9.0,7.0,10.0,14.0,14.0,13.0,10.0,10.0,10.0,14.0,20.0,12.0,11.0,10.0,10.0,7.0,6.0,13.0,17.0,12.0,10.0,12.0,12.0,8.0,10.0,2.0,23.0,0.0,0.0,7.0,3.0,181.0,71.0,2.0,2.0,2.0,2.0,2.0,2.0,4.0,2.0,3.0,3.0,2.0,7.0,12.0,12.0,14.0,13.0,7.0,11.0,11.0,7.0,6.0,11.0,15.0,7.0,12.0,12.0,13.0,16.0,12.0,12.0,10.0,11.0,6.0,12.0,7.0,14.0,9.0,12.0,16.0,13.0,14.0,13.0,9.0,8.0,14.0,12.0,20.0,12.0,12.0,12.0,10.0,12.0,8.0,10.0,19.0,10.0,10.0,10.0,11.0,11.0,12.0,6.0
0,2,26.0,2.0,0.0,1.0,0.0,188.0,84.0,12.0,13.0,15.0,9.0,15.0,13.0,13.0,15.0,10.0,11.0,14.0,9.0,2.0,1.0,2.0,12.0,11.0,3.0,2.0,3.0,3.0,11.0,3.0,1.0,10.0,14.0,13.0,14.0,10.0,13.0,11.0,11.0,14.0,3.0,11.0,5.0,12.0,15.0,13.0,10.0,12.0,13.0,14.0,5.0,14.0,9.0,20.0,12.0,14.0,12.0,10.0,15.0,3.0,11.0,12.0,11.0,16.0,13.0,15.0,16.0,16.0,4.0,29.0,0.0,0.0,0.0,0.0,183.0,74.0,3.0,3.0,3.0,3.0,3.0,2.0,2.0,2.0,1.0,3.0,1.0,5.0,12.0,7.0,6.0,10.0,7.0,14.0,12.0,5.0,14.0,12.0,6.0,13.0,11.0,14.0,13.0,17.0,13.0,16.0,12.0,12.0,13.0,9.0,8.0,9.0,14.0,14.0,15.0,13.0,12.0,15.0,12.0,6.0,17.0,11.0,20.0,17.0,13.0,14.0,14.0,15.0,5.0,13.0,9.0,14.0,19.0,15.0,14.0,11.0,11.0,6.0,32.0,0.0,0.0,0.0,0.0,183.0,79.0,1.0,1.0,1.0,3.0,1.0,3.0,1.0,1.0,2.0,1.0,1.0,5.0,10.0,6.0,6.0,9.0,6.0,15.0,7.0,11.0,14.0,10.0,7.0,13.0,10.0,13.0,15.0,15.0,15.0,14.0,9.0,13.0,16.0,6.0,14.0,8.0,12.0,13.0,16.0,11.0,12.0,16.0,11.0,8.0,16.0,12.0,20.0,15.0,14.0,14.0,11.0,12.0,5.0,15.0,18.0,15.0,14.0,13.0,17.0,14.0,14.0,5.0,22.0,0.0,0.0,0.0,0.0,178.0,73.0,3.0,2.0,2.0,1.0,2.0,4.0,3.0,1.0,3.0,1.0,2.0,6.0,12.0,12.0,6.0,11.0,7.0,8.0,8.0,11.0,12.0,10.0,8.0,13.0,11.0,12.0,12.0,13.0,11.0,10.0,11.0,11.0,13.0,6.0,7.0,12.0,9.0,13.0,14.0,16.0,14.0,13.0,9.0,6.0,14.0,15.0,20.0,15.0,14.0,12.0,12.0,13.0,6.0,14.0,12.0,15.0,13.0,13.0,14.0,14.0,14.0,6.0,27.0,0.0,0.0,10.0,0.0,178.0,77.0,1.0,3.0,2.0,1.0,2.0,2.0,3.0,2.0,3.0,3.0,3.0,13.0,14.0,15.0,8.0,15.0,13.0,10.0,12.0,10.0,9.0,13.0,8.0,10.0,15.0,10.0,12.0,13.0,13.0,14.0,13.0,12.0,13.0,13.0,6.0,14.0,10.0,11.0,15.0,14.0,14.0,13.0,9.0,20.0,10.0,14.0,7.0,13.0,12.0,12.0,9.0,15.0,8.0,10.0,8.0,16.0,13.0,14.0,11.0,13.0,13.0,13.0,30.0,4.0,0.0,0.0,0.0,192.0,78.0,1.0,3.0,1.0,2.0,2.0,3.0,1.0,3.0,1.0,1.0,3.0,4.0,6.0,7.0,8.0,11.0,6.0,15.0,8.0,6.0,13.0,11.0,6.0,14.0,11.0,17.0,14.0,16.0,12.0,14.0,10.0,12.0,17.0,8.0,8.0,11.0,13.0,15.0,16.0,14.0,12.0,18.0,14.0,6.0,14.0,12.0,20.0,17.0,16.0,14.0,17.0,13.0,9.0,11.0,8.0,13.0,10.0,13.0,12.0,10.0,10.0,5.0,25.0,0.0,0.0,3.0,2.0,170.0,61.0,2.0,3.0,2.0,2.0,1.0,3.0,2.0,2.0,1.0,2.0,1.0,11.0,12.0,13.0,10.0,13.0,8.0,5.0,8.0,7.0,4.0,14.0,10.0,4.0,15.0,11.0,10.0,9.0,7.0,10.0,14.0,8.0,13.0,13.0,6.0,12.0,8.0,8.0,12.0,16.0,14.0,7.0,5.0,12.0,15.0,16.0,20.0,14.0,6.0,12.0,11.0,13.0,8.0,8.0,8.0,13.0,15.0,10.0,10.0,14.0,14.0,8.0,18.0,0.0,0.0,0.0,0.0,179.0,67.0,3.0,3.0,2.0,4.0,2.0,4.0,3.0,1.0,3.0,4.0,1.0,5.0,7.0,12.0,9.0,12.0,12.0,10.0,12.0,6.0,4.0,12.0,12.0,3.0,14.0,11.0,12.0,11.0,11.0,8.0,13.0,12.0,12.0,12.0,6.0,12.0,5.0,10.0,12.0,15.0,11.0,12.0,10.0,20.0,13.0,14.0,8.0,14.0,8.0,9.0,6.0,14.0,5.0,10.0,16.0,13.0,12.0,12.0,13.0,9.0,15.0,2.0,18.0,0.0,0.0,0.0,0.0,188.0,80.0,1.0,3.0,1.0,3.0,2.0,3.0,3.0,1.0,2.0,2.0,4.0,6.0,8.0,12.0,11.0,12.0,7.0,13.0,10.0,4.0,4.0,8.0,10.0,5.0,12.0,11.0,11.0,13.0,10.0,11.0,11.0,12.0,11.0,13.0,7.0,13.0,8.0,13.0,13.0,11.0,12.0,12.0,12.0,10.0,12.0,11.0,20.0,10.0,12.0,12.0,8.0,11.0,7.0,13.0,8.0,13.0,13.0,11.0,12.0,12.0,13.0,7.0,30.0,5.0,0.0,22.0,9.0,181.0,84.0,2.0,3.0,3.0,1.0,2.0,3.0,3.0,1.0,3.0,1.0,3.0,7.0,10.0,12.0,13.0,11.0,7.0,13.0,10.0,12.0,6.0,11.0,13.0,6.0,13.0,17.0,13.0,16.0,11.0,13.0,11.0,11.0,17.0,14.0,8.0,14.0,9.0,13.0,17.0,15.0,12.0,15.0,11.0,8.0,14.0,15.0,20.0,14.0,14.0,13.0,9.0,13.0,7.0,10.0,7.0,16.0,13.0,14.0,13.0,15.0,15.0,10.0,25.0,0.0,0.0,0.0,0.0,176.0,74.0,2.0,2.0,1.0,3.0,2.0,2.0,2.0,4.0,3.0,3.0,3.0,12.0,12.0,14.0,12.0,14.0,13.0,7.0,12.0,6.0,3.0,12.0,12.0,3.0,15.0,9.0,10.0,8.0,12.0,11.0,12.0,10.0,10.0,14.0,5.0,13.0,4.0,6.0,8.0,17.0,15.0,12.0,8.0,20.0,12.0,14.0,8.0,13.0,12.0,11.0,9.0,14.0,10.0,8.0,8.0,14.0,12.0,7.0,10.0,11.0,11.0,9.0,25.0,4.0,0.0,11.0,0.0,184.0,81.0,14.0,14.0,13.0,9.0,15.0,12.0,16.0,16.0,13.0,7.0,11.0,8.0,1.0,2.0,1.0,11.0,12.0,6.0,1.0,3.0,3.0,11.0,5.0,3.0,11.0,8.0,15.0,15.0,13.0,14.0,10.0,11.0,14.0,8.0,13.0,5.0,13.0,10.0,10.0,14.0,16.0,14.0,13.0,20.0,14.0,12.0,5.0,14.0,14.0,15.0,9.0,16.0,6.0,1.0,17.0,11.0,15.0,13.0,14.0,12.0,12.0,4.0,27.0,0.0,0.0,0.0,0.0,184.0,81.0,1.0,1.0,1.0,3.0,3.0,2.0,2.0,2.0,1.0,2.0,3.0,8.0,6.0,8.0,12.0,10.0,8.0,12.0,9.0,1.0,3.0,8.0,14.0,4.0,9.0,4.0,11.0,12.0,11.0,8.0,8.0,11.0,10.0,9.0,8.0,11.0,9.0,8.0,11.0,10.0,8.0,13.0,13.0,9.0,13.0,9.0,20.0,12.0,13.0,13.0,9.0,2.0,9.0,9.0,15.0,10.0,12.0,10.0,11.0,6.0,4.0,6.0,32.0,0.0,0.0,0.0,0.0,172.0,71.0,2.0,1.0,3.0,1.0,2.0,3.0,2.0,3.0,2.0,2.0,2.0,8.0,9.0,7.0,6.0,10.0,6.0,10.0,9.0,10.0,14.0,11.0,6.0,14.0,11.0,10.0,16.0,15.0,12.0,12.0,7.0,12.0,15.0,9.0,13.0,8.0,14.0,15.0,15.0,14.0,14.0,14.0,10.0,20.0,14.0,14.0,8.0,15.0,13.0,13.0,11.0,13.0,7.0,13.0,17.0,14.0,17.0,8.0,13.0,15.0,15.0,6.0,19.0,0.0,0.0,3.0,1.0,181.0,69.0,3.0,2.0,3.0,3.0,2.0,1.0,1.0,1.0,3.0,3.0,4.0,10.0,10.0,12.0,12.0,12.0,7.0,8.0,11.0,5.0,7.0,10.0,10.0,7.0,11.0,8.0,10.0,10.0,12.0,8.0,11.0,8.0,14.0,13.0,6.0,14.0,8.0,13.0,13.0,16.0,14.0,13.0,9.0,20.0,15.0,16.0,10.0,15.0,13.0,12.0,8.0,11.0,7.0,12.0,11.0,11.0,15.0,10.0,12.0,14.0,14.0,1.0,21.0,0.0,0.0,0.0,0.0,179.0,68.0,2.0,3.0,2.0,1.0,2.0,1.0,2.0,3.0,2.0,1.0,1.0,6.0,13.0,12.0,6.0,13.0,6.0,8.0,7.0,12.0,10.0,12.0,8.0,12.0,13.0,10.0,11.0,11.0,12.0,10.0,11.0,11.0,12.0,11.0,7.0,13.0,10.0,12.0,14.0,15.0,13.0,12.0,10.0,20.0,14.0,14.0,8.0,14.0,10.0,13.0,8.0,13.0,8.0,12.0,13.0,14.0,10.0,12.0,10.0,10.0,12.0,10.0,37.0,0.0,0.0,0.0,0.0,185.0,83.0,1.0,1.0,2.0,1.0,3.0,2.0,3.0,1.0,1.0,3.0,1.0,6.0,8.0,9.0,12.0,10.0,8.0,13.0,9.0,4.0,5.0,10.0,14.0,4.0,11.0,11.0,10.0,11.0,13.0,12.0,12.0,13.0,15.0,14.0,12.0,11.0,7.0,12.0,8.0,7.0,7.0,12.0,12.0,11.0,11.0,7.0,20.0,8.0,14.0,12.0,8.0,13.0,9.0,12.0,12.0,12.0,19.0,14.0,15.0,14.0,8.0,8.0,19.0,0.0,0.0,0.0,0.0,185.0,82.0,4.0,2.0,3.0,1.0,3.0,2.0,1.0,2.0,1.0,2.0,3.0,7.0,7.0,10.0,6.0,13.0,7.0,14.0,7.0,6.0,12.0,13.0,7.0,13.0,13.0,13.0,13.0,13.0,11.0,12.0,11.0,12.0,14.0,9.0,14.0,11.0,11.0,15.0,15.0,12.0,12.0,14.0,13.0,5.0,14.0,12.0,20.0,14.0,13.0,10.0,11.0,11.0,6.0,10.0,10.0,12.0,12.0,14.0,14.0,11.0,16.0,6.0,19.0,0.0,0.0,0.0,0.0,175.0,67.0,3.0,2.0,1.0,3.0,3.0,1.0,1.0,1.0,2.0,1.0,3.0,7.0,8.0,12.0,8.0,10.0,6.0,12.0,9.0,8.0,10.0,10.0,8.0,12.0,11.0,14.0,10.0,12.0,9.0,10.0,11.0,10.0,12.0,12.0,10.0,12.0,12.0,13.0,14.0,13.0,11.0,14.0,8.0,6.0,14.0,12.0,20.0,14.0,12.0,12.0,8.0,11.0,6.0,12.0,17.0,13.0,10.0,11.0,12.0,11.0,17.0,5.0,18.0,0.0,0.0,0.0,0.0,170.0,67.0,3.0,1.0,3.0,3.0,3.0,4.0,1.0,2.0,1.0,2.0,2.0,11.0,11.0,12.0,13.0,12.0,11.0,6.0,10.0,8.0,7.0,12.0,10.0,7.0,13.0,9.0,11.0,8.0,10.0,10.0,12.0,12.0,15.0,12.0,12.0,11.0,12.0,11.0,12.0,12.0,12.0,10.0,6.0,5.0,14.0,12.0,20.0,10.0,9.0,10.0,8.0,2.0,6.0,12.0,11.0,11.0,12.0,13.0,14.0,11.0,13.0,4.0,22.0,0.0,0.0,0.0,0.0,186.0,0.0,1.0,2.0,3.0,3.0,1.0,3.0,1.0,2.0,1.0,2.0,1.0,4.0,1.0,12.0,12.0,12.0,1.0,7.0,5.0,1.0,3.0,5.0,1.0,1.0,8.0,8.0,6.0,6.0,4.0,5.0,4.0,11.0,6.0,9.0,12.0,12.0,5.0,4.0,5.0,12.0,12.0,5.0,11.0,12.0,10.0,12.0,20.0,6.0,8.0,8.0,8.0,8.0,7.0,8.0,13.0,11.0,12.0,13.0,12.0,5.0,14.0,5.0,22.0,5.0,1.0,1.0,0.0,173.0,72.0,1.0,3.0,1.0,3.0,3.0,3.0,3.0,3.0,3.0,2.0,2.0,14.0,13.0,16.0,14.0,16.0,14.0,5.0,11.0,5.0,5.0,15.0,11.0,5.0,16.0,8.0,13.0,9.0,14.0,13.0,15.0,13.0,15.0,16.0,5.0,13.0,5.0,9.0,10.0,15.0,16.0,14.0,5.0,20.0,14.0,15.0,5.0,12.0,14.0,13.0,11.0,13.0,8.0,14.0,10.0,15.0,14.0,10.0,13.0,10.0,10.0,13.0
2,2,31.0,22.0,0.0,17.0,0.0,185.0,82.0,12.0,12.0,13.0,6.0,14.0,11.0,15.0,18.0,14.0,10.0,13.0,7.0,3.0,8.0,5.0,9.0,10.0,8.0,12.0,2.0,2.0,9.0,6.0,3.0,10.0,6.0,12.0,15.0,16.0,12.0,8.0,12.0,14.0,8.0,15.0,3.0,13.0,13.0,8.0,13.0,17.0,14.0,13.0,7.0,12.0,11.0,20.0,15.0,14.0,13.0,6.0,16.0,3.0,1.0,8.0,16.0,12.0,13.0,16.0,16.0,16.0,7.0,30.0,19.0,0.0,7.0,0.0,189.0,77.0,3.0,2.0,3.0,2.0,3.0,3.0,1.0,3.0,3.0,1.0,2.0,5.0,8.0,7.0,10.0,10.0,9.0,15.0,9.0,8.0,14.0,12.0,10.0,15.0,10.0,15.0,14.0,13.0,13.0,14.0,10.0,12.0,14.0,10.0,14.0,11.0,12.0,14.0,14.0,8.0,10.0,12.0,16.0,10.0,16.0,10.0,20.0,13.0,16.0,13.0,11.0,13.0,7.0,10.0,6.0,14.0,12.0,13.0,14.0,13.0,13.0,7.0,30.0,32.0,1.0,0.0,0.0,190.0,88.0,1.0,2.0,2.0,2.0,3.0,1.0,1.0,3.0,3.0,2.0,2.0,5.0,7.0,9.0,8.0,10.0,7.0,16.0,11.0,9.0,15.0,13.0,5.0,16.0,12.0,17.0,16.0,17.0,13.0,13.0,11.0,12.0,16.0,7.0,14.0,10.0,14.0,15.0,15.0,14.0,12.0,17.0,16.0,9.0,15.0,14.0,20.0,16.0,18.0,15.0,15.0,14.0,10.0,12.0,14.0,15.0,12.0,14.0,12.0,13.0,11.0,15.0,26.0,27.0,0.0,0.0,0.0,183.0,70.0,1.0,3.0,1.0,3.0,4.0,1.0,3.0,3.0,2.0,1.0,3.0,9.0,14.0,12.0,8.0,10.0,8.0,12.0,13.0,14.0,9.0,12.0,7.0,13.0,11.0,14.0,9.0,15.0,10.0,12.0,9.0,10.0,16.0,10.0,9.0,12.0,8.0,12.0,17.0,14.0,11.0,13.0,12.0,10.0,16.0,16.0,20.0,16.0,13.0,13.0,10.0,14.0,6.0,15.0,10.0,15.0,14.0,10.0,16.0,13.0,13.0,4.0,24.0,0.0,0.0,0.0,0.0,177.0,65.0,1.0,2.0,1.0,2.0,1.0,2.0,1.0,1.0,1.0,2.0,3.0,8.0,11.0,13.0,10.0,13.0,8.0,10.0,11.0,7.0,5.0,12.0,13.0,6.0,13.0,8.0,11.0,9.0,10.0,9.0,9.0,11.0,13.0,12.0,5.0,12.0,8.0,7.0,9.0,16.0,15.0,12.0,8.0,10.0,15.0,15.0,20.0,14.0,12.0,11.0,8.0,13.0,7.0,12.0,20.0,14.0,13.0,12.0,9.0,12.0,11.0,10.0,28.0,41.0,2.0,0.0,0.0,187.0,80.0,3.0,2.0,3.0,2.0,1.0,1.0,2.0,3.0,1.0,4.0,2.0,7.0,10.0,11.0,7.0,12.0,7.0,10.0,12.0,13.0,15.0,13.0,8.0,18.0,12.0,18.0,13.0,17.0,12.0,14.0,10.0,12.0,17.0,7.0,13.0,9.0,14.0,17.0,18.0,14.0,13.0,16.0,14.0,20.0,18.0,13.0,12.0,18.0,14.0,15.0,16.0,15.0,6.0,15.0,14.0,13.0,10.0,14.0,12.0,8.0,7.0,8.0,21.0,0.0,0.0,11.0,2.0,180.0,72.0,2.0,3.0,3.0,3.0,3.0,2.0,2.0,1.0,3.0,2.0,3.0,12.0,13.0,14.0,9.0,14.0,13.0,8.0,12.0,5.0,8.0,14.0,10.0,9.0,14.0,12.0,12.0,9.0,13.0,12.0,15.0,13.0,14.0,15.0,8.0,13.0,10.0,16.0,14.0,15.0,14.0,12.0,9.0,8.0,15.0,14.0,20.0,13.0,12.0,12.0,8.0,11.0,10.0,11.0,10.0,14.0,16.0,14.0,15.0,15.0,15.0,6.0,21.0,0.0,0.0,0.0,0.0,187.0,84.0,4.0,2.0,1.0,2.0,3.0,1.0,2.0,3.0,1.0,1.0,2.0,11.0,13.0,15.0,12.0,14.0,11.0,13.0,14.0,4.0,5.0,12.0,14.0,5.0,16.0,12.0,12.0,14.0,12.0,10.0,10.0,9.0,14.0,17.0,10.0,12.0,7.0,10.0,14.0,14.0,16.0,14.0,15.0,9.0,13.0,14.0,20.0,14.0,14.0,14.0,8.0,15.0,5.0,14.0,11.0,16.0,13.0,14.0,13.0,15.0,15.0,6.0,29.0,26.0,6.0,12.0,4.0,175.0,77.0,1.0,2.0,1.0,3.0,3.0,2.0,1.0,2.0,1.0,2.0,2.0,16.0,14.0,16.0,15.0,15.0,18.0,6.0,15.0,6.0,6.0,18.0,11.0,5.0,17.0,9.0,12.0,10.0,16.0,12.0,16.0,14.0,14.0,16.0,6.0,16.0,6.0,10.0,10.0,13.0,15.0,14.0,8.0,15.0,15.0,14.0,20.0,13.0,12.0,11.0,9.0,16.0,7.0,8.0,8.0,11.0,8.0,13.0,12.0,13.0,11.0,10.0,23.0,0.0,0.0,10.0,7.0,179.0,70.0,1.0,1.0,2.0,2.0,1.0,3.0,3.0,2.0,1.0,4.0,3.0,10.0,13.0,14.0,12.0,15.0,11.0,10.0,13.0,6.0,3.0,13.0,12.0,4.0,16.0,11.0,12.0,11.0,13.0,11.0,13.0,12.0,12.0,16.0,6.0,14.0,6.0,10.0,12.0,16.0,14.0,12.0,9.0,20.0,13.0,14.0,10.0,13.0,10.0,12.0,7.0,12.0,6.0,8.0,12.0,13.0,5.0,10.0,8.0,14.0,12.0,8.0,26.0,0.0,0.0,4.0,0.0,180.0,73.0,2.0,3.0,1.0,4.0,2.0,3.0,3.0,1.0,1.0,4.0,1.0,11.0,13.0,13.0,14.0,14.0,11.0,15.0,12.0,3.0,7.0,14.0,14.0,8.0,13.0,12.0,14.0,17.0,13.0,15.0,14.0,14.0,16.0,12.0,15.0,16.0,12.0,18.0,16.0,13.0,14.0,13.0,12.0,8.0,14.0,13.0,20.0,15.0,12.0,15.0,8.0,14.0,7.0,15.0,19.0,14.0,17.0,14.0,18.0,16.0,16.0,5.0,31.0,25.0,0.0,6.0,0.0,191.0,84.0,11.0,14.0,13.0,12.0,15.0,14.0,15.0,16.0,13.0,14.0,14.0,8.0,2.0,10.0,5.0,11.0,11.0,7.0,10.0,2.0,5.0,10.0,11.0,11.0,9.0,12.0,13.0,15.0,13.0,13.0,8.0,13.0,16.0,12.0,14.0,1.0,16.0,13.0,11.0,12.0,13.0,16.0,16.0,8.0,16.0,13.0,20.0,15.0,15.0,17.0,8.0,15.0,7.0,2.0,15.0,15.0,17.0,15.0,17.0,16.0,15.0,6.0,23.0,0.0,0.0,0.0,0.0,184.0,77.0,1.0,1.0,1.0,1.0,3.0,2.0,3.0,2.0,2.0,2.0,3.0,6.0,9.0,11.0,7.0,12.0,7.0,15.0,9.0,11.0,14.0,13.0,10.0,15.0,12.0,14.0,15.0,15.0,13.0,12.0,11.0,13.0,15.0,11.0,9.0,9.0,14.0,14.0,14.0,14.0,13.0,15.0,13.0,9.0,16.0,15.0,20.0,14.0,14.0,14.0,11.0,14.0,4.0,11.0,14.0,13.0,15.0,14.0,16.0,14.0,15.0,6.0,28.0,46.0,3.0,14.0,3.0,190.0,80.0,2.0,3.0,3.0,2.0,2.0,1.0,1.0,3.0,1.0,3.0,1.0,4.0,6.0,7.0,9.0,11.0,7.0,17.0,11.0,10.0,15.0,12.0,11.0,16.0,10.0,17.0,15.0,18.0,13.0,14.0,12.0,14.0,18.0,6.0,17.0,8.0,15.0,15.0,14.0,11.0,10.0,17.0,16.0,7.0,17.0,13.0,20.0,15.0,18.0,17.0,14.0,16.0,4.0,6.0,14.0,15.0,16.0,17.0,18.0,14.0,15.0,6.0,23.0,0.0,0.0,1.0,0.0,182.0,71.0,3.0,1.0,2.0,3.0,4.0,2.0,3.0,1.0,2.0,1.0,3.0,9.0,13.0,14.0,8.0,14.0,13.0,12.0,10.0,13.0,14.0,14.0,13.0,15.0,13.0,14.0,14.0,13.0,11.0,12.0,12.0,13.0,16.0,12.0,12.0,15.0,13.0,14.0,15.0,15.0,13.0,14.0,12.0,9.0,16.0,15.0,20.0,15.0,15.0,15.0,10.0,14.0,6.0,12.0,8.0,15.0,14.0,16.0,15.0,15.0,16.0,6.0,20.0,0.0,0.0,0.0,0.0,184.0,80.0,1.0,4.0,4.0,1.0,3.0,1.0,4.0,3.0,3.0,3.0,2.0,7.0,14.0,13.0,8.0,12.0,7.0,16.0,7.0,12.0,13.0,13.0,11.0,12.0,13.0,12.0,13.0,14.0,13.0,12.0,12.0,12.0,15.0,12.0,10.0,14.0,13.0,14.0,13.0,14.0,12.0,14.0,12.0,6.0,13.0,14.0,20.0,13.0,14.0,14.0,8.0,15.0,10.0,13.0,9.0,16.0,15.0,14.0,16.0,16.0,17.0,5.0,31.0,0.0,0.0,6.0,0.0,174.0,80.0,1.0,1.0,1.0,1.0,1.0,5.0,1.0,1.0,1.0,1.0,1.0,14.0,12.0,11.0,7.0,12.0,13.0,9.0,7.0,10.0,11.0,11.0,10.0,10.0,12.0,11.0,11.0,11.0,10.0,6.0,10.0,9.0,12.0,12.0,12.0,10.0,12.0,12.0,14.0,12.0,15.0,10.0,9.0,20.0,12.0,12.0,7.0,12.0,9.0,9.0,10.0,12.0,7.0,9.0,11.0,14.0,9.0,7.0,14.0,8.0,9.0,9.0,29.0,90.0,4.0,16.0,2.0,170.0,61.0,2.0,3.0,3.0,1.0,3.0,1.0,2.0,2.0,2.0,2.0,1.0,15.0,14.0,15.0,9.0,17.0,16.0,7.0,12.0,4.0,11.0,18.0,15.0,12.0,17.0,15.0,15.0,16.0,13.0,16.0,17.0,14.0,16.0,15.0,14.0,12.0,14.0,18.0,16.0,13.0,14.0,12.0,8.0,10.0,14.0,11.0,20.0,14.0,10.0,14.0,9.0,17.0,10.0,14.0,13.0,17.0,15.0,16.0,17.0,15.0,16.0,7.0,19.0,0.0,0.0,12.0,4.0,177.0,75.0,2.0,1.0,1.0,1.0,2.0,2.0,3.0,1.0,1.0,3.0,3.0,11.0,12.0,13.0,8.0,15.0,11.0,5.0,12.0,8.0,5.0,15.0,16.0,8.0,16.0,10.0,12.0,14.0,13.0,13.0,13.0,11.0,10.0,15.0,9.0,12.0,5.0,10.0,7.0,13.0,15.0,7.0,9.0,14.0,13.0,13.0,20.0,11.0,6.0,12.0,11.0,13.0,5.0,11.0,12.0,15.0,16.0,14.0,12.0,15.0,15.0,5.0,24.0,6.0,1.0,0.0,0.0,183.0,66.0,1.0,1.0,2.0,2.0,1.0,2.0,1.0,2.0,3.0,2.0,1.0,14.0,14.0,14.0,10.0,14.0,14.0,9.0,10.0,8.0,8.0,14.0,10.0,8.0,15.0,9.0,11.0,13.0,11.0,11.0,13.0,10.0,14.0,13.0,5.0,12.0,9.0,14.0,13.0,14.0,16.0,12.0,9.0,20.0,13.0,14.0,5.0,15.0,9.0,12.0,10.0,12.0,8.0,9.0,16.0,9.0,16.0,13.0,11.0,12.0,13.0,9.0,30.0,62.0,25.0,13.0,8.0,177.0,72.0,1.0,3.0,3.0,1.0,3.0,2.0,1.0,3.0,1.0,4.0,1.0,8.0,11.0,12.0,17.0,14.0,12.0,18.0,14.0,3.0,4.0,13.0,18.0,5.0,16.0,14.0,15.0,16.0,17.0,13.0,14.0,16.0,16.0,16.0,16.0,16.0,6.0,13.0,13.0,13.0,14.0,13.0,11.0,14.0,13.0,12.0,20.0,12.0,12.0,15.0,8.0,19.0,10.0,6.0,13.0,18.0,14.0,19.0,15.0,16.0,17.0,10.0,21.0,3.0,0.0,0.0,0.0,181.0,77.0,2.0,2.0,2.0,1.0,1.0,1.0,3.0,2.0,4.0,3.0,3.0,6.0,13.0,16.0,12.0,15.0,7.0,6.0,10.0,5.0,5.0,13.0,10.0,6.0,16.0,13.0,13.0,13.0,9.0,10.0,11.0,13.0,15.0,17.0,10.0,14.0,5.0,12.0,11.0,16.0,15.0,13.0,10.0,15.0,16.0,15.0,20.0,13.0,14.0,14.0,10.0,13.0,8.0,16.0,17.0,17.0,11.0,14.0,10.0,9.0,11.0,9.0
2,1,25.0,0.0,0.0,0.0,0.0,187.0,83.0,11.0,14.0,12.0,8.0,13.0,11.0,14.0,15.0,13.0,13.0,9.0,8.0,1.0,1.0,1.0,11.0,11.0,1.0,2.0,2.0,1.0,10.0,3.0,2.0,11.0,8.0,12.0,14.0,12.0,12.0,10.0,12.0,14.0,6.0,14.0,2.0,12.0,12.0,8.0,13.0,15.0,14.0,13.0,20.0,15.0,11.0,5.0,14.0,13.0,13.0,8.0,8.0,10.0,1.0,9.0,13.0,14.0,12.0,15.0,15.0,15.0,5.0,17.0,0.0,0.0,0.0,0.0,178.0,72.0,2.0,2.0,1.0,2.0,1.0,1.0,3.0,3.0,2.0,2.0,3.0,7.0,9.0,7.0,3.0,9.0,4.0,7.0,5.0,8.0,7.0,10.0,6.0,13.0,10.0,4.0,7.0,9.0,7.0,9.0,9.0,10.0,9.0,9.0,5.0,8.0,8.0,9.0,9.0,15.0,11.0,9.0,9.0,20.0,10.0,12.0,8.0,7.0,10.0,9.0,4.0,9.0,9.0,9.0,12.0,12.0,12.0,11.0,11.0,10.0,20.0,4.0,26.0,0.0,0.0,0.0,0.0,183.0,79.0,1.0,1.0,3.0,4.0,3.0,2.0,2.0,1.0,2.0,1.0,1.0,9.0,8.0,12.0,11.0,10.0,11.0,10.0,9.0,7.0,6.0,8.0,9.0,5.0,12.0,10.0,9.0,8.0,11.0,11.0,9.0,8.0,11.0,14.0,6.0,12.0,8.0,10.0,11.0,11.0,12.0,11.0,10.0,10.0,10.0,12.0,20.0,11.0,11.0,9.0,9.0,9.0,6.0,13.0,17.0,11.0,10.0,11.0,12.0,10.0,10.0,4.0,31.0,0.0,0.0,7.0,2.0,185.0,80.0,3.0,3.0,1.0,1.0,4.0,1.0,4.0,3.0,3.0,3.0,1.0,5.0,10.0,9.0,6.0,11.0,7.0,15.0,8.0,8.0,14.0,12.0,6.0,13.0,11.0,12.0,14.0,16.0,12.0,13.0,8.0,11.0,17.0,5.0,14.0,6.0,15.0,14.0,14.0,12.0,11.0,15.0,14.0,10.0,16.0,11.0,20.0,14.0,15.0,14.0,12.0,15.0,8.0,13.0,8.0,15.0,17.0,14.0,16.0,15.0,15.0,7.0,18.0,0.0,0.0,0.0,0.0,185.0,74.0,2.0,2.0,1.0,3.0,3.0,1.0,4.0,2.0,2.0,3.0,2.0,8.0,6.0,8.0,6.0,10.0,6.0,13.0,5.0,9.0,12.0,10.0,9.0,13.0,10.0,12.0,12.0,13.0,11.0,12.0,8.0,11.0,12.0,3.0,8.0,8.0,11.0,10.0,13.0,13.0,11.0,12.0,12.0,6.0,12.0,12.0,20.0,13.0,14.0,11.0,7.0,10.0,5.0,10.0,7.0,13.0,12.0,12.0,13.0,9.0,15.0,7.0,23.0,0.0,0.0,0.0,0.0,172.0,70.0,3.0,3.0,3.0,1.0,1.0,2.0,4.0,2.0,4.0,2.0,1.0,5.0,12.0,11.0,7.0,12.0,6.0,9.0,7.0,11.0,12.0,12.0,8.0,13.0,12.0,12.0,12.0,14.0,11.0,12.0,9.0,11.0,14.0,8.0,7.0,12.0,10.0,14.0,15.0,13.0,13.0,11.0,7.0,6.0,14.0,14.0,20.0,15.0,11.0,12.0,10.0,12.0,10.0,11.0,16.0,12.0,14.0,10.0,14.0,12.0,10.0,6.0,21.0,0.0,0.0,0.0,0.0,185.0,69.0,2.0,3.0,2.0,1.0,3.0,3.0,3.0,3.0,3.0,2.0,2.0,5.0,9.0,12.0,9.0,16.0,10.0,11.0,15.0,5.0,13.0,13.0,8.0,14.0,13.0,11.0,16.0,13.0,13.0,14.0,12.0,11.0,15.0,10.0,7.0,8.0,13.0,14.0,13.0,13.0,13.0,14.0,12.0,6.0,13.0,12.0,20.0,13.0,11.0,12.0,10.0,12.0,7.0,13.0,10.0,14.0,14.0,11.0,14.0,14.0,14.0,6.0,27.0,0.0,0.0,0.0,0.0,186.0,77.0,2.0,4.0,2.0,2.0,1.0,1.0,1.0,3.0,2.0,2.0,1.0,10.0,11.0,12.0,10.0,13.0,11.0,12.0,14.0,8.0,10.0,14.0,6.0,12.0,13.0,13.0,12.0,13.0,12.0,12.0,12.0,12.0,14.0,9.0,10.0,12.0,11.0,14.0,15.0,12.0,13.0,14.0,12.0,20.0,12.0,11.0,9.0,16.0,13.0,13.0,13.0,13.0,15.0,12.0,14.0,13.0,14.0,13.0,15.0,15.0,15.0,5.0,18.0,0.0,0.0,0.0,0.0,175.0,67.0,3.0,2.0,3.0,2.0,1.0,1.0,1.0,2.0,3.0,2.0,1.0,9.0,9.0,14.0,10.0,13.0,11.0,7.0,12.0,7.0,4.0,9.0,6.0,4.0,14.0,8.0,10.0,12.0,10.0,9.0,9.0,10.0,11.0,14.0,5.0,11.0,7.0,9.0,10.0,13.0,15.0,12.0,9.0,20.0,14.0,14.0,8.0,11.0,9.0,11.0,8.0,12.0,6.0,9.0,18.0,12.0,10.0,12.0,12.0,10.0,10.0,4.0,23.0,3.0,2.0,15.0,5.0,173.0,70.0,4.0,2.0,3.0,3.0,2.0,1.0,1.0,3.0,2.0,1.0,1.0,7.0,12.0,15.0,12.0,12.0,10.0,6.0,15.0,7.0,5.0,13.0,9.0,7.0,13.0,6.0,9.0,7.0,10.0,9.0,15.0,9.0,14.0,15.0,7.0,13.0,12.0,12.0,11.0,17.0,15.0,15.0,9.0,20.0,14.0,15.0,15.0,13.0,7.0,8.0,8.0,11.0,9.0,9.0,12.0,17.0,9.0,9.0,12.0,10.0,10.0,7.0,33.0,35.0,7.0,0.0,0.0,174.0,75.0,3.0,2.0,1.0,1.0,2.0,1.0,4.0,3.0,2.0,3.0,2.0,8.0,11.0,12.0,12.0,12.0,11.0,15.0,13.0,7.0,5.0,10.0,14.0,4.0,13.0,7.0,13.0,12.0,11.0,12.0,11.0,11.0,14.0,11.0,14.0,14.0,9.0,15.0,14.0,14.0,13.0,13.0,10.0,7.0,15.0,13.0,20.0,12.0,13.0,13.0,7.0,14.0,7.0,8.0,14.0,12.0,14.0,12.0,14.0,15.0,15.0,6.0,33.0,0.0,0.0,3.0,0.0,188.0,84.0,14.0,13.0,13.0,9.0,13.0,13.0,15.0,15.0,11.0,11.0,9.0,7.0,3.0,3.0,1.0,7.0,10.0,2.0,1.0,1.0,2.0,6.0,4.0,1.0,7.0,8.0,13.0,14.0,14.0,14.0,8.0,11.0,15.0,6.0,13.0,3.0,13.0,12.0,8.0,12.0,14.0,15.0,14.0,8.0,13.0,11.0,20.0,13.0,15.0,16.0,8.0,13.0,6.0,1.0,11.0,14.0,13.0,11.0,16.0,14.0,11.0,6.0,29.0,2.0,0.0,0.0,0.0,185.0,75.0,2.0,3.0,3.0,3.0,2.0,3.0,2.0,1.0,3.0,1.0,2.0,4.0,10.0,8.0,6.0,10.0,6.0,14.0,7.0,7.0,14.0,11.0,6.0,14.0,9.0,13.0,13.0,14.0,11.0,12.0,12.0,12.0,14.0,8.0,11.0,12.0,13.0,13.0,13.0,15.0,12.0,15.0,12.0,8.0,15.0,13.0,20.0,14.0,15.0,14.0,7.0,14.0,8.0,6.0,14.0,13.0,15.0,14.0,14.0,14.0,14.0,6.0,28.0,0.0,0.0,0.0,0.0,193.0,84.0,1.0,1.0,2.0,2.0,2.0,3.0,2.0,3.0,2.0,1.0,3.0,4.0,8.0,8.0,9.0,10.0,6.0,14.0,7.0,8.0,14.0,12.0,6.0,14.0,11.0,12.0,13.0,14.0,11.0,14.0,12.0,12.0,14.0,6.0,11.0,8.0,14.0,13.0,13.0,11.0,11.0,16.0,16.0,20.0,12.0,12.0,8.0,14.0,16.0,14.0,12.0,13.0,6.0,10.0,7.0,12.0,15.0,12.0,16.0,15.0,13.0,6.0,26.0,0.0,0.0,0.0,0.0,182.0,68.0,1.0,4.0,3.0,2.0,3.0,1.0,2.0,1.0,2.0,4.0,1.0,7.0,12.0,9.0,5.0,10.0,6.0,12.0,7.0,15.0,12.0,9.0,6.0,12.0,10.0,12.0,13.0,14.0,11.0,10.0,9.0,9.0,13.0,7.0,6.0,10.0,10.0,14.0,15.0,16.0,13.0,13.0,11.0,5.0,15.0,15.0,20.0,14.0,10.0,12.0,12.0,13.0,7.0,12.0,12.0,14.0,14.0,15.0,13.0,14.0,14.0,7.0,26.0,0.0,0.0,0.0,0.0,175.0,69.0,3.0,3.0,2.0,2.0,3.0,1.0,3.0,1.0,3.0,2.0,2.0,6.0,12.0,10.0,5.0,11.0,6.0,10.0,10.0,10.0,13.0,12.0,9.0,13.0,12.0,12.0,13.0,14.0,12.0,13.0,12.0,11.0,15.0,11.0,13.0,12.0,13.0,14.0,14.0,15.0,13.0,12.0,7.0,9.0,13.0,13.0,20.0,14.0,11.0,14.0,12.0,12.0,11.0,15.0,14.0,9.0,17.0,10.0,8.0,11.0,20.0,7.0,27.0,32.0,6.0,0.0,0.0,188.0,78.0,3.0,2.0,3.0,2.0,1.0,3.0,3.0,3.0,2.0,2.0,2.0,4.0,8.0,11.0,12.0,12.0,6.0,16.0,13.0,8.0,13.0,14.0,7.0,12.0,12.0,12.0,10.0,14.0,13.0,12.0,11.0,12.0,15.0,9.0,11.0,12.0,6.0,13.0,12.0,14.0,13.0,15.0,15.0,5.0,13.0,12.0,20.0,16.0,15.0,14.0,12.0,15.0,11.0,10.0,9.0,15.0,12.0,12.0,13.0,13.0,13.0,7.0,21.0,0.0,0.0,0.0,0.0,183.0,73.0,1.0,4.0,3.0,3.0,3.0,1.0,4.0,1.0,2.0,3.0,2.0,11.0,10.0,12.0,11.0,13.0,9.0,12.0,10.0,5.0,8.0,12.0,9.0,8.0,13.0,13.0,12.0,12.0,10.0,12.0,14.0,12.0,12.0,14.0,8.0,12.0,8.0,12.0,12.0,14.0,14.0,14.0,11.0,8.0,13.0,13.0,20.0,12.0,12.0,12.0,5.0,10.0,7.0,12.0,15.0,11.0,11.0,10.0,11.0,12.0,11.0,4.0,29.0,0.0,0.0,0.0,0.0,183.0,78.0,1.0,3.0,3.0,3.0,3.0,1.0,2.0,3.0,3.0,1.0,1.0,13.0,8.0,9.0,6.0,12.0,14.0,13.0,10.0,12.0,11.0,12.0,8.0,13.0,12.0,12.0,15.0,13.0,13.0,13.0,11.0,13.0,15.0,6.0,12.0,7.0,13.0,16.0,18.0,12.0,11.0,14.0,12.0,20.0,14.0,11.0,8.0,16.0,14.0,14.0,12.0,14.0,6.0,12.0,10.0,12.0,13.0,11.0,15.0,15.0,15.0,5.0,29.0,0.0,0.0,0.0,0.0,180.0,71.0,1.0,3.0,1.0,1.0,1.0,4.0,4.0,1.0,1.0,2.0,3.0,10.0,11.0,12.0,9.0,13.0,11.0,8.0,14.0,6.0,8.0,11.0,10.0,8.0,12.0,10.0,11.0,12.0,12.0,9.0,12.0,11.0,14.0,12.0,7.0,12.0,10.0,12.0,14.0,15.0,14.0,12.0,10.0,20.0,16.0,13.0,12.0,15.0,10.0,13.0,10.0,15.0,7.0,8.0,16.0,12.0,12.0,13.0,14.0,15.0,15.0,6.0,23.0,0.0,0.0,0.0,0.0,175.0,70.0,2.0,1.0,2.0,2.0,1.0,2.0,2.0,3.0,4.0,1.0,2.0,10.0,11.0,12.0,9.0,13.0,8.0,6.0,13.0,2.0,5.0,13.0,10.0,6.0,13.0,7.0,13.0,9.0,13.0,11.0,13.0,12.0,13.0,12.0,10.0,12.0,10.0,13.0,12.0,11.0,12.0,13.0,8.0,8.0,14.0,12.0,20.0,14.0,12.0,13.0,9.0,11.0,10.0,11.0,19.0,12.0,14.0,11.0,13.0,10.0,16.0,7.0,23.0,1.0,0.0,0.0,0.0,185.0,70.0,4.0,3.0,1.0,2.0,1.0,3.0,2.0,3.0,1.0,2.0,3.0,5.0,8.0,12.0,13.0,13.0,7.0,14.0,11.0,5.0,5.0,8.0,13.0,5.0,13.0,6.0,13.0,10.0,12.0,12.0,11.0,11.0,13.0,12.0,7.0,13.0,9.0,8.0,10.0,16.0,12.0,14.0,12.0,8.0,14.0,15.0,20.0,13.0,13.0,12.0,7.0,15.0,7.0,7.0,13.0,13.0,12.0,10.0,12.0,15.0,15.0,7.0
3,2,36.0,0.0,0.0,0.0,0.0,185.0,78.0,11.0,14.0,12.0,7.0,13.0,12.0,14.0,15.0,13.0,14.0,10.0,4.0,1.0,3.0,1.0,8.0,8.0,11.0,8.0,3.0,3.0,7.0,2.0,1.0,8.0,11.0,13.0,15.0,11.0,12.0,7.0,13.0,9.0,5.0,14.0,3.0,13.0,15.0,8.0,11.0,14.0,13.0,12.0,5.0,15.0,11.0,20.0,12.0,14.0,13.0,11.0,13.0,8.0,1.0,19.0,14.0,16.0,10.0,17.0,9.0,9.0,11.0,21.0,0.0,0.0,0.0,0.0,182.0,74.0,2.0,2.0,2.0,2.0,2.0,1.0,1.0,1.0,3.0,2.0,2.0,9.0,11.0,12.0,7.0,9.0,8.0,12.0,7.0,11.0,12.0,7.0,8.0,13.0,11.0,12.0,12.0,14.0,12.0,13.0,7.0,12.0,11.0,1.0,9.0,11.0,9.0,10.0,12.0,14.0,10.0,13.0,11.0,9.0,8.0,12.0,20.0,13.0,11.0,10.0,13.0,8.0,10.0,10.0,15.0,11.0,13.0,10.0,10.0,8.0,13.0,7.0,28.0,0.0,0.0,0.0,0.0,183.0,81.0,1.0,2.0,4.0,1.0,1.0,3.0,2.0,3.0,3.0,3.0,1.0,5.0,5.0,6.0,10.0,12.0,6.0,14.0,8.0,6.0,15.0,11.0,6.0,13.0,12.0,13.0,14.0,16.0,14.0,14.0,10.0,12.0,14.0,5.0,14.0,8.0,14.0,15.0,15.0,9.0,12.0,15.0,13.0,7.0,11.0,12.0,20.0,15.0,15.0,14.0,14.0,14.0,9.0,8.0,14.0,14.0,11.0,13.0,15.0,13.0,15.0,6.0,28.0,8.0,0.0,1.0,0.0,182.0,79.0,1.0,1.0,3.0,2.0,4.0,1.0,3.0,3.0,1.0,1.0,3.0,5.0,9.0,9.0,9.0,11.0,6.0,13.0,8.0,12.0,14.0,9.0,8.0,14.0,11.0,14.0,14.0,15.0,10.0,13.0,7.0,12.0,16.0,8.0,8.0,9.0,14.0,13.0,14.0,15.0,12.0,13.0,11.0,5.0,13.0,14.0,20.0,15.0,14.0,12.0,14.0,13.0,7.0,15.0,11.0,13.0,10.0,13.0,10.0,11.0,12.0,5.0,24.0,0.0,0.0,0.0,0.0,188.0,75.0,1.0,3.0,2.0,2.0,1.0,1.0,2.0,1.0,3.0,3.0,1.0,15.0,11.0,11.0,12.0,13.0,15.0,11.0,12.0,9.0,6.0,15.0,13.0,6.0,11.0,11.0,12.0,12.0,14.0,14.0,14.0,14.0,14.0,12.0,12.0,11.0,8.0,13.0,13.0,11.0,12.0,9.0,15.0,20.0,12.0,10.0,8.0,13.0,9.0,12.0,7.0,14.0,11.0,11.0,14.0,14.0,12.0,11.0,10.0,11.0,10.0,6.0,19.0,0.0,0.0,0.0,0.0,184.0,72.0,2.0,2.0,3.0,2.0,1.0,2.0,1.0,3.0,2.0,1.0,2.0,11.0,9.0,9.0,10.0,15.0,11.0,11.0,16.0,8.0,14.0,11.0,9.0,16.0,10.0,11.0,13.0,6.0,12.0,11.0,10.0,12.0,12.0,7.0,4.0,12.0,13.0,12.0,15.0,14.0,9.0,13.0,12.0,7.0,13.0,11.0,20.0,10.0,12.0,10.0,11.0,8.0,8.0,11.0,12.0,14.0,8.0,13.0,12.0,5.0,9.0,3.0,33.0,0.0,0.0,0.0,0.0,187.0,76.0,2.0,2.0,3.0,1.0,1.0,3.0,2.0,1.0,2.0,3.0,2.0,15.0,14.0,14.0,10.0,15.0,13.0,10.0,12.0,7.0,4.0,15.0,13.0,7.0,15.0,6.0,12.0,9.0,14.0,11.0,15.0,12.0,12.0,14.0,12.0,13.0,7.0,13.0,12.0,11.0,12.0,14.0,12.0,14.0,15.0,12.0,20.0,11.0,12.0,12.0,6.0,14.0,6.0,11.0,14.0,13.0,12.0,12.0,15.0,15.0,13.0,9.0,21.0,0.0,0.0,4.0,1.0,184.0,79.0,1.0,2.0,3.0,1.0,2.0,1.0,3.0,2.0,2.0,1.0,3.0,3.0,6.0,10.0,12.0,12.0,7.0,15.0,8.0,4.0,5.0,13.0,10.0,8.0,12.0,18.0,12.0,19.0,13.0,10.0,13.0,12.0,14.0,13.0,10.0,12.0,9.0,16.0,15.0,12.0,14.0,14.0,14.0,12.0,13.0,10.0,20.0,14.0,14.0,11.0,14.0,14.0,11.0,5.0,10.0,13.0,14.0,15.0,10.0,8.0,4.0,15.0,30.0,0.0,0.0,0.0,0.0,178.0,73.0,3.0,4.0,1.0,1.0,2.0,4.0,3.0,2.0,2.0,2.0,3.0,13.0,14.0,12.0,7.0,13.0,12.0,7.0,13.0,5.0,10.0,13.0,9.0,10.0,13.0,11.0,11.0,12.0,12.0,13.0,11.0,14.0,14.0,11.0,7.0,11.0,10.0,13.0,15.0,13.0,15.0,15.0,8.0,20.0,14.0,14.0,8.0,14.0,11.0,13.0,11.0,14.0,8.0,10.0,19.0,12.0,12.0,9.0,12.0,12.0,10.0,10.0,26.0,0.0,0.0,0.0,0.0,193.0,81.0,1.0,3.0,3.0,3.0,3.0,1.0,2.0,2.0,2.0,3.0,3.0,4.0,9.0,14.0,10.0,13.0,12.0,14.0,14.0,5.0,5.0,10.0,12.0,3.0,14.0,8.0,13.0,12.0,9.0,10.0,11.0,11.0,12.0,16.0,5.0,14.0,6.0,9.0,12.0,14.0,13.0,14.0,16.0,14.0,13.0,13.0,20.0,13.0,14.0,10.0,8.0,14.0,9.0,8.0,16.0,16.0,11.0,13.0,11.0,13.0,13.0,10.0,27.0,0.0,0.0,0.0,0.0,190.0,87.0,1.0,3.0,2.0,3.0,1.0,3.0,1.0,1.0,2.0,3.0,2.0,5.0,7.0,9.0,14.0,14.0,10.0,14.0,13.0,5.0,6.0,12.0,12.0,8.0,14.0,14.0,13.0,16.0,14.0,11.0,10.0,13.0,15.0,10.0,11.0,14.0,9.0,15.0,14.0,10.0,11.0,16.0,15.0,9.0,12.0,12.0,20.0,14.0,16.0,13.0,13.0,12.0,7.0,5.0,10.0,12.0,14.0,12.0,14.0,14.0,19.0,12.0,30.0,42.0,0.0,13.0,0.0,195.0,88.0,16.0,13.0,14.0,6.0,14.0,13.0,13.0,15.0,12.0,10.0,14.0,1.0,8.0,5.0,2.0,8.0,2.0,8.0,2.0,5.0,3.0,9.0,5.0,3.0,8.0,10.0,12.0,10.0,14.0,10.0,10.0,14.0,13.0,3.0,14.0,3.0,12.0,14.0,12.0,8.0,13.0,18.0,18.0,17.0,14.0,11.0,20.0,14.0,17.0,14.0,4.0,14.0,4.0,1.0,12.0,13.0,14.0,9.0,15.0,13.0,13.0,5.0,24.0,0.0,0.0,0.0,0.0,185.0,77.0,1.0,1.0,3.0,2.0,1.0,1.0,3.0,1.0,3.0,3.0,1.0,7.0,10.0,12.0,11.0,12.0,12.0,14.0,13.0,7.0,13.0,12.0,8.0,14.0,12.0,10.0,13.0,11.0,13.0,13.0,12.0,13.0,16.0,10.0,8.0,12.0,13.0,13.0,13.0,14.0,14.0,12.0,14.0,12.0,14.0,13.0,20.0,11.0,12.0,12.0,12.0,10.0,11.0,7.0,17.0,11.0,10.0,10.0,10.0,7.0,8.0,5.0,28.0,0.0,0.0,0.0,0.0,190.0,85.0,3.0,2.0,3.0,3.0,2.0,2.0,2.0,4.0,3.0,1.0,2.0,5.0,9.0,8.0,9.0,8.0,7.0,14.0,10.0,9.0,15.0,9.0,6.0,14.0,9.0,16.0,13.0,16.0,10.0,13.0,10.0,12.0,15.0,6.0,13.0,7.0,13.0,14.0,16.0,12.0,11.0,17.0,13.0,20.0,15.0,13.0,8.0,15.0,15.0,12.0,14.0,14.0,9.0,8.0,14.0,13.0,14.0,11.0,12.0,13.0,16.0,14.0,23.0,0.0,0.0,0.0,0.0,184.0,71.0,1.0,2.0,1.0,2.0,2.0,2.0,2.0,4.0,2.0,1.0,3.0,4.0,10.0,10.0,6.0,11.0,6.0,14.0,8.0,7.0,14.0,11.0,6.0,13.0,11.0,12.0,12.0,13.0,12.0,11.0,12.0,12.0,14.0,6.0,8.0,10.0,13.0,13.0,14.0,15.0,13.0,14.0,13.0,8.0,12.0,14.0,20.0,13.0,14.0,13.0,12.0,14.0,15.0,8.0,11.0,13.0,13.0,10.0,8.0,9.0,16.0,7.0,28.0,0.0,0.0,0.0,0.0,174.0,67.0,3.0,4.0,1.0,1.0,1.0,3.0,1.0,3.0,2.0,1.0,2.0,11.0,8.0,11.0,9.0,13.0,6.0,7.0,12.0,8.0,10.0,10.0,3.0,6.0,12.0,10.0,13.0,7.0,12.0,8.0,10.0,9.0,12.0,13.0,5.0,12.0,9.0,12.0,11.0,14.0,14.0,11.0,7.0,10.0,15.0,12.0,20.0,11.0,6.0,9.0,6.0,10.0,10.0,9.0,11.0,14.0,9.0,11.0,12.0,8.0,8.0,8.0,21.0,0.0,0.0,0.0,0.0,178.0,65.0,2.0,3.0,3.0,3.0,3.0,1.0,1.0,1.0,1.0,3.0,1.0,9.0,13.0,11.0,6.0,12.0,7.0,9.0,8.0,8.0,13.0,12.0,7.0,13.0,12.0,8.0,12.0,13.0,12.0,12.0,13.0,13.0,14.0,9.0,8.0,12.0,12.0,13.0,13.0,12.0,14.0,13.0,11.0,8.0,15.0,12.0,20.0,13.0,12.0,14.0,8.0,11.0,7.0,10.0,19.0,10.0,13.0,10.0,11.0,15.0,15.0,6.0,26.0,25.0,1.0,7.0,0.0,189.0,78.0,1.0,1.0,1.0,1.0,1.0,1.0,1.0,1.0,1.0,1.0,1.0,8.0,9.0,10.0,6.0,12.0,8.0,13.0,14.0,7.0,11.0,14.0,11.0,13.0,13.0,13.0,13.0,16.0,13.0,13.0,12.0,13.0,14.0,10.0,10.0,12.0,13.0,15.0,15.0,12.0,11.0,9.0,15.0,10.0,14.0,13.0,20.0,14.0,14.0,12.0,13.0,11.0,14.0,12.0,14.0,11.0,14.0,12.0,16.0,15.0,13.0,5.0,21.0,0.0,0.0,0.0,0.0,172.0,66.0,2.0,3.0,2.0,2.0,1.0,1.0,1.0,3.0,2.0,1.0,1.0,10.0,10.0,13.0,9.0,14.0,9.0,8.0,10.0,7.0,13.0,13.0,9.0,12.0,13.0,10.0,12.0,13.0,13.0,12.0,14.0,13.0,13.0,11.0,9.0,14.0,13.0,14.0,14.0,14.0,13.0,12.0,8.0,8.0,12.0,12.0,20.0,13.0,12.0,14.0,10.0,11.0,8.0,12.0,15.0,10.0,15.0,8.0,11.0,14.0,14.0,6.0,22.0,0.0,0.0,0.0,0.0,177.0,72.0,2.0,1.0,2.0,4.0,2.0,2.0,1.0,3.0,4.0,2.0,3.0,10.0,12.0,13.0,11.0,12.0,10.0,12.0,12.0,4.0,10.0,13.0,11.0,11.0,13.0,11.0,12.0,11.0,13.0,9.0,13.0,12.0,3.0,12.0,8.0,14.0,12.0,12.0,13.0,16.0,13.0,12.0,9.0,8.0,15.0,14.0,20.0,14.0,13.0,10.0,4.0,11.0,11.0,12.0,19.0,9.0,12.0,13.0,12.0,11.0,14.0,7.0,24.0,4.0,1.0,0.0,0.0,188.0,79.0,2.0,3.0,2.0,1.0,2.0,1.0,1.0,2.0,1.0,2.0,2.0,10.0,11.0,13.0,12.0,11.0,9.0,13.0,9.0,5.0,8.0,11.0,11.0,7.0,13.0,10.0,12.0,11.0,11.0,12.0,13.0,11.0,14.0,12.0,9.0,12.0,12.0,14.0,14.0,12.0,13.0,15.0,14.0,8.0,13.0,12.0,20.0,13.0,14.0,11.0,9.0,10.0,5.0,10.0,14.0,12.0,13.0,10.0,14.0,13.0,12.0,10.0,25.0,0.0,0.0,0.0,0.0,187.0,83.0,2.0,1.0,3.0,3.0,1.0,3.0,3.0,3.0,1.0,1.0,3.0,4.0,8.0,10.0,14.0,12.0,8.0,14.0,9.0,5.0,7.0,11.0,13.0,5.0,12.0,11.0,13.0,13.0,13.0,11.0,10.0,12.0,16.0,9.0,8.0,13.0,11.0,13.0,16.0,14.0,13.0,15.0,13.0,20.0,14.0,12.0,8.0,14.0,16.0,13.0,11.0,13.0,7.0,5.0,13.0,14.0,13.0,14.0,14.0,13.0,13.0,6.0
3,2,31.0,25.0,0.0,6.0,0.0,191.0,84.0,11.0,14.0,13.0,12.0,15.0,14.0,15.0,16.0,13.0,14.0,14.0,8.0,2.0,10.0,5.0,11.0,11.0,7.0,10.0,2.0,5.0,10.0,11.0,11.0,9.0,12.0,13.0,15.0,13.0,13.0,8.0,13.0,16.0,12.0,14.0,1.0,16.0,13.0,11.0,12.0,13.0,16.0,16.0,8.0,16.0,13.0,20.0,15.0,15.0,17.0,8.0,15.0,7.0,2.0,15.0,15.0,17.0,15.0,17.0,16.0,15.0,6.0,23.0,0.0,0.0,0.0,0.0,184.0,77.0,1.0,1.0,1.0,1.0,3.0,2.0,3.0,2.0,2.0,2.0,3.0,6.0,9.0,11.0,7.0,12.0,7.0,15.0,9.0,11.0,14.0,13.0,10.0,15.0,12.0,14.0,15.0,15.0,13.0,12.0,11.0,13.0,15.0,11.0,9.0,9.0,14.0,14.0,14.0,14.0,13.0,15.0,13.0,9.0,16.0,15.0,20.0,14.0,14.0,14.0,11.0,14.0,4.0,11.0,14.0,13.0,15.0,14.0,16.0,14.0,15.0,6.0,28.0,46.0,3.0,14.0,3.0,190.0,80.0,2.0,3.0,3.0,2.0,2.0,1.0,1.0,3.0,1.0,3.0,1.0,4.0,6.0,7.0,9.0,11.0,7.0,17.0,11.0,10.0,15.0,12.0,11.0,16.0,10.0,17.0,15.0,18.0,13.0,14.0,12.0,14.0,18.0,6.0,17.0,8.0,15.0,15.0,14.0,11.0,10.0,17.0,16.0,7.0,17.0,13.0,20.0,15.0,18.0,17.0,14.0,16.0,4.0,6.0,14.0,15.0,16.0,17.0,18.0,14.0,15.0,6.0,32.0,0.0,0.0,3.0,0.0,187.0,82.0,1.0,2.0,2.0,3.0,2.0,1.0,1.0,2.0,2.0,3.0,1.0,5.0,11.0,8.0,7.0,10.0,6.0,15.0,9.0,13.0,15.0,10.0,8.0,16.0,9.0,16.0,14.0,17.0,12.0,15.0,8.0,12.0,17.0,9.0,14.0,11.0,13.0,15.0,13.0,12.0,11.0,16.0,14.0,6.0,13.0,14.0,20.0,13.0,16.0,15.0,14.0,14.0,8.0,14.0,14.0,14.0,15.0,16.0,15.0,12.0,10.0,7.0,20.0,0.0,0.0,0.0,0.0,184.0,80.0,1.0,4.0,4.0,1.0,3.0,1.0,4.0,3.0,3.0,3.0,2.0,7.0,14.0,13.0,8.0,12.0,7.0,16.0,7.0,12.0,13.0,13.0,11.0,12.0,13.0,12.0,13.0,14.0,13.0,12.0,12.0,12.0,15.0,12.0,10.0,14.0,13.0,14.0,13.0,14.0,12.0,14.0,12.0,6.0,13.0,14.0,20.0,13.0,14.0,14.0,8.0,15.0,10.0,13.0,9.0,16.0,15.0,14.0,16.0,16.0,17.0,5.0,31.0,0.0,0.0,6.0,0.0,174.0,80.0,1.0,1.0,1.0,1.0,1.0,5.0,1.0,1.0,1.0,1.0,1.0,14.0,12.0,11.0,7.0,12.0,13.0,9.0,7.0,10.0,11.0,11.0,10.0,10.0,12.0,11.0,11.0,11.0,10.0,6.0,10.0,9.0,12.0,12.0,12.0,10.0,12.0,12.0,14.0,12.0,15.0,10.0,9.0,20.0,12.0,12.0,7.0,12.0,9.0,9.0,10.0,12.0,7.0,9.0,11.0,14.0,9.0,7.0,14.0,8.0,9.0,9.0,19.0,0.0,0.0,12.0,4.0,177.0,75.0,2.0,1.0,1.0,1.0,2.0,2.0,3.0,1.0,1.0,3.0,3.0,11.0,12.0,13.0,8.0,15.0,11.0,5.0,12.0,8.0,5.0,15.0,16.0,8.0,16.0,10.0,12.0,14.0,13.0,13.0,13.0,11.0,10.0,15.0,9.0,12.0,5.0,10.0,7.0,13.0,15.0,7.0,9.0,14.0,13.0,13.0,20.0,11.0,6.0,12.0,11.0,13.0,5.0,11.0,12.0,15.0,16.0,14.0,12.0,15.0,15.0,5.0,29.0,90.0,4.0,16.0,2.0,170.0,61.0,2.0,3.0,3.0,1.0,3.0,1.0,2.0,2.0,2.0,2.0,1.0,15.0,14.0,15.0,9.0,17.0,16.0,7.0,12.0,4.0,11.0,18.0,15.0,12.0,17.0,15.0,15.0,16.0,13.0,16.0,17.0,14.0,16.0,15.0,14.0,12.0,14.0,18.0,16.0,13.0,14.0,12.0,8.0,10.0,14.0,11.0,20.0,14.0,10.0,14.0,9.0,17.0,10.0,14.0,13.0,17.0,15.0,16.0,17.0,15.0,16.0,7.0,20.0,0.0,0.0,10.0,1.0,174.0,68.0,1.0,3.0,3.0,3.0,2.0,3.0,3.0,2.0,1.0,2.0,2.0,11.0,12.0,15.0,11.0,14.0,12.0,6.0,12.0,2.0,4.0,14.0,11.0,4.0,15.0,9.0,11.0,10.0,12.0,11.0,14.0,12.0,14.0,14.0,7.0,13.0,7.0,11.0,13.0,14.0,15.0,13.0,7.0,20.0,12.0,14.0,10.0,13.0,9.0,12.0,7.0,12.0,10.0,12.0,15.0,16.0,12.0,14.0,13.0,15.0,15.0,5.0,30.0,62.0,25.0,13.0,8.0,177.0,72.0,1.0,3.0,3.0,1.0,3.0,2.0,1.0,3.0,1.0,4.0,1.0,8.0,11.0,12.0,17.0,14.0,12.0,18.0,14.0,3.0,4.0,13.0,18.0,5.0,16.0,14.0,15.0,16.0,17.0,13.0,14.0,16.0,16.0,16.0,16.0,16.0,6.0,13.0,13.0,13.0,14.0,13.0,11.0,14.0,13.0,12.0,20.0,12.0,12.0,15.0,8.0,19.0,10.0,6.0,13.0,18.0,14.0,19.0,15.0,16.0,17.0,10.0,21.0,3.0,0.0,0.0,0.0,181.0,77.0,2.0,2.0,2.0,1.0,1.0,1.0,3.0,2.0,4.0,3.0,3.0,6.0,13.0,16.0,12.0,15.0,7.0,6.0,10.0,5.0,5.0,13.0,10.0,6.0,16.0,13.0,13.0,13.0,9.0,10.0,11.0,13.0,15.0,17.0,10.0,14.0,5.0,12.0,11.0,16.0,15.0,13.0,10.0,15.0,16.0,15.0,20.0,13.0,14.0,14.0,10.0,13.0,8.0,16.0,17.0,17.0,11.0,14.0,10.0,9.0,11.0,9.0,25.0,4.0,0.0,11.0,0.0,184.0,81.0,14.0,14.0,13.0,9.0,15.0,12.0,16.0,16.0,13.0,7.0,11.0,8.0,1.0,2.0,1.0,11.0,12.0,6.0,1.0,3.0,3.0,11.0,5.0,3.0,11.0,8.0,15.0,15.0,13.0,14.0,10.0,11.0,14.0,8.0,13.0,5.0,13.0,10.0,10.0,14.0,16.0,14.0,13.0,20.0,14.0,12.0,5.0,14.0,14.0,15.0,9.0,16.0,6.0,1.0,17.0,11.0,15.0,13.0,14.0,12.0,12.0,4.0,32.0,0.0,0.0,0.0,0.0,172.0,71.0,2.0,1.0,3.0,1.0,2.0,3.0,2.0,3.0,2.0,2.0,2.0,8.0,9.0,7.0,6.0,10.0,6.0,10.0,9.0,10.0,14.0,11.0,6.0,14.0,11.0,10.0,16.0,15.0,12.0,12.0,7.0,12.0,15.0,9.0,13.0,8.0,14.0,15.0,15.0,14.0,14.0,14.0,10.0,20.0,14.0,14.0,8.0,15.0,13.0,13.0,11.0,13.0,7.0,13.0,17.0,14.0,17.0,8.0,13.0,15.0,15.0,6.0,27.0,0.0,0.0,0.0,0.0,184.0,81.0,1.0,1.0,1.0,3.0,3.0,2.0,2.0,2.0,1.0,2.0,3.0,8.0,6.0,8.0,12.0,10.0,8.0,12.0,9.0,1.0,3.0,8.0,14.0,4.0,9.0,4.0,11.0,12.0,11.0,8.0,8.0,11.0,10.0,9.0,8.0,11.0,9.0,8.0,11.0,10.0,8.0,13.0,13.0,9.0,13.0,9.0,20.0,12.0,13.0,13.0,9.0,2.0,9.0,9.0,15.0,10.0,12.0,10.0,11.0,6.0,4.0,6.0,20.0,4.0,0.0,0.0,0.0,180.0,77.0,4.0,1.0,2.0,2.0,1.0,1.0,1.0,1.0,3.0,3.0,3.0,7.0,9.0,11.0,5.0,12.0,5.0,11.0,7.0,10.0,15.0,11.0,6.0,16.0,11.0,15.0,11.0,15.0,11.0,11.0,10.0,13.0,13.0,9.0,7.0,12.0,14.0,12.0,14.0,14.0,13.0,14.0,12.0,10.0,14.0,14.0,20.0,14.0,14.0,13.0,9.0,13.0,5.0,12.0,7.0,12.0,10.0,10.0,10.0,4.0,7.0,10.0,21.0,0.0,0.0,0.0,0.0,179.0,68.0,2.0,3.0,2.0,1.0,2.0,1.0,2.0,3.0,2.0,1.0,1.0,6.0,13.0,12.0,6.0,13.0,6.0,8.0,7.0,12.0,10.0,12.0,8.0,12.0,13.0,10.0,11.0,11.0,12.0,10.0,11.0,11.0,12.0,11.0,7.0,13.0,10.0,12.0,14.0,15.0,13.0,12.0,10.0,20.0,14.0,14.0,8.0,14.0,10.0,13.0,8.0,13.0,8.0,12.0,13.0,14.0,10.0,12.0,10.0,10.0,12.0,10.0,18.0,0.0,0.0,0.0,0.0,170.0,67.0,3.0,1.0,3.0,3.0,3.0,4.0,1.0,2.0,1.0,2.0,2.0,11.0,11.0,12.0,13.0,12.0,11.0,6.0,10.0,8.0,7.0,12.0,10.0,7.0,13.0,9.0,11.0,8.0,10.0,10.0,12.0,12.0,15.0,12.0,12.0,11.0,12.0,11.0,12.0,12.0,12.0,10.0,6.0,5.0,14.0,12.0,20.0,10.0,9.0,10.0,8.0,2.0,6.0,12.0,11.0,11.0,12.0,13.0,14.0,11.0,13.0,4.0,19.0,0.0,0.0,0.0,0.0,175.0,67.0,3.0,2.0,1.0,3.0,3.0,1.0,1.0,1.0,2.0,1.0,3.0,7.0,8.0,12.0,8.0,10.0,6.0,12.0,9.0,8.0,10.0,10.0,8.0,12.0,11.0,14.0,10.0,12.0,9.0,10.0,11.0,10.0,12.0,12.0,10.0,12.0,12.0,13.0,14.0,13.0,11.0,14.0,8.0,6.0,14.0,12.0,20.0,14.0,12.0,12.0,8.0,11.0,6.0,12.0,17.0,13.0,10.0,11.0,12.0,11.0,17.0,5.0,22.0,24.0,3.0,7.0,0.0,177.0,78.0,2.0,1.0,2.0,3.0,2.0,2.0,4.0,3.0,3.0,2.0,1.0,10.0,13.0,16.0,14.0,16.0,16.0,8.0,16.0,4.0,4.0,15.0,12.0,4.0,16.0,12.0,11.0,12.0,13.0,10.0,11.0,8.0,13.0,17.0,5.0,14.0,5.0,10.0,12.0,15.0,14.0,13.0,9.0,10.0,17.0,16.0,20.0,15.0,14.0,12.0,11.0,15.0,4.0,12.0,19.0,16.0,14.0,14.0,11.0,13.0,10.0,12.0,20.0,29.0,2.0,0.0,0.0,181.0,75.0,1.0,1.0,2.0,2.0,2.0,3.0,2.0,1.0,1.0,3.0,2.0,5.0,9.0,15.0,10.0,11.0,9.0,10.0,8.0,7.0,3.0,10.0,10.0,5.0,15.0,7.0,10.0,9.0,12.0,10.0,8.0,11.0,14.0,12.0,5.0,13.0,5.0,11.0,12.0,16.0,12.0,9.0,12.0,20.0,14.0,16.0,7.0,12.0,10.0,9.0,10.0,10.0,11.0,6.0,10.0,15.0,9.0,13.0,11.0,14.0,18.0,7.0,22.0,5.0,1.0,1.0,0.0,173.0,72.0,1.0,3.0,1.0,3.0,3.0,3.0,3.0,3.0,3.0,2.0,2.0,14.0,13.0,16.0,14.0,16.0,14.0,5.0,11.0,5.0,5.0,15.0,11.0,5.0,16.0,8.0,13.0,9.0,14.0,13.0,15.0,13.0,15.0,16.0,5.0,13.0,5.0,9.0,10.0,15.0,16.0,14.0,5.0,20.0,14.0,15.0,5.0,12.0,14.0,13.0,11.0,13.0,8.0,14.0,10.0,15.0,14.0,10.0,13.0,10.0,10.0,13.0,22.0,0.0,0.0,0.0,0.0,186.0,0.0,1.0,2.0,3.0,3.0,1.0,3.0,1.0,2.0,1.0,2.0,1.0,4.0,1.0,12.0,12.0,12.0,1.0,7.0,5.0,1.0,3.0,5.0,1.0,1.0,8.0,8.0,6.0,6.0,4.0,5.0,4.0,11.0,6.0,9.0,12.0,12.0,5.0,4.0,5.0,12.0,12.0,5.0,11.0,12.0,10.0,12.0,20.0,6.0,8.0,8.0,8.0,8.0,7.0,8.0,13.0,11.0,12.0,13.0,12.0,5.0,14.0,5.0
0,4,33.0,0.0,0.0,3.0,0.0,188.0,84.0,14.0,13.0,13.0,9.0,13.0,13.0,15.0,15.0,11.0,11.0,9.0,7.0,3.0,3.0,1.0,7.0,10.0,2.0,1.0,1.0,2.0,6.0,4.0,1.0,7.0,8.0,13.0,14.0,14.0,14.0,8.0,11.0,15.0,6.0,13.0,3.0,13.0,12.0,8.0,12.0,14.0,15.0,14.0,8.0,13.0,11.0,20.0,13.0,15.0,16.0,8.0,13.0,6.0,1.0,11.0,14.0,13.0,11.0,16.0,14.0,11.0,6.0,28.0,0.0,0.0,0.0,0.0,193.0,84.0,1.0,1.0,2.0,2.0,2.0,3.0,2.0,3.0,2.0,1.0,3.0,4.0,8.0,8.0,9.0,10.0,6.0,14.0,7.0,8.0,14.0,12.0,6.0,14.0,11.0,12.0,13.0,14.0,11.0,14.0,12.0,12.0,14.0,6.0,11.0,8.0,14.0,13.0,13.0,11.0,11.0,16.0,16.0,20.0,12.0,12.0,8.0,14.0,16.0,14.0,12.0,13.0,6.0,10.0,7.0,12.0,15.0,12.0,16.0,15.0,13.0,6.0,29.0,2.0,0.0,0.0,0.0,185.0,75.0,2.0,3.0,3.0,3.0,2.0,3.0,2.0,1.0,3.0,1.0,2.0,4.0,10.0,8.0,6.0,10.0,6.0,14.0,7.0,7.0,14.0,11.0,6.0,14.0,9.0,13.0,13.0,14.0,11.0,12.0,12.0,12.0,14.0,8.0,11.0,12.0,13.0,13.0,13.0,15.0,12.0,15.0,12.0,8.0,15.0,13.0,20.0,14.0,15.0,14.0,7.0,14.0,8.0,6.0,14.0,13.0,15.0,14.0,14.0,14.0,14.0,6.0,27.0,0.0,0.0,0.0,0.0,175.0,64.0,1.0,1.0,1.0,2.0,1.0,4.0,2.0,1.0,1.0,3.0,3.0,7.0,13.0,9.0,6.0,12.0,6.0,12.0,10.0,10.0,14.0,13.0,6.0,13.0,12.0,14.0,13.0,13.0,12.0,12.0,10.0,12.0,14.0,7.0,9.0,11.0,12.0,13.0,15.0,14.0,13.0,15.0,11.0,10.0,12.0,12.0,20.0,14.0,12.0,12.0,12.0,13.0,10.0,10.0,10.0,12.0,14.0,13.0,14.0,15.0,15.0,6.0,26.0,0.0,0.0,0.0,0.0,182.0,68.0,1.0,4.0,3.0,2.0,3.0,1.0,2.0,1.0,2.0,4.0,1.0,7.0,12.0,9.0,5.0,10.0,6.0,12.0,7.0,15.0,12.0,9.0,6.0,12.0,10.0,12.0,13.0,14.0,11.0,10.0,9.0,9.0,13.0,7.0,6.0,10.0,10.0,14.0,15.0,16.0,13.0,13.0,11.0,5.0,15.0,15.0,20.0,14.0,10.0,12.0,12.0,13.0,7.0,12.0,12.0,14.0,14.0,15.0,13.0,14.0,14.0,7.0,27.0,32.0,6.0,0.0,0.0,188.0,78.0,3.0,2.0,3.0,2.0,1.0,3.0,3.0,3.0,2.0,2.0,2.0,4.0,8.0,11.0,12.0,12.0,6.0,16.0,13.0,8.0,13.0,14.0,7.0,12.0,12.0,12.0,10.0,14.0,13.0,12.0,11.0,12.0,15.0,9.0,11.0,12.0,6.0,13.0,12.0,14.0,13.0,15.0,15.0,5.0,13.0,12.0,20.0,16.0,15.0,14.0,12.0,15.0,11.0,10.0,9.0,15.0,12.0,12.0,13.0,13.0,13.0,7.0,21.0,0.0,0.0,0.0,0.0,183.0,73.0,1.0,4.0,3.0,3.0,3.0,1.0,4.0,1.0,2.0,3.0,2.0,11.0,10.0,12.0,11.0,13.0,9.0,12.0,10.0,5.0,8.0,12.0,9.0,8.0,13.0,13.0,12.0,12.0,10.0,12.0,14.0,12.0,12.0,14.0,8.0,12.0,8.0,12.0,12.0,14.0,14.0,14.0,11.0,8.0,13.0,13.0,20.0,12.0,12.0,12.0,5.0,10.0,7.0,12.0,15.0,11.0,11.0,10.0,11.0,12.0,11.0,4.0,29.0,0.0,0.0,0.0,0.0,183.0,78.0,1.0,3.0,3.0,3.0,3.0,1.0,2.0,3.0,3.0,1.0,1.0,13.0,8.0,9.0,6.0,12.0,14.0,13.0,10.0,12.0,11.0,12.0,8.0,13.0,12.0,12.0,15.0,13.0,13.0,13.0,11.0,13.0,15.0,6.0,12.0,7.0,13.0,16.0,18.0,12.0,11.0,14.0,12.0,20.0,14.0,11.0,8.0,16.0,14.0,14.0,12.0,14.0,6.0,12.0,10.0,12.0,13.0,11.0,15.0,15.0,15.0,5.0,29.0,0.0,0.0,0.0,0.0,180.0,71.0,1.0,3.0,1.0,1.0,1.0,4.0,4.0,1.0,1.0,2.0,3.0,10.0,11.0,12.0,9.0,13.0,11.0,8.0,14.0,6.0,8.0,11.0,10.0,8.0,12.0,10.0,11.0,12.0,12.0,9.0,12.0,11.0,14.0,12.0,7.0,12.0,10.0,12.0,14.0,15.0,14.0,12.0,10.0,20.0,16.0,13.0,12.0,15.0,10.0,13.0,10.0,15.0,7.0,8.0,16.0,12.0,12.0,13.0,14.0,15.0,15.0,6.0,19.0,0.0,0.0,0.0,0.0,185.0,80.0,3.0,2.0,2.0,3.0,3.0,4.0,3.0,3.0,3.0,2.0,1.0,8.0,12.0,13.0,8.0,12.0,13.0,12.0,9.0,6.0,12.0,13.0,9.0,13.0,12.0,12.0,13.0,12.0,12.0,10.0,12.0,12.0,4.0,13.0,8.0,12.0,8.0,12.0,14.0,13.0,14.0,12.0,11.0,5.0,15.0,14.0,20.0,13.0,13.0,12.0,10.0,9.0,11.0,15.0,15.0,9.0,10.0,9.0,12.0,11.0,10.0,5.0,23.0,1.0,0.0,0.0,0.0,185.0,70.0,4.0,3.0,1.0,2.0,1.0,3.0,2.0,3.0,1.0,2.0,3.0,5.0,8.0,12.0,13.0,13.0,7.0,14.0,11.0,5.0,5.0,8.0,13.0,5.0,13.0,6.0,13.0,10.0,12.0,12.0,11.0,11.0,13.0,12.0,7.0,13.0,9.0,8.0,10.0,16.0,12.0,14.0,12.0,8.0,14.0,15.0,20.0,13.0,13.0,12.0,7.0,15.0,7.0,7.0,13.0,13.0,12.0,10.0,12.0,15.0,15.0,7.0,20.0,0.0,0.0,0.0,0.0,192.0,80.0,14.0,9.0,9.0,11.0,12.0,11.0,14.0,12.0,10.0,12.0,12.0,4.0,3.0,3.0,1.0,8.0,7.0,7.0,2.0,2.0,2.0,8.0,2.0,3.0,6.0,10.0,8.0,11.0,10.0,9.0,9.0,9.0,13.0,8.0,12.0,2.0,10.0,11.0,11.0,13.0,14.0,15.0,17.0,5.0,14.0,12.0,20.0,12.0,15.0,10.0,10.0,11.0,7.0,1.0,11.0,13.0,13.0,12.0,12.0,15.0,14.0,9.0,28.0,46.0,3.0,14.0,3.0,190.0,80.0,2.0,3.0,3.0,2.0,2.0,1.0,1.0,3.0,1.0,3.0,1.0,4.0,6.0,7.0,9.0,11.0,7.0,17.0,11.0,10.0,15.0,12.0,11.0,16.0,10.0,17.0,15.0,18.0,13.0,14.0,12.0,14.0,18.0,6.0,17.0,8.0,15.0,15.0,14.0,11.0,10.0,17.0,16.0,7.0,17.0,13.0,20.0,15.0,18.0,17.0,14.0,16.0,4.0,6.0,14.0,15.0,16.0,17.0,18.0,14.0,15.0,6.0,32.0,0.0,0.0,3.0,0.0,187.0,82.0,1.0,2.0,2.0,3.0,2.0,1.0,1.0,2.0,2.0,3.0,1.0,5.0,11.0,8.0,7.0,10.0,6.0,15.0,9.0,13.0,15.0,10.0,8.0,16.0,9.0,16.0,14.0,17.0,12.0,15.0,8.0,12.0,17.0,9.0,14.0,11.0,13.0,15.0,13.0,12.0,11.0,16.0,14.0,6.0,13.0,14.0,20.0,13.0,16.0,15.0,14.0,14.0,8.0,14.0,14.0,14.0,15.0,16.0,15.0,12.0,10.0,7.0,23.0,0.0,0.0,0.0,0.0,184.0,77.0,1.0,1.0,1.0,1.0,3.0,2.0,3.0,2.0,2.0,2.0,3.0,6.0,9.0,11.0,7.0,12.0,7.0,15.0,9.0,11.0,14.0,13.0,10.0,15.0,12.0,14.0,15.0,15.0,13.0,12.0,11.0,13.0,15.0,11.0,9.0,9.0,14.0,14.0,14.0,14.0,13.0,15.0,13.0,9.0,16.0,15.0,20.0,14.0,14.0,14.0,11.0,14.0,4.0,11.0,14.0,13.0,15.0,14.0,16.0,14.0,15.0,6.0,23.0,0.0,0.0,1.0,0.0,182.0,71.0,3.0,1.0,2.0,3.0,4.0,2.0,3.0,1.0,2.0,1.0,3.0,9.0,13.0,14.0,8.0,14.0,13.0,12.0,10.0,13.0,14.0,14.0,13.0,15.0,13.0,14.0,14.0,13.0,11.0,12.0,12.0,13.0,16.0,12.0,12.0,15.0,13.0,14.0,15.0,15.0,13.0,14.0,12.0,9.0,16.0,15.0,20.0,15.0,15.0,15.0,10.0,14.0,6.0,12.0,8.0,15.0,14.0,16.0,15.0,15.0,16.0,6.0,19.0,0.0,0.0,12.0,4.0,177.0,75.0,2.0,1.0,1.0,1.0,2.0,2.0,3.0,1.0,1.0,3.0,3.0,11.0,12.0,13.0,8.0,15.0,11.0,5.0,12.0,8.0,5.0,15.0,16.0,8.0,16.0,10.0,12.0,14.0,13.0,13.0,13.0,11.0,10.0,15.0,9.0,12.0,5.0,10.0,7.0,13.0,15.0,7.0,9.0,14.0,13.0,13.0,20.0,11.0,6.0,12.0,11.0,13.0,5.0,11.0,12.0,15.0,16.0,14.0,12.0,15.0,15.0,5.0,29.0,90.0,4.0,16.0,2.0,170.0,61.0,2.0,3.0,3.0,1.0,3.0,1.0,2.0,2.0,2.0,2.0,1.0,15.0,14.0,15.0,9.0,17.0,16.0,7.0,12.0,4.0,11.0,18.0,15.0,12.0,17.0,15.0,15.0,16.0,13.0,16.0,17.0,14.0,16.0,15.0,14.0,12.0,14.0,18.0,16.0,13.0,14.0,12.0,8.0,10.0,14.0,11.0,20.0,14.0,10.0,14.0,9.0,17.0,10.0,14.0,13.0,17.0,15.0,16.0,17.0,15.0,16.0,7.0,31.0,0.0,0.0,6.0,0.0,174.0,80.0,1.0,1.0,1.0,1.0,1.0,5.0,1.0,1.0,1.0,1.0,1.0,14.0,12.0,11.0,7.0,12.0,13.0,9.0,7.0,10.0,11.0,11.0,10.0,10.0,12.0,11.0,11.0,11.0,10.0,6.0,10.0,9.0,12.0,12.0,12.0,10.0,12.0,12.0,14.0,12.0,15.0,10.0,9.0,20.0,12.0,12.0,7.0,12.0,9.0,9.0,10.0,12.0,7.0,9.0,11.0,14.0,9.0,7.0,14.0,8.0,9.0,9.0,20.0,0.0,0.0,10.0,1.0,174.0,68.0,1.0,3.0,3.0,3.0,2.0,3.0,3.0,2.0,1.0,2.0,2.0,11.0,12.0,15.0,11.0,14.0,12.0,6.0,12.0,2.0,4.0,14.0,11.0,4.0,15.0,9.0,11.0,10.0,12.0,11.0,14.0,12.0,14.0,14.0,7.0,13.0,7.0,11.0,13.0,14.0,15.0,13.0,7.0,20.0,12.0,14.0,10.0,13.0,9.0,12.0,7.0,12.0,10.0,12.0,15.0,16.0,12.0,14.0,13.0,15.0,15.0,5.0,19.0,0.0,0.0,0.0,0.0,185.0,65.0,1.0,3.0,4.0,2.0,1.0,3.0,3.0,1.0,3.0,3.0,1.0,4.0,12.0,12.0,9.0,11.0,8.0,12.0,10.0,6.0,4.0,10.0,12.0,6.0,13.0,8.0,11.0,11.0,11.0,11.0,10.0,11.0,11.0,13.0,7.0,13.0,7.0,11.0,13.0,14.0,12.0,14.0,14.0,20.0,13.0,15.0,8.0,12.0,8.0,11.0,8.0,12.0,8.0,11.0,7.0,12.0,9.0,12.0,12.0,13.0,15.0,5.0,26.0,40.0,16.0,6.0,2.0,183.0,79.0,1.0,2.0,1.0,2.0,2.0,1.0,2.0,1.0,3.0,2.0,2.0,9.0,14.0,16.0,14.0,17.0,13.0,10.0,13.0,4.0,5.0,15.0,14.0,7.0,17.0,12.0,13.0,10.0,14.0,12.0,14.0,15.0,14.0,17.0,13.0,12.0,7.0,11.0,11.0,14.0,15.0,14.0,11.0,11.0,8.0,15.0,20.0,12.0,12.0,13.0,12.0,15.0,16.0,13.0,13.0,15.0,13.0,13.0,15.0,16.0,18.0,7.0
0,0,26.0,2.0,0.0,1.0,0.0,188.0,84.0,12.0,13.0,15.0,9.0,15.0,13.0,13.0,15.0,10.0,11.0,14.0,9.0,2.0,1.0,2.0,12.0,11.0,3.0,2.0,3.0,3.0,11.0,3.0,1.0,10.0,14.0,13.0,14.0,10.0,13.0,11.0,11.0,14.0,3.0,11.0,5.0,12.0,15.0,13.0,10.0,12.0,13.0,14.0,5.0,14.0,9.0,20.0,12.0,14.0,12.0,10.0,15.0,3.0,11.0,12.0,11.0,16.0,13.0,15.0,16.0,16.0,4.0,29.0,0.0,0.0,0.0,0.0,183.0,74.0,3.0,3.0,3.0,3.0,3.0,2.0,2.0,2.0,1.0,3.0,1.0,5.0,12.0,7.0,6.0,10.0,7.0,14.0,12.0,5.0,14.0,12.0,6.0,13.0,11.0,14.0,13.0,17.0,13.0,16.0,12.0,12.0,13.0,9.0,8.0,9.0,14.0,14.0,15.0,13.0,12.0,15.0,12.0,6.0,17.0,11.0,20.0,17.0,13.0,14.0,14.0,15.0,5.0,13.0,9.0,14.0,19.0,15.0,14.0,11.0,11.0,6.0,19.0,1.0,0.0,0.0,0.0,182.0,67.0,1.0,3.0,2.0,1.0,2.0,3.0,1.0,1.0,2.0,1.0,1.0,7.0,7.0,8.0,4.0,10.0,7.0,9.0,9.0,7.0,14.0,9.0,7.0,13.0,9.0,9.0,10.0,8.0,9.0,8.0,9.0,14.0,2.0,7.0,12.0,7.0,8.0,8.0,12.0,12.0,10.0,9.0,11.0,5.0,13.0,8.0,20.0,11.0,8.0,9.0,5.0,4.0,9.0,9.0,10.0,12.0,13.0,9.0,10.0,13.0,12.0,3.0,22.0,0.0,0.0,0.0,0.0,178.0,73.0,3.0,2.0,2.0,1.0,2.0,4.0,3.0,1.0,3.0,1.0,2.0,6.0,12.0,12.0,6.0,11.0,7.0,8.0,8.0,11.0,12.0,10.0,8.0,13.0,11.0,12.0,12.0,13.0,11.0,10.0,11.0,11.0,13.0,6.0,7.0,12.0,9.0,13.0,14.0,16.0,14.0,13.0,9.0,6.0,14.0,15.0,20.0,15.0,14.0,12.0,12.0,13.0,6.0,14.0,12.0,15.0,13.0,13.0,14.0,14.0,14.0,6.0,21.0,0.0,0.0,0.0,0.0,172.0,68.0,3.0,3.0,1.0,2.0,1.0,2.0,3.0,2.0,2.0,3.0,2.0,12.0,13.0,12.0,8.0,12.0,12.0,5.0,8.0,12.0,11.0,13.0,8.0,13.0,12.0,14.0,13.0,14.0,13.0,13.0,10.0,11.0,15.0,9.0,13.0,13.0,12.0,13.0,14.0,12.0,12.0,12.0,6.0,20.0,13.0,13.0,13.0,13.0,11.0,12.0,10.0,10.0,11.0,9.0,20.0,13.0,15.0,12.0,16.0,13.0,13.0,8.0,21.0,4.0,1.0,0.0,0.0,176.0,60.0,1.0,1.0,3.0,2.0,3.0,2.0,1.0,3.0,3.0,4.0,2.0,9.0,10.0,13.0,9.0,13.0,8.0,7.0,12.0,7.0,11.0,13.0,7.0,12.0,11.0,9.0,14.0,12.0,9.0,11.0,12.0,11.0,10.0,9.0,5.0,10.0,12.0,12.0,15.0,15.0,14.0,13.0,7.0,12.0,10.0,12.0,20.0,14.0,4.0,9.0,9.0,9.0,7.0,5.0,15.0,16.0,12.0,10.0,9.0,16.0,8.0,3.0,25.0,5.0,0.0,5.0,0.0,186.0,72.0,1.0,2.0,1.0,2.0,2.0,3.0,3.0,3.0,3.0,3.0,2.0,13.0,12.0,14.0,9.0,16.0,15.0,11.0,12.0,5.0,8.0,16.0,11.0,10.0,15.0,8.0,13.0,11.0,14.0,13.0,15.0,14.0,15.0,14.0,11.0,13.0,10.0,12.0,12.0,13.0,14.0,14.0,10.0,10.0,13.0,11.0,20.0,11.0,11.0,13.0,9.0,15.0,13.0,7.0,15.0,17.0,14.0,13.0,15.0,15.0,15.0,7.0,25.0,0.0,0.0,3.0,2.0,170.0,61.0,2.0,3.0,2.0,2.0,1.0,3.0,2.0,2.0,1.0,2.0,1.0,11.0,12.0,13.0,10.0,13.0,8.0,5.0,8.0,7.0,4.0,14.0,10.0,4.0,15.0,11.0,10.0,9.0,7.0,10.0,14.0,8.0,13.0,13.0,6.0,12.0,8.0,8.0,12.0,16.0,14.0,7.0,5.0,12.0,15.0,16.0,20.0,14.0,6.0,12.0,11.0,13.0,8.0,8.0,8.0,13.0,15.0,10.0,10.0,14.0,14.0,8.0,20.0,0.0,0.0,2.0,0.0,180.0,75.0,3.0,1.0,2.0,2.0,3.0,2.0,1.0,1.0,3.0,3.0,1.0,8.0,13.0,14.0,9.0,13.0,8.0,10.0,9.0,6.0,5.0,12.0,6.0,5.0,14.0,8.0,13.0,12.0,13.0,12.0,12.0,12.0,7.0,13.0,8.0,14.0,7.0,12.0,13.0,15.0,13.0,14.0,10.0,8.0,14.0,15.0,20.0,13.0,12.0,13.0,11.0,9.0,7.0,13.0,9.0,11.0,11.0,11.0,12.0,11.0,10.0,1.0,18.0,0.0,0.0,0.0,0.0,179.0,67.0,3.0,3.0,2.0,4.0,2.0,4.0,3.0,1.0,3.0,4.0,1.0,5.0,7.0,12.0,9.0,12.0,12.0,10.0,12.0,6.0,4.0,12.0,12.0,3.0,14.0,11.0,12.0,11.0,11.0,8.0,13.0,12.0,12.0,12.0,6.0,12.0,5.0,10.0,12.0,15.0,11.0,12.0,10.0,20.0,13.0,14.0,8.0,14.0,8.0,9.0,6.0,14.0,5.0,10.0,16.0,13.0,12.0,12.0,13.0,9.0,15.0,2.0,30.0,5.0,0.0,22.0,9.0,181.0,84.0,2.0,3.0,3.0,1.0,2.0,3.0,3.0,1.0,3.0,1.0,3.0,7.0,10.0,12.0,13.0,11.0,7.0,13.0,10.0,12.0,6.0,11.0,13.0,6.0,13.0,17.0,13.0,16.0,11.0,13.0,11.0,11.0,17.0,14.0,8.0,14.0,9.0,13.0,17.0,15.0,12.0,15.0,11.0,8.0,14.0,15.0,20.0,14.0,14.0,13.0,9.0,13.0,7.0,10.0,7.0,16.0,13.0,14.0,13.0,15.0,15.0,10.0,36.0,0.0,0.0,0.0,0.0,185.0,78.0,11.0,14.0,12.0,7.0,13.0,12.0,14.0,15.0,13.0,14.0,10.0,4.0,1.0,3.0,1.0,8.0,8.0,11.0,8.0,3.0,3.0,7.0,2.0,1.0,8.0,11.0,13.0,15.0,11.0,12.0,7.0,13.0,9.0,5.0,14.0,3.0,13.0,15.0,8.0,11.0,14.0,13.0,12.0,5.0,15.0,11.0,20.0,12.0,14.0,13.0,11.0,13.0,8.0,1.0,19.0,14.0,16.0,10.0,17.0,9.0,9.0,11.0,21.0,0.0,0.0,0.0,0.0,182.0,74.0,2.0,2.0,2.0,2.0,2.0,1.0,1.0,1.0,3.0,2.0,2.0,9.0,11.0,12.0,7.0,9.0,8.0,12.0,7.0,11.0,12.0,7.0,8.0,13.0,11.0,12.0,12.0,14.0,12.0,13.0,7.0,12.0,11.0,1.0,9.0,11.0,9.0,10.0,12.0,14.0,10.0,13.0,11.0,9.0,8.0,12.0,20.0,13.0,11.0,10.0,13.0,8.0,10.0,10.0,15.0,11.0,13.0,10.0,10.0,8.0,13.0,7.0,28.0,8.0,0.0,1.0,0.0,182.0,79.0,1.0,1.0,3.0,2.0,4.0,1.0,3.0,3.0,1.0,1.0,3.0,5.0,9.0,9.0,9.0,11.0,6.0,13.0,8.0,12.0,14.0,9.0,8.0,14.0,11.0,14.0,14.0,15.0,10.0,13.0,7.0,12.0,16.0,8.0,8.0,9.0,14.0,13.0,14.0,15.0,12.0,13.0,11.0,5.0,13.0,14.0,20.0,15.0,14.0,12.0,14.0,13.0,7.0,15.0,11.0,13.0,10.0,13.0,10.0,11.0,12.0,5.0,28.0,0.0,0.0,0.0,0.0,183.0,81.0,1.0,2.0,4.0,1.0,1.0,3.0,2.0,3.0,3.0,3.0,1.0,5.0,5.0,6.0,10.0,12.0,6.0,14.0,8.0,6.0,15.0,11.0,6.0,13.0,12.0,13.0,14.0,16.0,14.0,14.0,10.0,12.0,14.0,5.0,14.0,8.0,14.0,15.0,15.0,9.0,12.0,15.0,13.0,7.0,11.0,12.0,20.0,15.0,15.0,14.0,14.0,14.0,9.0,8.0,14.0,14.0,11.0,13.0,15.0,13.0,15.0,6.0,21.0,0.0,0.0,1.0,0.0,177.0,68.0,4.0,1.0,2.0,1.0,1.0,1.0,1.0,1.0,2.0,1.0,2.0,5.0,12.0,9.0,7.0,12.0,8.0,13.0,10.0,16.0,13.0,12.0,8.0,14.0,12.0,12.0,13.0,12.0,12.0,12.0,10.0,13.0,15.0,11.0,13.0,11.0,13.0,13.0,14.0,13.0,14.0,13.0,11.0,10.0,14.0,12.0,20.0,12.0,14.0,12.0,11.0,12.0,8.0,14.0,13.0,10.0,14.0,12.0,14.0,12.0,11.0,5.0,24.0,0.0,0.0,0.0,0.0,188.0,75.0,1.0,3.0,2.0,2.0,1.0,1.0,2.0,1.0,3.0,3.0,1.0,15.0,11.0,11.0,12.0,13.0,15.0,11.0,12.0,9.0,6.0,15.0,13.0,6.0,11.0,11.0,12.0,12.0,14.0,14.0,14.0,14.0,14.0,12.0,12.0,11.0,8.0,13.0,13.0,11.0,12.0,9.0,15.0,20.0,12.0,10.0,8.0,13.0,9.0,12.0,7.0,14.0,11.0,11.0,14.0,14.0,12.0,11.0,10.0,11.0,10.0,6.0,19.0,0.0,0.0,0.0,0.0,184.0,72.0,2.0,2.0,3.0,2.0,1.0,2.0,1.0,3.0,2.0,1.0,2.0,11.0,9.0,9.0,10.0,15.0,11.0,11.0,16.0,8.0,14.0,11.0,9.0,16.0,10.0,11.0,13.0,6.0,12.0,11.0,10.0,12.0,12.0,7.0,4.0,12.0,13.0,12.0,15.0,14.0,9.0,13.0,12.0,7.0,13.0,11.0,20.0,10.0,12.0,10.0,11.0,8.0,8.0,11.0,12.0,14.0,8.0,13.0,12.0,5.0,9.0,3.0,18.0,2.0,0.0,0.0,0.0,179.0,71.0,2.0,1.0,2.0,1.0,2.0,2.0,4.0,4.0,1.0,2.0,2.0,4.0,6.0,1.0,4.0,11.0,6.0,13.0,6.0,4.0,10.0,7.0,1.0,13.0,7.0,9.0,8.0,8.0,6.0,7.0,5.0,13.0,9.0,9.0,6.0,2.0,11.0,7.0,11.0,11.0,11.0,7.0,8.0,5.0,9.0,10.0,20.0,13.0,6.0,8.0,9.0,9.0,9.0,9.0,14.0,12.0,10.0,12.0,12.0,12.0,14.0,3.0,33.0,0.0,0.0,0.0,0.0,187.0,76.0,2.0,2.0,3.0,1.0,1.0,3.0,2.0,1.0,2.0,3.0,2.0,15.0,14.0,14.0,10.0,15.0,13.0,10.0,12.0,7.0,4.0,15.0,13.0,7.0,15.0,6.0,12.0,9.0,14.0,11.0,15.0,12.0,12.0,14.0,12.0,13.0,7.0,13.0,12.0,11.0,12.0,14.0,12.0,14.0,15.0,12.0,20.0,11.0,12.0,12.0,6.0,14.0,6.0,11.0,14.0,13.0,12.0,12.0,15.0,15.0,13.0,9.0,21.0,0.0,0.0,4.0,1.0,184.0,79.0,1.0,2.0,3.0,1.0,2.0,1.0,3.0,2.0,2.0,1.0,3.0,3.0,6.0,10.0,12.0,12.0,7.0,15.0,8.0,4.0,5.0,13.0,10.0,8.0,12.0,18.0,12.0,19.0,13.0,10.0,13.0,12.0,14.0,13.0,10.0,12.0,9.0,16.0,15.0,12.0,14.0,14.0,14.0,12.0,13.0,10.0,20.0,14.0,14.0,11.0,14.0,14.0,11.0,5.0,10.0,13.0,14.0,15.0,10.0,8.0,4.0,15.0,26.0,0.0,0.0,0.0,0.0,193.0,81.0,1.0,3.0,3.0,3.0,3.0,1.0,2.0,2.0,2.0,3.0,3.0,4.0,9.0,14.0,10.0,13.0,12.0,14.0,14.0,5.0,5.0,10.0,12.0,3.0,14.0,8.0,13.0,12.0,9.0,10.0,11.0,11.0,12.0,16.0,5.0,14.0,6.0,9.0,12.0,14.0,13.0,14.0,16.0,14.0,13.0,13.0,20.0,13.0,14.0,10.0,8.0,14.0,9.0,8.0,16.0,16.0,11.0,13.0,11.0,13.0,13.0,10.0
2,1,27.0,0.0,0.0,0.0,0.0,185.0,81.0,13.0,11.0,11.0,9.0,11.0,11.0,12.0,13.0,11.0,14.0,8.0,4.0,1.0,1.0,2.0,9.0,8.0,7.0,2.0,2.0,1.0,8.0,5.0,1.0,8.0,10.0,12.0,15.0,12.0,12.0,8.0,11.0,14.0,6.0,11.0,2.0,11.0,12.0,6.0,12.0,13.0,14.0,13.0,5.0,14.0,10.0,20.0,12.0,13.0,12.0,10.0,13.0,10.0,1.0,10.0,14.0,14.0,12.0,13.0,14.0,11.0,7.0,33.0,24.0,1.0,3.0,0.0,193.0,90.0,1.0,2.0,2.0,2.0,3.0,2.0,3.0,1.0,3.0,2.0,3.0,3.0,6.0,8.0,8.0,11.0,10.0,17.0,8.0,5.0,13.0,10.0,7.0,14.0,11.0,14.0,14.0,16.0,11.0,10.0,9.0,10.0,14.0,7.0,13.0,7.0,13.0,14.0,11.0,9.0,10.0,15.0,15.0,7.0,13.0,10.0,20.0,10.0,13.0,10.0,13.0,15.0,9.0,8.0,12.0,15.0,13.0,11.0,15.0,12.0,13.0,7.0,16.0,0.0,0.0,0.0,0.0,177.0,0.0,3.0,2.0,1.0,1.0,3.0,3.0,2.0,2.0,2.0,1.0,3.0,1.0,3.0,2.0,2.0,4.0,1.0,3.0,1.0,6.0,9.0,2.0,1.0,9.0,6.0,14.0,4.0,5.0,5.0,3.0,2.0,5.0,4.0,5.0,7.0,4.0,8.0,4.0,3.0,10.0,7.0,13.0,7.0,15.0,13.0,9.0,20.0,5.0,8.0,7.0,11.0,5.0,8.0,8.0,11.0,11.0,5.0,14.0,20.0,7.0,12.0,5.0,24.0,0.0,0.0,0.0,0.0,178.0,77.0,2.0,1.0,3.0,2.0,1.0,3.0,3.0,3.0,1.0,3.0,2.0,5.0,10.0,8.0,5.0,9.0,6.0,11.0,8.0,12.0,11.0,8.0,6.0,12.0,9.0,11.0,11.0,13.0,11.0,12.0,7.0,11.0,15.0,9.0,6.0,9.0,11.0,12.0,14.0,16.0,12.0,14.0,10.0,5.0,15.0,15.0,20.0,14.0,13.0,14.0,11.0,13.0,5.0,8.0,17.0,12.0,14.0,14.0,14.0,14.0,14.0,6.0,23.0,0.0,0.0,8.0,0.0,183.0,77.0,2.0,3.0,1.0,2.0,1.0,3.0,3.0,3.0,3.0,2.0,2.0,7.0,13.0,12.0,7.0,12.0,6.0,8.0,9.0,11.0,12.0,9.0,7.0,12.0,12.0,10.0,12.0,14.0,13.0,12.0,11.0,11.0,15.0,11.0,7.0,13.0,12.0,12.0,13.0,16.0,13.0,14.0,11.0,8.0,15.0,15.0,20.0,13.0,13.0,11.0,10.0,13.0,7.0,8.0,11.0,13.0,14.0,11.0,14.0,15.0,15.0,5.0,30.0,0.0,0.0,0.0,0.0,178.0,79.0,1.0,2.0,2.0,3.0,2.0,2.0,1.0,2.0,1.0,2.0,1.0,11.0,13.0,9.0,6.0,11.0,11.0,12.0,11.0,10.0,12.0,12.0,7.0,13.0,11.0,15.0,13.0,15.0,11.0,12.0,10.0,12.0,13.0,12.0,15.0,10.0,12.0,16.0,15.0,14.0,12.0,13.0,9.0,5.0,13.0,12.0,20.0,15.0,14.0,14.0,14.0,13.0,9.0,14.0,18.0,12.0,15.0,14.0,14.0,14.0,14.0,6.0,26.0,0.0,0.0,0.0,0.0,184.0,76.0,2.0,3.0,1.0,3.0,1.0,1.0,3.0,1.0,3.0,2.0,2.0,10.0,12.0,14.0,12.0,14.0,12.0,11.0,13.0,11.0,13.0,14.0,13.0,12.0,15.0,14.0,13.0,12.0,11.0,11.0,13.0,14.0,14.0,12.0,13.0,12.0,11.0,11.0,14.0,15.0,14.0,13.0,10.0,5.0,14.0,14.0,20.0,14.0,14.0,14.0,7.0,16.0,6.0,8.0,19.0,14.0,14.0,14.0,14.0,14.0,14.0,6.0,22.0,0.0,0.0,0.0,0.0,188.0,79.0,1.0,2.0,2.0,3.0,2.0,2.0,3.0,4.0,3.0,2.0,1.0,8.0,10.0,11.0,7.0,11.0,8.0,10.0,8.0,7.0,8.0,10.0,10.0,11.0,11.0,11.0,12.0,13.0,11.0,10.0,8.0,11.0,10.0,8.0,8.0,12.0,10.0,12.0,15.0,13.0,12.0,14.0,14.0,20.0,13.0,12.0,8.0,14.0,14.0,12.0,10.0,6.0,8.0,15.0,11.0,11.0,11.0,11.0,11.0,10.0,12.0,6.0,28.0,0.0,0.0,0.0,0.0,181.0,75.0,4.0,2.0,1.0,3.0,3.0,3.0,2.0,2.0,2.0,2.0,2.0,13.0,12.0,12.0,9.0,12.0,13.0,7.0,11.0,7.0,7.0,13.0,5.0,7.0,13.0,9.0,13.0,3.0,12.0,11.0,12.0,12.0,3.0,12.0,14.0,12.0,9.0,12.0,13.0,13.0,13.0,10.0,11.0,20.0,13.0,12.0,6.0,13.0,9.0,13.0,6.0,13.0,8.0,10.0,20.0,12.0,14.0,11.0,13.0,10.0,11.0,4.0,25.0,1.0,1.0,0.0,0.0,182.0,70.0,2.0,1.0,2.0,3.0,3.0,2.0,2.0,4.0,1.0,3.0,2.0,9.0,7.0,13.0,13.0,12.0,6.0,13.0,12.0,8.0,8.0,10.0,14.0,6.0,11.0,13.0,10.0,13.0,12.0,12.0,10.0,12.0,13.0,8.0,9.0,14.0,8.0,11.0,12.0,14.0,13.0,14.0,11.0,8.0,13.0,14.0,20.0,13.0,13.0,12.0,6.0,12.0,6.0,11.0,14.0,11.0,10.0,11.0,10.0,9.0,19.0,5.0,18.0,0.0,0.0,0.0,0.0,184.0,71.0,2.0,3.0,2.0,3.0,1.0,2.0,1.0,3.0,2.0,1.0,3.0,8.0,10.0,14.0,10.0,12.0,8.0,5.0,10.0,3.0,5.0,12.0,7.0,6.0,13.0,8.0,8.0,8.0,11.0,8.0,11.0,14.0,12.0,10.0,11.0,10.0,9.0,9.0,13.0,14.0,13.0,5.0,10.0,10.0,13.0,14.0,20.0,12.0,8.0,10.0,8.0,10.0,4.0,10.0,11.0,12.0,11.0,12.0,13.0,11.0,13.0,6.0,24.0,0.0,0.0,0.0,0.0,186.0,80.0,9.0,10.0,13.0,6.0,12.0,11.0,13.0,14.0,11.0,12.0,7.0,5.0,2.0,2.0,3.0,9.0,10.0,2.0,2.0,2.0,1.0,8.0,2.0,1.0,9.0,8.0,11.0,13.0,9.0,10.0,7.0,9.0,14.0,6.0,9.0,1.0,11.0,12.0,6.0,10.0,13.0,14.0,13.0,20.0,14.0,7.0,5.0,12.0,14.0,10.0,8.0,14.0,7.0,1.0,15.0,13.0,15.0,11.0,14.0,13.0,12.0,8.0,23.0,0.0,0.0,0.0,0.0,188.0,75.0,2.0,2.0,2.0,2.0,3.0,4.0,2.0,2.0,2.0,3.0,3.0,4.0,10.0,7.0,5.0,10.0,7.0,13.0,10.0,5.0,13.0,11.0,6.0,13.0,12.0,13.0,13.0,14.0,11.0,11.0,8.0,11.0,12.0,5.0,6.0,10.0,12.0,13.0,14.0,13.0,11.0,15.0,14.0,5.0,14.0,12.0,20.0,14.0,14.0,12.0,13.0,11.0,7.0,12.0,9.0,12.0,11.0,7.0,12.0,10.0,10.0,8.0,24.0,0.0,0.0,0.0,0.0,185.0,70.0,3.0,2.0,3.0,2.0,2.0,1.0,2.0,1.0,1.0,2.0,3.0,5.0,6.0,9.0,7.0,11.0,8.0,15.0,12.0,7.0,14.0,13.0,7.0,11.0,11.0,11.0,14.0,14.0,13.0,9.0,9.0,12.0,4.0,8.0,5.0,10.0,12.0,15.0,12.0,11.0,11.0,14.0,13.0,6.0,15.0,11.0,20.0,13.0,14.0,13.0,9.0,11.0,7.0,10.0,15.0,11.0,13.0,11.0,10.0,9.0,14.0,4.0,24.0,0.0,0.0,0.0,0.0,183.0,78.0,2.0,3.0,1.0,3.0,2.0,1.0,1.0,1.0,1.0,3.0,3.0,5.0,10.0,9.0,5.0,12.0,11.0,12.0,11.0,8.0,13.0,13.0,11.0,14.0,10.0,15.0,14.0,14.0,13.0,15.0,10.0,14.0,14.0,6.0,6.0,9.0,14.0,13.0,14.0,12.0,12.0,14.0,11.0,5.0,15.0,11.0,20.0,14.0,14.0,14.0,13.0,12.0,7.0,10.0,12.0,13.0,16.0,13.0,15.0,15.0,15.0,5.0,24.0,0.0,0.0,0.0,0.0,175.0,72.0,3.0,2.0,4.0,3.0,2.0,4.0,1.0,1.0,1.0,2.0,2.0,8.0,12.0,12.0,6.0,11.0,7.0,10.0,9.0,12.0,11.0,12.0,8.0,12.0,11.0,11.0,12.0,13.0,10.0,10.0,9.0,9.0,3.0,9.0,9.0,11.0,12.0,11.0,11.0,14.0,13.0,11.0,8.0,20.0,12.0,13.0,6.0,12.0,11.0,10.0,10.0,10.0,9.0,10.0,10.0,13.0,10.0,11.0,10.0,13.0,18.0,1.0,29.0,0.0,0.0,0.0,0.0,188.0,74.0,1.0,2.0,3.0,3.0,2.0,3.0,1.0,3.0,2.0,1.0,1.0,4.0,8.0,10.0,6.0,13.0,7.0,14.0,9.0,6.0,13.0,12.0,8.0,13.0,13.0,12.0,14.0,13.0,14.0,11.0,13.0,12.0,14.0,6.0,13.0,8.0,14.0,15.0,15.0,9.0,12.0,14.0,14.0,10.0,13.0,10.0,20.0,16.0,12.0,13.0,12.0,15.0,9.0,11.0,11.0,14.0,14.0,12.0,15.0,13.0,13.0,6.0,21.0,0.0,0.0,3.0,0.0,174.0,70.0,3.0,1.0,3.0,3.0,2.0,2.0,1.0,3.0,3.0,2.0,1.0,10.0,11.0,12.0,10.0,13.0,8.0,7.0,11.0,6.0,10.0,14.0,11.0,8.0,13.0,7.0,11.0,11.0,12.0,12.0,14.0,11.0,8.0,11.0,10.0,12.0,8.0,13.0,14.0,13.0,14.0,13.0,9.0,20.0,11.0,12.0,8.0,13.0,11.0,13.0,7.0,10.0,5.0,12.0,13.0,11.0,12.0,9.0,11.0,12.0,10.0,5.0,39.0,0.0,0.0,0.0,0.0,178.0,75.0,4.0,3.0,1.0,2.0,2.0,2.0,3.0,3.0,2.0,2.0,1.0,12.0,12.0,13.0,12.0,15.0,12.0,12.0,11.0,6.0,6.0,15.0,15.0,8.0,16.0,7.0,12.0,12.0,13.0,14.0,14.0,12.0,14.0,11.0,12.0,9.0,12.0,12.0,14.0,11.0,12.0,14.0,8.0,10.0,15.0,10.0,20.0,10.0,12.0,15.0,7.0,16.0,6.0,10.0,14.0,14.0,14.0,14.0,14.0,14.0,14.0,6.0,21.0,0.0,0.0,0.0,0.0,180.0,68.0,4.0,1.0,1.0,1.0,1.0,3.0,1.0,2.0,2.0,2.0,3.0,10.0,10.0,13.0,9.0,13.0,9.0,8.0,8.0,6.0,11.0,13.0,10.0,10.0,12.0,8.0,8.0,8.0,11.0,10.0,13.0,10.0,20.0,13.0,6.0,9.0,9.0,7.0,10.0,14.0,14.0,13.0,10.0,10.0,10.0,14.0,20.0,12.0,11.0,10.0,10.0,7.0,6.0,13.0,17.0,12.0,10.0,12.0,12.0,8.0,10.0,2.0,19.0,0.0,0.0,0.0,0.0,168.0,64.0,3.0,2.0,4.0,1.0,2.0,2.0,1.0,1.0,1.0,1.0,3.0,9.0,11.0,13.0,10.0,11.0,8.0,4.0,10.0,3.0,4.0,11.0,10.0,4.0,12.0,8.0,11.0,11.0,9.0,8.0,10.0,10.0,12.0,11.0,6.0,9.0,9.0,10.0,9.0,14.0,11.0,10.0,7.0,11.0,12.0,14.0,20.0,11.0,10.0,11.0,12.0,9.0,8.0,11.0,10.0,11.0,9.0,11.0,8.0,7.0,8.0,10.0,23.0,0.0,0.0,7.0,3.0,181.0,71.0,2.0,2.0,2.0,2.0,2.0,2.0,4.0,2.0,3.0,3.0,2.0,7.0,12.0,12.0,14.0,13.0,7.0,11.0,11.0,7.0,6.0,11.0,15.0,7.0,12.0,12.0,13.0,16.0,12.0,12.0,10.0,11.0,6.0,12.0,7.0,14.0,9.0,12.0,16.0,13.0,14.0,13.0,9.0,8.0,14.0,12.0,20.0,12.0,12.0,12.0,10.0,12.0,8.0,10.0,19.0,10.0,10.0,10.0,11.0,11.0,12.0,6.0
2,2,36.0,0.0,0.0,0.0,0.0,185.0,78.0,11.0,14.0,12.0,7.0,13.0,12.0,14.0,15.0,13.0,14.0,10.0,4.0,1.0,3.0,1.0,8.0,8.0,11.0,8.0,3.0,3.0,7.0,2.0,1.0,8.0,11.0,13.0,15.0,11.0,12.0,7.0,13.0,9.0,5.0,14.0,3.0,13.0,15.0,8.0,11.0,14.0,13.0,12.0,5.0,15.0,11.0,20.0,12.0,14.0,13.0,11.0,13.0,8.0,1.0,19.0,14.0,16.0,10.0,17.0,9.0,9.0,11.0,28.0,8.0,0.0,1.0,0.0,182.0,79.0,1.0,1.0,3.0,2.0,4.0,1.0,3.0,3.0,1.0,1.0,3.0,5.0,9.0,9.0,9.0,11.0,6.0,13.0,8.0,12.0,14.0,9.0,8.0,14.0,11.0,14.0,14.0,15.0,10.0,13.0,7.0,12.0,16.0,8.0,8.0,9.0,14.0,13.0,14.0,15.0,12.0,13.0,11.0,5.0,13.0,14.0,20.0,15.0,14.0,12.0,14.0,13.0,7.0,15.0,11.0,13.0,10.0,13.0,10.0,11.0,12.0,5.0,28.0,0.0,0.0,0.0,0.0,183.0,81.0,1.0,2.0,4.0,1.0,1.0,3.0,2.0,3.0,3.0,3.0,1.0,5.0,5.0,6.0,10.0,12.0,6.0,14.0,8.0,6.0,15.0,11.0,6.0,13.0,12.0,13.0,14.0,16.0,14.0,14.0,10.0,12.0,14.0,5.0,14.0,8.0,14.0,15.0,15.0,9.0,12.0,15.0,13.0,7.0,11.0,12.0,20.0,15.0,15.0,14.0,14.0,14.0,9.0,8.0,14.0,14.0,11.0,13.0,15.0,13.0,15.0,6.0,21.0,0.0,0.0,1.0,0.0,177.0,68.0,4.0,1.0,2.0,1.0,1.0,1.0,1.0,1.0,2.0,1.0,2.0,5.0,12.0,9.0,7.0,12.0,8.0,13.0,10.0,16.0,13.0,12.0,8.0,14.0,12.0,12.0,13.0,12.0,12.0,12.0,10.0,13.0,15.0,11.0,13.0,11.0,13.0,13.0,14.0,13.0,14.0,13.0,11.0,10.0,14.0,12.0,20.0,12.0,14.0,12.0,11.0,12.0,8.0,14.0,13.0,10.0,14.0,12.0,14.0,12.0,11.0,5.0,24.0,10.0,0.0,0.0,0.0,180.0,73.0,3.0,2.0,3.0,1.0,1.0,1.0,1.0,3.0,3.0,3.0,2.0,5.0,10.0,8.0,5.0,8.0,6.0,13.0,8.0,6.0,14.0,12.0,6.0,13.0,10.0,12.0,13.0,13.0,11.0,12.0,9.0,12.0,14.0,1.0,7.0,7.0,12.0,12.0,13.0,15.0,11.0,13.0,10.0,5.0,15.0,14.0,20.0,12.0,14.0,12.0,12.0,11.0,8.0,11.0,8.0,11.0,9.0,15.0,12.0,11.0,19.0,6.0,23.0,14.0,1.0,0.0,0.0,180.0,75.0,1.0,3.0,2.0,4.0,1.0,3.0,2.0,2.0,4.0,1.0,2.0,5.0,12.0,12.0,6.0,11.0,7.0,13.0,12.0,6.0,12.0,12.0,6.0,12.0,11.0,13.0,13.0,15.0,11.0,11.0,12.0,9.0,16.0,7.0,12.0,8.0,12.0,14.0,16.0,14.0,13.0,15.0,10.0,8.0,15.0,13.0,20.0,15.0,14.0,14.0,13.0,12.0,7.0,11.0,12.0,13.0,14.0,14.0,14.0,13.0,13.0,6.0,24.0,0.0,0.0,0.0,0.0,188.0,75.0,1.0,3.0,2.0,2.0,1.0,1.0,2.0,1.0,3.0,3.0,1.0,15.0,11.0,11.0,12.0,13.0,15.0,11.0,12.0,9.0,6.0,15.0,13.0,6.0,11.0,11.0,12.0,12.0,14.0,14.0,14.0,14.0,14.0,12.0,12.0,11.0,8.0,13.0,13.0,11.0,12.0,9.0,15.0,20.0,12.0,10.0,8.0,13.0,9.0,12.0,7.0,14.0,11.0,11.0,14.0,14.0,12.0,11.0,10.0,11.0,10.0,6.0,18.0,2.0,0.0,0.0,0.0,179.0,71.0,2.0,1.0,2.0,1.0,2.0,2.0,4.0,4.0,1.0,2.0,2.0,4.0,6.0,1.0,4.0,11.0,6.0,13.0,6.0,4.0,10.0,7.0,1.0,13.0,7.0,9.0,8.0,8.0,6.0,7.0,5.0,13.0,9.0,9.0,6.0,2.0,11.0,7.0,11.0,11.0,11.0,7.0,8.0,5.0,9.0,10.0,20.0,13.0,6.0,8.0,9.0,9.0,9.0,9.0,14.0,12.0,10.0,12.0,12.0,12.0,14.0,3.0,33.0,0.0,0.0,0.0,0.0,187.0,76.0,2.0,2.0,3.0,1.0,1.0,3.0,2.0,1.0,2.0,3.0,2.0,15.0,14.0,14.0,10.0,15.0,13.0,10.0,12.0,7.0,4.0,15.0,13.0,7.0,15.0,6.0,12.0,9.0,14.0,11.0,15.0,12.0,12.0,14.0,12.0,13.0,7.0,13.0,12.0,11.0,12.0,14.0,12.0,14.0,15.0,12.0,20.0,11.0,12.0,12.0,6.0,14.0,6.0,11.0,14.0,13.0,12.0,12.0,15.0,15.0,13.0,9.0,21.0,0.0,0.0,4.0,1.0,184.0,79.0,1.0,2.0,3.0,1.0,2.0,1.0,3.0,2.0,2.0,1.0,3.0,3.0,6.0,10.0,12.0,12.0,7.0,15.0,8.0,4.0,5.0,13.0,10.0,8.0,12.0,18.0,12.0,19.0,13.0,10.0,13.0,12.0,14.0,13.0,10.0,12.0,9.0,16.0,15.0,12.0,14.0,14.0,14.0,12.0,13.0,10.0,20.0,14.0,14.0,11.0,14.0,14.0,11.0,5.0,10.0,13.0,14.0,15.0,10.0,8.0,4.0,15.0,26.0,0.0,0.0,0.0,0.0,193.0,81.0,1.0,3.0,3.0,3.0,3.0,1.0,2.0,2.0,2.0,3.0,3.0,4.0,9.0,14.0,10.0,13.0,12.0,14.0,14.0,5.0,5.0,10.0,12.0,3.0,14.0,8.0,13.0,12.0,9.0,10.0,11.0,11.0,12.0,16.0,5.0,14.0,6.0,9.0,12.0,14.0,13.0,14.0,16.0,14.0,13.0,13.0,20.0,13.0,14.0,10.0,8.0,14.0,9.0,8.0,16.0,16.0,11.0,13.0,11.0,13.0,13.0,10.0,23.0,3.0,0.0,12.0,0.0,187.0,98.0,12.0,14.0,15.0,6.0,14.0,12.0,14.0,15.0,11.0,10.0,14.0,2.0,1.0,1.0,1.0,7.0,2.0,2.0,2.0,5.0,6.0,9.0,9.0,8.0,6.0,10.0,11.0,14.0,11.0,11.0,6.0,12.0,15.0,15.0,16.0,4.0,12.0,12.0,2.0,12.0,12.0,12.0,13.0,5.0,13.0,12.0,20.0,9.0,14.0,14.0,10.0,11.0,10.0,1.0,10.0,13.0,13.0,17.0,8.0,11.0,8.0,10.0,19.0,0.0,0.0,0.0,0.0,182.0,77.0,1.0,1.0,2.0,2.0,3.0,2.0,2.0,1.0,2.0,2.0,2.0,2.0,7.0,6.0,4.0,10.0,5.0,12.0,6.0,5.0,9.0,9.0,8.0,11.0,11.0,8.0,9.0,10.0,11.0,11.0,8.0,15.0,12.0,5.0,12.0,6.0,9.0,10.0,12.0,9.0,10.0,13.0,11.0,10.0,15.0,11.0,20.0,12.0,11.0,10.0,8.0,6.0,10.0,10.0,18.0,14.0,10.0,9.0,14.0,15.0,15.0,8.0,19.0,0.0,0.0,0.0,0.0,182.0,89.0,1.0,2.0,2.0,1.0,1.0,1.0,2.0,1.0,3.0,3.0,3.0,5.0,8.0,6.0,5.0,11.0,5.0,14.0,6.0,6.0,12.0,11.0,8.0,13.0,10.0,13.0,12.0,15.0,12.0,13.0,9.0,12.0,12.0,8.0,8.0,7.0,12.0,13.0,14.0,12.0,11.0,15.0,12.0,10.0,15.0,13.0,20.0,14.0,16.0,13.0,4.0,10.0,6.0,11.0,9.0,13.0,10.0,13.0,13.0,14.0,14.0,6.0,21.0,0.0,0.0,1.0,0.0,186.0,75.0,3.0,4.0,2.0,2.0,2.0,2.0,1.0,2.0,2.0,1.0,3.0,10.0,11.0,10.0,8.0,13.0,11.0,10.0,11.0,8.0,12.0,11.0,7.0,14.0,12.0,11.0,12.0,14.0,11.0,10.0,10.0,11.0,14.0,12.0,11.0,14.0,11.0,12.0,12.0,13.0,11.0,12.0,14.0,20.0,11.0,14.0,5.0,13.0,12.0,12.0,11.0,11.0,10.0,11.0,11.0,14.0,11.0,12.0,9.0,8.0,7.0,2.0,29.0,0.0,0.0,4.0,0.0,184.0,72.0,3.0,2.0,4.0,2.0,3.0,1.0,1.0,3.0,1.0,1.0,1.0,8.0,13.0,10.0,6.0,11.0,7.0,12.0,8.0,10.0,12.0,11.0,9.0,13.0,11.0,9.0,14.0,14.0,11.0,14.0,10.0,12.0,16.0,9.0,14.0,12.0,13.0,15.0,16.0,15.0,12.0,14.0,12.0,8.0,13.0,14.0,20.0,16.0,12.0,13.0,9.0,16.0,8.0,15.0,13.0,13.0,17.0,14.0,16.0,16.0,16.0,5.0,25.0,0.0,0.0,7.0,0.0,180.0,76.0,2.0,1.0,3.0,3.0,3.0,3.0,4.0,2.0,1.0,1.0,3.0,10.0,12.0,11.0,8.0,14.0,9.0,12.0,13.0,8.0,10.0,14.0,8.0,12.0,14.0,13.0,13.0,15.0,13.0,14.0,13.0,13.0,15.0,10.0,7.0,11.0,12.0,15.0,16.0,14.0,15.0,14.0,10.0,8.0,14.0,13.0,20.0,15.0,13.0,14.0,13.0,14.0,9.0,16.0,12.0,13.0,15.0,13.0,14.0,12.0,11.0,8.0,22.0,5.0,0.0,9.0,2.0,181.0,73.0,3.0,1.0,2.0,1.0,3.0,2.0,2.0,3.0,3.0,1.0,1.0,12.0,13.0,12.0,7.0,14.0,12.0,9.0,11.0,6.0,7.0,14.0,10.0,8.0,15.0,13.0,11.0,12.0,13.0,12.0,15.0,12.0,12.0,11.0,10.0,11.0,11.0,14.0,13.0,11.0,13.0,14.0,10.0,10.0,16.0,12.0,20.0,14.0,12.0,12.0,11.0,14.0,9.0,8.0,12.0,13.0,16.0,12.0,14.0,13.0,14.0,5.0,20.0,0.0,0.0,0.0,0.0,183.0,70.0,1.0,1.0,2.0,2.0,3.0,1.0,1.0,2.0,2.0,2.0,3.0,6.0,10.0,12.0,7.0,11.0,8.0,9.0,10.0,6.0,3.0,11.0,8.0,2.0,14.0,8.0,10.0,7.0,10.0,10.0,14.0,10.0,11.0,12.0,6.0,11.0,7.0,8.0,11.0,14.0,13.0,12.0,12.0,20.0,13.0,12.0,8.0,10.0,7.0,10.0,8.0,10.0,7.0,14.0,14.0,12.0,13.0,11.0,11.0,10.0,17.0,6.0,22.0,0.0,0.0,0.0,0.0,178.0,71.0,3.0,1.0,1.0,1.0,4.0,1.0,1.0,1.0,4.0,1.0,3.0,10.0,11.0,12.0,7.0,13.0,11.0,7.0,11.0,5.0,8.0,14.0,8.0,8.0,14.0,9.0,13.0,12.0,13.0,11.0,13.0,12.0,16.0,8.0,11.0,10.0,11.0,15.0,14.0,10.0,14.0,12.0,9.0,8.0,14.0,8.0,20.0,14.0,11.0,14.0,9.0,10.0,7.0,12.0,20.0,12.0,15.0,12.0,11.0,14.0,14.0,6.0,26.0,6.0,1.0,0.0,0.0,184.0,79.0,1.0,2.0,3.0,1.0,3.0,2.0,3.0,3.0,2.0,3.0,3.0,4.0,7.0,11.0,17.0,13.0,10.0,16.0,11.0,5.0,5.0,11.0,13.0,4.0,12.0,13.0,14.0,13.0,12.0,11.0,9.0,12.0,16.0,12.0,10.0,15.0,7.0,13.0,18.0,15.0,13.0,15.0,13.0,7.0,14.0,13.0,20.0,16.0,14.0,15.0,13.0,14.0,8.0,8.0,18.0,14.0,14.0,12.0,14.0,13.0,11.0,10.0,18.0,0.0,0.0,4.0,0.0,188.0,81.0,3.0,3.0,1.0,3.0,1.0,4.0,1.0,2.0,1.0,3.0,4.0,6.0,8.0,13.0,10.0,10.0,10.0,8.0,12.0,6.0,6.0,10.0,14.0,6.0,9.0,10.0,7.0,14.0,9.0,9.0,11.0,11.0,10.0,8.0,11.0,8.0,4.0,11.0,13.0,12.0,13.0,14.0,13.0,8.0,14.0,14.0,20.0,12.0,13.0,10.0,10.0,7.0,6.0,10.0,17.0,10.0,9.0,9.0,13.0,10.0,11.0,6.0
1,0,24.0,0.0,0.0,0.0,0.0,186.0,80.0,9.0,10.0,13.0,6.0,12.0,11.0,13.0,14.0,11.0,12.0,7.0,5.0,2.0,2.0,3.0,9.0,10.0,2.0,2.0,2.0,1.0,8.0,2.0,1.0,9.0,8.0,11.0,13.0,9.0,10.0,7.0,9.0,14.0,6.0,9.0,1.0,11.0,12.0,6.0,10.0,13.0,14.0,13.0,20.0,14.0,7.0,5.0,12.0,14.0,10.0,8.0,14.0,7.0,1.0,15.0,13.0,15.0,11.0,14.0,13.0,12.0,8.0,23.0,0.0,0.0,0.0,0.0,188.0,75.0,2.0,2.0,2.0,2.0,3.0,4.0,2.0,2.0,2.0,3.0,3.0,4.0,10.0,7.0,5.0,10.0,7.0,13.0,10.0,5.0,13.0,11.0,6.0,13.0,12.0,13.0,13.0,14.0,11.0,11.0,8.0,11.0,12.0,5.0,6.0,10.0,12.0,13.0,14.0,13.0,11.0,15.0,14.0,5.0,14.0,12.0,20.0,14.0,14.0,12.0,13.0,11.0,7.0,12.0,9.0,12.0,11.0,7.0,12.0,10.0,10.0,8.0,24.0,0.0,0.0,0.0,0.0,185.0,70.0,3.0,2.0,3.0,2.0,2.0,1.0,2.0,1.0,1.0,2.0,3.0,5.0,6.0,9.0,7.0,11.0,8.0,15.0,12.0,7.0,14.0,13.0,7.0,11.0,11.0,11.0,14.0,14.0,13.0,9.0,9.0,12.0,4.0,8.0,5.0,10.0,12.0,15.0,12.0,11.0,11.0,14.0,13.0,6.0,15.0,11.0,20.0,13.0,14.0,13.0,9.0,11.0,7.0,10.0,15.0,11.0,13.0,11.0,10.0,9.0,14.0,4.0,24.0,0.0,0.0,0.0,0.0,183.0,78.0,2.0,3.0,1.0,3.0,2.0,1.0,1.0,1.0,1.0,3.0,3.0,5.0,10.0,9.0,5.0,12.0,11.0,12.0,11.0,8.0,13.0,13.0,11.0,14.0,10.0,15.0,14.0,14.0,13.0,15.0,10.0,14.0,14.0,6.0,6.0,9.0,14.0,13.0,14.0,12.0,12.0,14.0,11.0,5.0,15.0,11.0,20.0,14.0,14.0,14.0,13.0,12.0,7.0,10.0,12.0,13.0,16.0,13.0,15.0,15.0,15.0,5.0,24.0,0.0,0.0,0.0,0.0,175.0,72.0,3.0,2.0,4.0,3.0,2.0,4.0,1.0,1.0,1.0,2.0,2.0,8.0,12.0,12.0,6.0,11.0,7.0,10.0,9.0,12.0,11.0,12.0,8.0,12.0,11.0,11.0,12.0,13.0,10.0,10.0,9.0,9.0,3.0,9.0,9.0,11.0,12.0,11.0,11.0,14.0,13.0,11.0,8.0,20.0,12.0,13.0,6.0,12.0,11.0,10.0,10.0,10.0,9.0,10.0,10.0,13.0,10.0,11.0,10.0,13.0,18.0,1.0,29.0,0.0,0.0,0.0,0.0,188.0,74.0,1.0,2.0,3.0,3.0,2.0,3.0,1.0,3.0,2.0,1.0,1.0,4.0,8.0,10.0,6.0,13.0,7.0,14.0,9.0,6.0,13.0,12.0,8.0,13.0,13.0,12.0,14.0,13.0,14.0,11.0,13.0,12.0,14.0,6.0,13.0,8.0,14.0,15.0,15.0,9.0,12.0,14.0,14.0,10.0,13.0,10.0,20.0,16.0,12.0,13.0,12.0,15.0,9.0,11.0,11.0,14.0,14.0,12.0,15.0,13.0,13.0,6.0,21.0,0.0,0.0,3.0,0.0,174.0,70.0,3.0,1.0,3.0,3.0,2.0,2.0,1.0,3.0,3.0,2.0,1.0,10.0,11.0,12.0,10.0,13.0,8.0,7.0,11.0,6.0,10.0,14.0,11.0,8.0,13.0,7.0,11.0,11.0,12.0,12.0,14.0,11.0,8.0,11.0,10.0,12.0,8.0,13.0,14.0,13.0,14.0,13.0,9.0,20.0,11.0,12.0,8.0,13.0,11.0,13.0,7.0,10.0,5.0,12.0,13.0,11.0,12.0,9.0,11.0,12.0,10.0,5.0,24.0,0.0,0.0,0.0,0.0,169.0,65.0,3.0,3.0,2.0,1.0,2.0,4.0,1.0,3.0,4.0,3.0,2.0,11.0,12.0,12.0,7.0,12.0,9.0,5.0,10.0,7.0,3.0,11.0,12.0,5.0,13.0,7.0,10.0,9.0,12.0,9.0,12.0,10.0,4.0,11.0,6.0,12.0,6.0,12.0,14.0,16.0,14.0,11.0,6.0,20.0,14.0,15.0,5.0,14.0,7.0,12.0,7.0,14.0,6.0,8.0,16.0,13.0,16.0,12.0,12.0,10.0,15.0,6.0,19.0,0.0,0.0,0.0,0.0,168.0,64.0,3.0,2.0,4.0,1.0,2.0,2.0,1.0,1.0,1.0,1.0,3.0,9.0,11.0,13.0,10.0,11.0,8.0,4.0,10.0,3.0,4.0,11.0,10.0,4.0,12.0,8.0,11.0,11.0,9.0,8.0,10.0,10.0,12.0,11.0,6.0,9.0,9.0,10.0,9.0,14.0,11.0,10.0,7.0,11.0,12.0,14.0,20.0,11.0,10.0,11.0,12.0,9.0,8.0,11.0,10.0,11.0,9.0,11.0,8.0,7.0,8.0,10.0,21.0,0.0,0.0,0.0,0.0,180.0,68.0,4.0,1.0,1.0,1.0,1.0,3.0,1.0,2.0,2.0,2.0,3.0,10.0,10.0,13.0,9.0,13.0,9.0,8.0,8.0,6.0,11.0,13.0,10.0,10.0,12.0,8.0,8.0,8.0,11.0,10.0,13.0,10.0,20.0,13.0,6.0,9.0,9.0,7.0,10.0,14.0,14.0,13.0,10.0,10.0,10.0,14.0,20.0,12.0,11.0,10.0,10.0,7.0,6.0,13.0,17.0,12.0,10.0,12.0,12.0,8.0,10.0,2.0,23.0,0.0,0.0,7.0,3.0,181.0,71.0,2.0,2.0,2.0,2.0,2.0,2.0,4.0,2.0,3.0,3.0,2.0,7.0,12.0,12.0,14.0,13.0,7.0,11.0,11.0,7.0,6.0,11.0,15.0,7.0,12.0,12.0,13.0,16.0,12.0,12.0,10.0,11.0,6.0,12.0,7.0,14.0,9.0,12.0,16.0,13.0,14.0,13.0,9.0,8.0,14.0,12.0,20.0,12.0,12.0,12.0,10.0,12.0,8.0,10.0,19.0,10.0,10.0,10.0,11.0,11.0,12.0,6.0,33.0,70.0,0.0,0.0,0.0,185.0,81.0,12.0,9.0,11.0,10.0,11.0,11.0,12.0,15.0,10.0,15.0,8.0,6.0,2.0,8.0,1.0,12.0,8.0,10.0,1.0,2.0,1.0,2.0,1.0,3.0,11.0,10.0,9.0,13.0,11.0,15.0,9.0,11.0,15.0,2.0,10.0,1.0,12.0,17.0,9.0,7.0,14.0,13.0,14.0,10.0,7.0,9.0,20.0,11.0,10.0,14.0,11.0,13.0,6.0,11.0,18.0,18.0,10.0,10.0,17.0,14.0,12.0,2.0,26.0,1.0,0.0,0.0,0.0,185.0,80.0,3.0,1.0,3.0,3.0,3.0,3.0,2.0,3.0,4.0,2.0,1.0,5.0,9.0,11.0,8.0,11.0,6.0,12.0,8.0,10.0,15.0,11.0,12.0,14.0,12.0,16.0,12.0,17.0,14.0,9.0,9.0,10.0,15.0,13.0,9.0,7.0,10.0,8.0,12.0,15.0,13.0,17.0,14.0,8.0,13.0,18.0,20.0,13.0,14.0,11.0,12.0,11.0,4.0,10.0,12.0,12.0,13.0,10.0,10.0,8.0,7.0,14.0,27.0,0.0,0.0,0.0,0.0,181.0,79.0,3.0,1.0,3.0,1.0,3.0,1.0,1.0,2.0,3.0,3.0,3.0,5.0,12.0,10.0,5.0,10.0,6.0,11.0,7.0,8.0,12.0,9.0,7.0,12.0,11.0,13.0,13.0,14.0,13.0,12.0,9.0,9.0,13.0,9.0,7.0,8.0,13.0,13.0,13.0,15.0,12.0,13.0,10.0,5.0,13.0,13.0,20.0,15.0,14.0,15.0,13.0,7.0,6.0,10.0,8.0,13.0,13.0,13.0,14.0,14.0,14.0,5.0,20.0,0.0,0.0,0.0,0.0,190.0,80.0,2.0,2.0,1.0,4.0,2.0,2.0,3.0,4.0,2.0,2.0,1.0,12.0,12.0,10.0,9.0,11.0,7.0,12.0,8.0,12.0,10.0,10.0,9.0,12.0,11.0,13.0,11.0,13.0,11.0,12.0,8.0,11.0,11.0,7.0,8.0,10.0,10.0,13.0,12.0,13.0,12.0,12.0,15.0,20.0,13.0,14.0,6.0,13.0,14.0,12.0,6.0,10.0,5.0,13.0,16.0,13.0,9.0,12.0,10.0,10.0,11.0,4.0,29.0,0.0,0.0,0.0,0.0,170.0,66.0,1.0,1.0,1.0,1.0,4.0,3.0,1.0,2.0,3.0,1.0,1.0,11.0,13.0,12.0,7.0,12.0,10.0,7.0,12.0,9.0,13.0,12.0,8.0,12.0,13.0,14.0,11.0,15.0,12.0,14.0,10.0,12.0,14.0,12.0,10.0,13.0,8.0,13.0,15.0,14.0,13.0,10.0,7.0,20.0,15.0,13.0,10.0,15.0,7.0,14.0,14.0,14.0,6.0,16.0,9.0,13.0,14.0,14.0,16.0,11.0,9.0,9.0,24.0,0.0,0.0,0.0,0.0,174.0,68.0,3.0,1.0,3.0,1.0,1.0,2.0,1.0,3.0,1.0,1.0,1.0,13.0,12.0,12.0,10.0,13.0,13.0,8.0,13.0,10.0,6.0,14.0,12.0,7.0,13.0,9.0,13.0,11.0,13.0,11.0,13.0,13.0,12.0,11.0,7.0,12.0,9.0,12.0,12.0,14.0,13.0,12.0,8.0,8.0,14.0,12.0,20.0,13.0,10.0,13.0,10.0,13.0,7.0,12.0,14.0,14.0,15.0,9.0,11.0,13.0,12.0,8.0,31.0,0.0,0.0,0.0,0.0,180.0,74.0,3.0,2.0,3.0,1.0,2.0,3.0,2.0,1.0,4.0,3.0,3.0,12.0,12.0,10.0,9.0,13.0,14.0,11.0,13.0,6.0,10.0,14.0,15.0,13.0,13.0,15.0,14.0,17.0,12.0,14.0,13.0,13.0,15.0,7.0,13.0,10.0,13.0,18.0,15.0,9.0,11.0,14.0,10.0,10.0,13.0,12.0,20.0,15.0,14.0,14.0,13.0,15.0,8.0,7.0,19.0,13.0,13.0,13.0,13.0,13.0,12.0,9.0,27.0,0.0,0.0,11.0,1.0,174.0,72.0,2.0,3.0,4.0,1.0,1.0,4.0,3.0,3.0,3.0,3.0,1.0,10.0,13.0,14.0,8.0,14.0,7.0,6.0,11.0,5.0,6.0,13.0,10.0,5.0,14.0,7.0,12.0,10.0,10.0,12.0,9.0,12.0,12.0,12.0,4.0,14.0,6.0,9.0,13.0,16.0,14.0,10.0,6.0,9.0,13.0,16.0,20.0,12.0,9.0,14.0,6.0,11.0,7.0,10.0,10.0,13.0,12.0,11.0,14.0,14.0,16.0,8.0,30.0,1.0,0.0,2.0,0.0,177.0,61.0,4.0,2.0,3.0,3.0,2.0,1.0,4.0,2.0,1.0,1.0,3.0,10.0,14.0,11.0,11.0,12.0,14.0,9.0,12.0,11.0,10.0,14.0,8.0,11.0,13.0,11.0,12.0,15.0,12.0,13.0,14.0,14.0,15.0,10.0,18.0,13.0,7.0,13.0,13.0,12.0,13.0,14.0,7.0,12.0,10.0,11.0,20.0,11.0,8.0,14.0,10.0,12.0,11.0,11.0,7.0,14.0,12.0,8.0,14.0,10.0,10.0,10.0,26.0,0.0,0.0,15.0,6.0,182.0,80.0,1.0,4.0,1.0,3.0,1.0,3.0,3.0,1.0,2.0,1.0,3.0,5.0,9.0,11.0,12.0,10.0,9.0,13.0,10.0,5.0,4.0,9.0,13.0,6.0,12.0,9.0,12.0,12.0,12.0,12.0,11.0,12.0,12.0,13.0,8.0,13.0,10.0,12.0,12.0,16.0,15.0,12.0,12.0,7.0,14.0,16.0,20.0,12.0,15.0,12.0,6.0,12.0,7.0,10.0,11.0,11.0,13.0,8.0,12.0,14.0,14.0,7.0,28.0,0.0,0.0,2.0,2.0,182.0,79.0,1.0,1.0,2.0,2.0,3.0,1.0,2.0,3.0,1.0,2.0,2.0,8.0,11.0,14.0,12.0,14.0,11.0,12.0,13.0,6.0,4.0,11.0,13.0,5.0,14.0,11.0,12.0,13.0,10.0,12.0,11.0,11.0,15.0,13.0,7.0,14.0,7.0,12.0,14.0,15.0,14.0,14.0,12.0,8.0,15.0,14.0,20.0,15.0,14.0,12.0,11.0,15.0,8.0,8.0,16.0,15.0,12.0,11.0,14.0,13.0,12.0,8.0
2,0,25.0,0.0,0.0,0.0,0.0,185.0,85.0,14.0,11.0,14.0,10.0,12.0,14.0,13.0,14.0,11.0,15.0,9.0,4.0,1.0,3.0,1.0,9.0,8.0,3.0,11.0,1.0,2.0,8.0,2.0,7.0,9.0,8.0,13.0,13.0,12.0,12.0,8.0,11.0,16.0,6.0,14.0,1.0,12.0,12.0,7.0,10.0,13.0,15.0,12.0,5.0,17.0,9.0,20.0,13.0,15.0,14.0,8.0,13.0,3.0,1.0,17.0,13.0,13.0,13.0,14.0,14.0,14.0,5.0,28.0,0.0,0.0,0.0,0.0,184.0,85.0,2.0,3.0,2.0,1.0,1.0,3.0,2.0,2.0,3.0,1.0,3.0,4.0,8.0,8.0,6.0,12.0,6.0,14.0,8.0,5.0,13.0,12.0,6.0,14.0,12.0,11.0,13.0,14.0,13.0,12.0,11.0,11.0,13.0,7.0,14.0,10.0,15.0,16.0,12.0,12.0,11.0,15.0,12.0,20.0,13.0,11.0,7.0,14.0,16.0,13.0,11.0,13.0,13.0,12.0,15.0,13.0,13.0,14.0,15.0,14.0,14.0,6.0,27.0,15.0,0.0,0.0,0.0,193.0,82.0,4.0,1.0,3.0,1.0,1.0,4.0,2.0,4.0,3.0,3.0,2.0,5.0,9.0,9.0,8.0,10.0,8.0,12.0,11.0,8.0,12.0,12.0,7.0,15.0,13.0,14.0,11.0,17.0,14.0,14.0,10.0,11.0,16.0,8.0,13.0,10.0,10.0,8.0,12.0,13.0,12.0,17.0,17.0,20.0,15.0,15.0,14.0,13.0,16.0,14.0,14.0,14.0,7.0,8.0,12.0,17.0,12.0,15.0,14.0,10.0,9.0,10.0,25.0,0.0,0.0,0.0,0.0,191.0,81.0,1.0,1.0,3.0,2.0,3.0,2.0,3.0,4.0,2.0,1.0,2.0,4.0,3.0,10.0,8.0,6.0,6.0,11.0,6.0,10.0,11.0,10.0,5.0,12.0,7.0,16.0,13.0,16.0,11.0,13.0,7.0,10.0,14.0,5.0,12.0,10.0,13.0,13.0,12.0,13.0,13.0,16.0,16.0,7.0,16.0,14.0,20.0,14.0,14.0,13.0,13.0,15.0,6.0,12.0,13.0,6.0,14.0,8.0,8.0,13.0,7.0,4.0,24.0,2.0,0.0,0.0,0.0,188.0,83.0,2.0,2.0,2.0,1.0,3.0,2.0,3.0,3.0,1.0,2.0,1.0,11.0,12.0,11.0,6.0,12.0,11.0,11.0,9.0,13.0,11.0,11.0,10.0,12.0,12.0,13.0,13.0,12.0,12.0,9.0,11.0,11.0,2.0,12.0,11.0,12.0,8.0,12.0,12.0,11.0,10.0,13.0,13.0,20.0,12.0,12.0,4.0,12.0,13.0,12.0,9.0,5.0,7.0,11.0,8.0,10.0,14.0,12.0,12.0,1.0,18.0,8.0,19.0,0.0,0.0,0.0,0.0,175.0,70.0,1.0,3.0,3.0,1.0,1.0,3.0,1.0,1.0,2.0,2.0,2.0,6.0,10.0,6.0,7.0,10.0,2.0,10.0,6.0,9.0,10.0,11.0,2.0,15.0,9.0,9.0,12.0,9.0,10.0,8.0,10.0,13.0,2.0,9.0,1.0,9.0,9.0,10.0,11.0,14.0,12.0,7.0,7.0,4.0,13.0,13.0,20.0,9.0,8.0,9.0,9.0,8.0,9.0,14.0,12.0,7.0,9.0,9.0,9.0,10.0,19.0,3.0,36.0,0.0,0.0,3.0,0.0,168.0,72.0,3.0,2.0,1.0,3.0,1.0,3.0,3.0,1.0,3.0,3.0,1.0,11.0,8.0,12.0,5.0,13.0,11.0,8.0,13.0,6.0,12.0,13.0,8.0,14.0,13.0,17.0,14.0,17.0,14.0,15.0,13.0,14.0,17.0,12.0,16.0,10.0,15.0,16.0,14.0,10.0,13.0,14.0,4.0,8.0,16.0,8.0,20.0,12.0,13.0,17.0,14.0,14.0,7.0,10.0,19.0,15.0,14.0,16.0,15.0,9.0,9.0,7.0,23.0,2.0,0.0,5.0,0.0,180.0,77.0,3.0,2.0,2.0,3.0,2.0,3.0,2.0,2.0,3.0,3.0,4.0,14.0,12.0,12.0,10.0,13.0,14.0,6.0,14.0,8.0,8.0,13.0,12.0,9.0,14.0,13.0,12.0,12.0,11.0,10.0,12.0,13.0,13.0,10.0,6.0,13.0,10.0,12.0,14.0,13.0,14.0,13.0,10.0,8.0,13.0,14.0,20.0,14.0,14.0,9.0,8.0,14.0,6.0,16.0,13.0,12.0,13.0,12.0,13.0,13.0,14.0,6.0,26.0,0.0,0.0,0.0,0.0,175.0,70.0,2.0,1.0,1.0,2.0,2.0,2.0,3.0,2.0,2.0,1.0,1.0,13.0,12.0,11.0,8.0,14.0,11.0,7.0,11.0,6.0,5.0,14.0,11.0,6.0,15.0,11.0,12.0,12.0,15.0,10.0,13.0,12.0,14.0,13.0,7.0,12.0,12.0,16.0,12.0,12.0,14.0,12.0,8.0,8.0,11.0,13.0,20.0,11.0,9.0,8.0,8.0,12.0,15.0,14.0,12.0,13.0,11.0,13.0,12.0,15.0,15.0,7.0,27.0,11.0,1.0,0.0,0.0,187.0,86.0,3.0,1.0,2.0,2.0,4.0,3.0,2.0,1.0,1.0,3.0,1.0,3.0,9.0,13.0,15.0,12.0,10.0,17.0,11.0,5.0,5.0,9.0,14.0,4.0,11.0,9.0,12.0,13.0,12.0,11.0,9.0,10.0,13.0,11.0,10.0,13.0,10.0,15.0,15.0,14.0,12.0,15.0,13.0,7.0,15.0,13.0,20.0,13.0,15.0,14.0,9.0,13.0,7.0,5.0,15.0,13.0,13.0,11.0,10.0,12.0,18.0,6.0,21.0,0.0,0.0,0.0,0.0,172.0,70.0,2.0,3.0,1.0,1.0,3.0,3.0,1.0,2.0,1.0,1.0,1.0,5.0,7.0,14.0,12.0,14.0,7.0,6.0,11.0,5.0,3.0,12.0,12.0,4.0,15.0,7.0,12.0,9.0,12.0,10.0,10.0,11.0,12.0,16.0,6.0,14.0,5.0,9.0,9.0,14.0,16.0,14.0,7.0,12.0,13.0,15.0,20.0,13.0,12.0,11.0,7.0,2.0,12.0,12.0,9.0,12.0,14.0,11.0,13.0,16.0,16.0,5.0,36.0,0.0,0.0,0.0,0.0,185.0,78.0,11.0,14.0,12.0,7.0,13.0,12.0,14.0,15.0,13.0,14.0,10.0,4.0,1.0,3.0,1.0,8.0,8.0,11.0,8.0,3.0,3.0,7.0,2.0,1.0,8.0,11.0,13.0,15.0,11.0,12.0,7.0,13.0,9.0,5.0,14.0,3.0,13.0,15.0,8.0,11.0,14.0,13.0,12.0,5.0,15.0,11.0,20.0,12.0,14.0,13.0,11.0,13.0,8.0,1.0,19.0,14.0,16.0,10.0,17.0,9.0,9.0,11.0,28.0,0.0,0.0,0.0,0.0,183.0,81.0,1.0,2.0,4.0,1.0,1.0,3.0,2.0,3.0,3.0,3.0,1.0,5.0,5.0,6.0,10.0,12.0,6.0,14.0,8.0,6.0,15.0,11.0,6.0,13.0,12.0,13.0,14.0,16.0,14.0,14.0,10.0,12.0,14.0,5.0,14.0,8.0,14.0,15.0,15.0,9.0,12.0,15.0,13.0,7.0,11.0,12.0,20.0,15.0,15.0,14.0,14.0,14.0,9.0,8.0,14.0,14.0,11.0,13.0,15.0,13.0,15.0,6.0,28.0,8.0,0.0,1.0,0.0,182.0,79.0,1.0,1.0,3.0,2.0,4.0,1.0,3.0,3.0,1.0,1.0,3.0,5.0,9.0,9.0,9.0,11.0,6.0,13.0,8.0,12.0,14.0,9.0,8.0,14.0,11.0,14.0,14.0,15.0,10.0,13.0,7.0,12.0,16.0,8.0,8.0,9.0,14.0,13.0,14.0,15.0,12.0,13.0,11.0,5.0,13.0,14.0,20.0,15.0,14.0,12.0,14.0,13.0,7.0,15.0,11.0,13.0,10.0,13.0,10.0,11.0,12.0,5.0,21.0,0.0,0.0,0.0,0.0,182.0,74.0,2.0,2.0,2.0,2.0,2.0,1.0,1.0,1.0,3.0,2.0,2.0,9.0,11.0,12.0,7.0,9.0,8.0,12.0,7.0,11.0,12.0,7.0,8.0,13.0,11.0,12.0,12.0,14.0,12.0,13.0,7.0,12.0,11.0,1.0,9.0,11.0,9.0,10.0,12.0,14.0,10.0,13.0,11.0,9.0,8.0,12.0,20.0,13.0,11.0,10.0,13.0,8.0,10.0,10.0,15.0,11.0,13.0,10.0,10.0,8.0,13.0,7.0,21.0,0.0,0.0,1.0,0.0,177.0,68.0,4.0,1.0,2.0,1.0,1.0,1.0,1.0,1.0,2.0,1.0,2.0,5.0,12.0,9.0,7.0,12.0,8.0,13.0,10.0,16.0,13.0,12.0,8.0,14.0,12.0,12.0,13.0,12.0,12.0,12.0,10.0,13.0,15.0,11.0,13.0,11.0,13.0,13.0,14.0,13.0,14.0,13.0,11.0,10.0,14.0,12.0,20.0,12.0,14.0,12.0,11.0,12.0,8.0,14.0,13.0,10.0,14.0,12.0,14.0,12.0,11.0,5.0,17.0,0.0,0.0,0.0,0.0,173.0,0.0,2.0,1.0,3.0,1.0,2.0,3.0,1.0,3.0,2.0,1.0,2.0,3.0,5.0,7.0,6.0,8.0,2.0,8.0,1.0,8.0,10.0,7.0,4.0,15.0,10.0,9.0,7.0,10.0,7.0,6.0,5.0,8.0,9.0,5.0,12.0,8.0,6.0,9.0,9.0,15.0,15.0,9.0,7.0,20.0,14.0,15.0,5.0,7.0,8.0,9.0,9.0,9.0,9.0,9.0,18.0,8.0,10.0,11.0,11.0,8.0,12.0,4.0,24.0,0.0,0.0,0.0,0.0,188.0,75.0,1.0,3.0,2.0,2.0,1.0,1.0,2.0,1.0,3.0,3.0,1.0,15.0,11.0,11.0,12.0,13.0,15.0,11.0,12.0,9.0,6.0,15.0,13.0,6.0,11.0,11.0,12.0,12.0,14.0,14.0,14.0,14.0,14.0,12.0,12.0,11.0,8.0,13.0,13.0,11.0,12.0,9.0,15.0,20.0,12.0,10.0,8.0,13.0,9.0,12.0,7.0,14.0,11.0,11.0,14.0,14.0,12.0,11.0,10.0,11.0,10.0,6.0,33.0,0.0,0.0,0.0,0.0,187.0,76.0,2.0,2.0,3.0,1.0,1.0,3.0,2.0,1.0,2.0,3.0,2.0,15.0,14.0,14.0,10.0,15.0,13.0,10.0,12.0,7.0,4.0,15.0,13.0,7.0,15.0,6.0,12.0,9.0,14.0,11.0,15.0,12.0,12.0,14.0,12.0,13.0,7.0,13.0,12.0,11.0,12.0,14.0,12.0,14.0,15.0,12.0,20.0,11.0,12.0,12.0,6.0,14.0,6.0,11.0,14.0,13.0,12.0,12.0,15.0,15.0,13.0,9.0,27.0,0.0,0.0,0.0,0.0,190.0,87.0,1.0,3.0,2.0,3.0,1.0,3.0,1.0,1.0,2.0,3.0,2.0,5.0,7.0,9.0,14.0,14.0,10.0,14.0,13.0,5.0,6.0,12.0,12.0,8.0,14.0,14.0,13.0,16.0,14.0,11.0,10.0,13.0,15.0,10.0,11.0,14.0,9.0,15.0,14.0,10.0,11.0,16.0,15.0,9.0,12.0,12.0,20.0,14.0,16.0,13.0,13.0,12.0,7.0,5.0,10.0,12.0,14.0,12.0,14.0,14.0,19.0,12.0,26.0,0.0,0.0,0.0,0.0,193.0,81.0,1.0,3.0,3.0,3.0,3.0,1.0,2.0,2.0,2.0,3.0,3.0,4.0,9.0,14.0,10.0,13.0,12.0,14.0,14.0,5.0,5.0,10.0,12.0,3.0,14.0,8.0,13.0,12.0,9.0,10.0,11.0,11.0,12.0,16.0,5.0,14.0,6.0,9.0,12.0,14.0,13.0,14.0,16.0,14.0,13.0,13.0,20.0,13.0,14.0,10.0,8.0,14.0,9.0,8.0,16.0,16.0,11.0,13.0,11.0,13.0,13.0,10.0,21.0,0.0,0.0,4.0,1.0,184.0,79.0,1.0,2.0,3.0,1.0,2.0,1.0,3.0,2.0,2.0,1.0,3.0,3.0,6.0,10.0,12.0,12.0,7.0,15.0,8.0,4.0,5.0,13.0,10.0,8.0,12.0,18.0,12.0,19.0,13.0,10.0,13.0,12.0,14.0,13.0,10.0,12.0,9.0,16.0,15.0,12.0,14.0,14.0,14.0,12.0,13.0,10.0,20.0,14.0,14.0,11.0,14.0,14.0,11.0,5.0,10.0,13.0,14.0,15.0,10.0,8.0,4.0,15.0
3,4,33.0,0.0,0.0,3.0,0.0,188.0,84.0,14.0,13.0,13.0,9.0,13.0,13.0,15.0,15.0,11.0,11.0,9.0,7.0,3.0,3.0,1.0,7.0,10.0,2.0,1.0,1.0,2.0,6.0,4.0,1.0,7.0,8.0,13.0,14.0,14.0,14.0,8.0,11.0,15.0,6.0,13.0,3.0,13.0,12.0,8.0,12.0,14.0,15.0,14.0,8.0,13.0,11.0,20.0,13.0,15.0,16.0,8.0,13.0,6.0,1.0,11.0,14.0,13.0,11.0,16.0,14.0,11.0,6.0,29.0,2.0,0.0,0.0,0.0,185.0,75.0,2.0,3.0,3.0,3.0,2.0,3.0,2.0,1.0,3.0,1.0,2.0,4.0,10.0,8.0,6.0,10.0,6.0,14.0,7.0,7.0,14.0,11.0,6.0,14.0,9.0,13.0,13.0,14.0,11.0,12.0,12.0,12.0,14.0,8.0,11.0,12.0,13.0,13.0,13.0,15.0,12.0,15.0,12.0,8.0,15.0,13.0,20.0,14.0,15.0,14.0,7.0,14.0,8.0,6.0,14.0,13.0,15.0,14.0,14.0,14.0,14.0,6.0,28.0,0.0,0.0,0.0,0.0,193.0,84.0,1.0,1.0,2.0,2.0,2.0,3.0,2.0,3.0,2.0,1.0,3.0,4.0,8.0,8.0,9.0,10.0,6.0,14.0,7.0,8.0,14.0,12.0,6.0,14.0,11.0,12.0,13.0,14.0,11.0,14.0,12.0,12.0,14.0,6.0,11.0,8.0,14.0,13.0,13.0,11.0,11.0,16.0,16.0,20.0,12.0,12.0,8.0,14.0,16.0,14.0,12.0,13.0,6.0,10.0,7.0,12.0,15.0,12.0,16.0,15.0,13.0,6.0,26.0,0.0,0.0,0.0,0.0,182.0,68.0,1.0,4.0,3.0,2.0,3.0,1.0,2.0,1.0,2.0,4.0,1.0,7.0,12.0,9.0,5.0,10.0,6.0,12.0,7.0,15.0,12.0,9.0,6.0,12.0,10.0,12.0,13.0,14.0,11.0,10.0,9.0,9.0,13.0,7.0,6.0,10.0,10.0,14.0,15.0,16.0,13.0,13.0,11.0,5.0,15.0,15.0,20.0,14.0,10.0,12.0,12.0,13.0,7.0,12.0,12.0,14.0,14.0,15.0,13.0,14.0,14.0,7.0,26.0,0.0,0.0,0.0,0.0,175.0,69.0,3.0,3.0,2.0,2.0,3.0,1.0,3.0,1.0,3.0,2.0,2.0,6.0,12.0,10.0,5.0,11.0,6.0,10.0,10.0,10.0,13.0,12.0,9.0,13.0,12.0,12.0,13.0,14.0,12.0,13.0,12.0,11.0,15.0,11.0,13.0,12.0,13.0,14.0,14.0,15.0,13.0,12.0,7.0,9.0,13.0,13.0,20.0,14.0,11.0,14.0,12.0,12.0,11.0,15.0,14.0,9.0,17.0,10.0,8.0,11.0,20.0,7.0,25.0,0.0,0.0,15.0,1.0,176.0,64.0,2.0,2.0,3.0,3.0,1.0,1.0,3.0,3.0,2.0,1.0,3.0,9.0,9.0,11.0,7.0,13.0,11.0,14.0,9.0,6.0,12.0,14.0,6.0,13.0,13.0,13.0,14.0,15.0,14.0,14.0,13.0,13.0,15.0,8.0,11.0,9.0,12.0,15.0,18.0,14.0,14.0,12.0,10.0,5.0,15.0,11.0,20.0,16.0,10.0,15.0,13.0,15.0,5.0,10.0,11.0,14.0,14.0,14.0,17.0,13.0,13.0,5.0,29.0,0.0,0.0,0.0,0.0,183.0,78.0,1.0,3.0,3.0,3.0,3.0,1.0,2.0,3.0,3.0,1.0,1.0,13.0,8.0,9.0,6.0,12.0,14.0,13.0,10.0,12.0,11.0,12.0,8.0,13.0,12.0,12.0,15.0,13.0,13.0,13.0,11.0,13.0,15.0,6.0,12.0,7.0,13.0,16.0,18.0,12.0,11.0,14.0,12.0,20.0,14.0,11.0,8.0,16.0,14.0,14.0,12.0,14.0,6.0,12.0,10.0,12.0,13.0,11.0,15.0,15.0,15.0,5.0,29.0,0.0,0.0,0.0,0.0,180.0,71.0,1.0,3.0,1.0,1.0,1.0,4.0,4.0,1.0,1.0,2.0,3.0,10.0,11.0,12.0,9.0,13.0,11.0,8.0,14.0,6.0,8.0,11.0,10.0,8.0,12.0,10.0,11.0,12.0,12.0,9.0,12.0,11.0,14.0,12.0,7.0,12.0,10.0,12.0,14.0,15.0,14.0,12.0,10.0,20.0,16.0,13.0,12.0,15.0,10.0,13.0,10.0,15.0,7.0,8.0,16.0,12.0,12.0,13.0,14.0,15.0,15.0,6.0,19.0,0.0,0.0,0.0,0.0,185.0,80.0,3.0,2.0,2.0,3.0,3.0,4.0,3.0,3.0,3.0,2.0,1.0,8.0,12.0,13.0,8.0,12.0,13.0,12.0,9.0,6.0,12.0,13.0,9.0,13.0,12.0,12.0,13.0,12.0,12.0,10.0,12.0,12.0,4.0,13.0,8.0,12.0,8.0,12.0,14.0,13.0,14.0,12.0,11.0,5.0,15.0,14.0,20.0,13.0,13.0,12.0,10.0,9.0,11.0,15.0,15.0,9.0,10.0,9.0,12.0,11.0,10.0,5.0,23.0,0.0,0.0,0.0,0.0,175.0,70.0,2.0,1.0,2.0,2.0,1.0,2.0,2.0,3.0,4.0,1.0,2.0,10.0,11.0,12.0,9.0,13.0,8.0,6.0,13.0,2.0,5.0,13.0,10.0,6.0,13.0,7.0,13.0,9.0,13.0,11.0,13.0,12.0,13.0,12.0,10.0,12.0,10.0,13.0,12.0,11.0,12.0,13.0,8.0,8.0,14.0,12.0,20.0,14.0,12.0,13.0,9.0,11.0,10.0,11.0,19.0,12.0,14.0,11.0,13.0,10.0,16.0,7.0,24.0,0.0,0.0,4.0,0.0,181.0,79.0,1.0,3.0,2.0,2.0,1.0,1.0,1.0,2.0,2.0,2.0,1.0,4.0,6.0,10.0,11.0,11.0,7.0,12.0,10.0,5.0,5.0,7.0,13.0,3.0,10.0,9.0,12.0,12.0,11.0,10.0,6.0,10.0,8.0,9.0,5.0,11.0,5.0,9.0,12.0,15.0,13.0,13.0,11.0,5.0,11.0,14.0,20.0,13.0,14.0,11.0,9.0,12.0,13.0,5.0,19.0,11.0,9.0,9.0,7.0,14.0,14.0,13.0,19.0,0.0,0.0,0.0,0.0,190.0,78.0,13.0,12.0,11.0,14.0,13.0,6.0,11.0,13.0,13.0,12.0,7.0,3.0,3.0,1.0,3.0,8.0,8.0,3.0,1.0,2.0,3.0,7.0,3.0,1.0,7.0,8.0,13.0,13.0,12.0,13.0,7.0,11.0,11.0,3.0,14.0,2.0,11.0,11.0,10.0,12.0,13.0,11.0,15.0,20.0,10.0,13.0,5.0,13.0,13.0,9.0,10.0,6.0,10.0,10.0,10.0,12.0,11.0,14.0,14.0,12.0,13.0,3.0,24.0,0.0,0.0,5.0,2.0,182.0,78.0,2.0,2.0,3.0,2.0,2.0,1.0,3.0,1.0,1.0,2.0,3.0,5.0,10.0,8.0,7.0,10.0,6.0,13.0,11.0,8.0,13.0,8.0,7.0,12.0,9.0,15.0,14.0,18.0,12.0,11.0,7.0,10.0,14.0,9.0,11.0,9.0,12.0,14.0,15.0,14.0,12.0,15.0,11.0,6.0,14.0,15.0,20.0,14.0,16.0,13.0,14.0,15.0,8.0,8.0,11.0,14.0,13.0,11.0,13.0,12.0,13.0,6.0,21.0,0.0,0.0,0.0,0.0,185.0,79.0,3.0,4.0,3.0,1.0,3.0,1.0,2.0,1.0,1.0,1.0,1.0,7.0,9.0,7.0,8.0,12.0,7.0,13.0,8.0,8.0,13.0,12.0,8.0,13.0,10.0,14.0,11.0,13.0,10.0,12.0,11.0,10.0,14.0,10.0,7.0,8.0,13.0,11.0,10.0,12.0,11.0,13.0,13.0,6.0,13.0,11.0,20.0,13.0,15.0,12.0,12.0,10.0,5.0,14.0,17.0,12.0,13.0,10.0,12.0,12.0,12.0,4.0,19.0,0.0,0.0,0.0,0.0,179.0,70.0,2.0,1.0,2.0,4.0,3.0,1.0,3.0,3.0,4.0,2.0,3.0,8.0,10.0,8.0,7.0,12.0,6.0,11.0,6.0,5.0,12.0,10.0,8.0,13.0,10.0,12.0,12.0,12.0,11.0,11.0,7.0,12.0,10.0,7.0,9.0,10.0,10.0,10.0,12.0,12.0,12.0,13.0,10.0,20.0,10.0,13.0,10.0,12.0,14.0,14.0,10.0,3.0,7.0,10.0,13.0,10.0,9.0,10.0,8.0,9.0,15.0,7.0,17.0,0.0,0.0,0.0,0.0,177.0,69.0,2.0,3.0,2.0,2.0,1.0,1.0,3.0,2.0,1.0,3.0,4.0,6.0,11.0,10.0,6.0,11.0,6.0,7.0,8.0,8.0,8.0,9.0,7.0,10.0,11.0,12.0,10.0,12.0,9.0,10.0,11.0,8.0,11.0,9.0,6.0,9.0,8.0,10.0,12.0,13.0,12.0,10.0,7.0,8.0,9.0,12.0,20.0,10.0,7.0,9.0,9.0,7.0,8.0,12.0,8.0,11.0,13.0,11.0,10.0,10.0,11.0,6.0,30.0,4.0,0.0,0.0,0.0,192.0,78.0,1.0,3.0,1.0,2.0,2.0,3.0,1.0,3.0,1.0,1.0,3.0,4.0,6.0,7.0,8.0,11.0,6.0,15.0,8.0,6.0,13.0,11.0,6.0,14.0,11.0,17.0,14.0,16.0,12.0,14.0,10.0,12.0,17.0,8.0,8.0,11.0,13.0,15.0,16.0,14.0,12.0,18.0,14.0,6.0,14.0,12.0,20.0,17.0,16.0,14.0,17.0,13.0,9.0,11.0,8.0,13.0,10.0,13.0,12.0,10.0,10.0,5.0,24.0,0.0,0.0,0.0,0.0,172.0,69.0,3.0,4.0,1.0,4.0,1.0,2.0,1.0,2.0,2.0,3.0,3.0,10.0,12.0,13.0,7.0,13.0,13.0,7.0,11.0,6.0,2.0,12.0,10.0,4.0,15.0,12.0,11.0,12.0,9.0,10.0,13.0,11.0,3.0,15.0,6.0,13.0,5.0,10.0,13.0,14.0,15.0,11.0,7.0,5.0,14.0,14.0,20.0,13.0,10.0,13.0,12.0,13.0,8.0,10.0,9.0,11.0,10.0,11.0,9.0,11.0,10.0,3.0,20.0,0.0,0.0,0.0,0.0,176.0,73.0,1.0,3.0,2.0,1.0,3.0,3.0,1.0,2.0,2.0,2.0,1.0,10.0,12.0,11.0,11.0,11.0,10.0,13.0,9.0,8.0,7.0,12.0,14.0,4.0,12.0,10.0,10.0,13.0,10.0,10.0,6.0,9.0,12.0,10.0,6.0,12.0,6.0,10.0,12.0,13.0,13.0,14.0,11.0,8.0,4.0,12.0,20.0,11.0,9.0,13.0,10.0,10.0,8.0,10.0,12.0,11.0,11.0,10.0,10.0,9.0,8.0,4.0,21.0,0.0,0.0,0.0,0.0,180.0,71.0,1.0,2.0,1.0,3.0,3.0,3.0,2.0,2.0,2.0,2.0,3.0,10.0,10.0,11.0,10.0,12.0,10.0,8.0,10.0,8.0,8.0,12.0,5.0,6.0,12.0,4.0,11.0,8.0,10.0,9.0,11.0,10.0,10.0,13.0,8.0,12.0,7.0,11.0,12.0,13.0,12.0,10.0,10.0,5.0,12.0,12.0,20.0,11.0,10.0,10.0,10.0,5.0,10.0,12.0,7.0,10.0,14.0,12.0,9.0,10.0,16.0,7.0,21.0,0.0,0.0,0.0,0.0,179.0,75.0,3.0,3.0,2.0,2.0,1.0,3.0,3.0,3.0,1.0,1.0,1.0,5.0,9.0,13.0,11.0,11.0,8.0,10.0,11.0,5.0,2.0,9.0,12.0,2.0,12.0,7.0,11.0,12.0,10.0,9.0,10.0,10.0,13.0,12.0,5.0,13.0,7.0,7.0,11.0,14.0,13.0,13.0,9.0,6.0,12.0,15.0,20.0,13.0,14.0,11.0,10.0,10.0,5.0,10.0,16.0,11.0,10.0,12.0,9.0,13.0,13.0,9.0,23.0,0.0,0.0,0.0,0.0,181.0,73.0,2.0,1.0,2.0,1.0,3.0,3.0,2.0,2.0,4.0,2.0,1.0,5.0,12.0,14.0,13.0,13.0,7.0,12.0,8.0,4.0,5.0,9.0,12.0,5.0,13.0,11.0,11.0,12.0,13.0,11.0,8.0,12.0,14.0,11.0,6.0,13.0,7.0,12.0,13.0,12.0,14.0,13.0,10.0,8.0,14.0,11.0,20.0,13.0,12.0,13.0,5.0,10.0,7.0,14.0,12.0,11.0,14.0,10.0,11.0,10.0,15.0,4.0
1,0,24.0,0.0,0.0,0.0,0.0,197.0,86.0,15.0,9.0,12.0,14.0,13.0,12.0,10.0,13.0,11.0,7.0,8.0,2.0,3.0,3.0,3.0,8.0,7.0,1.0,3.0,1.0,2.0,12.0,2.0,2.0,8.0,10.0,12.0,10.0,14.0,12.0,10.0,10.0,10.0,3.0,8.0,1.0,11.0,10.0,6.0,12.0,13.0,10.0,16.0,5.0,13.0,11.0,20.0,9.0,10.0,10.0,10.0,10.0,7.0,10.0,9.0,11.0,11.0,9.0,12.0,13.0,10.0,8.0,28.0,0.0,0.0,0.0,0.0,190.0,83.0,1.0,1.0,3.0,2.0,1.0,1.0,3.0,3.0,1.0,2.0,1.0,2.0,9.0,5.0,6.0,10.0,5.0,13.0,7.0,4.0,12.0,9.0,7.0,10.0,11.0,13.0,14.0,15.0,13.0,11.0,8.0,11.0,13.0,8.0,12.0,7.0,12.0,12.0,12.0,11.0,11.0,15.0,15.0,20.0,15.0,11.0,5.0,13.0,16.0,15.0,13.0,11.0,7.0,5.0,12.0,12.0,14.0,12.0,15.0,13.0,12.0,6.0,25.0,0.0,0.0,0.0,0.0,184.0,83.0,3.0,1.0,1.0,3.0,2.0,3.0,2.0,3.0,1.0,1.0,1.0,4.0,8.0,7.0,5.0,10.0,6.0,14.0,7.0,8.0,13.0,11.0,6.0,11.0,10.0,12.0,14.0,15.0,9.0,12.0,9.0,11.0,15.0,8.0,8.0,7.0,14.0,14.0,13.0,12.0,11.0,15.0,12.0,20.0,14.0,11.0,8.0,15.0,13.0,13.0,12.0,14.0,9.0,12.0,8.0,13.0,14.0,14.0,14.0,14.0,14.0,6.0,20.0,0.0,0.0,0.0,0.0,176.0,71.0,3.0,3.0,1.0,3.0,1.0,2.0,3.0,2.0,3.0,2.0,2.0,12.0,14.0,12.0,9.0,11.0,10.0,7.0,10.0,12.0,11.0,12.0,9.0,12.0,12.0,9.0,12.0,10.0,10.0,9.0,10.0,12.0,11.0,14.0,8.0,13.0,12.0,10.0,11.0,16.0,15.0,10.0,8.0,20.0,10.0,16.0,5.0,15.0,11.0,10.0,9.0,9.0,8.0,10.0,9.0,11.0,11.0,11.0,12.0,10.0,17.0,1.0,26.0,0.0,0.0,0.0,0.0,178.0,75.0,1.0,2.0,2.0,2.0,2.0,2.0,1.0,2.0,2.0,1.0,4.0,7.0,12.0,12.0,4.0,13.0,4.0,12.0,6.0,12.0,13.0,12.0,10.0,13.0,11.0,15.0,9.0,15.0,10.0,11.0,10.0,9.0,15.0,8.0,7.0,14.0,9.0,9.0,14.0,14.0,13.0,14.0,10.0,5.0,17.0,14.0,20.0,15.0,13.0,9.0,13.0,15.0,6.0,9.0,11.0,13.0,17.0,14.0,13.0,10.0,9.0,11.0,32.0,55.0,0.0,0.0,0.0,180.0,74.0,1.0,3.0,3.0,2.0,1.0,2.0,2.0,1.0,3.0,3.0,1.0,6.0,8.0,8.0,6.0,11.0,10.0,12.0,10.0,6.0,13.0,11.0,7.0,15.0,11.0,14.0,14.0,17.0,12.0,14.0,10.0,13.0,16.0,8.0,12.0,8.0,14.0,16.0,18.0,12.0,13.0,13.0,10.0,8.0,16.0,14.0,20.0,18.0,13.0,16.0,15.0,14.0,5.0,10.0,9.0,15.0,13.0,15.0,14.0,11.0,10.0,7.0,25.0,0.0,0.0,0.0,0.0,177.0,66.0,2.0,3.0,1.0,3.0,2.0,3.0,4.0,1.0,4.0,3.0,1.0,11.0,11.0,11.0,7.0,13.0,11.0,8.0,10.0,7.0,4.0,12.0,11.0,6.0,12.0,8.0,12.0,11.0,12.0,12.0,12.0,9.0,13.0,11.0,7.0,11.0,9.0,14.0,13.0,11.0,13.0,12.0,9.0,20.0,14.0,10.0,8.0,16.0,9.0,13.0,8.0,2.0,6.0,10.0,9.0,11.0,15.0,12.0,14.0,14.0,14.0,6.0,28.0,15.0,2.0,8.0,1.0,171.0,68.0,3.0,1.0,4.0,2.0,3.0,1.0,3.0,2.0,3.0,2.0,1.0,14.0,14.0,14.0,7.0,14.0,14.0,7.0,13.0,6.0,4.0,15.0,12.0,7.0,14.0,11.0,13.0,10.0,13.0,11.0,14.0,12.0,14.0,12.0,8.0,13.0,9.0,15.0,10.0,14.0,15.0,12.0,6.0,12.0,12.0,13.0,20.0,12.0,8.0,12.0,11.0,13.0,15.0,10.0,20.0,15.0,15.0,9.0,13.0,16.0,16.0,7.0,21.0,2.0,1.0,0.0,0.0,173.0,68.0,4.0,1.0,1.0,3.0,1.0,3.0,1.0,1.0,1.0,1.0,1.0,8.0,12.0,11.0,11.0,12.0,8.0,5.0,6.0,4.0,5.0,12.0,9.0,7.0,12.0,13.0,10.0,10.0,9.0,13.0,13.0,11.0,10.0,13.0,6.0,12.0,8.0,10.0,13.0,14.0,14.0,14.0,7.0,13.0,12.0,13.0,20.0,11.0,7.0,13.0,6.0,12.0,6.0,9.0,11.0,12.0,9.0,7.0,10.0,11.0,13.0,7.0,19.0,0.0,0.0,0.0,0.0,185.0,79.0,2.0,3.0,3.0,1.0,2.0,1.0,2.0,3.0,3.0,3.0,2.0,11.0,11.0,11.0,12.0,11.0,10.0,12.0,12.0,5.0,6.0,11.0,12.0,6.0,12.0,15.0,12.0,13.0,11.0,10.0,12.0,11.0,10.0,13.0,12.0,12.0,8.0,10.0,12.0,10.0,13.0,12.0,12.0,20.0,10.0,9.0,10.0,10.0,7.0,10.0,12.0,10.0,5.0,9.0,11.0,12.0,13.0,10.0,13.0,14.0,18.0,3.0,28.0,0.0,0.0,0.0,0.0,185.0,80.0,3.0,4.0,2.0,1.0,3.0,3.0,4.0,1.0,3.0,2.0,2.0,10.0,12.0,13.0,12.0,14.0,11.0,13.0,10.0,4.0,6.0,13.0,10.0,4.0,13.0,15.0,12.0,16.0,10.0,10.0,12.0,12.0,14.0,12.0,5.0,13.0,8.0,11.0,14.0,13.0,13.0,14.0,12.0,8.0,13.0,14.0,20.0,11.0,13.0,13.0,11.0,13.0,7.0,10.0,12.0,14.0,12.0,12.0,11.0,13.0,13.0,7.0,25.0,0.0,0.0,3.0,0.0,187.0,83.0,15.0,9.0,12.0,8.0,13.0,11.0,12.0,14.0,7.0,12.0,8.0,4.0,2.0,3.0,2.0,9.0,9.0,6.0,2.0,2.0,1.0,9.0,2.0,1.0,9.0,8.0,13.0,15.0,12.0,10.0,7.0,9.0,15.0,5.0,9.0,3.0,12.0,13.0,8.0,12.0,12.0,15.0,14.0,20.0,13.0,9.0,5.0,14.0,14.0,12.0,8.0,10.0,7.0,1.0,14.0,11.0,16.0,11.0,14.0,14.0,14.0,6.0,32.0,0.0,0.0,0.0,0.0,172.0,71.0,2.0,1.0,3.0,1.0,2.0,3.0,2.0,3.0,2.0,2.0,2.0,8.0,9.0,7.0,6.0,10.0,6.0,10.0,9.0,10.0,14.0,11.0,6.0,14.0,11.0,10.0,16.0,15.0,12.0,12.0,7.0,12.0,15.0,9.0,13.0,8.0,14.0,15.0,15.0,14.0,14.0,14.0,10.0,20.0,14.0,14.0,8.0,15.0,13.0,13.0,11.0,13.0,7.0,13.0,17.0,14.0,17.0,8.0,13.0,15.0,15.0,6.0,27.0,0.0,0.0,0.0,0.0,184.0,81.0,1.0,1.0,1.0,3.0,3.0,2.0,2.0,2.0,1.0,2.0,3.0,8.0,6.0,8.0,12.0,10.0,8.0,12.0,9.0,1.0,3.0,8.0,14.0,4.0,9.0,4.0,11.0,12.0,11.0,8.0,8.0,11.0,10.0,9.0,8.0,11.0,9.0,8.0,11.0,10.0,8.0,13.0,13.0,9.0,13.0,9.0,20.0,12.0,13.0,13.0,9.0,2.0,9.0,9.0,15.0,10.0,12.0,10.0,11.0,6.0,4.0,6.0,21.0,0.0,0.0,0.0,0.0,178.0,65.0,2.0,3.0,3.0,3.0,3.0,1.0,1.0,1.0,1.0,3.0,1.0,9.0,13.0,11.0,6.0,12.0,7.0,9.0,8.0,8.0,13.0,12.0,7.0,13.0,12.0,8.0,12.0,13.0,12.0,12.0,13.0,13.0,14.0,9.0,8.0,12.0,12.0,13.0,13.0,12.0,14.0,13.0,11.0,8.0,15.0,12.0,20.0,13.0,12.0,14.0,8.0,11.0,7.0,10.0,19.0,10.0,13.0,10.0,11.0,15.0,15.0,6.0,21.0,0.0,0.0,0.0,0.0,179.0,68.0,2.0,3.0,2.0,1.0,2.0,1.0,2.0,3.0,2.0,1.0,1.0,6.0,13.0,12.0,6.0,13.0,6.0,8.0,7.0,12.0,10.0,12.0,8.0,12.0,13.0,10.0,11.0,11.0,12.0,10.0,11.0,11.0,12.0,11.0,7.0,13.0,10.0,12.0,14.0,15.0,13.0,12.0,10.0,20.0,14.0,14.0,8.0,14.0,10.0,13.0,8.0,13.0,8.0,12.0,13.0,14.0,10.0,12.0,10.0,10.0,12.0,10.0,19.0,0.0,0.0,0.0,0.0,185.0,82.0,4.0,2.0,3.0,1.0,3.0,2.0,1.0,2.0,1.0,2.0,3.0,7.0,7.0,10.0,6.0,13.0,7.0,14.0,7.0,6.0,12.0,13.0,7.0,13.0,13.0,13.0,13.0,13.0,11.0,12.0,11.0,12.0,14.0,9.0,14.0,11.0,11.0,15.0,15.0,12.0,12.0,14.0,13.0,5.0,14.0,12.0,20.0,14.0,13.0,10.0,11.0,11.0,6.0,10.0,10.0,12.0,12.0,14.0,14.0,11.0,16.0,6.0,18.0,0.0,0.0,0.0,0.0,170.0,67.0,3.0,1.0,3.0,3.0,3.0,4.0,1.0,2.0,1.0,2.0,2.0,11.0,11.0,12.0,13.0,12.0,11.0,6.0,10.0,8.0,7.0,12.0,10.0,7.0,13.0,9.0,11.0,8.0,10.0,10.0,12.0,12.0,15.0,12.0,12.0,11.0,12.0,11.0,12.0,12.0,12.0,10.0,6.0,5.0,14.0,12.0,20.0,10.0,9.0,10.0,8.0,2.0,6.0,12.0,11.0,11.0,12.0,13.0,14.0,11.0,13.0,4.0,19.0,0.0,0.0,0.0,0.0,175.0,67.0,3.0,2.0,1.0,3.0,3.0,1.0,1.0,1.0,2.0,1.0,3.0,7.0,8.0,12.0,8.0,10.0,6.0,12.0,9.0,8.0,10.0,10.0,8.0,12.0,11.0,14.0,10.0,12.0,9.0,10.0,11.0,10.0,12.0,12.0,10.0,12.0,12.0,13.0,14.0,13.0,11.0,14.0,8.0,6.0,14.0,12.0,20.0,14.0,12.0,12.0,8.0,11.0,6.0,12.0,17.0,13.0,10.0,11.0,12.0,11.0,17.0,5.0,22.0,0.0,0.0,0.0,0.0,186.0,0.0,1.0,2.0,3.0,3.0,1.0,3.0,1.0,2.0,1.0,2.0,1.0,4.0,1.0,12.0,12.0,12.0,1.0,7.0,5.0,1.0,3.0,5.0,1.0,1.0,8.0,8.0,6.0,6.0,4.0,5.0,4.0,11.0,6.0,9.0,12.0,12.0,5.0,4.0,5.0,12.0,12.0,5.0,11.0,12.0,10.0,12.0,20.0,6.0,8.0,8.0,8.0,8.0,7.0,8.0,13.0,11.0,12.0,13.0,12.0,5.0,14.0,5.0,22.0,24.0,3.0,7.0,0.0,177.0,78.0,2.0,1.0,2.0,3.0,2.0,2.0,4.0,3.0,3.0,2.0,1.0,10.0,13.0,16.0,14.0,16.0,16.0,8.0,16.0,4.0,4.0,15.0,12.0,4.0,16.0,12.0,11.0,12.0,13.0,10.0,11.0,8.0,13.0,17.0,5.0,14.0,5.0,10.0,12.0,15.0,14.0,13.0,9.0,10.0,17.0,16.0,20.0,15.0,14.0,12.0,11.0,15.0,4.0,12.0,19.0,16.0,14.0,14.0,11.0,13.0,10.0,12.0,20.0,29.0,2.0,0.0,0.0,181.0,75.0,1.0,1.0,2.0,2.0,2.0,3.0,2.0,1.0,1.0,3.0,2.0,5.0,9.0,15.0,10.0,11.0,9.0,10.0,8.0,7.0,3.0,10.0,10.0,5.0,15.0,7.0,10.0,9.0,12.0,10.0,8.0,11.0,14.0,12.0,5.0,13.0,5.0,11.0,12.0,16.0,12.0,9.0,12.0,20.0,14.0,16.0,7.0,12.0,10.0,9.0,10.0,10.0,11.0,6.0,10.0,15.0,9.0,13.0,11.0,14.0,18.0,7.0
1,3,26.0,2.0,0.0,1.0,0.0,188.0,84.0,12.0,13.0,15.0,9.0,15.0,13.0,13.0,15.0,10.0,11.0,14.0,9.0,2.0,1.0,2.0,12.0,11.0,3.0,2.0,3.0,3.0,11.0,3.0,1.0,10.0,14.0,13.0,14.0,10.0,13.0,11.0,11.0,14.0,3.0,11.0,5.0,12.0,15.0,13.0,10.0,12.0,13.0,14.0,5.0,14.0,9.0,20.0,12.0,14.0,12.0,10.0,15.0,3.0,11.0,12.0,11.0,16.0,13.0,15.0,16.0,16.0,4.0,29.0,0.0,0.0,0.0,0.0,183.0,74.0,3.0,3.0,3.0,3.0,3.0,2.0,2.0,2.0,1.0,3.0,1.0,5.0,12.0,7.0,6.0,10.0,7.0,14.0,12.0,5.0,14.0,12.0,6.0,13.0,11.0,14.0,13.0,17.0,13.0,16.0,12.0,12.0,13.0,9.0,8.0,9.0,14.0,14.0,15.0,13.0,12.0,15.0,12.0,6.0,17.0,11.0,20.0,17.0,13.0,14.0,14.0,15.0,5.0,13.0,9.0,14.0,19.0,15.0,14.0,11.0,11.0,6.0,19.0,1.0,0.0,0.0,0.0,182.0,67.0,1.0,3.0,2.0,1.0,2.0,3.0,1.0,1.0,2.0,1.0,1.0,7.0,7.0,8.0,4.0,10.0,7.0,9.0,9.0,7.0,14.0,9.0,7.0,13.0,9.0,9.0,10.0,8.0,9.0,8.0,9.0,14.0,2.0,7.0,12.0,7.0,8.0,8.0,12.0,12.0,10.0,9.0,11.0,5.0,13.0,8.0,20.0,11.0,8.0,9.0,5.0,4.0,9.0,9.0,10.0,12.0,13.0,9.0,10.0,13.0,12.0,3.0,22.0,0.0,0.0,0.0,0.0,178.0,73.0,3.0,2.0,2.0,1.0,2.0,4.0,3.0,1.0,3.0,1.0,2.0,6.0,12.0,12.0,6.0,11.0,7.0,8.0,8.0,11.0,12.0,10.0,8.0,13.0,11.0,12.0,12.0,13.0,11.0,10.0,11.0,11.0,13.0,6.0,7.0,12.0,9.0,13.0,14.0,16.0,14.0,13.0,9.0,6.0,14.0,15.0,20.0,15.0,14.0,12.0,12.0,13.0,6.0,14.0,12.0,15.0,13.0,13.0,14.0,14.0,14.0,6.0,21.0,0.0,0.0,0.0,0.0,172.0,68.0,3.0,3.0,1.0,2.0,1.0,2.0,3.0,2.0,2.0,3.0,2.0,12.0,13.0,12.0,8.0,12.0,12.0,5.0,8.0,12.0,11.0,13.0,8.0,13.0,12.0,14.0,13.0,14.0,13.0,13.0,10.0,11.0,15.0,9.0,13.0,13.0,12.0,13.0,14.0,12.0,12.0,12.0,6.0,20.0,13.0,13.0,13.0,13.0,11.0,12.0,10.0,10.0,11.0,9.0,20.0,13.0,15.0,12.0,16.0,13.0,13.0,8.0,32.0,0.0,0.0,13.0,0.0,175.0,65.0,2.0,1.0,1.0,2.0,3.0,3.0,1.0,2.0,3.0,2.0,3.0,15.0,13.0,11.0,6.0,14.0,13.0,10.0,12.0,8.0,8.0,16.0,8.0,12.0,13.0,11.0,14.0,15.0,14.0,15.0,14.0,14.0,14.0,6.0,13.0,9.0,15.0,18.0,13.0,12.0,13.0,13.0,8.0,8.0,13.0,10.0,20.0,13.0,13.0,12.0,11.0,15.0,12.0,10.0,17.0,14.0,15.0,14.0,16.0,14.0,14.0,6.0,25.0,0.0,0.0,3.0,2.0,170.0,61.0,2.0,3.0,2.0,2.0,1.0,3.0,2.0,2.0,1.0,2.0,1.0,11.0,12.0,13.0,10.0,13.0,8.0,5.0,8.0,7.0,4.0,14.0,10.0,4.0,15.0,11.0,10.0,9.0,7.0,10.0,14.0,8.0,13.0,13.0,6.0,12.0,8.0,8.0,12.0,16.0,14.0,7.0,5.0,12.0,15.0,16.0,20.0,14.0,6.0,12.0,11.0,13.0,8.0,8.0,8.0,13.0,15.0,10.0,10.0,14.0,14.0,8.0,18.0,0.0,0.0,0.0,0.0,179.0,67.0,3.0,3.0,2.0,4.0,2.0,4.0,3.0,1.0,3.0,4.0,1.0,5.0,7.0,12.0,9.0,12.0,12.0,10.0,12.0,6.0,4.0,12.0,12.0,3.0,14.0,11.0,12.0,11.0,11.0,8.0,13.0,12.0,12.0,12.0,6.0,12.0,5.0,10.0,12.0,15.0,11.0,12.0,10.0,20.0,13.0,14.0,8.0,14.0,8.0,9.0,6.0,14.0,5.0,10.0,16.0,13.0,12.0,12.0,13.0,9.0,15.0,2.0,20.0,0.0,0.0,2.0,0.0,180.0,75.0,3.0,1.0,2.0,2.0,3.0,2.0,1.0,1.0,3.0,3.0,1.0,8.0,13.0,14.0,9.0,13.0,8.0,10.0,9.0,6.0,5.0,12.0,6.0,5.0,14.0,8.0,13.0,12.0,13.0,12.0,12.0,12.0,7.0,13.0,8.0,14.0,7.0,12.0,13.0,15.0,13.0,14.0,10.0,8.0,14.0,15.0,20.0,13.0,12.0,13.0,11.0,9.0,7.0,13.0,9.0,11.0,11.0,11.0,12.0,11.0,10.0,1.0,18.0,0.0,0.0,0.0,0.0,188.0,80.0,1.0,3.0,1.0,3.0,2.0,3.0,3.0,1.0,2.0,2.0,4.0,6.0,8.0,12.0,11.0,12.0,7.0,13.0,10.0,4.0,4.0,8.0,10.0,5.0,12.0,11.0,11.0,13.0,10.0,11.0,11.0,12.0,11.0,13.0,7.0,13.0,8.0,13.0,13.0,11.0,12.0,12.0,12.0,10.0,12.0,11.0,20.0,10.0,12.0,12.0,8.0,11.0,7.0,13.0,8.0,13.0,13.0,11.0,12.0,12.0,13.0,7.0,28.0,0.0,0.0,2.0,2.0,182.0,79.0,1.0,1.0,2.0,2.0,3.0,1.0,2.0,3.0,1.0,2.0,2.0,8.0,11.0,14.0,12.0,14.0,11.0,12.0,13.0,6.0,4.0,11.0,13.0,5.0,14.0,11.0,12.0,13.0,10.0,12.0,11.0,11.0,15.0,13.0,7.0,14.0,7.0,12.0,14.0,15.0,14.0,14.0,12.0,8.0,15.0,14.0,20.0,15.0,14.0,12.0,11.0,15.0,8.0,8.0,16.0,15.0,12.0,11.0,14.0,13.0,12.0,8.0,38.0,161.0,0.0,11.0,0.0,192.0,91.0,14.0,20.0,20.0,16.0,14.0,12.0,17.0,19.0,18.0,16.0,13.0,1.0,1.0,1.0,1.0,9.0,1.0,1.0,1.0,1.0,1.0,8.0,4.0,1.0,8.0,5.0,17.0,17.0,17.0,16.0,7.0,17.0,18.0,12.0,20.0,1.0,20.0,6.0,10.0,8.0,14.0,14.0,14.0,7.0,12.0,8.0,20.0,10.0,15.0,19.0,5.0,17.0,12.0,1.0,12.0,16.0,20.0,18.0,16.0,15.0,14.0,4.0,31.0,0.0,0.0,0.0,0.0,171.0,65.0,1.0,3.0,1.0,3.0,2.0,2.0,3.0,1.0,2.0,2.0,3.0,8.0,9.0,11.0,7.0,5.0,6.0,5.0,6.0,7.0,14.0,14.0,6.0,14.0,13.0,14.0,12.0,13.0,12.0,11.0,11.0,12.0,12.0,11.0,7.0,12.0,12.0,12.0,10.0,15.0,15.0,7.0,9.0,9.0,12.0,14.0,20.0,12.0,13.0,11.0,13.0,11.0,9.0,10.0,15.0,14.0,12.0,11.0,14.0,13.0,12.0,7.0,29.0,0.0,0.0,0.0,0.0,170.0,65.0,2.0,1.0,3.0,3.0,1.0,3.0,2.0,1.0,2.0,3.0,2.0,5.0,11.0,4.0,6.0,7.0,4.0,7.0,5.0,6.0,6.0,6.0,2.0,6.0,7.0,9.0,10.0,13.0,8.0,12.0,8.0,13.0,15.0,2.0,7.0,5.0,9.0,8.0,8.0,12.0,12.0,14.0,4.0,9.0,12.0,11.0,20.0,12.0,5.0,9.0,9.0,9.0,9.0,9.0,10.0,12.0,12.0,12.0,12.0,7.0,5.0,8.0,24.0,9.0,0.0,7.0,1.0,190.0,82.0,2.0,2.0,3.0,3.0,1.0,2.0,2.0,1.0,1.0,3.0,1.0,8.0,14.0,13.0,11.0,12.0,10.0,12.0,11.0,9.0,11.0,13.0,8.0,13.0,13.0,10.0,14.0,14.0,13.0,13.0,14.0,14.0,16.0,11.0,6.0,12.0,12.0,16.0,16.0,12.0,11.0,11.0,14.0,8.0,14.0,14.0,20.0,15.0,13.0,14.0,9.0,13.0,8.0,14.0,13.0,14.0,12.0,14.0,16.0,12.0,15.0,2.0,17.0,0.0,0.0,0.0,0.0,168.0,62.0,1.0,2.0,2.0,1.0,1.0,1.0,2.0,2.0,3.0,2.0,1.0,5.0,6.0,4.0,4.0,10.0,2.0,7.0,3.0,9.0,7.0,9.0,4.0,10.0,11.0,9.0,7.0,10.0,9.0,10.0,9.0,16.0,10.0,9.0,9.0,5.0,11.0,10.0,10.0,16.0,13.0,10.0,5.0,6.0,16.0,11.0,20.0,10.0,6.0,9.0,9.0,9.0,9.0,9.0,9.0,10.0,11.0,11.0,10.0,11.0,13.0,8.0,17.0,0.0,0.0,0.0,0.0,177.0,0.0,3.0,2.0,1.0,3.0,1.0,3.0,2.0,2.0,2.0,3.0,1.0,5.0,6.0,13.0,15.0,12.0,5.0,10.0,10.0,5.0,6.0,11.0,4.0,8.0,12.0,9.0,10.0,5.0,9.0,5.0,11.0,10.0,5.0,9.0,9.0,8.0,5.0,9.0,10.0,15.0,11.0,8.0,7.0,20.0,14.0,11.0,8.0,8.0,12.0,9.0,8.0,1.0,6.0,9.0,13.0,13.0,12.0,12.0,11.0,10.0,15.0,8.0,18.0,0.0,0.0,0.0,0.0,178.0,68.0,1.0,2.0,1.0,3.0,2.0,1.0,1.0,2.0,2.0,1.0,3.0,12.0,10.0,12.0,6.0,13.0,13.0,8.0,8.0,5.0,8.0,14.0,3.0,9.0,14.0,13.0,11.0,12.0,12.0,11.0,13.0,12.0,12.0,12.0,6.0,12.0,8.0,13.0,13.0,15.0,13.0,12.0,8.0,10.0,13.0,14.0,20.0,12.0,8.0,12.0,12.0,12.0,7.0,12.0,10.0,13.0,12.0,12.0,12.0,11.0,13.0,7.0,21.0,0.0,0.0,15.0,1.0,189.0,75.0,3.0,3.0,3.0,3.0,1.0,1.0,3.0,3.0,3.0,2.0,3.0,10.0,12.0,13.0,7.0,14.0,8.0,14.0,12.0,5.0,13.0,15.0,8.0,15.0,14.0,14.0,14.0,15.0,14.0,14.0,13.0,14.0,15.0,12.0,10.0,12.0,14.0,15.0,16.0,12.0,13.0,15.0,14.0,20.0,14.0,13.0,10.0,16.0,13.0,14.0,11.0,14.0,7.0,10.0,8.0,16.0,10.0,12.0,13.0,13.0,11.0,14.0,28.0,66.0,15.0,13.0,3.0,180.0,70.0,2.0,2.0,1.0,2.0,1.0,1.0,3.0,2.0,3.0,3.0,1.0,14.0,15.0,16.0,13.0,17.0,15.0,6.0,15.0,4.0,5.0,16.0,14.0,8.0,17.0,13.0,16.0,11.0,15.0,13.0,16.0,14.0,13.0,17.0,10.0,14.0,9.0,13.0,13.0,16.0,18.0,12.0,10.0,20.0,14.0,15.0,8.0,16.0,9.0,13.0,14.0,12.0,10.0,15.0,14.0,15.0,10.0,16.0,14.0,6.0,12.0,10.0,16.0,0.0,0.0,0.0,0.0,178.0,0.0,1.0,3.0,1.0,3.0,3.0,3.0,3.0,2.0,2.0,1.0,2.0,4.0,6.0,15.0,10.0,13.0,8.0,11.0,8.0,3.0,6.0,9.0,8.0,5.0,12.0,9.0,14.0,6.0,12.0,6.0,8.0,7.0,9.0,9.0,4.0,15.0,6.0,8.0,5.0,12.0,11.0,9.0,6.0,5.0,15.0,11.0,20.0,10.0,11.0,5.0,6.0,4.0,6.0,9.0,16.0,9.0,12.0,9.0,10.0,11.0,16.0,1.0,24.0,70.0,46.0,7.0,9.0,174.0,68.0,2.0,3.0,2.0,1.0,3.0,1.0,2.0,3.0,1.0,1.0,3.0,16.0,16.0,20.0,16.0,17.0,16.0,9.0,13.0,3.0,4.0,16.0,16.0,4.0,20.0,10.0,17.0,14.0,15.0,15.0,16.0,15.0,15.0,19.0,13.0,19.0,4.0,13.0,12.0,18.0,19.0,14.0,6.0,15.0,16.0,16.0,20.0,13.0,10.0,14.0,11.0,15.0,6.0,12.0,15.0,16.0,19.0,14.0,15.0,8.0,8.0,17.0
3,1,19.0,0.0,0.0,0.0,0.0,190.0,78.0,13.0,12.0,11.0,14.0,13.0,6.0,11.0,13.0,13.0,12.0,7.0,3.0,3.0,1.0,3.0,8.0,8.0,3.0,1.0,2.0,3.0,7.0,3.0,1.0,7.0,8.0,13.0,13.0,12.0,13.0,7.0,11.0,11.0,3.0,14.0,2.0,11.0,11.0,10.0,12.0,13.0,11.0,15.0,20.0,10.0,13.0,5.0,13.0,13.0,9.0,10.0,6.0,10.0,10.0,10.0,12.0,11.0,14.0,14.0,12.0,13.0,3.0,24.0,0.0,0.0,5.0,2.0,182.0,78.0,2.0,2.0,3.0,2.0,2.0,1.0,3.0,1.0,1.0,2.0,3.0,5.0,10.0,8.0,7.0,10.0,6.0,13.0,11.0,8.0,13.0,8.0,7.0,12.0,9.0,15.0,14.0,18.0,12.0,11.0,7.0,10.0,14.0,9.0,11.0,9.0,12.0,14.0,15.0,14.0,12.0,15.0,11.0,6.0,14.0,15.0,20.0,14.0,16.0,13.0,14.0,15.0,8.0,8.0,11.0,14.0,13.0,11.0,13.0,12.0,13.0,6.0,21.0,0.0,0.0,0.0,0.0,185.0,79.0,3.0,4.0,3.0,1.0,3.0,1.0,2.0,1.0,1.0,1.0,1.0,7.0,9.0,7.0,8.0,12.0,7.0,13.0,8.0,8.0,13.0,12.0,8.0,13.0,10.0,14.0,11.0,13.0,10.0,12.0,11.0,10.0,14.0,10.0,7.0,8.0,13.0,11.0,10.0,12.0,11.0,13.0,13.0,6.0,13.0,11.0,20.0,13.0,15.0,12.0,12.0,10.0,5.0,14.0,17.0,12.0,13.0,10.0,12.0,12.0,12.0,4.0,17.0,0.0,0.0,0.0,0.0,177.0,69.0,2.0,3.0,2.0,2.0,1.0,1.0,3.0,2.0,1.0,3.0,4.0,6.0,11.0,10.0,6.0,11.0,6.0,7.0,8.0,8.0,8.0,9.0,7.0,10.0,11.0,12.0,10.0,12.0,9.0,10.0,11.0,8.0,11.0,9.0,6.0,9.0,8.0,10.0,12.0,13.0,12.0,10.0,7.0,8.0,9.0,12.0,20.0,10.0,7.0,9.0,9.0,7.0,8.0,12.0,8.0,11.0,13.0,11.0,10.0,10.0,11.0,6.0,22.0,0.0,0.0,0.0,0.0,182.0,71.0,3.0,2.0,1.0,1.0,3.0,1.0,3.0,2.0,3.0,2.0,1.0,8.0,9.0,11.0,7.0,11.0,7.0,12.0,12.0,12.0,10.0,12.0,5.0,11.0,8.0,13.0,11.0,13.0,8.0,11.0,8.0,11.0,15.0,11.0,7.0,6.0,11.0,13.0,13.0,13.0,12.0,13.0,10.0,5.0,15.0,13.0,20.0,14.0,12.0,10.0,6.0,10.0,5.0,10.0,9.0,11.0,11.0,14.0,10.0,11.0,11.0,1.0,30.0,4.0,0.0,0.0,0.0,192.0,78.0,1.0,3.0,1.0,2.0,2.0,3.0,1.0,3.0,1.0,1.0,3.0,4.0,6.0,7.0,8.0,11.0,6.0,15.0,8.0,6.0,13.0,11.0,6.0,14.0,11.0,17.0,14.0,16.0,12.0,14.0,10.0,12.0,17.0,8.0,8.0,11.0,13.0,15.0,16.0,14.0,12.0,18.0,14.0,6.0,14.0,12.0,20.0,17.0,16.0,14.0,17.0,13.0,9.0,11.0,8.0,13.0,10.0,13.0,12.0,10.0,10.0,5.0,24.0,0.0,0.0,0.0,0.0,172.0,69.0,3.0,4.0,1.0,4.0,1.0,2.0,1.0,2.0,2.0,3.0,3.0,10.0,12.0,13.0,7.0,13.0,13.0,7.0,11.0,6.0,2.0,12.0,10.0,4.0,15.0,12.0,11.0,12.0,9.0,10.0,13.0,11.0,3.0,15.0,6.0,13.0,5.0,10.0,13.0,14.0,15.0,11.0,7.0,5.0,14.0,14.0,20.0,13.0,10.0,13.0,12.0,13.0,8.0,10.0,9.0,11.0,10.0,11.0,9.0,11.0,10.0,3.0,21.0,0.0,0.0,0.0,0.0,180.0,71.0,1.0,2.0,1.0,3.0,3.0,3.0,2.0,2.0,2.0,2.0,3.0,10.0,10.0,11.0,10.0,12.0,10.0,8.0,10.0,8.0,8.0,12.0,5.0,6.0,12.0,4.0,11.0,8.0,10.0,9.0,11.0,10.0,10.0,13.0,8.0,12.0,7.0,11.0,12.0,13.0,12.0,10.0,10.0,5.0,12.0,12.0,20.0,11.0,10.0,10.0,10.0,5.0,10.0,12.0,7.0,10.0,14.0,12.0,9.0,10.0,16.0,7.0,20.0,0.0,0.0,0.0,0.0,176.0,73.0,1.0,3.0,2.0,1.0,3.0,3.0,1.0,2.0,2.0,2.0,1.0,10.0,12.0,11.0,11.0,11.0,10.0,13.0,9.0,8.0,7.0,12.0,14.0,4.0,12.0,10.0,10.0,13.0,10.0,10.0,6.0,9.0,12.0,10.0,6.0,12.0,6.0,10.0,12.0,13.0,13.0,14.0,11.0,8.0,4.0,12.0,20.0,11.0,9.0,13.0,10.0,10.0,8.0,10.0,12.0,11.0,11.0,10.0,10.0,9.0,8.0,4.0,21.0,0.0,0.0,0.0,0.0,179.0,75.0,3.0,3.0,2.0,2.0,1.0,3.0,3.0,3.0,1.0,1.0,1.0,5.0,9.0,13.0,11.0,11.0,8.0,10.0,11.0,5.0,2.0,9.0,12.0,2.0,12.0,7.0,11.0,12.0,10.0,9.0,10.0,10.0,13.0,12.0,5.0,13.0,7.0,7.0,11.0,14.0,13.0,13.0,9.0,6.0,12.0,15.0,20.0,13.0,14.0,11.0,10.0,10.0,5.0,10.0,16.0,11.0,10.0,12.0,9.0,13.0,13.0,9.0,23.0,0.0,0.0,0.0,0.0,181.0,73.0,2.0,1.0,2.0,1.0,3.0,3.0,2.0,2.0,4.0,2.0,1.0,5.0,12.0,14.0,13.0,13.0,7.0,12.0,8.0,4.0,5.0,9.0,12.0,5.0,13.0,11.0,11.0,12.0,13.0,11.0,8.0,12.0,14.0,11.0,6.0,13.0,7.0,12.0,13.0,12.0,14.0,13.0,10.0,8.0,14.0,11.0,20.0,13.0,12.0,13.0,5.0,10.0,7.0,14.0,12.0,11.0,14.0,10.0,11.0,10.0,15.0,4.0,31.0,22.0,0.0,17.0,0.0,185.0,82.0,12.0,12.0,13.0,6.0,14.0,11.0,15.0,18.0,14.0,10.0,13.0,7.0,3.0,8.0,5.0,9.0,10.0,8.0,12.0,2.0,2.0,9.0,6.0,3.0,10.0,6.0,12.0,15.0,16.0,12.0,8.0,12.0,14.0,8.0,15.0,3.0,13.0,13.0,8.0,13.0,17.0,14.0,13.0,7.0,12.0,11.0,20.0,15.0,14.0,13.0,6.0,16.0,3.0,1.0,8.0,16.0,12.0,13.0,16.0,16.0,16.0,7.0,30.0,32.0,1.0,0.0,0.0,190.0,88.0,1.0,2.0,2.0,2.0,3.0,1.0,1.0,3.0,3.0,2.0,2.0,5.0,7.0,9.0,8.0,10.0,7.0,16.0,11.0,9.0,15.0,13.0,5.0,16.0,12.0,17.0,16.0,17.0,13.0,13.0,11.0,12.0,16.0,7.0,14.0,10.0,14.0,15.0,15.0,14.0,12.0,17.0,16.0,9.0,15.0,14.0,20.0,16.0,18.0,15.0,15.0,14.0,10.0,12.0,14.0,15.0,12.0,14.0,12.0,13.0,11.0,15.0,19.0,0.0,0.0,7.0,2.0,188.0,85.0,1.0,3.0,2.0,1.0,2.0,3.0,3.0,2.0,2.0,3.0,1.0,10.0,6.0,9.0,8.0,10.0,12.0,15.0,8.0,7.0,14.0,11.0,10.0,13.0,10.0,14.0,11.0,13.0,9.0,11.0,10.0,10.0,9.0,1.0,8.0,12.0,13.0,13.0,14.0,13.0,10.0,13.0,15.0,9.0,12.0,13.0,20.0,14.0,14.0,9.0,11.0,4.0,9.0,11.0,14.0,13.0,12.0,12.0,12.0,1.0,13.0,2.0,26.0,27.0,0.0,0.0,0.0,183.0,70.0,1.0,3.0,1.0,3.0,4.0,1.0,3.0,3.0,2.0,1.0,3.0,9.0,14.0,12.0,8.0,10.0,8.0,12.0,13.0,14.0,9.0,12.0,7.0,13.0,11.0,14.0,9.0,15.0,10.0,12.0,9.0,10.0,16.0,10.0,9.0,12.0,8.0,12.0,17.0,14.0,11.0,13.0,12.0,10.0,16.0,16.0,20.0,16.0,13.0,13.0,10.0,14.0,6.0,15.0,10.0,15.0,14.0,10.0,16.0,13.0,13.0,4.0,22.0,0.0,0.0,3.0,0.0,176.0,70.0,1.0,1.0,1.0,3.0,2.0,1.0,2.0,3.0,1.0,3.0,3.0,10.0,15.0,14.0,6.0,13.0,10.0,13.0,10.0,9.0,9.0,13.0,8.0,11.0,14.0,10.0,11.0,12.0,10.0,13.0,11.0,13.0,14.0,13.0,7.0,13.0,9.0,11.0,13.0,17.0,13.0,12.0,10.0,20.0,14.0,16.0,5.0,15.0,11.0,13.0,10.0,14.0,8.0,10.0,11.0,13.0,16.0,11.0,15.0,14.0,13.0,7.0,28.0,41.0,2.0,0.0,0.0,187.0,80.0,3.0,2.0,3.0,2.0,1.0,1.0,2.0,3.0,1.0,4.0,2.0,7.0,10.0,11.0,7.0,12.0,7.0,10.0,12.0,13.0,15.0,13.0,8.0,18.0,12.0,18.0,13.0,17.0,12.0,14.0,10.0,12.0,17.0,7.0,13.0,9.0,14.0,17.0,18.0,14.0,13.0,16.0,14.0,20.0,18.0,13.0,12.0,18.0,14.0,15.0,16.0,15.0,6.0,15.0,14.0,13.0,10.0,14.0,12.0,8.0,7.0,8.0,21.0,0.0,0.0,11.0,2.0,180.0,72.0,2.0,3.0,3.0,3.0,3.0,2.0,2.0,1.0,3.0,2.0,3.0,12.0,13.0,14.0,9.0,14.0,13.0,8.0,12.0,5.0,8.0,14.0,10.0,9.0,14.0,12.0,12.0,9.0,13.0,12.0,15.0,13.0,14.0,15.0,8.0,13.0,10.0,16.0,14.0,15.0,14.0,12.0,9.0,8.0,15.0,14.0,20.0,13.0,12.0,12.0,8.0,11.0,10.0,11.0,10.0,14.0,16.0,14.0,15.0,15.0,15.0,6.0,23.0,0.0,0.0,10.0,7.0,179.0,70.0,1.0,1.0,2.0,2.0,1.0,3.0,3.0,2.0,1.0,4.0,3.0,10.0,13.0,14.0,12.0,15.0,11.0,10.0,13.0,6.0,3.0,13.0,12.0,4.0,16.0,11.0,12.0,11.0,13.0,11.0,13.0,12.0,12.0,16.0,6.0,14.0,6.0,10.0,12.0,16.0,14.0,12.0,9.0,20.0,13.0,14.0,10.0,13.0,10.0,12.0,7.0,12.0,6.0,8.0,12.0,13.0,5.0,10.0,8.0,14.0,12.0,8.0,21.0,0.0,0.0,0.0,0.0,187.0,84.0,4.0,2.0,1.0,2.0,3.0,1.0,2.0,3.0,1.0,1.0,2.0,11.0,13.0,15.0,12.0,14.0,11.0,13.0,14.0,4.0,5.0,12.0,14.0,5.0,16.0,12.0,12.0,14.0,12.0,10.0,10.0,9.0,14.0,17.0,10.0,12.0,7.0,10.0,14.0,14.0,16.0,14.0,15.0,9.0,13.0,14.0,20.0,14.0,14.0,14.0,8.0,15.0,5.0,14.0,11.0,16.0,13.0,14.0,13.0,15.0,15.0,6.0,29.0,26.0,6.0,12.0,4.0,175.0,77.0,1.0,2.0,1.0,3.0,3.0,2.0,1.0,2.0,1.0,2.0,2.0,16.0,14.0,16.0,15.0,15.0,18.0,6.0,15.0,6.0,6.0,18.0,11.0,5.0,17.0,9.0,12.0,10.0,16.0,12.0,16.0,14.0,14.0,16.0,6.0,16.0,6.0,10.0,10.0,13.0,15.0,14.0,8.0,15.0,15.0,14.0,20.0,13.0,12.0,11.0,9.0,16.0,7.0,8.0,8.0,11.0,8.0,13.0,12.0,13.0,11.0,10.0,26.0,0.0,0.0,4.0,0.0,180.0,73.0,2.0,3.0,1.0,4.0,2.0,3.0,3.0,1.0,1.0,4.0,1.0,11.0,13.0,13.0,14.0,14.0,11.0,15.0,12.0,3.0,7.0,14.0,14.0,8.0,13.0,12.0,14.0,17.0,13.0,15.0,14.0,14.0,16.0,12.0,15.0,16.0,12.0,18.0,16.0,13.0,14.0,13.0,12.0,8.0,14.0,13.0,20.0,15.0,12.0,15.0,8.0,14.0,7.0,15.0,19.0,14.0,17.0,14.0,18.0,16.0,16.0,5.0
3,1,23.0,0.0,0.0,9.0,0.0,194.0,88.0,14.0,13.0,12.0,9.0,13.0,12.0,14.0,15.0,14.0,8.0,10.0,8.0,2.0,3.0,1.0,8.0,11.0,2.0,12.0,2.0,2.0,8.0,3.0,1.0,8.0,8.0,13.0,12.0,14.0,14.0,9.0,12.0,14.0,8.0,9.0,3.0,11.0,14.0,10.0,13.0,14.0,17.0,15.0,10.0,15.0,12.0,20.0,14.0,17.0,13.0,8.0,12.0,9.0,1.0,9.0,15.0,15.0,11.0,15.0,17.0,17.0,5.0,19.0,0.0,0.0,0.0,0.0,185.0,73.0,1.0,1.0,4.0,3.0,3.0,4.0,3.0,2.0,2.0,1.0,1.0,6.0,9.0,10.0,6.0,12.0,5.0,14.0,7.0,10.0,12.0,13.0,7.0,15.0,13.0,11.0,14.0,13.0,15.0,8.0,12.0,10.0,10.0,9.0,11.0,7.0,11.0,14.0,9.0,13.0,12.0,14.0,14.0,12.0,16.0,17.0,20.0,13.0,11.0,11.0,9.0,14.0,5.0,17.0,10.0,17.0,5.0,12.0,9.0,14.0,12.0,15.0,29.0,0.0,0.0,0.0,0.0,170.0,65.0,2.0,1.0,3.0,3.0,1.0,3.0,2.0,1.0,2.0,3.0,2.0,5.0,11.0,4.0,6.0,7.0,4.0,7.0,5.0,6.0,6.0,6.0,2.0,6.0,7.0,9.0,10.0,13.0,8.0,12.0,8.0,13.0,15.0,2.0,7.0,5.0,9.0,8.0,8.0,12.0,12.0,14.0,4.0,9.0,12.0,11.0,20.0,12.0,5.0,9.0,9.0,9.0,9.0,9.0,10.0,12.0,12.0,12.0,12.0,7.0,5.0,8.0,20.0,0.0,0.0,7.0,0.0,186.0,72.0,3.0,3.0,2.0,3.0,3.0,4.0,3.0,3.0,2.0,2.0,2.0,4.0,9.0,8.0,6.0,13.0,6.0,14.0,6.0,7.0,14.0,12.0,8.0,13.0,13.0,11.0,13.0,14.0,14.0,14.0,9.0,13.0,13.0,8.0,8.0,8.0,13.0,14.0,14.0,13.0,13.0,15.0,13.0,20.0,15.0,14.0,8.0,14.0,13.0,12.0,8.0,12.0,4.0,10.0,8.0,15.0,14.0,12.0,14.0,15.0,14.0,7.0,31.0,0.0,0.0,0.0,0.0,171.0,65.0,1.0,3.0,1.0,3.0,2.0,2.0,3.0,1.0,2.0,2.0,3.0,8.0,9.0,11.0,7.0,5.0,6.0,5.0,6.0,7.0,14.0,14.0,6.0,14.0,13.0,14.0,12.0,13.0,12.0,11.0,11.0,12.0,12.0,11.0,7.0,12.0,12.0,12.0,10.0,15.0,15.0,7.0,9.0,9.0,12.0,14.0,20.0,12.0,13.0,11.0,13.0,11.0,9.0,10.0,15.0,14.0,12.0,11.0,14.0,13.0,12.0,7.0,24.0,9.0,0.0,7.0,1.0,190.0,82.0,2.0,2.0,3.0,3.0,1.0,2.0,2.0,1.0,1.0,3.0,1.0,8.0,14.0,13.0,11.0,12.0,10.0,12.0,11.0,9.0,11.0,13.0,8.0,13.0,13.0,10.0,14.0,14.0,13.0,13.0,14.0,14.0,16.0,11.0,6.0,12.0,12.0,16.0,16.0,12.0,11.0,11.0,14.0,8.0,14.0,14.0,20.0,15.0,13.0,14.0,9.0,13.0,8.0,14.0,13.0,14.0,12.0,14.0,16.0,12.0,15.0,2.0,21.0,0.0,0.0,15.0,1.0,189.0,75.0,3.0,3.0,3.0,3.0,1.0,1.0,3.0,3.0,3.0,2.0,3.0,10.0,12.0,13.0,7.0,14.0,8.0,14.0,12.0,5.0,13.0,15.0,8.0,15.0,14.0,14.0,14.0,15.0,14.0,14.0,13.0,14.0,15.0,12.0,10.0,12.0,14.0,15.0,16.0,12.0,13.0,15.0,14.0,20.0,14.0,13.0,10.0,16.0,13.0,14.0,11.0,14.0,7.0,10.0,8.0,16.0,10.0,12.0,13.0,13.0,11.0,14.0,28.0,66.0,15.0,13.0,3.0,180.0,70.0,2.0,2.0,1.0,2.0,1.0,1.0,3.0,2.0,3.0,3.0,1.0,14.0,15.0,16.0,13.0,17.0,15.0,6.0,15.0,4.0,5.0,16.0,14.0,8.0,17.0,13.0,16.0,11.0,15.0,13.0,16.0,14.0,13.0,17.0,10.0,14.0,9.0,13.0,13.0,16.0,18.0,12.0,10.0,20.0,14.0,15.0,8.0,16.0,9.0,13.0,14.0,12.0,10.0,15.0,14.0,15.0,10.0,16.0,14.0,6.0,12.0,10.0,29.0,76.0,27.0,13.0,9.0,188.0,72.0,2.0,3.0,1.0,2.0,3.0,3.0,1.0,3.0,3.0,3.0,3.0,5.0,10.0,13.0,16.0,13.0,11.0,17.0,13.0,5.0,10.0,13.0,14.0,10.0,13.0,15.0,16.0,18.0,14.0,15.0,10.0,13.0,14.0,13.0,10.0,18.0,12.0,14.0,19.0,15.0,14.0,16.0,14.0,10.0,18.0,16.0,20.0,18.0,14.0,14.0,8.0,15.0,5.0,16.0,10.0,16.0,12.0,14.0,16.0,14.0,10.0,10.0,24.0,70.0,46.0,7.0,9.0,174.0,68.0,2.0,3.0,2.0,1.0,3.0,1.0,2.0,3.0,1.0,1.0,3.0,16.0,16.0,20.0,16.0,17.0,16.0,9.0,13.0,3.0,4.0,16.0,16.0,4.0,20.0,10.0,17.0,14.0,15.0,15.0,16.0,15.0,15.0,19.0,13.0,19.0,4.0,13.0,12.0,18.0,19.0,14.0,6.0,15.0,16.0,16.0,20.0,13.0,10.0,14.0,11.0,15.0,6.0,12.0,15.0,16.0,19.0,14.0,15.0,8.0,8.0,17.0,17.0,0.0,0.0,0.0,0.0,178.0,68.0,2.0,1.0,2.0,1.0,3.0,3.0,3.0,1.0,3.0,3.0,2.0,10.0,11.0,15.0,12.0,13.0,10.0,8.0,9.0,2.0,3.0,12.0,12.0,3.0,16.0,11.0,9.0,11.0,12.0,9.0,12.0,10.0,17.0,17.0,9.0,13.0,5.0,9.0,13.0,15.0,14.0,11.0,9.0,8.0,14.0,14.0,20.0,12.0,9.0,14.0,7.0,15.0,7.0,13.0,13.0,19.0,12.0,16.0,15.0,14.0,14.0,7.0,33.0,0.0,0.0,3.0,0.0,188.0,84.0,14.0,13.0,13.0,9.0,13.0,13.0,15.0,15.0,11.0,11.0,9.0,7.0,3.0,3.0,1.0,7.0,10.0,2.0,1.0,1.0,2.0,6.0,4.0,1.0,7.0,8.0,13.0,14.0,14.0,14.0,8.0,11.0,15.0,6.0,13.0,3.0,13.0,12.0,8.0,12.0,14.0,15.0,14.0,8.0,13.0,11.0,20.0,13.0,15.0,16.0,8.0,13.0,6.0,1.0,11.0,14.0,13.0,11.0,16.0,14.0,11.0,6.0,29.0,2.0,0.0,0.0,0.0,185.0,75.0,2.0,3.0,3.0,3.0,2.0,3.0,2.0,1.0,3.0,1.0,2.0,4.0,10.0,8.0,6.0,10.0,6.0,14.0,7.0,7.0,14.0,11.0,6.0,14.0,9.0,13.0,13.0,14.0,11.0,12.0,12.0,12.0,14.0,8.0,11.0,12.0,13.0,13.0,13.0,15.0,12.0,15.0,12.0,8.0,15.0,13.0,20.0,14.0,15.0,14.0,7.0,14.0,8.0,6.0,14.0,13.0,15.0,14.0,14.0,14.0,14.0,6.0,26.0,0.0,0.0,10.0,1.0,196.0,91.0,3.0,1.0,2.0,2.0,2.0,3.0,2.0,4.0,2.0,2.0,1.0,3.0,5.0,8.0,6.0,9.0,5.0,14.0,7.0,8.0,13.0,10.0,5.0,12.0,10.0,10.0,13.0,14.0,12.0,12.0,7.0,10.0,13.0,6.0,9.0,6.0,12.0,14.0,10.0,9.0,8.0,13.0,18.0,8.0,17.0,11.0,20.0,12.0,16.0,13.0,12.0,10.0,7.0,4.0,18.0,10.0,12.0,9.0,13.0,7.0,10.0,7.0,26.0,0.0,0.0,0.0,0.0,175.0,69.0,3.0,3.0,2.0,2.0,3.0,1.0,3.0,1.0,3.0,2.0,2.0,6.0,12.0,10.0,5.0,11.0,6.0,10.0,10.0,10.0,13.0,12.0,9.0,13.0,12.0,12.0,13.0,14.0,12.0,13.0,12.0,11.0,15.0,11.0,13.0,12.0,13.0,14.0,14.0,15.0,13.0,12.0,7.0,9.0,13.0,13.0,20.0,14.0,11.0,14.0,12.0,12.0,11.0,15.0,14.0,9.0,17.0,10.0,8.0,11.0,20.0,7.0,30.0,9.0,1.0,0.0,0.0,192.0,90.0,2.0,2.0,2.0,2.0,3.0,1.0,3.0,4.0,1.0,1.0,3.0,4.0,7.0,10.0,10.0,9.0,8.0,17.0,12.0,6.0,13.0,12.0,8.0,12.0,11.0,13.0,14.0,15.0,13.0,13.0,10.0,12.0,14.0,12.0,13.0,13.0,12.0,14.0,16.0,12.0,12.0,18.0,16.0,8.0,14.0,13.0,20.0,16.0,18.0,13.0,13.0,14.0,7.0,12.0,13.0,13.0,13.0,13.0,13.0,13.0,13.0,6.0,29.0,0.0,0.0,0.0,0.0,183.0,78.0,1.0,3.0,3.0,3.0,3.0,1.0,2.0,3.0,3.0,1.0,1.0,13.0,8.0,9.0,6.0,12.0,14.0,13.0,10.0,12.0,11.0,12.0,8.0,13.0,12.0,12.0,15.0,13.0,13.0,13.0,11.0,13.0,15.0,6.0,12.0,7.0,13.0,16.0,18.0,12.0,11.0,14.0,12.0,20.0,14.0,11.0,8.0,16.0,14.0,14.0,12.0,14.0,6.0,12.0,10.0,12.0,13.0,11.0,15.0,15.0,15.0,5.0,21.0,0.0,0.0,0.0,0.0,183.0,73.0,1.0,4.0,3.0,3.0,3.0,1.0,4.0,1.0,2.0,3.0,2.0,11.0,10.0,12.0,11.0,13.0,9.0,12.0,10.0,5.0,8.0,12.0,9.0,8.0,13.0,13.0,12.0,12.0,10.0,12.0,14.0,12.0,12.0,14.0,8.0,12.0,8.0,12.0,12.0,14.0,14.0,14.0,11.0,8.0,13.0,13.0,20.0,12.0,12.0,12.0,5.0,10.0,7.0,12.0,15.0,11.0,11.0,10.0,11.0,12.0,11.0,4.0,29.0,0.0,0.0,0.0,0.0,180.0,71.0,1.0,3.0,1.0,1.0,1.0,4.0,4.0,1.0,1.0,2.0,3.0,10.0,11.0,12.0,9.0,13.0,11.0,8.0,14.0,6.0,8.0,11.0,10.0,8.0,12.0,10.0,11.0,12.0,12.0,9.0,12.0,11.0,14.0,12.0,7.0,12.0,10.0,12.0,14.0,15.0,14.0,12.0,10.0,20.0,16.0,13.0,12.0,15.0,10.0,13.0,10.0,15.0,7.0,8.0,16.0,12.0,12.0,13.0,14.0,15.0,15.0,6.0,19.0,0.0,0.0,0.0,0.0,185.0,80.0,3.0,2.0,2.0,3.0,3.0,4.0,3.0,3.0,3.0,2.0,1.0,8.0,12.0,13.0,8.0,12.0,13.0,12.0,9.0,6.0,12.0,13.0,9.0,13.0,12.0,12.0,13.0,12.0,12.0,10.0,12.0,12.0,4.0,13.0,8.0,12.0,8.0,12.0,14.0,13.0,14.0,12.0,11.0,5.0,15.0,14.0,20.0,13.0,13.0,12.0,10.0,9.0,11.0,15.0,15.0,9.0,10.0,9.0,12.0,11.0,10.0,5.0,18.0,0.0,0.0,0.0,0.0,188.0,0.0,2.0,2.0,1.0,1.0,1.0,2.0,1.0,4.0,2.0,2.0,1.0,8.0,11.0,14.0,11.0,13.0,10.0,11.0,10.0,2.0,6.0,12.0,11.0,8.0,13.0,8.0,11.0,9.0,13.0,9.0,13.0,11.0,14.0,15.0,8.0,12.0,7.0,11.0,13.0,14.0,12.0,12.0,13.0,12.0,11.0,14.0,20.0,11.0,11.0,12.0,8.0,11.0,8.0,14.0,12.0,11.0,10.0,12.0,13.0,12.0,14.0,7.0,23.0,0.0,0.0,0.0,0.0,175.0,70.0,2.0,1.0,2.0,2.0,1.0,2.0,2.0,3.0,4.0,1.0,2.0,10.0,11.0,12.0,9.0,13.0,8.0,6.0,13.0,2.0,5.0,13.0,10.0,6.0,13.0,7.0,13.0,9.0,13.0,11.0,13.0,12.0,13.0,12.0,10.0,12.0,10.0,13.0,12.0,11.0,12.0,13.0,8.0,8.0,14.0,12.0,20.0,14.0,12.0,13.0,9.0,11.0,10.0,11.0,19.0,12.0,14.0,11.0,13.0,10.0,16.0,7.0
4,1,29.0,0.0,0.0,0.0,0.0,183.0,83.0,13.0,13.0,11.0,7.0,12.0,11.0,12.0,13.0,11.0,10.0,10.0,3.0,1.0,3.0,1.0,7.0,8.0,1.0,3.0,2.0,3.0,8.0,3.0,2.0,7.0,8.0,13.0,13.0,12.0,13.0,6.0,11.0,14.0,6.0,9.0,1.0,12.0,13.0,9.0,10.0,12.0,15.0,11.0,6.0,15.0,11.0,20.0,14.0,14.0,14.0,8.0,13.0,5.0,1.0,10.0,12.0,16.0,13.0,15.0,15.0,15.0,6.0,23.0,0.0,0.0,0.0,0.0,184.0,83.0,1.0,2.0,1.0,2.0,3.0,1.0,1.0,1.0,3.0,3.0,2.0,4.0,8.0,7.0,6.0,10.0,6.0,14.0,9.0,7.0,12.0,9.0,10.0,10.0,8.0,10.0,13.0,13.0,11.0,13.0,8.0,12.0,14.0,6.0,6.0,7.0,12.0,13.0,10.0,12.0,12.0,14.0,13.0,20.0,14.0,11.0,6.0,13.0,13.0,11.0,10.0,8.0,6.0,8.0,9.0,11.0,13.0,10.0,13.0,14.0,14.0,6.0,30.0,46.0,1.0,0.0,0.0,181.0,70.0,1.0,2.0,1.0,3.0,2.0,2.0,3.0,3.0,4.0,1.0,3.0,6.0,8.0,7.0,6.0,10.0,6.0,14.0,10.0,6.0,13.0,10.0,6.0,12.0,10.0,12.0,13.0,14.0,12.0,12.0,8.0,11.0,13.0,8.0,11.0,7.0,13.0,13.0,14.0,12.0,12.0,14.0,12.0,8.0,13.0,13.0,20.0,14.0,12.0,13.0,13.0,12.0,7.0,12.0,11.0,13.0,12.0,14.0,11.0,14.0,15.0,7.0,26.0,0.0,0.0,0.0,0.0,183.0,74.0,1.0,3.0,2.0,3.0,3.0,3.0,1.0,2.0,1.0,1.0,1.0,10.0,11.0,8.0,7.0,11.0,8.0,12.0,5.0,13.0,12.0,10.0,6.0,12.0,10.0,12.0,11.0,13.0,11.0,10.0,8.0,11.0,12.0,8.0,10.0,12.0,12.0,12.0,14.0,13.0,12.0,13.0,11.0,20.0,14.0,13.0,6.0,14.0,13.0,13.0,8.0,13.0,11.0,12.0,19.0,13.0,12.0,13.0,11.0,13.0,18.0,1.0,21.0,4.0,0.0,16.0,1.0,181.0,79.0,2.0,1.0,2.0,3.0,1.0,1.0,2.0,1.0,1.0,2.0,1.0,8.0,14.0,9.0,4.0,12.0,9.0,9.0,9.0,9.0,13.0,12.0,8.0,13.0,12.0,11.0,13.0,11.0,12.0,13.0,12.0,13.0,13.0,8.0,6.0,14.0,13.0,13.0,13.0,13.0,11.0,11.0,9.0,7.0,12.0,14.0,20.0,14.0,11.0,13.0,6.0,11.0,10.0,7.0,15.0,12.0,12.0,13.0,13.0,14.0,15.0,2.0,23.0,12.0,3.0,0.0,0.0,184.0,79.0,2.0,2.0,2.0,2.0,2.0,3.0,3.0,3.0,1.0,1.0,3.0,11.0,10.0,12.0,9.0,11.0,12.0,12.0,9.0,9.0,13.0,13.0,9.0,11.0,14.0,9.0,13.0,13.0,9.0,9.0,13.0,9.0,13.0,11.0,9.0,14.0,12.0,15.0,13.0,15.0,11.0,9.0,12.0,10.0,14.0,14.0,20.0,13.0,13.0,12.0,9.0,13.0,9.0,14.0,13.0,15.0,11.0,14.0,14.0,14.0,13.0,7.0,22.0,0.0,0.0,0.0,0.0,188.0,85.0,4.0,2.0,2.0,1.0,1.0,1.0,1.0,1.0,1.0,2.0,1.0,4.0,8.0,12.0,6.0,11.0,5.0,9.0,7.0,5.0,10.0,11.0,7.0,13.0,13.0,11.0,9.0,11.0,8.0,9.0,12.0,12.0,10.0,13.0,6.0,10.0,8.0,9.0,12.0,12.0,13.0,15.0,13.0,5.0,13.0,12.0,20.0,15.0,15.0,10.0,10.0,10.0,8.0,7.0,15.0,18.0,10.0,10.0,10.0,10.0,11.0,2.0,22.0,0.0,0.0,0.0,0.0,176.0,75.0,2.0,3.0,2.0,3.0,1.0,1.0,1.0,2.0,1.0,1.0,3.0,13.0,12.0,13.0,11.0,13.0,13.0,7.0,10.0,6.0,6.0,11.0,8.0,6.0,13.0,11.0,10.0,9.0,10.0,11.0,11.0,11.0,11.0,13.0,5.0,13.0,8.0,9.0,11.0,14.0,12.0,11.0,8.0,10.0,11.0,12.0,20.0,13.0,9.0,12.0,9.0,7.0,8.0,13.0,19.0,11.0,10.0,12.0,12.0,12.0,12.0,4.0,24.0,0.0,0.0,13.0,0.0,171.0,73.0,4.0,1.0,3.0,3.0,1.0,1.0,3.0,1.0,3.0,1.0,3.0,7.0,11.0,13.0,11.0,11.0,9.0,6.0,11.0,6.0,4.0,9.0,11.0,5.0,11.0,8.0,12.0,11.0,10.0,10.0,8.0,9.0,14.0,15.0,8.0,10.0,8.0,9.0,15.0,17.0,14.0,10.0,8.0,20.0,14.0,16.0,6.0,13.0,6.0,9.0,6.0,10.0,12.0,13.0,12.0,13.0,9.0,12.0,12.0,12.0,7.0,8.0,23.0,16.0,7.0,4.0,0.0,183.0,79.0,4.0,3.0,3.0,4.0,3.0,2.0,2.0,1.0,2.0,3.0,3.0,11.0,11.0,13.0,14.0,14.0,8.0,13.0,12.0,4.0,4.0,11.0,12.0,7.0,13.0,13.0,12.0,9.0,12.0,12.0,8.0,12.0,13.0,13.0,8.0,14.0,7.0,8.0,11.0,14.0,13.0,11.0,12.0,12.0,14.0,13.0,20.0,14.0,13.0,11.0,13.0,12.0,5.0,13.0,13.0,13.0,11.0,8.0,11.0,6.0,10.0,5.0,21.0,0.0,0.0,6.0,1.0,179.0,76.0,2.0,1.0,2.0,3.0,2.0,2.0,3.0,3.0,3.0,2.0,3.0,9.0,7.0,12.0,12.0,15.0,9.0,12.0,7.0,2.0,9.0,10.0,5.0,7.0,11.0,8.0,15.0,10.0,12.0,12.0,11.0,12.0,12.0,8.0,2.0,12.0,12.0,11.0,11.0,12.0,12.0,10.0,13.0,11.0,15.0,12.0,20.0,12.0,11.0,10.0,10.0,4.0,7.0,12.0,10.0,10.0,11.0,10.0,9.0,8.0,11.0,11.0,24.0,0.0,0.0,0.0,0.0,197.0,86.0,15.0,9.0,12.0,14.0,13.0,12.0,10.0,13.0,11.0,7.0,8.0,2.0,3.0,3.0,3.0,8.0,7.0,1.0,3.0,1.0,2.0,12.0,2.0,2.0,8.0,10.0,12.0,10.0,14.0,12.0,10.0,10.0,10.0,3.0,8.0,1.0,11.0,10.0,6.0,12.0,13.0,10.0,16.0,5.0,13.0,11.0,20.0,9.0,10.0,10.0,10.0,10.0,7.0,10.0,9.0,11.0,11.0,9.0,12.0,13.0,10.0,8.0,25.0,0.0,0.0,0.0,0.0,184.0,83.0,3.0,1.0,1.0,3.0,2.0,3.0,2.0,3.0,1.0,1.0,1.0,4.0,8.0,7.0,5.0,10.0,6.0,14.0,7.0,8.0,13.0,11.0,6.0,11.0,10.0,12.0,14.0,15.0,9.0,12.0,9.0,11.0,15.0,8.0,8.0,7.0,14.0,14.0,13.0,12.0,11.0,15.0,12.0,20.0,14.0,11.0,8.0,15.0,13.0,13.0,12.0,14.0,9.0,12.0,8.0,13.0,14.0,14.0,14.0,14.0,14.0,6.0,28.0,0.0,0.0,0.0,0.0,190.0,83.0,1.0,1.0,3.0,2.0,1.0,1.0,3.0,3.0,1.0,2.0,1.0,2.0,9.0,5.0,6.0,10.0,5.0,13.0,7.0,4.0,12.0,9.0,7.0,10.0,11.0,13.0,14.0,15.0,13.0,11.0,8.0,11.0,13.0,8.0,12.0,7.0,12.0,12.0,12.0,11.0,11.0,15.0,15.0,20.0,15.0,11.0,5.0,13.0,16.0,15.0,13.0,11.0,7.0,5.0,12.0,12.0,14.0,12.0,15.0,13.0,12.0,6.0,20.0,0.0,0.0,0.0,0.0,176.0,71.0,3.0,3.0,1.0,3.0,1.0,2.0,3.0,2.0,3.0,2.0,2.0,12.0,14.0,12.0,9.0,11.0,10.0,7.0,10.0,12.0,11.0,12.0,9.0,12.0,12.0,9.0,12.0,10.0,10.0,9.0,10.0,12.0,11.0,14.0,8.0,13.0,12.0,10.0,11.0,16.0,15.0,10.0,8.0,20.0,10.0,16.0,5.0,15.0,11.0,10.0,9.0,9.0,8.0,10.0,9.0,11.0,11.0,11.0,12.0,10.0,17.0,1.0,26.0,0.0,0.0,0.0,0.0,178.0,75.0,1.0,2.0,2.0,2.0,2.0,2.0,1.0,2.0,2.0,1.0,4.0,7.0,12.0,12.0,4.0,13.0,4.0,12.0,6.0,12.0,13.0,12.0,10.0,13.0,11.0,15.0,9.0,15.0,10.0,11.0,10.0,9.0,15.0,8.0,7.0,14.0,9.0,9.0,14.0,14.0,13.0,14.0,10.0,5.0,17.0,14.0,20.0,15.0,13.0,9.0,13.0,15.0,6.0,9.0,11.0,13.0,17.0,14.0,13.0,10.0,9.0,11.0,32.0,55.0,0.0,0.0,0.0,180.0,74.0,1.0,3.0,3.0,2.0,1.0,2.0,2.0,1.0,3.0,3.0,1.0,6.0,8.0,8.0,6.0,11.0,10.0,12.0,10.0,6.0,13.0,11.0,7.0,15.0,11.0,14.0,14.0,17.0,12.0,14.0,10.0,13.0,16.0,8.0,12.0,8.0,14.0,16.0,18.0,12.0,13.0,13.0,10.0,8.0,16.0,14.0,20.0,18.0,13.0,16.0,15.0,14.0,5.0,10.0,9.0,15.0,13.0,15.0,14.0,11.0,10.0,7.0,25.0,0.0,0.0,0.0,0.0,177.0,66.0,2.0,3.0,1.0,3.0,2.0,3.0,4.0,1.0,4.0,3.0,1.0,11.0,11.0,11.0,7.0,13.0,11.0,8.0,10.0,7.0,4.0,12.0,11.0,6.0,12.0,8.0,12.0,11.0,12.0,12.0,12.0,9.0,13.0,11.0,7.0,11.0,9.0,14.0,13.0,11.0,13.0,12.0,9.0,20.0,14.0,10.0,8.0,16.0,9.0,13.0,8.0,2.0,6.0,10.0,9.0,11.0,15.0,12.0,14.0,14.0,14.0,6.0,28.0,15.0,2.0,8.0,1.0,171.0,68.0,3.0,1.0,4.0,2.0,3.0,1.0,3.0,2.0,3.0,2.0,1.0,14.0,14.0,14.0,7.0,14.0,14.0,7.0,13.0,6.0,4.0,15.0,12.0,7.0,14.0,11.0,13.0,10.0,13.0,11.0,14.0,12.0,14.0,12.0,8.0,13.0,9.0,15.0,10.0,14.0,15.0,12.0,6.0,12.0,12.0,13.0,20.0,12.0,8.0,12.0,11.0,13.0,15.0,10.0,20.0,15.0,15.0,9.0,13.0,16.0,16.0,7.0,21.0,2.0,1.0,0.0,0.0,173.0,68.0,4.0,1.0,1.0,3.0,1.0,3.0,1.0,1.0,1.0,1.0,1.0,8.0,12.0,11.0,11.0,12.0,8.0,5.0,6.0,4.0,5.0,12.0,9.0,7.0,12.0,13.0,10.0,10.0,9.0,13.0,13.0,11.0,10.0,13.0,6.0,12.0,8.0,10.0,13.0,14.0,14.0,14.0,7.0,13.0,12.0,13.0,20.0,11.0,7.0,13.0,6.0,12.0,6.0,9.0,11.0,12.0,9.0,7.0,10.0,11.0,13.0,7.0,19.0,0.0,0.0,0.0,0.0,185.0,79.0,2.0,3.0,3.0,1.0,2.0,1.0,2.0,3.0,3.0,3.0,2.0,11.0,11.0,11.0,12.0,11.0,10.0,12.0,12.0,5.0,6.0,11.0,12.0,6.0,12.0,15.0,12.0,13.0,11.0,10.0,12.0,11.0,10.0,13.0,12.0,12.0,8.0,10.0,12.0,10.0,13.0,12.0,12.0,20.0,10.0,9.0,10.0,10.0,7.0,10.0,12.0,10.0,5.0,9.0,11.0,12.0,13.0,10.0,13.0,14.0,18.0,3.0,28.0,0.0,0.0,0.0,0.0,185.0,80.0,3.0,4.0,2.0,1.0,3.0,3.0,4.0,1.0,3.0,2.0,2.0,10.0,12.0,13.0,12.0,14.0,11.0,13.0,10.0,4.0,6.0,13.0,10.0,4.0,13.0,15.0,12.0,16.0,10.0,10.0,12.0,12.0,14.0,12.0,5.0,13.0,8.0,11.0,14.0,13.0,13.0,14.0,12.0,8.0,13.0,14.0,20.0,11.0,13.0,13.0,11.0,13.0,7.0,10.0,12.0,14.0,12.0,12.0,11.0,13.0,13.0,7.0
0,0,30.0,42.0,0.0,13.0,0.0,195.0,88.0,16.0,13.0,14.0,6.0,14.0,13.0,13.0,15.0,12.0,10.0,14.0,1.0,8.0,5.0,2.0,8.0,2.0,8.0,2.0,5.0,3.0,9.0,5.0,3.0,8.0,10.0,12.0,10.0,14.0,10.0,10.0,14.0,13.0,3.0,14.0,3.0,12.0,14.0,12.0,8.0,13.0,18.0,18.0,17.0,14.0,11.0,20.0,14.0,17.0,14.0,4.0,14.0,4.0,1.0,12.0,13.0,14.0,9.0,15.0,13.0,13.0,5.0,28.0,0.0,0.0,0.0,0.0,174.0,67.0,3.0,4.0,1.0,1.0,1.0,3.0,1.0,3.0,2.0,1.0,2.0,11.0,8.0,11.0,9.0,13.0,6.0,7.0,12.0,8.0,10.0,10.0,3.0,6.0,12.0,10.0,13.0,7.0,12.0,8.0,10.0,9.0,12.0,13.0,5.0,12.0,9.0,12.0,11.0,14.0,14.0,11.0,7.0,10.0,15.0,12.0,20.0,11.0,6.0,9.0,6.0,10.0,10.0,9.0,11.0,14.0,9.0,11.0,12.0,8.0,8.0,8.0,20.0,2.0,0.0,3.0,1.0,191.0,84.0,2.0,1.0,1.0,2.0,2.0,1.0,3.0,2.0,1.0,3.0,3.0,4.0,6.0,10.0,5.0,10.0,4.0,14.0,6.0,6.0,13.0,12.0,5.0,14.0,10.0,7.0,10.0,12.0,12.0,12.0,9.0,11.0,11.0,4.0,9.0,5.0,13.0,13.0,14.0,11.0,10.0,13.0,14.0,12.0,12.0,14.0,20.0,14.0,12.0,13.0,7.0,12.0,2.0,7.0,6.0,12.0,10.0,10.0,12.0,14.0,13.0,4.0,21.0,0.0,0.0,0.0,0.0,177.0,0.0,1.0,1.0,1.0,2.0,3.0,3.0,2.0,3.0,2.0,2.0,3.0,6.0,4.0,13.0,13.0,13.0,6.0,13.0,7.0,3.0,5.0,7.0,6.0,1.0,11.0,9.0,7.0,8.0,7.0,7.0,7.0,8.0,7.0,11.0,8.0,13.0,7.0,6.0,7.0,12.0,13.0,7.0,6.0,8.0,8.0,13.0,20.0,5.0,5.0,9.0,5.0,9.0,9.0,9.0,10.0,10.0,12.0,12.0,11.0,10.0,9.0,6.0,19.0,0.0,0.0,0.0,0.0,183.0,79.0,3.0,1.0,3.0,3.0,3.0,2.0,1.0,2.0,3.0,1.0,2.0,5.0,10.0,9.0,7.0,10.0,4.0,10.0,9.0,6.0,12.0,11.0,7.0,12.0,8.0,10.0,12.0,11.0,11.0,11.0,12.0,11.0,13.0,11.0,9.0,12.0,12.0,12.0,14.0,12.0,13.0,13.0,11.0,8.0,13.0,12.0,20.0,13.0,12.0,12.0,10.0,11.0,5.0,9.0,12.0,12.0,13.0,11.0,14.0,12.0,10.0,10.0,26.0,25.0,1.0,7.0,0.0,189.0,78.0,1.0,1.0,1.0,1.0,1.0,1.0,1.0,1.0,1.0,1.0,1.0,8.0,9.0,10.0,6.0,12.0,8.0,13.0,14.0,7.0,11.0,14.0,11.0,13.0,13.0,13.0,13.0,16.0,13.0,13.0,12.0,13.0,14.0,10.0,10.0,12.0,13.0,15.0,15.0,12.0,11.0,9.0,15.0,10.0,14.0,13.0,20.0,14.0,14.0,12.0,13.0,11.0,14.0,12.0,14.0,11.0,14.0,12.0,16.0,15.0,13.0,5.0,19.0,0.0,0.0,0.0,0.0,174.0,61.0,1.0,3.0,2.0,3.0,2.0,1.0,2.0,2.0,3.0,1.0,1.0,5.0,9.0,10.0,6.0,12.0,6.0,8.0,8.0,5.0,9.0,10.0,7.0,9.0,13.0,11.0,12.0,12.0,11.0,9.0,11.0,11.0,8.0,9.0,10.0,8.0,10.0,12.0,16.0,13.0,13.0,10.0,8.0,20.0,15.0,11.0,8.0,13.0,9.0,15.0,11.0,10.0,6.0,13.0,10.0,9.0,14.0,11.0,12.0,14.0,14.0,8.0,21.0,0.0,0.0,10.0,1.0,181.0,77.0,1.0,3.0,2.0,2.0,1.0,3.0,3.0,2.0,1.0,1.0,2.0,11.0,12.0,14.0,11.0,13.0,12.0,12.0,12.0,8.0,10.0,13.0,12.0,10.0,13.0,9.0,13.0,8.0,10.0,11.0,13.0,11.0,12.0,14.0,8.0,13.0,9.0,10.0,12.0,14.0,14.0,10.0,10.0,20.0,10.0,14.0,10.0,12.0,9.0,10.0,10.0,12.0,11.0,16.0,9.0,14.0,12.0,10.0,13.0,9.0,12.0,9.0,21.0,0.0,0.0,0.0,0.0,172.0,66.0,2.0,3.0,2.0,2.0,1.0,1.0,1.0,3.0,2.0,1.0,1.0,10.0,10.0,13.0,9.0,14.0,9.0,8.0,10.0,7.0,13.0,13.0,9.0,12.0,13.0,10.0,12.0,13.0,13.0,12.0,14.0,13.0,13.0,11.0,9.0,14.0,13.0,14.0,14.0,14.0,13.0,12.0,8.0,8.0,12.0,12.0,20.0,13.0,12.0,14.0,10.0,11.0,8.0,12.0,15.0,10.0,15.0,8.0,11.0,14.0,14.0,6.0,24.0,24.0,4.0,0.0,0.0,172.0,74.0,2.0,4.0,3.0,2.0,2.0,1.0,2.0,2.0,3.0,2.0,4.0,8.0,9.0,14.0,13.0,14.0,9.0,11.0,10.0,7.0,5.0,12.0,12.0,3.0,13.0,10.0,12.0,12.0,13.0,12.0,11.0,10.0,14.0,13.0,7.0,14.0,9.0,9.0,13.0,16.0,15.0,13.0,6.0,8.0,13.0,16.0,20.0,14.0,12.0,11.0,11.0,13.0,9.0,8.0,9.0,13.0,9.0,11.0,12.0,13.0,10.0,9.0,25.0,0.0,0.0,0.0,0.0,187.0,83.0,2.0,1.0,3.0,3.0,1.0,3.0,3.0,3.0,1.0,1.0,3.0,4.0,8.0,10.0,14.0,12.0,8.0,14.0,9.0,5.0,7.0,11.0,13.0,5.0,12.0,11.0,13.0,13.0,13.0,11.0,10.0,12.0,16.0,9.0,8.0,13.0,11.0,13.0,16.0,14.0,13.0,15.0,13.0,20.0,14.0,12.0,8.0,14.0,16.0,13.0,11.0,13.0,7.0,5.0,13.0,14.0,13.0,14.0,14.0,13.0,13.0,6.0,24.0,0.0,0.0,0.0,0.0,197.0,86.0,15.0,9.0,12.0,14.0,13.0,12.0,10.0,13.0,11.0,7.0,8.0,2.0,3.0,3.0,3.0,8.0,7.0,1.0,3.0,1.0,2.0,12.0,2.0,2.0,8.0,10.0,12.0,10.0,14.0,12.0,10.0,10.0,10.0,3.0,8.0,1.0,11.0,10.0,6.0,12.0,13.0,10.0,16.0,5.0,13.0,11.0,20.0,9.0,10.0,10.0,10.0,10.0,7.0,10.0,9.0,11.0,11.0,9.0,12.0,13.0,10.0,8.0,28.0,0.0,0.0,0.0,0.0,190.0,83.0,1.0,1.0,3.0,2.0,1.0,1.0,3.0,3.0,1.0,2.0,1.0,2.0,9.0,5.0,6.0,10.0,5.0,13.0,7.0,4.0,12.0,9.0,7.0,10.0,11.0,13.0,14.0,15.0,13.0,11.0,8.0,11.0,13.0,8.0,12.0,7.0,12.0,12.0,12.0,11.0,11.0,15.0,15.0,20.0,15.0,11.0,5.0,13.0,16.0,15.0,13.0,11.0,7.0,5.0,12.0,12.0,14.0,12.0,15.0,13.0,12.0,6.0,21.0,0.0,0.0,0.0,0.0,193.0,79.0,3.0,3.0,4.0,4.0,2.0,3.0,1.0,1.0,3.0,2.0,3.0,8.0,8.0,8.0,8.0,12.0,11.0,14.0,11.0,12.0,15.0,14.0,6.0,13.0,10.0,12.0,11.0,12.0,12.0,14.0,11.0,10.0,15.0,12.0,12.0,12.0,13.0,14.0,12.0,12.0,12.0,14.0,16.0,9.0,8.0,12.0,20.0,12.0,14.0,13.0,9.0,11.0,16.0,12.0,12.0,14.0,11.0,14.0,12.0,11.0,10.0,5.0,21.0,0.0,0.0,9.0,0.0,178.0,77.0,4.0,3.0,1.0,1.0,1.0,2.0,2.0,3.0,3.0,3.0,1.0,11.0,13.0,11.0,8.0,12.0,9.0,8.0,9.0,8.0,12.0,10.0,8.0,12.0,12.0,8.0,10.0,14.0,11.0,14.0,12.0,12.0,14.0,12.0,8.0,10.0,8.0,15.0,14.0,15.0,12.0,12.0,8.0,7.0,5.0,14.0,20.0,14.0,10.0,12.0,5.0,10.0,11.0,8.0,15.0,10.0,10.0,12.0,9.0,10.0,12.0,5.0,20.0,0.0,0.0,0.0,0.0,176.0,71.0,3.0,3.0,1.0,3.0,1.0,2.0,3.0,2.0,3.0,2.0,2.0,12.0,14.0,12.0,9.0,11.0,10.0,7.0,10.0,12.0,11.0,12.0,9.0,12.0,12.0,9.0,12.0,10.0,10.0,9.0,10.0,12.0,11.0,14.0,8.0,13.0,12.0,10.0,11.0,16.0,15.0,10.0,8.0,20.0,10.0,16.0,5.0,15.0,11.0,10.0,9.0,9.0,8.0,10.0,9.0,11.0,11.0,11.0,12.0,10.0,17.0,1.0,32.0,55.0,0.0,0.0,0.0,180.0,74.0,1.0,3.0,3.0,2.0,1.0,2.0,2.0,1.0,3.0,3.0,1.0,6.0,8.0,8.0,6.0,11.0,10.0,12.0,10.0,6.0,13.0,11.0,7.0,15.0,11.0,14.0,14.0,17.0,12.0,14.0,10.0,13.0,16.0,8.0,12.0,8.0,14.0,16.0,18.0,12.0,13.0,13.0,10.0,8.0,16.0,14.0,20.0,18.0,13.0,16.0,15.0,14.0,5.0,10.0,9.0,15.0,13.0,15.0,14.0,11.0,10.0,7.0,25.0,0.0,0.0,0.0,0.0,177.0,66.0,2.0,3.0,1.0,3.0,2.0,3.0,4.0,1.0,4.0,3.0,1.0,11.0,11.0,11.0,7.0,13.0,11.0,8.0,10.0,7.0,4.0,12.0,11.0,6.0,12.0,8.0,12.0,11.0,12.0,12.0,12.0,9.0,13.0,11.0,7.0,11.0,9.0,14.0,13.0,11.0,13.0,12.0,9.0,20.0,14.0,10.0,8.0,16.0,9.0,13.0,8.0,2.0,6.0,10.0,9.0,11.0,15.0,12.0,14.0,14.0,14.0,6.0,21.0,2.0,1.0,0.0,0.0,173.0,68.0,4.0,1.0,1.0,3.0,1.0,3.0,1.0,1.0,1.0,1.0,1.0,8.0,12.0,11.0,11.0,12.0,8.0,5.0,6.0,4.0,5.0,12.0,9.0,7.0,12.0,13.0,10.0,10.0,9.0,13.0,13.0,11.0,10.0,13.0,6.0,12.0,8.0,10.0,13.0,14.0,14.0,14.0,7.0,13.0,12.0,13.0,20.0,11.0,7.0,13.0,6.0,12.0,6.0,9.0,11.0,12.0,9.0,7.0,10.0,11.0,13.0,7.0,19.0,0.0,0.0,0.0,0.0,175.0,60.0,4.0,2.0,2.0,1.0,1.0,2.0,3.0,2.0,3.0,3.0,1.0,10.0,11.0,15.0,12.0,14.0,6.0,4.0,13.0,10.0,10.0,12.0,9.0,11.0,14.0,8.0,10.0,10.0,14.0,11.0,12.0,15.0,4.0,11.0,7.0,8.0,10.0,11.0,12.0,12.0,12.0,11.0,8.0,5.0,9.0,10.0,20.0,9.0,8.0,10.0,10.0,7.0,10.0,10.0,14.0,12.0,10.0,11.0,14.0,10.0,11.0,2.0,28.0,0.0,0.0,0.0,0.0,185.0,80.0,3.0,4.0,2.0,1.0,3.0,3.0,4.0,1.0,3.0,2.0,2.0,10.0,12.0,13.0,12.0,14.0,11.0,13.0,10.0,4.0,6.0,13.0,10.0,4.0,13.0,15.0,12.0,16.0,10.0,10.0,12.0,12.0,14.0,12.0,5.0,13.0,8.0,11.0,14.0,13.0,13.0,14.0,12.0,8.0,13.0,14.0,20.0,11.0,13.0,13.0,11.0,13.0,7.0,10.0,12.0,14.0,12.0,12.0,11.0,13.0,13.0,7.0,19.0,0.0,0.0,0.0,0.0,185.0,79.0,2.0,3.0,3.0,1.0,2.0,1.0,2.0,3.0,3.0,3.0,2.0,11.0,11.0,11.0,12.0,11.0,10.0,12.0,12.0,5.0,6.0,11.0,12.0,6.0,12.0,15.0,12.0,13.0,11.0,10.0,12.0,11.0,10.0,13.0,12.0,12.0,8.0,10.0,12.0,10.0,13.0,12.0,12.0,20.0,10.0,9.0,10.0,10.0,7.0,10.0,12.0,10.0,5.0,9.0,11.0,12.0,13.0,10.0,13.0,14.0,18.0,3.0
0,1,33.0,0.0,0.0,3.0,0.0,188.0,84.0,14.0,13.0,13.0,9.0,13.0,13.0,15.0,15.0,11.0,11.0,9.0,7.0,3.0,3.0,1.0,7.0,10.0,2.0,1.0,1.0,2.0,6.0,4.0,1.0,7.0,8.0,13.0,14.0,14.0,14.0,8.0,11.0,15.0,6.0,13.0,3.0,13.0,12.0,8.0,12.0,14.0,15.0,14.0,8.0,13.0,11.0,20.0,13.0,15.0,16.0,8.0,13.0,6.0,1.0,11.0,14.0,13.0,11.0,16.0,14.0,11.0,6.0,28.0,0.0,0.0,0.0,0.0,193.0,84.0,1.0,1.0,2.0,2.0,2.0,3.0,2.0,3.0,2.0,1.0,3.0,4.0,8.0,8.0,9.0,10.0,6.0,14.0,7.0,8.0,14.0,12.0,6.0,14.0,11.0,12.0,13.0,14.0,11.0,14.0,12.0,12.0,14.0,6.0,11.0,8.0,14.0,13.0,13.0,11.0,11.0,16.0,16.0,20.0,12.0,12.0,8.0,14.0,16.0,14.0,12.0,13.0,6.0,10.0,7.0,12.0,15.0,12.0,16.0,15.0,13.0,6.0,29.0,2.0,0.0,0.0,0.0,185.0,75.0,2.0,3.0,3.0,3.0,2.0,3.0,2.0,1.0,3.0,1.0,2.0,4.0,10.0,8.0,6.0,10.0,6.0,14.0,7.0,7.0,14.0,11.0,6.0,14.0,9.0,13.0,13.0,14.0,11.0,12.0,12.0,12.0,14.0,8.0,11.0,12.0,13.0,13.0,13.0,15.0,12.0,15.0,12.0,8.0,15.0,13.0,20.0,14.0,15.0,14.0,7.0,14.0,8.0,6.0,14.0,13.0,15.0,14.0,14.0,14.0,14.0,6.0,26.0,0.0,0.0,0.0,0.0,182.0,68.0,1.0,4.0,3.0,2.0,3.0,1.0,2.0,1.0,2.0,4.0,1.0,7.0,12.0,9.0,5.0,10.0,6.0,12.0,7.0,15.0,12.0,9.0,6.0,12.0,10.0,12.0,13.0,14.0,11.0,10.0,9.0,9.0,13.0,7.0,6.0,10.0,10.0,14.0,15.0,16.0,13.0,13.0,11.0,5.0,15.0,15.0,20.0,14.0,10.0,12.0,12.0,13.0,7.0,12.0,12.0,14.0,14.0,15.0,13.0,14.0,14.0,7.0,26.0,0.0,0.0,0.0,0.0,175.0,69.0,3.0,3.0,2.0,2.0,3.0,1.0,3.0,1.0,3.0,2.0,2.0,6.0,12.0,10.0,5.0,11.0,6.0,10.0,10.0,10.0,13.0,12.0,9.0,13.0,12.0,12.0,13.0,14.0,12.0,13.0,12.0,11.0,15.0,11.0,13.0,12.0,13.0,14.0,14.0,15.0,13.0,12.0,7.0,9.0,13.0,13.0,20.0,14.0,11.0,14.0,12.0,12.0,11.0,15.0,14.0,9.0,17.0,10.0,8.0,11.0,20.0,7.0,25.0,0.0,0.0,15.0,1.0,176.0,64.0,2.0,2.0,3.0,3.0,1.0,1.0,3.0,3.0,2.0,1.0,3.0,9.0,9.0,11.0,7.0,13.0,11.0,14.0,9.0,6.0,12.0,14.0,6.0,13.0,13.0,13.0,14.0,15.0,14.0,14.0,13.0,13.0,15.0,8.0,11.0,9.0,12.0,15.0,18.0,14.0,14.0,12.0,10.0,5.0,15.0,11.0,20.0,16.0,10.0,15.0,13.0,15.0,5.0,10.0,11.0,14.0,14.0,14.0,17.0,13.0,13.0,5.0,21.0,0.0,0.0,0.0,0.0,183.0,73.0,1.0,4.0,3.0,3.0,3.0,1.0,4.0,1.0,2.0,3.0,2.0,11.0,10.0,12.0,11.0,13.0,9.0,12.0,10.0,5.0,8.0,12.0,9.0,8.0,13.0,13.0,12.0,12.0,10.0,12.0,14.0,12.0,12.0,14.0,8.0,12.0,8.0,12.0,12.0,14.0,14.0,14.0,11.0,8.0,13.0,13.0,20.0,12.0,12.0,12.0,5.0,10.0,7.0,12.0,15.0,11.0,11.0,10.0,11.0,12.0,11.0,4.0,30.0,9.0,1.0,0.0,0.0,192.0,90.0,2.0,2.0,2.0,2.0,3.0,1.0,3.0,4.0,1.0,1.0,3.0,4.0,7.0,10.0,10.0,9.0,8.0,17.0,12.0,6.0,13.0,12.0,8.0,12.0,11.0,13.0,14.0,15.0,13.0,13.0,10.0,12.0,14.0,12.0,13.0,13.0,12.0,14.0,16.0,12.0,12.0,18.0,16.0,8.0,14.0,13.0,20.0,16.0,18.0,13.0,13.0,14.0,7.0,12.0,13.0,13.0,13.0,13.0,13.0,13.0,13.0,6.0,18.0,0.0,0.0,0.0,0.0,188.0,0.0,2.0,2.0,1.0,1.0,1.0,2.0,1.0,4.0,2.0,2.0,1.0,8.0,11.0,14.0,11.0,13.0,10.0,11.0,10.0,2.0,6.0,12.0,11.0,8.0,13.0,8.0,11.0,9.0,13.0,9.0,13.0,11.0,14.0,15.0,8.0,12.0,7.0,11.0,13.0,14.0,12.0,12.0,13.0,12.0,11.0,14.0,20.0,11.0,11.0,12.0,8.0,11.0,8.0,14.0,12.0,11.0,10.0,12.0,13.0,12.0,14.0,7.0,23.0,0.0,0.0,0.0,0.0,175.0,70.0,2.0,1.0,2.0,2.0,1.0,2.0,2.0,3.0,4.0,1.0,2.0,10.0,11.0,12.0,9.0,13.0,8.0,6.0,13.0,2.0,5.0,13.0,10.0,6.0,13.0,7.0,13.0,9.0,13.0,11.0,13.0,12.0,13.0,12.0,10.0,12.0,10.0,13.0,12.0,11.0,12.0,13.0,8.0,8.0,14.0,12.0,20.0,14.0,12.0,13.0,9.0,11.0,10.0,11.0,19.0,12.0,14.0,11.0,13.0,10.0,16.0,7.0,24.0,0.0,0.0,4.0,0.0,181.0,79.0,1.0,3.0,2.0,2.0,1.0,1.0,1.0,2.0,2.0,2.0,1.0,4.0,6.0,10.0,11.0,11.0,7.0,12.0,10.0,5.0,5.0,7.0,13.0,3.0,10.0,9.0,12.0,12.0,11.0,10.0,6.0,10.0,8.0,9.0,5.0,11.0,5.0,9.0,12.0,15.0,13.0,13.0,11.0,5.0,11.0,14.0,20.0,13.0,14.0,11.0,9.0,12.0,13.0,5.0,19.0,11.0,9.0,9.0,7.0,14.0,14.0,13.0,26.0,2.0,0.0,1.0,0.0,188.0,84.0,12.0,13.0,15.0,9.0,15.0,13.0,13.0,15.0,10.0,11.0,14.0,9.0,2.0,1.0,2.0,12.0,11.0,3.0,2.0,3.0,3.0,11.0,3.0,1.0,10.0,14.0,13.0,14.0,10.0,13.0,11.0,11.0,14.0,3.0,11.0,5.0,12.0,15.0,13.0,10.0,12.0,13.0,14.0,5.0,14.0,9.0,20.0,12.0,14.0,12.0,10.0,15.0,3.0,11.0,12.0,11.0,16.0,13.0,15.0,16.0,16.0,4.0,19.0,1.0,0.0,0.0,0.0,182.0,67.0,1.0,3.0,2.0,1.0,2.0,3.0,1.0,1.0,2.0,1.0,1.0,7.0,7.0,8.0,4.0,10.0,7.0,9.0,9.0,7.0,14.0,9.0,7.0,13.0,9.0,9.0,10.0,8.0,9.0,8.0,9.0,14.0,2.0,7.0,12.0,7.0,8.0,8.0,12.0,12.0,10.0,9.0,11.0,5.0,13.0,8.0,20.0,11.0,8.0,9.0,5.0,4.0,9.0,9.0,10.0,12.0,13.0,9.0,10.0,13.0,12.0,3.0,32.0,0.0,0.0,0.0,0.0,183.0,79.0,1.0,1.0,1.0,3.0,1.0,3.0,1.0,1.0,2.0,1.0,1.0,5.0,10.0,6.0,6.0,9.0,6.0,15.0,7.0,11.0,14.0,10.0,7.0,13.0,10.0,13.0,15.0,15.0,15.0,14.0,9.0,13.0,16.0,6.0,14.0,8.0,12.0,13.0,16.0,11.0,12.0,16.0,11.0,8.0,16.0,12.0,20.0,15.0,14.0,14.0,11.0,12.0,5.0,15.0,18.0,15.0,14.0,13.0,17.0,14.0,14.0,5.0,29.0,0.0,0.0,0.0,0.0,183.0,74.0,3.0,3.0,3.0,3.0,3.0,2.0,2.0,2.0,1.0,3.0,1.0,5.0,12.0,7.0,6.0,10.0,7.0,14.0,12.0,5.0,14.0,12.0,6.0,13.0,11.0,14.0,13.0,17.0,13.0,16.0,12.0,12.0,13.0,9.0,8.0,9.0,14.0,14.0,15.0,13.0,12.0,15.0,12.0,6.0,17.0,11.0,20.0,17.0,13.0,14.0,14.0,15.0,5.0,13.0,9.0,14.0,19.0,15.0,14.0,11.0,11.0,6.0,22.0,0.0,0.0,0.0,0.0,178.0,73.0,3.0,2.0,2.0,1.0,2.0,4.0,3.0,1.0,3.0,1.0,2.0,6.0,12.0,12.0,6.0,11.0,7.0,8.0,8.0,11.0,12.0,10.0,8.0,13.0,11.0,12.0,12.0,13.0,11.0,10.0,11.0,11.0,13.0,6.0,7.0,12.0,9.0,13.0,14.0,16.0,14.0,13.0,9.0,6.0,14.0,15.0,20.0,15.0,14.0,12.0,12.0,13.0,6.0,14.0,12.0,15.0,13.0,13.0,14.0,14.0,14.0,6.0,21.0,0.0,0.0,0.0,0.0,172.0,68.0,3.0,3.0,1.0,2.0,1.0,2.0,3.0,2.0,2.0,3.0,2.0,12.0,13.0,12.0,8.0,12.0,12.0,5.0,8.0,12.0,11.0,13.0,8.0,13.0,12.0,14.0,13.0,14.0,13.0,13.0,10.0,11.0,15.0,9.0,13.0,13.0,12.0,13.0,14.0,12.0,12.0,12.0,6.0,20.0,13.0,13.0,13.0,13.0,11.0,12.0,10.0,10.0,11.0,9.0,20.0,13.0,15.0,12.0,16.0,13.0,13.0,8.0,32.0,0.0,0.0,13.0,0.0,175.0,65.0,2.0,1.0,1.0,2.0,3.0,3.0,1.0,2.0,3.0,2.0,3.0,15.0,13.0,11.0,6.0,14.0,13.0,10.0,12.0,8.0,8.0,16.0,8.0,12.0,13.0,11.0,14.0,15.0,14.0,15.0,14.0,14.0,14.0,6.0,13.0,9.0,15.0,18.0,13.0,12.0,13.0,13.0,8.0,8.0,13.0,10.0,20.0,13.0,13.0,12.0,11.0,15.0,12.0,10.0,17.0,14.0,15.0,14.0,16.0,14.0,14.0,6.0,27.0,0.0,0.0,0.0,0.0,188.0,77.0,1.0,4.0,1.0,1.0,3.0,1.0,2.0,1.0,2.0,2.0,2.0,4.0,7.0,8.0,7.0,13.0,6.0,15.0,9.0,6.0,13.0,12.0,6.0,12.0,11.0,14.0,14.0,15.0,10.0,12.0,11.0,13.0,16.0,7.0,12.0,9.0,12.0,15.0,16.0,14.0,10.0,14.0,15.0,9.0,13.0,12.0,20.0,14.0,16.0,12.0,14.0,13.0,6.0,12.0,4.0,13.0,18.0,13.0,14.0,14.0,13.0,7.0,18.0,0.0,0.0,0.0,0.0,179.0,67.0,3.0,3.0,2.0,4.0,2.0,4.0,3.0,1.0,3.0,4.0,1.0,5.0,7.0,12.0,9.0,12.0,12.0,10.0,12.0,6.0,4.0,12.0,12.0,3.0,14.0,11.0,12.0,11.0,11.0,8.0,13.0,12.0,12.0,12.0,6.0,12.0,5.0,10.0,12.0,15.0,11.0,12.0,10.0,20.0,13.0,14.0,8.0,14.0,8.0,9.0,6.0,14.0,5.0,10.0,16.0,13.0,12.0,12.0,13.0,9.0,15.0,2.0,25.0,0.0,0.0,3.0,2.0,170.0,61.0,2.0,3.0,2.0,2.0,1.0,3.0,2.0,2.0,1.0,2.0,1.0,11.0,12.0,13.0,10.0,13.0,8.0,5.0,8.0,7.0,4.0,14.0,10.0,4.0,15.0,11.0,10.0,9.0,7.0,10.0,14.0,8.0,13.0,13.0,6.0,12.0,8.0,8.0,12.0,16.0,14.0,7.0,5.0,12.0,15.0,16.0,20.0,14.0,6.0,12.0,11.0,13.0,8.0,8.0,8.0,13.0,15.0,10.0,10.0,14.0,14.0,8.0,28.0,0.0,0.0,2.0,2.0,182.0,79.0,1.0,1.0,2.0,2.0,3.0,1.0,2.0,3.0,1.0,2.0,2.0,8.0,11.0,14.0,12.0,14.0,11.0,12.0,13.0,6.0,4.0,11.0,13.0,5.0,14.0,11.0,12.0,13.0,10.0,12.0,11.0,11.0,15.0,13.0,7.0,14.0,7.0,12.0,14.0,15.0,14.0,14.0,12.0,8.0,15.0,14.0,20.0,15.0,14.0,12.0,11.0,15.0,8.0,8.0,16.0,15.0,12.0,11.0,14.0,13.0,12.0,8.0
1,0,22.0,0.0,0.0,0.0,0.0,186.0,79.0,14.0,13.0,11.0,7.0,12.0,10.0,13.0,14.0,8.0,6.0,8.0,2.0,1.0,3.0,6.0,8.0,5.0,3.0,11.0,3.0,2.0,8.0,8.0,1.0,8.0,8.0,12.0,14.0,12.0,11.0,7.0,11.0,12.0,6.0,9.0,3.0,12.0,12.0,5.0,8.0,12.0,15.0,15.0,20.0,15.0,7.0,5.0,9.0,15.0,14.0,8.0,5.0,5.0,1.0,10.0,12.0,13.0,12.0,8.0,15.0,15.0,5.0,21.0,0.0,0.0,0.0,0.0,182.0,74.0,2.0,2.0,2.0,2.0,2.0,1.0,1.0,1.0,3.0,2.0,2.0,9.0,11.0,12.0,7.0,9.0,8.0,12.0,7.0,11.0,12.0,7.0,8.0,13.0,11.0,12.0,12.0,14.0,12.0,13.0,7.0,12.0,11.0,1.0,9.0,11.0,9.0,10.0,12.0,14.0,10.0,13.0,11.0,9.0,8.0,12.0,20.0,13.0,11.0,10.0,13.0,8.0,10.0,10.0,15.0,11.0,13.0,10.0,10.0,8.0,13.0,7.0,28.0,0.0,0.0,9.0,1.0,187.0,85.0,3.0,3.0,2.0,2.0,3.0,2.0,2.0,1.0,1.0,1.0,2.0,4.0,10.0,7.0,7.0,11.0,8.0,16.0,11.0,13.0,14.0,10.0,6.0,14.0,11.0,14.0,14.0,17.0,11.0,14.0,8.0,13.0,14.0,7.0,12.0,7.0,13.0,16.0,15.0,12.0,12.0,15.0,13.0,8.0,14.0,11.0,20.0,14.0,15.0,15.0,6.0,15.0,8.0,8.0,8.0,15.0,12.0,12.0,13.0,14.0,14.0,5.0,17.0,0.0,0.0,0.0,0.0,173.0,0.0,2.0,1.0,3.0,1.0,2.0,3.0,1.0,3.0,2.0,1.0,2.0,3.0,5.0,7.0,6.0,8.0,2.0,8.0,1.0,8.0,10.0,7.0,4.0,15.0,10.0,9.0,7.0,10.0,7.0,6.0,5.0,8.0,9.0,5.0,12.0,8.0,6.0,9.0,9.0,15.0,15.0,9.0,7.0,20.0,14.0,15.0,5.0,7.0,8.0,9.0,9.0,9.0,9.0,9.0,18.0,8.0,10.0,11.0,11.0,8.0,12.0,4.0,21.0,0.0,0.0,1.0,0.0,177.0,68.0,4.0,1.0,2.0,1.0,1.0,1.0,1.0,1.0,2.0,1.0,2.0,5.0,12.0,9.0,7.0,12.0,8.0,13.0,10.0,16.0,13.0,12.0,8.0,14.0,12.0,12.0,13.0,12.0,12.0,12.0,10.0,13.0,15.0,11.0,13.0,11.0,13.0,13.0,14.0,13.0,14.0,13.0,11.0,10.0,14.0,12.0,20.0,12.0,14.0,12.0,11.0,12.0,8.0,14.0,13.0,10.0,14.0,12.0,14.0,12.0,11.0,5.0,27.0,32.0,6.0,0.0,0.0,188.0,78.0,3.0,2.0,3.0,2.0,1.0,3.0,3.0,3.0,2.0,2.0,2.0,4.0,8.0,11.0,12.0,12.0,6.0,16.0,13.0,8.0,13.0,14.0,7.0,12.0,12.0,12.0,10.0,14.0,13.0,12.0,11.0,12.0,15.0,9.0,11.0,12.0,6.0,13.0,12.0,14.0,13.0,15.0,15.0,5.0,13.0,12.0,20.0,16.0,15.0,14.0,12.0,15.0,11.0,10.0,9.0,15.0,12.0,12.0,13.0,13.0,13.0,7.0,27.0,1.0,0.0,0.0,0.0,179.0,70.0,3.0,2.0,1.0,3.0,3.0,2.0,1.0,3.0,2.0,1.0,1.0,14.0,15.0,15.0,11.0,15.0,14.0,8.0,12.0,5.0,8.0,13.0,12.0,9.0,18.0,11.0,11.0,11.0,9.0,10.0,16.0,10.0,17.0,15.0,8.0,12.0,8.0,12.0,11.0,14.0,13.0,12.0,10.0,12.0,13.0,14.0,20.0,16.0,12.0,10.0,9.0,10.0,7.0,8.0,13.0,15.0,13.0,10.0,11.0,12.0,10.0,8.0,27.0,0.0,0.0,0.0,0.0,191.0,83.0,1.0,1.0,3.0,2.0,1.0,1.0,1.0,1.0,2.0,3.0,1.0,5.0,9.0,11.0,12.0,11.0,7.0,13.0,9.0,5.0,4.0,9.0,3.0,3.0,10.0,10.0,12.0,14.0,10.0,10.0,7.0,11.0,12.0,10.0,6.0,13.0,5.0,13.0,14.0,12.0,11.0,14.0,16.0,5.0,12.0,11.0,20.0,13.0,15.0,12.0,12.0,8.0,7.0,10.0,13.0,11.0,13.0,12.0,12.0,13.0,12.0,8.0,23.0,15.0,5.0,0.0,0.0,186.0,81.0,3.0,1.0,1.0,4.0,1.0,1.0,2.0,2.0,3.0,3.0,4.0,5.0,10.0,13.0,14.0,10.0,5.0,11.0,13.0,5.0,4.0,9.0,10.0,4.0,10.0,13.0,11.0,14.0,12.0,9.0,8.0,8.0,15.0,13.0,7.0,8.0,7.0,10.0,10.0,15.0,12.0,15.0,12.0,7.0,10.0,18.0,20.0,17.0,15.0,8.0,8.0,11.0,12.0,12.0,12.0,15.0,13.0,12.0,15.0,13.0,13.0,6.0,28.0,2.0,1.0,0.0,0.0,174.0,66.0,2.0,2.0,2.0,1.0,1.0,3.0,2.0,3.0,3.0,1.0,4.0,6.0,11.0,13.0,15.0,13.0,11.0,14.0,11.0,6.0,5.0,10.0,12.0,5.0,13.0,8.0,14.0,10.0,13.0,14.0,8.0,12.0,12.0,12.0,5.0,14.0,8.0,12.0,11.0,17.0,15.0,11.0,12.0,7.0,14.0,15.0,20.0,13.0,10.0,12.0,8.0,14.0,8.0,8.0,19.0,15.0,12.0,10.0,11.0,13.0,13.0,12.0,24.0,4.0,1.0,0.0,0.0,188.0,79.0,2.0,3.0,2.0,1.0,2.0,1.0,1.0,2.0,1.0,2.0,2.0,10.0,11.0,13.0,12.0,11.0,9.0,13.0,9.0,5.0,8.0,11.0,11.0,7.0,13.0,10.0,12.0,11.0,11.0,12.0,13.0,11.0,14.0,12.0,9.0,12.0,12.0,14.0,14.0,12.0,13.0,15.0,14.0,8.0,13.0,12.0,20.0,13.0,14.0,11.0,9.0,10.0,5.0,10.0,14.0,12.0,13.0,10.0,14.0,13.0,12.0,10.0,29.0,0.0,0.0,0.0,0.0,183.0,83.0,13.0,13.0,11.0,7.0,12.0,11.0,12.0,13.0,11.0,10.0,10.0,3.0,1.0,3.0,1.0,7.0,8.0,1.0,3.0,2.0,3.0,8.0,3.0,2.0,7.0,8.0,13.0,13.0,12.0,13.0,6.0,11.0,14.0,6.0,9.0,1.0,12.0,13.0,9.0,10.0,12.0,15.0,11.0,6.0,15.0,11.0,20.0,14.0,14.0,14.0,8.0,13.0,5.0,1.0,10.0,12.0,16.0,13.0,15.0,15.0,15.0,6.0,30.0,46.0,1.0,0.0,0.0,181.0,70.0,1.0,2.0,1.0,3.0,2.0,2.0,3.0,3.0,4.0,1.0,3.0,6.0,8.0,7.0,6.0,10.0,6.0,14.0,10.0,6.0,13.0,10.0,6.0,12.0,10.0,12.0,13.0,14.0,12.0,12.0,8.0,11.0,13.0,8.0,11.0,7.0,13.0,13.0,14.0,12.0,12.0,14.0,12.0,8.0,13.0,13.0,20.0,14.0,12.0,13.0,13.0,12.0,7.0,12.0,11.0,13.0,12.0,14.0,11.0,14.0,15.0,7.0,23.0,0.0,0.0,0.0,0.0,184.0,83.0,1.0,2.0,1.0,2.0,3.0,1.0,1.0,1.0,3.0,3.0,2.0,4.0,8.0,7.0,6.0,10.0,6.0,14.0,9.0,7.0,12.0,9.0,10.0,10.0,8.0,10.0,13.0,13.0,11.0,13.0,8.0,12.0,14.0,6.0,6.0,7.0,12.0,13.0,10.0,12.0,12.0,14.0,13.0,20.0,14.0,11.0,6.0,13.0,13.0,11.0,10.0,8.0,6.0,8.0,9.0,11.0,13.0,10.0,13.0,14.0,14.0,6.0,26.0,0.0,0.0,0.0,0.0,183.0,74.0,1.0,3.0,2.0,3.0,3.0,3.0,1.0,2.0,1.0,1.0,1.0,10.0,11.0,8.0,7.0,11.0,8.0,12.0,5.0,13.0,12.0,10.0,6.0,12.0,10.0,12.0,11.0,13.0,11.0,10.0,8.0,11.0,12.0,8.0,10.0,12.0,12.0,12.0,14.0,13.0,12.0,13.0,11.0,20.0,14.0,13.0,6.0,14.0,13.0,13.0,8.0,13.0,11.0,12.0,19.0,13.0,12.0,13.0,11.0,13.0,18.0,1.0,25.0,0.0,0.0,0.0,0.0,181.0,76.0,1.0,3.0,1.0,2.0,3.0,2.0,3.0,3.0,1.0,3.0,2.0,6.0,12.0,10.0,6.0,11.0,7.0,11.0,8.0,10.0,11.0,11.0,6.0,12.0,11.0,14.0,12.0,14.0,11.0,12.0,10.0,11.0,15.0,11.0,8.0,13.0,12.0,13.0,15.0,12.0,11.0,14.0,10.0,6.0,14.0,11.0,20.0,14.0,12.0,13.0,8.0,10.0,6.0,14.0,20.0,12.0,14.0,12.0,13.0,15.0,15.0,6.0,25.0,0.0,0.0,0.0,0.0,184.0,80.0,3.0,2.0,1.0,2.0,2.0,2.0,2.0,2.0,2.0,3.0,1.0,9.0,12.0,10.0,6.0,13.0,6.0,10.0,12.0,7.0,11.0,13.0,6.0,10.0,12.0,13.0,12.0,14.0,13.0,13.0,7.0,12.0,13.0,8.0,13.0,10.0,12.0,14.0,15.0,11.0,9.0,14.0,12.0,12.0,13.0,12.0,20.0,13.0,13.0,13.0,13.0,14.0,13.0,12.0,18.0,13.0,14.0,14.0,14.0,15.0,15.0,6.0,22.0,0.0,0.0,0.0,0.0,188.0,85.0,4.0,2.0,2.0,1.0,1.0,1.0,1.0,1.0,1.0,2.0,1.0,4.0,8.0,12.0,6.0,11.0,5.0,9.0,7.0,5.0,10.0,11.0,7.0,13.0,13.0,11.0,9.0,11.0,8.0,9.0,12.0,12.0,10.0,13.0,6.0,10.0,8.0,9.0,12.0,12.0,13.0,15.0,13.0,5.0,13.0,12.0,20.0,15.0,15.0,10.0,10.0,10.0,8.0,7.0,15.0,18.0,10.0,10.0,10.0,10.0,11.0,2.0,23.0,0.0,0.0,0.0,0.0,182.0,73.0,4.0,1.0,3.0,3.0,2.0,1.0,1.0,2.0,2.0,1.0,3.0,11.0,11.0,10.0,6.0,9.0,10.0,10.0,8.0,3.0,7.0,10.0,4.0,8.0,9.0,8.0,8.0,9.0,8.0,7.0,10.0,8.0,12.0,9.0,6.0,9.0,9.0,11.0,11.0,11.0,10.0,11.0,10.0,20.0,10.0,11.0,12.0,13.0,10.0,11.0,6.0,9.0,9.0,18.0,12.0,12.0,11.0,7.0,10.0,1.0,15.0,3.0,22.0,0.0,0.0,0.0,0.0,176.0,75.0,2.0,3.0,2.0,3.0,1.0,1.0,1.0,2.0,1.0,1.0,3.0,13.0,12.0,13.0,11.0,13.0,13.0,7.0,10.0,6.0,6.0,11.0,8.0,6.0,13.0,11.0,10.0,9.0,10.0,11.0,11.0,11.0,11.0,13.0,5.0,13.0,8.0,9.0,11.0,14.0,12.0,11.0,8.0,10.0,11.0,12.0,20.0,13.0,9.0,12.0,9.0,7.0,8.0,13.0,19.0,11.0,10.0,12.0,12.0,12.0,12.0,4.0,23.0,16.0,7.0,4.0,0.0,183.0,79.0,4.0,3.0,3.0,4.0,3.0,2.0,2.0,1.0,2.0,3.0,3.0,11.0,11.0,13.0,14.0,14.0,8.0,13.0,12.0,4.0,4.0,11.0,12.0,7.0,13.0,13.0,12.0,9.0,12.0,12.0,8.0,12.0,13.0,13.0,8.0,14.0,7.0,8.0,11.0,14.0,13.0,11.0,12.0,12.0,14.0,13.0,20.0,14.0,13.0,11.0,13.0,12.0,5.0,13.0,13.0,13.0,11.0,8.0,11.0,6.0,10.0,5.0,21.0,0.0,0.0,6.0,1.0,179.0,76.0,2.0,1.0,2.0,3.0,2.0,2.0,3.0,3.0,3.0,2.0,3.0,9.0,7.0,12.0,12.0,15.0,9.0,12.0,7.0,2.0,9.0,10.0,5.0,7.0,11.0,8.0,15.0,10.0,12.0,12.0,11.0,12.0,12.0,8.0,2.0,12.0,12.0,11.0,11.0,12.0,12.0,10.0,13.0,11.0,15.0,12.0,20.0,12.0,11.0,10.0,10.0,4.0,7.0,12.0,10.0,10.0,11.0,10.0,9.0,8.0,11.0,11.0
3,0,25.0,0.0,0.0,0.0,0.0,187.0,83.0,11.0,14.0,12.0,8.0,13.0,11.0,14.0,15.0,13.0,13.0,9.0,8.0,1.0,1.0,1.0,11.0,11.0,1.0,2.0,2.0,1.0,10.0,3.0,2.0,11.0,8.0,12.0,14.0,12.0,12.0,10.0,12.0,14.0,6.0,14.0,2.0,12.0,12.0,8.0,13.0,15.0,14.0,13.0,20.0,15.0,11.0,5.0,14.0,13.0,13.0,8.0,8.0,10.0,1.0,9.0,13.0,14.0,12.0,15.0,15.0,15.0,5.0,17.0,0.0,0.0,0.0,0.0,178.0,72.0,2.0,2.0,1.0,2.0,1.0,1.0,3.0,3.0,2.0,2.0,3.0,7.0,9.0,7.0,3.0,9.0,4.0,7.0,5.0,8.0,7.0,10.0,6.0,13.0,10.0,4.0,7.0,9.0,7.0,9.0,9.0,10.0,9.0,9.0,5.0,8.0,8.0,9.0,9.0,15.0,11.0,9.0,9.0,20.0,10.0,12.0,8.0,7.0,10.0,9.0,4.0,9.0,9.0,9.0,12.0,12.0,12.0,11.0,11.0,10.0,20.0,4.0,31.0,0.0,0.0,7.0,2.0,185.0,80.0,3.0,3.0,1.0,1.0,4.0,1.0,4.0,3.0,3.0,3.0,1.0,5.0,10.0,9.0,6.0,11.0,7.0,15.0,8.0,8.0,14.0,12.0,6.0,13.0,11.0,12.0,14.0,16.0,12.0,13.0,8.0,11.0,17.0,5.0,14.0,6.0,15.0,14.0,14.0,12.0,11.0,15.0,14.0,10.0,16.0,11.0,20.0,14.0,15.0,14.0,12.0,15.0,8.0,13.0,8.0,15.0,17.0,14.0,16.0,15.0,15.0,7.0,26.0,0.0,0.0,0.0,0.0,183.0,79.0,1.0,1.0,3.0,4.0,3.0,2.0,2.0,1.0,2.0,1.0,1.0,9.0,8.0,12.0,11.0,10.0,11.0,10.0,9.0,7.0,6.0,8.0,9.0,5.0,12.0,10.0,9.0,8.0,11.0,11.0,9.0,8.0,11.0,14.0,6.0,12.0,8.0,10.0,11.0,11.0,12.0,11.0,10.0,10.0,10.0,12.0,20.0,11.0,11.0,9.0,9.0,9.0,6.0,13.0,17.0,11.0,10.0,11.0,12.0,10.0,10.0,4.0,23.0,0.0,0.0,0.0,0.0,172.0,70.0,3.0,3.0,3.0,1.0,1.0,2.0,4.0,2.0,4.0,2.0,1.0,5.0,12.0,11.0,7.0,12.0,6.0,9.0,7.0,11.0,12.0,12.0,8.0,13.0,12.0,12.0,12.0,14.0,11.0,12.0,9.0,11.0,14.0,8.0,7.0,12.0,10.0,14.0,15.0,13.0,13.0,11.0,7.0,6.0,14.0,14.0,20.0,15.0,11.0,12.0,10.0,12.0,10.0,11.0,16.0,12.0,14.0,10.0,14.0,12.0,10.0,6.0,25.0,13.0,1.0,0.0,0.0,176.0,69.0,3.0,3.0,3.0,1.0,1.0,3.0,1.0,3.0,3.0,2.0,3.0,9.0,12.0,12.0,6.0,11.0,11.0,9.0,7.0,8.0,10.0,11.0,3.0,11.0,11.0,6.0,10.0,8.0,8.0,8.0,7.0,11.0,5.0,8.0,4.0,13.0,11.0,12.0,15.0,15.0,14.0,15.0,8.0,20.0,15.0,15.0,10.0,13.0,8.0,9.0,5.0,2.0,11.0,12.0,14.0,13.0,8.0,13.0,13.0,11.0,16.0,4.0,21.0,0.0,0.0,0.0,0.0,185.0,69.0,2.0,3.0,2.0,1.0,3.0,3.0,3.0,3.0,3.0,2.0,2.0,5.0,9.0,12.0,9.0,16.0,10.0,11.0,15.0,5.0,13.0,13.0,8.0,14.0,13.0,11.0,16.0,13.0,13.0,14.0,12.0,11.0,15.0,10.0,7.0,8.0,13.0,14.0,13.0,13.0,13.0,14.0,12.0,6.0,13.0,12.0,20.0,13.0,11.0,12.0,10.0,12.0,7.0,13.0,10.0,14.0,14.0,11.0,14.0,14.0,14.0,6.0,26.0,0.0,0.0,4.0,0.0,184.0,74.0,3.0,3.0,4.0,2.0,3.0,3.0,3.0,3.0,2.0,3.0,2.0,5.0,8.0,12.0,11.0,13.0,9.0,15.0,11.0,5.0,12.0,12.0,11.0,13.0,13.0,14.0,12.0,13.0,11.0,12.0,12.0,11.0,13.0,12.0,10.0,13.0,12.0,13.0,13.0,11.0,12.0,15.0,13.0,9.0,12.0,11.0,20.0,14.0,12.0,13.0,14.0,14.0,9.0,16.0,15.0,14.0,8.0,9.0,9.0,11.0,11.0,11.0,24.0,0.0,0.0,0.0,0.0,174.0,68.0,3.0,1.0,3.0,1.0,1.0,2.0,1.0,3.0,1.0,1.0,1.0,13.0,12.0,12.0,10.0,13.0,13.0,8.0,13.0,10.0,6.0,14.0,12.0,7.0,13.0,9.0,13.0,11.0,13.0,11.0,13.0,13.0,12.0,11.0,7.0,12.0,9.0,12.0,12.0,14.0,13.0,12.0,8.0,8.0,14.0,12.0,20.0,13.0,10.0,13.0,10.0,13.0,7.0,12.0,14.0,14.0,15.0,9.0,11.0,13.0,12.0,8.0,24.0,0.0,0.0,0.0,0.0,182.0,82.0,3.0,3.0,2.0,1.0,1.0,3.0,2.0,2.0,3.0,2.0,2.0,4.0,7.0,13.0,14.0,13.0,12.0,14.0,12.0,5.0,7.0,10.0,14.0,6.0,15.0,13.0,13.0,16.0,8.0,12.0,11.0,11.0,12.0,14.0,7.0,13.0,8.0,12.0,13.0,14.0,14.0,15.0,12.0,10.0,10.0,12.0,20.0,16.0,15.0,12.0,13.0,14.0,10.0,8.0,8.0,13.0,5.0,10.0,11.0,9.0,9.0,13.0,22.0,0.0,0.0,0.0,0.0,181.0,81.0,2.0,3.0,2.0,1.0,3.0,3.0,4.0,2.0,1.0,1.0,2.0,5.0,11.0,12.0,14.0,12.0,6.0,13.0,10.0,5.0,4.0,12.0,12.0,4.0,13.0,8.0,12.0,13.0,12.0,12.0,11.0,11.0,15.0,14.0,5.0,14.0,10.0,13.0,15.0,13.0,12.0,14.0,10.0,20.0,15.0,12.0,14.0,13.0,14.0,13.0,8.0,12.0,5.0,14.0,8.0,12.0,12.0,9.0,13.0,12.0,14.0,7.0,19.0,0.0,0.0,0.0,0.0,190.0,78.0,13.0,12.0,11.0,14.0,13.0,6.0,11.0,13.0,13.0,12.0,7.0,3.0,3.0,1.0,3.0,8.0,8.0,3.0,1.0,2.0,3.0,7.0,3.0,1.0,7.0,8.0,13.0,13.0,12.0,13.0,7.0,11.0,11.0,3.0,14.0,2.0,11.0,11.0,10.0,12.0,13.0,11.0,15.0,20.0,10.0,13.0,5.0,13.0,13.0,9.0,10.0,6.0,10.0,10.0,10.0,12.0,11.0,14.0,14.0,12.0,13.0,3.0,32.0,0.0,0.0,0.0,0.0,187.0,90.0,3.0,1.0,1.0,1.0,1.0,1.0,3.0,1.0,2.0,3.0,1.0,4.0,8.0,6.0,6.0,8.0,6.0,14.0,7.0,6.0,13.0,8.0,7.0,13.0,8.0,14.0,12.0,16.0,10.0,13.0,6.0,11.0,14.0,6.0,14.0,8.0,12.0,14.0,13.0,9.0,8.0,17.0,13.0,20.0,14.0,11.0,5.0,13.0,15.0,13.0,14.0,14.0,7.0,6.0,14.0,12.0,13.0,13.0,13.0,11.0,13.0,7.0,21.0,0.0,0.0,0.0,0.0,185.0,79.0,3.0,4.0,3.0,1.0,3.0,1.0,2.0,1.0,1.0,1.0,1.0,7.0,9.0,7.0,8.0,12.0,7.0,13.0,8.0,8.0,13.0,12.0,8.0,13.0,10.0,14.0,11.0,13.0,10.0,12.0,11.0,10.0,14.0,10.0,7.0,8.0,13.0,11.0,10.0,12.0,11.0,13.0,13.0,6.0,13.0,11.0,20.0,13.0,15.0,12.0,12.0,10.0,5.0,14.0,17.0,12.0,13.0,10.0,12.0,12.0,12.0,4.0,17.0,0.0,0.0,0.0,0.0,177.0,69.0,2.0,3.0,2.0,2.0,1.0,1.0,3.0,2.0,1.0,3.0,4.0,6.0,11.0,10.0,6.0,11.0,6.0,7.0,8.0,8.0,8.0,9.0,7.0,10.0,11.0,12.0,10.0,12.0,9.0,10.0,11.0,8.0,11.0,9.0,6.0,9.0,8.0,10.0,12.0,13.0,12.0,10.0,7.0,8.0,9.0,12.0,20.0,10.0,7.0,9.0,9.0,7.0,8.0,12.0,8.0,11.0,13.0,11.0,10.0,10.0,11.0,6.0,17.0,0.0,0.0,0.0,0.0,170.0,74.0,3.0,3.0,2.0,1.0,3.0,3.0,2.0,3.0,1.0,3.0,4.0,8.0,13.0,11.0,10.0,9.0,10.0,6.0,7.0,6.0,10.0,9.0,4.0,11.0,12.0,9.0,10.0,10.0,10.0,12.0,12.0,8.0,10.0,8.0,2.0,10.0,11.0,11.0,11.0,13.0,16.0,11.0,7.0,20.0,15.0,15.0,6.0,12.0,13.0,12.0,3.0,6.0,10.0,14.0,12.0,16.0,11.0,11.0,12.0,12.0,17.0,8.0,30.0,4.0,0.0,0.0,0.0,192.0,78.0,1.0,3.0,1.0,2.0,2.0,3.0,1.0,3.0,1.0,1.0,3.0,4.0,6.0,7.0,8.0,11.0,6.0,15.0,8.0,6.0,13.0,11.0,6.0,14.0,11.0,17.0,14.0,16.0,12.0,14.0,10.0,12.0,17.0,8.0,8.0,11.0,13.0,15.0,16.0,14.0,12.0,18.0,14.0,6.0,14.0,12.0,20.0,17.0,16.0,14.0,17.0,13.0,9.0,11.0,8.0,13.0,10.0,13.0,12.0,10.0,10.0,5.0,20.0,0.0,0.0,0.0,0.0,180.0,73.0,4.0,1.0,1.0,1.0,2.0,1.0,3.0,1.0,1.0,1.0,3.0,9.0,11.0,12.0,10.0,12.0,7.0,11.0,10.0,8.0,6.0,10.0,11.0,5.0,10.0,9.0,8.0,9.0,10.0,8.0,10.0,11.0,9.0,7.0,1.0,10.0,7.0,7.0,10.0,13.0,9.0,13.0,10.0,5.0,6.0,13.0,20.0,9.0,11.0,9.0,9.0,9.0,9.0,9.0,13.0,8.0,12.0,12.0,12.0,11.0,13.0,1.0,21.0,0.0,0.0,0.0,0.0,189.0,77.0,2.0,1.0,1.0,1.0,3.0,3.0,3.0,3.0,3.0,3.0,1.0,5.0,11.0,12.0,10.0,13.0,6.0,13.0,11.0,6.0,5.0,12.0,11.0,5.0,12.0,8.0,12.0,13.0,11.0,10.0,10.0,10.0,13.0,10.0,6.0,13.0,8.0,13.0,14.0,12.0,12.0,15.0,14.0,7.0,14.0,13.0,20.0,13.0,14.0,12.0,8.0,10.0,8.0,8.0,8.0,14.0,13.0,11.0,14.0,15.0,16.0,6.0,23.0,0.0,0.0,0.0,0.0,181.0,73.0,2.0,1.0,2.0,1.0,3.0,3.0,2.0,2.0,4.0,2.0,1.0,5.0,12.0,14.0,13.0,13.0,7.0,12.0,8.0,4.0,5.0,9.0,12.0,5.0,13.0,11.0,11.0,12.0,13.0,11.0,8.0,12.0,14.0,11.0,6.0,13.0,7.0,12.0,13.0,12.0,14.0,13.0,10.0,8.0,14.0,11.0,20.0,13.0,12.0,13.0,5.0,10.0,7.0,14.0,12.0,11.0,14.0,10.0,11.0,10.0,15.0,4.0,21.0,0.0,0.0,0.0,0.0,179.0,75.0,3.0,3.0,2.0,2.0,1.0,3.0,3.0,3.0,1.0,1.0,1.0,5.0,9.0,13.0,11.0,11.0,8.0,10.0,11.0,5.0,2.0,9.0,12.0,2.0,12.0,7.0,11.0,12.0,10.0,9.0,10.0,10.0,13.0,12.0,5.0,13.0,7.0,7.0,11.0,14.0,13.0,13.0,9.0,6.0,12.0,15.0,20.0,13.0,14.0,11.0,10.0,10.0,5.0,10.0,16.0,11.0,10.0,12.0,9.0,13.0,13.0,9.0,21.0,0.0,0.0,0.0,0.0,180.0,71.0,1.0,2.0,1.0,3.0,3.0,3.0,2.0,2.0,2.0,2.0,3.0,10.0,10.0,11.0,10.0,12.0,10.0,8.0,10.0,8.0,8.0,12.0,5.0,6.0,12.0,4.0,11.0,8.0,10.0,9.0,11.0,10.0,10.0,13.0,8.0,12.0,7.0,11.0,12.0,13.0,12.0,10.0,10.0,5.0,12.0,12.0,20.0,11.0,10.0,10.0,10.0,5.0,10.0,12.0,7.0,10.0,14.0,12.0,9.0,10.0,16.0,7.0
1,1,26.0,2.0,0.0,1.0,0.0,188.0,84.0,12.0,13.0,15.0,9.0,15.0,13.0,13.0,15.0,10.0,11.0,14.0,9.0,2.0,1.0,2.0,12.0,11.0,3.0,2.0,3.0,3.0,11.0,3.0,1.0,10.0,14.0,13.0,14.0,10.0,13.0,11.0,11.0,14.0,3.0,11.0,5.0,12.0,15.0,13.0,10.0,12.0,13.0,14.0,5.0,14.0,9.0,20.0,12.0,14.0,12.0,10.0,15.0,3.0,11.0,12.0,11.0,16.0,13.0,15.0,16.0,16.0,4.0,32.0,0.0,0.0,0.0,0.0,183.0,79.0,1.0,1.0,1.0,3.0,1.0,3.0,1.0,1.0,2.0,1.0,1.0,5.0,10.0,6.0,6.0,9.0,6.0,15.0,7.0,11.0,14.0,10.0,7.0,13.0,10.0,13.0,15.0,15.0,15.0,14.0,9.0,13.0,16.0,6.0,14.0,8.0,12.0,13.0,16.0,11.0,12.0,16.0,11.0,8.0,16.0,12.0,20.0,15.0,14.0,14.0,11.0,12.0,5.0,15.0,18.0,15.0,14.0,13.0,17.0,14.0,14.0,5.0,29.0,0.0,0.0,0.0,0.0,183.0,74.0,3.0,3.0,3.0,3.0,3.0,2.0,2.0,2.0,1.0,3.0,1.0,5.0,12.0,7.0,6.0,10.0,7.0,14.0,12.0,5.0,14.0,12.0,6.0,13.0,11.0,14.0,13.0,17.0,13.0,16.0,12.0,12.0,13.0,9.0,8.0,9.0,14.0,14.0,15.0,13.0,12.0,15.0,12.0,6.0,17.0,11.0,20.0,17.0,13.0,14.0,14.0,15.0,5.0,13.0,9.0,14.0,19.0,15.0,14.0,11.0,11.0,6.0,19.0,1.0,0.0,0.0,0.0,182.0,67.0,1.0,3.0,2.0,1.0,2.0,3.0,1.0,1.0,2.0,1.0,1.0,7.0,7.0,8.0,4.0,10.0,7.0,9.0,9.0,7.0,14.0,9.0,7.0,13.0,9.0,9.0,10.0,8.0,9.0,8.0,9.0,14.0,2.0,7.0,12.0,7.0,8.0,8.0,12.0,12.0,10.0,9.0,11.0,5.0,13.0,8.0,20.0,11.0,8.0,9.0,5.0,4.0,9.0,9.0,10.0,12.0,13.0,9.0,10.0,13.0,12.0,3.0,22.0,0.0,0.0,0.0,0.0,178.0,73.0,3.0,2.0,2.0,1.0,2.0,4.0,3.0,1.0,3.0,1.0,2.0,6.0,12.0,12.0,6.0,11.0,7.0,8.0,8.0,11.0,12.0,10.0,8.0,13.0,11.0,12.0,12.0,13.0,11.0,10.0,11.0,11.0,13.0,6.0,7.0,12.0,9.0,13.0,14.0,16.0,14.0,13.0,9.0,6.0,14.0,15.0,20.0,15.0,14.0,12.0,12.0,13.0,6.0,14.0,12.0,15.0,13.0,13.0,14.0,14.0,14.0,6.0,21.0,0.0,0.0,0.0,0.0,172.0,68.0,3.0,3.0,1.0,2.0,1.0,2.0,3.0,2.0,2.0,3.0,2.0,12.0,13.0,12.0,8.0,12.0,12.0,5.0,8.0,12.0,11.0,13.0,8.0,13.0,12.0,14.0,13.0,14.0,13.0,13.0,10.0,11.0,15.0,9.0,13.0,13.0,12.0,13.0,14.0,12.0,12.0,12.0,6.0,20.0,13.0,13.0,13.0,13.0,11.0,12.0,10.0,10.0,11.0,9.0,20.0,13.0,15.0,12.0,16.0,13.0,13.0,8.0,27.0,0.0,0.0,0.0,0.0,188.0,77.0,1.0,4.0,1.0,1.0,3.0,1.0,2.0,1.0,2.0,2.0,2.0,4.0,7.0,8.0,7.0,13.0,6.0,15.0,9.0,6.0,13.0,12.0,6.0,12.0,11.0,14.0,14.0,15.0,10.0,12.0,11.0,13.0,16.0,7.0,12.0,9.0,12.0,15.0,16.0,14.0,10.0,14.0,15.0,9.0,13.0,12.0,20.0,14.0,16.0,12.0,14.0,13.0,6.0,12.0,4.0,13.0,18.0,13.0,14.0,14.0,13.0,7.0,32.0,0.0,0.0,13.0,0.0,175.0,65.0,2.0,1.0,1.0,2.0,3.0,3.0,1.0,2.0,3.0,2.0,3.0,15.0,13.0,11.0,6.0,14.0,13.0,10.0,12.0,8.0,8.0,16.0,8.0,12.0,13.0,11.0,14.0,15.0,14.0,15.0,14.0,14.0,14.0,6.0,13.0,9.0,15.0,18.0,13.0,12.0,13.0,13.0,8.0,8.0,13.0,10.0,20.0,13.0,13.0,12.0,11.0,15.0,12.0,10.0,17.0,14.0,15.0,14.0,16.0,14.0,14.0,6.0,18.0,0.0,0.0,0.0,0.0,179.0,67.0,3.0,3.0,2.0,4.0,2.0,4.0,3.0,1.0,3.0,4.0,1.0,5.0,7.0,12.0,9.0,12.0,12.0,10.0,12.0,6.0,4.0,12.0,12.0,3.0,14.0,11.0,12.0,11.0,11.0,8.0,13.0,12.0,12.0,12.0,6.0,12.0,5.0,10.0,12.0,15.0,11.0,12.0,10.0,20.0,13.0,14.0,8.0,14.0,8.0,9.0,6.0,14.0,5.0,10.0,16.0,13.0,12.0,12.0,13.0,9.0,15.0,2.0,25.0,0.0,0.0,3.0,2.0,170.0,61.0,2.0,3.0,2.0,2.0,1.0,3.0,2.0,2.0,1.0,2.0,1.0,11.0,12.0,13.0,10.0,13.0,8.0,5.0,8.0,7.0,4.0,14.0,10.0,4.0,15.0,11.0,10.0,9.0,7.0,10.0,14.0,8.0,13.0,13.0,6.0,12.0,8.0,8.0,12.0,16.0,14.0,7.0,5.0,12.0,15.0,16.0,20.0,14.0,6.0,12.0,11.0,13.0,8.0,8.0,8.0,13.0,15.0,10.0,10.0,14.0,14.0,8.0,18.0,0.0,0.0,0.0,0.0,188.0,80.0,1.0,3.0,1.0,3.0,2.0,3.0,3.0,1.0,2.0,2.0,4.0,6.0,8.0,12.0,11.0,12.0,7.0,13.0,10.0,4.0,4.0,8.0,10.0,5.0,12.0,11.0,11.0,13.0,10.0,11.0,11.0,12.0,11.0,13.0,7.0,13.0,8.0,13.0,13.0,11.0,12.0,12.0,12.0,10.0,12.0,11.0,20.0,10.0,12.0,12.0,8.0,11.0,7.0,13.0,8.0,13.0,13.0,11.0,12.0,12.0,13.0,7.0,25.0,0.0,0.0,0.0,0.0,187.0,83.0,11.0,14.0,12.0,8.0,13.0,11.0,14.0,15.0,13.0,13.0,9.0,8.0,1.0,1.0,1.0,11.0,11.0,1.0,2.0,2.0,1.0,10.0,3.0,2.0,11.0,8.0,12.0,14.0,12.0,12.0,10.0,12.0,14.0,6.0,14.0,2.0,12.0,12.0,8.0,13.0,15.0,14.0,13.0,20.0,15.0,11.0,5.0,14.0,13.0,13.0,8.0,8.0,10.0,1.0,9.0,13.0,14.0,12.0,15.0,15.0,15.0,5.0,31.0,0.0,0.0,7.0,2.0,185.0,80.0,3.0,3.0,1.0,1.0,4.0,1.0,4.0,3.0,3.0,3.0,1.0,5.0,10.0,9.0,6.0,11.0,7.0,15.0,8.0,8.0,14.0,12.0,6.0,13.0,11.0,12.0,14.0,16.0,12.0,13.0,8.0,11.0,17.0,5.0,14.0,6.0,15.0,14.0,14.0,12.0,11.0,15.0,14.0,10.0,16.0,11.0,20.0,14.0,15.0,14.0,12.0,15.0,8.0,13.0,8.0,15.0,17.0,14.0,16.0,15.0,15.0,7.0,26.0,0.0,0.0,0.0,0.0,183.0,79.0,1.0,1.0,3.0,4.0,3.0,2.0,2.0,1.0,2.0,1.0,1.0,9.0,8.0,12.0,11.0,10.0,11.0,10.0,9.0,7.0,6.0,8.0,9.0,5.0,12.0,10.0,9.0,8.0,11.0,11.0,9.0,8.0,11.0,14.0,6.0,12.0,8.0,10.0,11.0,11.0,12.0,11.0,10.0,10.0,10.0,12.0,20.0,11.0,11.0,9.0,9.0,9.0,6.0,13.0,17.0,11.0,10.0,11.0,12.0,10.0,10.0,4.0,17.0,0.0,0.0,0.0,0.0,178.0,72.0,2.0,2.0,1.0,2.0,1.0,1.0,3.0,3.0,2.0,2.0,3.0,7.0,9.0,7.0,3.0,9.0,4.0,7.0,5.0,8.0,7.0,10.0,6.0,13.0,10.0,4.0,7.0,9.0,7.0,9.0,9.0,10.0,9.0,9.0,5.0,8.0,8.0,9.0,9.0,15.0,11.0,9.0,9.0,20.0,10.0,12.0,8.0,7.0,10.0,9.0,4.0,9.0,9.0,9.0,12.0,12.0,12.0,11.0,11.0,10.0,20.0,4.0,25.0,13.0,1.0,0.0,0.0,176.0,69.0,3.0,3.0,3.0,1.0,1.0,3.0,1.0,3.0,3.0,2.0,3.0,9.0,12.0,12.0,6.0,11.0,11.0,9.0,7.0,8.0,10.0,11.0,3.0,11.0,11.0,6.0,10.0,8.0,8.0,8.0,7.0,11.0,5.0,8.0,4.0,13.0,11.0,12.0,15.0,15.0,14.0,15.0,8.0,20.0,15.0,15.0,10.0,13.0,8.0,9.0,5.0,2.0,11.0,12.0,14.0,13.0,8.0,13.0,13.0,11.0,16.0,4.0,23.0,0.0,0.0,0.0,0.0,172.0,70.0,3.0,3.0,3.0,1.0,1.0,2.0,4.0,2.0,4.0,2.0,1.0,5.0,12.0,11.0,7.0,12.0,6.0,9.0,7.0,11.0,12.0,12.0,8.0,13.0,12.0,12.0,12.0,14.0,11.0,12.0,9.0,11.0,14.0,8.0,7.0,12.0,10.0,14.0,15.0,13.0,13.0,11.0,7.0,6.0,14.0,14.0,20.0,15.0,11.0,12.0,10.0,12.0,10.0,11.0,16.0,12.0,14.0,10.0,14.0,12.0,10.0,6.0,26.0,0.0,0.0,4.0,0.0,184.0,74.0,3.0,3.0,4.0,2.0,3.0,3.0,3.0,3.0,2.0,3.0,2.0,5.0,8.0,12.0,11.0,13.0,9.0,15.0,11.0,5.0,12.0,12.0,11.0,13.0,13.0,14.0,12.0,13.0,11.0,12.0,12.0,11.0,13.0,12.0,10.0,13.0,12.0,13.0,13.0,11.0,12.0,15.0,13.0,9.0,12.0,11.0,20.0,14.0,12.0,13.0,14.0,14.0,9.0,16.0,15.0,14.0,8.0,9.0,9.0,11.0,11.0,11.0,21.0,0.0,0.0,0.0,0.0,185.0,69.0,2.0,3.0,2.0,1.0,3.0,3.0,3.0,3.0,3.0,2.0,2.0,5.0,9.0,12.0,9.0,16.0,10.0,11.0,15.0,5.0,13.0,13.0,8.0,14.0,13.0,11.0,16.0,13.0,13.0,14.0,12.0,11.0,15.0,10.0,7.0,8.0,13.0,14.0,13.0,13.0,13.0,14.0,12.0,6.0,13.0,12.0,20.0,13.0,11.0,12.0,10.0,12.0,7.0,13.0,10.0,14.0,14.0,11.0,14.0,14.0,14.0,6.0,24.0,0.0,0.0,0.0,0.0,174.0,68.0,3.0,1.0,3.0,1.0,1.0,2.0,1.0,3.0,1.0,1.0,1.0,13.0,12.0,12.0,10.0,13.0,13.0,8.0,13.0,10.0,6.0,14.0,12.0,7.0,13.0,9.0,13.0,11.0,13.0,11.0,13.0,13.0,12.0,11.0,7.0,12.0,9.0,12.0,12.0,14.0,13.0,12.0,8.0,8.0,14.0,12.0,20.0,13.0,10.0,13.0,10.0,13.0,7.0,12.0,14.0,14.0,15.0,9.0,11.0,13.0,12.0,8.0,24.0,0.0,0.0,0.0,0.0,182.0,82.0,3.0,3.0,2.0,1.0,1.0,3.0,2.0,2.0,3.0,2.0,2.0,4.0,7.0,13.0,14.0,13.0,12.0,14.0,12.0,5.0,7.0,10.0,14.0,6.0,15.0,13.0,13.0,16.0,8.0,12.0,11.0,11.0,12.0,14.0,7.0,13.0,8.0,12.0,13.0,14.0,14.0,15.0,12.0,10.0,10.0,12.0,20.0,16.0,15.0,12.0,13.0,14.0,10.0,8.0,8.0,13.0,5.0,10.0,11.0,9.0,9.0,13.0,22.0,0.0,0.0,0.0,0.0,181.0,81.0,2.0,3.0,2.0,1.0,3.0,3.0,4.0,2.0,1.0,1.0,2.0,5.0,11.0,12.0,14.0,12.0,6.0,13.0,10.0,5.0,4.0,12.0,12.0,4.0,13.0,8.0,12.0,13.0,12.0,12.0,11.0,11.0,15.0,14.0,5.0,14.0,10.0,13.0,15.0,13.0,12.0,14.0,10.0,20.0,15.0,12.0,14.0,13.0,14.0,13.0,8.0,12.0,5.0,14.0,8.0,12.0,12.0,9.0,13.0,12.0,14.0,7.0
0,0,19.0,0.0,0.0,0.0,0.0,190.0,78.0,13.0,12.0,11.0,14.0,13.0,6.0,11.0,13.0,13.0,12.0,7.0,3.0,3.0,1.0,3.0,8.0,8.0,3.0,1.0,2.0,3.0,7.0,3.0,1.0,7.0,8.0,13.0,13.0,12.0,13.0,7.0,11.0,11.0,3.0,14.0,2.0,11.0,11.0,10.0,12.0,13.0,11.0,15.0,20.0,10.0,13.0,5.0,13.0,13.0,9.0,10.0,6.0,10.0,10.0,10.0,12.0,11.0,14.0,14.0,12.0,13.0,3.0,24.0,0.0,0.0,5.0,2.0,182.0,78.0,2.0,2.0,3.0,2.0,2.0,1.0,3.0,1.0,1.0,2.0,3.0,5.0,10.0,8.0,7.0,10.0,6.0,13.0,11.0,8.0,13.0,8.0,7.0,12.0,9.0,15.0,14.0,18.0,12.0,11.0,7.0,10.0,14.0,9.0,11.0,9.0,12.0,14.0,15.0,14.0,12.0,15.0,11.0,6.0,14.0,15.0,20.0,14.0,16.0,13.0,14.0,15.0,8.0,8.0,11.0,14.0,13.0,11.0,13.0,12.0,13.0,6.0,21.0,0.0,0.0,0.0,0.0,185.0,79.0,3.0,4.0,3.0,1.0,3.0,1.0,2.0,1.0,1.0,1.0,1.0,7.0,9.0,7.0,8.0,12.0,7.0,13.0,8.0,8.0,13.0,12.0,8.0,13.0,10.0,14.0,11.0,13.0,10.0,12.0,11.0,10.0,14.0,10.0,7.0,8.0,13.0,11.0,10.0,12.0,11.0,13.0,13.0,6.0,13.0,11.0,20.0,13.0,15.0,12.0,12.0,10.0,5.0,14.0,17.0,12.0,13.0,10.0,12.0,12.0,12.0,4.0,17.0,0.0,0.0,0.0,0.0,170.0,74.0,3.0,3.0,2.0,1.0,3.0,3.0,2.0,3.0,1.0,3.0,4.0,8.0,13.0,11.0,10.0,9.0,10.0,6.0,7.0,6.0,10.0,9.0,4.0,11.0,12.0,9.0,10.0,10.0,10.0,12.0,12.0,8.0,10.0,8.0,2.0,10.0,11.0,11.0,11.0,13.0,16.0,11.0,7.0,20.0,15.0,15.0,6.0,12.0,13.0,12.0,3.0,6.0,10.0,14.0,12.0,16.0,11.0,11.0,12.0,12.0,17.0,8.0,17.0,0.0,0.0,0.0,0.0,177.0,69.0,2.0,3.0,2.0,2.0,1.0,1.0,3.0,2.0,1.0,3.0,4.0,6.0,11.0,10.0,6.0,11.0,6.0,7.0,8.0,8.0,8.0,9.0,7.0,10.0,11.0,12.0,10.0,12.0,9.0,10.0,11.0,8.0,11.0,9.0,6.0,9.0,8.0,10.0,12.0,13.0,12.0,10.0,7.0,8.0,9.0,12.0,20.0,10.0,7.0,9.0,9.0,7.0,8.0,12.0,8.0,11.0,13.0,11.0,10.0,10.0,11.0,6.0,20.0,0.0,0.0,0.0,0.0,178.0,72.0,3.0,2.0,3.0,3.0,4.0,2.0,2.0,1.0,2.0,1.0,3.0,9.0,11.0,11.0,6.0,11.0,6.0,8.0,10.0,11.0,11.0,12.0,7.0,12.0,8.0,12.0,11.0,12.0,12.0,11.0,13.0,11.0,10.0,4.0,12.0,8.0,12.0,13.0,13.0,13.0,12.0,13.0,9.0,20.0,14.0,12.0,7.0,11.0,13.0,10.0,4.0,10.0,6.0,10.0,15.0,11.0,13.0,11.0,10.0,14.0,16.0,5.0,20.0,0.0,0.0,0.0,0.0,180.0,73.0,4.0,1.0,1.0,1.0,2.0,1.0,3.0,1.0,1.0,1.0,3.0,9.0,11.0,12.0,10.0,12.0,7.0,11.0,10.0,8.0,6.0,10.0,11.0,5.0,10.0,9.0,8.0,9.0,10.0,8.0,10.0,11.0,9.0,7.0,1.0,10.0,7.0,7.0,10.0,13.0,9.0,13.0,10.0,5.0,6.0,13.0,20.0,9.0,11.0,9.0,9.0,9.0,9.0,9.0,13.0,8.0,12.0,12.0,12.0,11.0,13.0,1.0,23.0,0.0,0.0,0.0,0.0,181.0,73.0,2.0,1.0,2.0,1.0,3.0,3.0,2.0,2.0,4.0,2.0,1.0,5.0,12.0,14.0,13.0,13.0,7.0,12.0,8.0,4.0,5.0,9.0,12.0,5.0,13.0,11.0,11.0,12.0,13.0,11.0,8.0,12.0,14.0,11.0,6.0,13.0,7.0,12.0,13.0,12.0,14.0,13.0,10.0,8.0,14.0,11.0,20.0,13.0,12.0,13.0,5.0,10.0,7.0,14.0,12.0,11.0,14.0,10.0,11.0,10.0,15.0,4.0,21.0,0.0,0.0,0.0,0.0,188.0,80.0,2.0,3.0,3.0,2.0,1.0,1.0,1.0,1.0,3.0,3.0,3.0,8.0,8.0,11.0,12.0,10.0,10.0,11.0,7.0,5.0,6.0,8.0,12.0,5.0,11.0,8.0,12.0,7.0,10.0,10.0,8.0,11.0,8.0,10.0,9.0,12.0,11.0,10.0,12.0,12.0,11.0,13.0,14.0,5.0,10.0,10.0,20.0,8.0,14.0,10.0,3.0,8.0,10.0,10.0,7.0,11.0,10.0,9.0,11.0,9.0,16.0,4.0,21.0,0.0,0.0,0.0,0.0,189.0,77.0,2.0,1.0,1.0,1.0,3.0,3.0,3.0,3.0,3.0,3.0,1.0,5.0,11.0,12.0,10.0,13.0,6.0,13.0,11.0,6.0,5.0,12.0,11.0,5.0,12.0,8.0,12.0,13.0,11.0,10.0,10.0,10.0,13.0,10.0,6.0,13.0,8.0,13.0,14.0,12.0,12.0,15.0,14.0,7.0,14.0,13.0,20.0,13.0,14.0,12.0,8.0,10.0,8.0,8.0,8.0,14.0,13.0,11.0,14.0,15.0,16.0,6.0,21.0,0.0,0.0,0.0,0.0,179.0,75.0,3.0,3.0,2.0,2.0,1.0,3.0,3.0,3.0,1.0,1.0,1.0,5.0,9.0,13.0,11.0,11.0,8.0,10.0,11.0,5.0,2.0,9.0,12.0,2.0,12.0,7.0,11.0,12.0,10.0,9.0,10.0,10.0,13.0,12.0,5.0,13.0,7.0,7.0,11.0,14.0,13.0,13.0,9.0,6.0,12.0,15.0,20.0,13.0,14.0,11.0,10.0,10.0,5.0,10.0,16.0,11.0,10.0,12.0,9.0,13.0,13.0,9.0,24.0,0.0,0.0,0.0,0.0,197.0,86.0,15.0,9.0,12.0,14.0,13.0,12.0,10.0,13.0,11.0,7.0,8.0,2.0,3.0,3.0,3.0,8.0,7.0,1.0,3.0,1.0,2.0,12.0,2.0,2.0,8.0,10.0,12.0,10.0,14.0,12.0,10.0,10.0,10.0,3.0,8.0,1.0,11.0,10.0,6.0,12.0,13.0,10.0,16.0,5.0,13.0,11.0,20.0,9.0,10.0,10.0,10.0,10.0,7.0,10.0,9.0,11.0,11.0,9.0,12.0,13.0,10.0,8.0,28.0,0.0,0.0,0.0,0.0,190.0,83.0,1.0,1.0,3.0,2.0,1.0,1.0,3.0,3.0,1.0,2.0,1.0,2.0,9.0,5.0,6.0,10.0,5.0,13.0,7.0,4.0,12.0,9.0,7.0,10.0,11.0,13.0,14.0,15.0,13.0,11.0,8.0,11.0,13.0,8.0,12.0,7.0,12.0,12.0,12.0,11.0,11.0,15.0,15.0,20.0,15.0,11.0,5.0,13.0,16.0,15.0,13.0,11.0,7.0,5.0,12.0,12.0,14.0,12.0,15.0,13.0,12.0,6.0,21.0,0.0,0.0,0.0,0.0,193.0,79.0,3.0,3.0,4.0,4.0,2.0,3.0,1.0,1.0,3.0,2.0,3.0,8.0,8.0,8.0,8.0,12.0,11.0,14.0,11.0,12.0,15.0,14.0,6.0,13.0,10.0,12.0,11.0,12.0,12.0,14.0,11.0,10.0,15.0,12.0,12.0,12.0,13.0,14.0,12.0,12.0,12.0,14.0,16.0,9.0,8.0,12.0,20.0,12.0,14.0,13.0,9.0,11.0,16.0,12.0,12.0,14.0,11.0,14.0,12.0,11.0,10.0,5.0,22.0,0.0,0.0,0.0,0.0,168.0,67.0,1.0,1.0,3.0,3.0,3.0,3.0,3.0,2.0,3.0,3.0,3.0,9.0,10.0,12.0,10.0,12.0,10.0,5.0,12.0,6.0,10.0,12.0,8.0,9.0,13.0,11.0,11.0,13.0,11.0,10.0,12.0,12.0,11.0,12.0,5.0,11.0,8.0,10.0,13.0,14.0,14.0,10.0,6.0,20.0,12.0,13.0,6.0,11.0,8.0,12.0,10.0,4.0,5.0,10.0,16.0,11.0,11.0,8.0,12.0,10.0,14.0,6.0,21.0,0.0,0.0,9.0,0.0,178.0,77.0,4.0,3.0,1.0,1.0,1.0,2.0,2.0,3.0,3.0,3.0,1.0,11.0,13.0,11.0,8.0,12.0,9.0,8.0,9.0,8.0,12.0,10.0,8.0,12.0,12.0,8.0,10.0,14.0,11.0,14.0,12.0,12.0,14.0,12.0,8.0,10.0,8.0,15.0,14.0,15.0,12.0,12.0,8.0,7.0,5.0,14.0,20.0,14.0,10.0,12.0,5.0,10.0,11.0,8.0,15.0,10.0,10.0,12.0,9.0,10.0,12.0,5.0,20.0,0.0,0.0,0.0,0.0,176.0,71.0,3.0,3.0,1.0,3.0,1.0,2.0,3.0,2.0,3.0,2.0,2.0,12.0,14.0,12.0,9.0,11.0,10.0,7.0,10.0,12.0,11.0,12.0,9.0,12.0,12.0,9.0,12.0,10.0,10.0,9.0,10.0,12.0,11.0,14.0,8.0,13.0,12.0,10.0,11.0,16.0,15.0,10.0,8.0,20.0,10.0,16.0,5.0,15.0,11.0,10.0,9.0,9.0,8.0,10.0,9.0,11.0,11.0,11.0,12.0,10.0,17.0,1.0,32.0,55.0,0.0,0.0,0.0,180.0,74.0,1.0,3.0,3.0,2.0,1.0,2.0,2.0,1.0,3.0,3.0,1.0,6.0,8.0,8.0,6.0,11.0,10.0,12.0,10.0,6.0,13.0,11.0,7.0,15.0,11.0,14.0,14.0,17.0,12.0,14.0,10.0,13.0,16.0,8.0,12.0,8.0,14.0,16.0,18.0,12.0,13.0,13.0,10.0,8.0,16.0,14.0,20.0,18.0,13.0,16.0,15.0,14.0,5.0,10.0,9.0,15.0,13.0,15.0,14.0,11.0,10.0,7.0,25.0,0.0,0.0,0.0,0.0,177.0,66.0,2.0,3.0,1.0,3.0,2.0,3.0,4.0,1.0,4.0,3.0,1.0,11.0,11.0,11.0,7.0,13.0,11.0,8.0,10.0,7.0,4.0,12.0,11.0,6.0,12.0,8.0,12.0,11.0,12.0,12.0,12.0,9.0,13.0,11.0,7.0,11.0,9.0,14.0,13.0,11.0,13.0,12.0,9.0,20.0,14.0,10.0,8.0,16.0,9.0,13.0,8.0,2.0,6.0,10.0,9.0,11.0,15.0,12.0,14.0,14.0,14.0,6.0,19.0,0.0,0.0,0.0,0.0,175.0,60.0,4.0,2.0,2.0,1.0,1.0,2.0,3.0,2.0,3.0,3.0,1.0,10.0,11.0,15.0,12.0,14.0,6.0,4.0,13.0,10.0,10.0,12.0,9.0,11.0,14.0,8.0,10.0,10.0,14.0,11.0,12.0,15.0,4.0,11.0,7.0,8.0,10.0,11.0,12.0,12.0,12.0,11.0,8.0,5.0,9.0,10.0,20.0,9.0,8.0,10.0,10.0,7.0,10.0,10.0,14.0,12.0,10.0,11.0,14.0,10.0,11.0,2.0,28.0,0.0,0.0,0.0,0.0,185.0,80.0,3.0,4.0,2.0,1.0,3.0,3.0,4.0,1.0,3.0,2.0,2.0,10.0,12.0,13.0,12.0,14.0,11.0,13.0,10.0,4.0,6.0,13.0,10.0,4.0,13.0,15.0,12.0,16.0,10.0,10.0,12.0,12.0,14.0,12.0,5.0,13.0,8.0,11.0,14.0,13.0,13.0,14.0,12.0,8.0,13.0,14.0,20.0,11.0,13.0,13.0,11.0,13.0,7.0,10.0,12.0,14.0,12.0,12.0,11.0,13.0,13.0,7.0,19.0,0.0,0.0,0.0,0.0,185.0,79.0,2.0,3.0,3.0,1.0,2.0,1.0,2.0,3.0,3.0,3.0,2.0,11.0,11.0,11.0,12.0,11.0,10.0,12.0,12.0,5.0,6.0,11.0,12.0,6.0,12.0,15.0,12.0,13.0,11.0,10.0,12.0,11.0,10.0,13.0,12.0,12.0,8.0,10.0,12.0,10.0,13.0,12.0,12.0,20.0,10.0,9.0,10.0,10.0,7.0,10.0,12.0,10.0,5.0,9.0,11.0,12.0,13.0,10.0,13.0,14.0,18.0,3.0
5,0,38.0,161.0,0.0,11.0,0.0,192.0,91.0,14.0,20.0,20.0,16.0,14.0,12.0,17.0,19.0,18.0,16.0,13.0,1.0,1.0,1.0,1.0,9.0,1.0,1.0,1.0,1.0,1.0,8.0,4.0,1.0,8.0,5.0,17.0,17.0,17.0,16.0,7.0,17.0,18.0,12.0,20.0,1.0,20.0,6.0,10.0,8.0,14.0,14.0,14.0,7.0,12.0,8.0,20.0,10.0,15.0,19.0,5.0,17.0,12.0,1.0,12.0,16.0,20.0,18.0,16.0,15.0,14.0,4.0,29.0,0.0,0.0,0.0,0.0,170.0,65.0,2.0,1.0,3.0,3.0,1.0,3.0,2.0,1.0,2.0,3.0,2.0,5.0,11.0,4.0,6.0,7.0,4.0,7.0,5.0,6.0,6.0,6.0,2.0,6.0,7.0,9.0,10.0,13.0,8.0,12.0,8.0,13.0,15.0,2.0,7.0,5.0,9.0,8.0,8.0,12.0,12.0,14.0,4.0,9.0,12.0,11.0,20.0,12.0,5.0,9.0,9.0,9.0,9.0,9.0,10.0,12.0,12.0,12.0,12.0,7.0,5.0,8.0,20.0,0.0,0.0,7.0,0.0,186.0,72.0,3.0,3.0,2.0,3.0,3.0,4.0,3.0,3.0,2.0,2.0,2.0,4.0,9.0,8.0,6.0,13.0,6.0,14.0,6.0,7.0,14.0,12.0,8.0,13.0,13.0,11.0,13.0,14.0,14.0,14.0,9.0,13.0,13.0,8.0,8.0,8.0,13.0,14.0,14.0,13.0,13.0,15.0,13.0,20.0,15.0,14.0,8.0,14.0,13.0,12.0,8.0,12.0,4.0,10.0,8.0,15.0,14.0,12.0,14.0,15.0,14.0,7.0,31.0,0.0,0.0,0.0,0.0,171.0,65.0,1.0,3.0,1.0,3.0,2.0,2.0,3.0,1.0,2.0,2.0,3.0,8.0,9.0,11.0,7.0,5.0,6.0,5.0,6.0,7.0,14.0,14.0,6.0,14.0,13.0,14.0,12.0,13.0,12.0,11.0,11.0,12.0,12.0,11.0,7.0,12.0,12.0,12.0,10.0,15.0,15.0,7.0,9.0,9.0,12.0,14.0,20.0,12.0,13.0,11.0,13.0,11.0,9.0,10.0,15.0,14.0,12.0,11.0,14.0,13.0,12.0,7.0,23.0,7.0,1.0,7.0,0.0,172.0,67.0,2.0,1.0,2.0,1.0,2.0,2.0,2.0,3.0,1.0,2.0,2.0,13.0,12.0,15.0,10.0,14.0,10.0,8.0,10.0,13.0,10.0,12.0,12.0,13.0,14.0,17.0,12.0,14.0,14.0,11.0,11.0,12.0,16.0,13.0,9.0,15.0,9.0,14.0,17.0,18.0,17.0,14.0,7.0,20.0,16.0,15.0,7.0,16.0,9.0,14.0,8.0,14.0,6.0,10.0,12.0,15.0,13.0,12.0,14.0,10.0,12.0,6.0,24.0,9.0,0.0,7.0,1.0,190.0,82.0,2.0,2.0,3.0,3.0,1.0,2.0,2.0,1.0,1.0,3.0,1.0,8.0,14.0,13.0,11.0,12.0,10.0,12.0,11.0,9.0,11.0,13.0,8.0,13.0,13.0,10.0,14.0,14.0,13.0,13.0,14.0,14.0,16.0,11.0,6.0,12.0,12.0,16.0,16.0,12.0,11.0,11.0,14.0,8.0,14.0,14.0,20.0,15.0,13.0,14.0,9.0,13.0,8.0,14.0,13.0,14.0,12.0,14.0,16.0,12.0,15.0,2.0,23.0,15.0,1.0,7.0,0.0,165.0,60.0,2.0,3.0,2.0,1.0,1.0,1.0,3.0,3.0,2.0,1.0,3.0,14.0,14.0,16.0,8.0,16.0,13.0,6.0,10.0,6.0,11.0,18.0,15.0,12.0,18.0,16.0,15.0,15.0,17.0,13.0,17.0,15.0,14.0,18.0,12.0,10.0,12.0,15.0,16.0,14.0,16.0,16.0,6.0,12.0,13.0,14.0,20.0,15.0,11.0,16.0,14.0,15.0,10.0,12.0,14.0,15.0,16.0,14.0,14.0,13.0,10.0,6.0,28.0,66.0,15.0,13.0,3.0,180.0,70.0,2.0,2.0,1.0,2.0,1.0,1.0,3.0,2.0,3.0,3.0,1.0,14.0,15.0,16.0,13.0,17.0,15.0,6.0,15.0,4.0,5.0,16.0,14.0,8.0,17.0,13.0,16.0,11.0,15.0,13.0,16.0,14.0,13.0,17.0,10.0,14.0,9.0,13.0,13.0,16.0,18.0,12.0,10.0,20.0,14.0,15.0,8.0,16.0,9.0,13.0,14.0,12.0,10.0,15.0,14.0,15.0,10.0,16.0,14.0,6.0,12.0,10.0,29.0,76.0,27.0,13.0,9.0,188.0,72.0,2.0,3.0,1.0,2.0,3.0,3.0,1.0,3.0,3.0,3.0,3.0,5.0,10.0,13.0,16.0,13.0,11.0,17.0,13.0,5.0,10.0,13.0,14.0,10.0,13.0,15.0,16.0,18.0,14.0,15.0,10.0,13.0,14.0,13.0,10.0,18.0,12.0,14.0,19.0,15.0,14.0,16.0,14.0,10.0,18.0,16.0,20.0,18.0,14.0,14.0,8.0,15.0,5.0,16.0,10.0,16.0,12.0,14.0,16.0,14.0,10.0,10.0,24.0,70.0,46.0,7.0,9.0,174.0,68.0,2.0,3.0,2.0,1.0,3.0,1.0,2.0,3.0,1.0,1.0,3.0,16.0,16.0,20.0,16.0,17.0,16.0,9.0,13.0,3.0,4.0,16.0,16.0,4.0,20.0,10.0,17.0,14.0,15.0,15.0,16.0,15.0,15.0,19.0,13.0,19.0,4.0,13.0,12.0,18.0,19.0,14.0,6.0,15.0,16.0,16.0,20.0,13.0,10.0,14.0,11.0,15.0,6.0,12.0,15.0,16.0,19.0,14.0,15.0,8.0,8.0,17.0,17.0,0.0,0.0,0.0,0.0,178.0,68.0,2.0,1.0,2.0,1.0,3.0,3.0,3.0,1.0,3.0,3.0,2.0,10.0,11.0,15.0,12.0,13.0,10.0,8.0,9.0,2.0,3.0,12.0,12.0,3.0,16.0,11.0,9.0,11.0,12.0,9.0,12.0,10.0,17.0,17.0,9.0,13.0,5.0,9.0,13.0,15.0,14.0,11.0,9.0,8.0,14.0,14.0,20.0,12.0,9.0,14.0,7.0,15.0,7.0,13.0,13.0,19.0,12.0,16.0,15.0,14.0,14.0,7.0,25.0,4.0,0.0,11.0,0.0,184.0,81.0,14.0,14.0,13.0,9.0,15.0,12.0,16.0,16.0,13.0,7.0,11.0,8.0,1.0,2.0,1.0,11.0,12.0,6.0,1.0,3.0,3.0,11.0,5.0,3.0,11.0,8.0,15.0,15.0,13.0,14.0,10.0,11.0,14.0,8.0,13.0,5.0,13.0,10.0,10.0,14.0,16.0,14.0,13.0,20.0,14.0,12.0,5.0,14.0,14.0,15.0,9.0,16.0,6.0,1.0,17.0,11.0,15.0,13.0,14.0,12.0,12.0,4.0,21.0,8.0,0.0,2.0,1.0,184.0,75.0,3.0,2.0,2.0,3.0,3.0,2.0,3.0,3.0,3.0,2.0,4.0,6.0,8.0,13.0,9.0,13.0,5.0,13.0,6.0,10.0,12.0,11.0,10.0,15.0,13.0,15.0,13.0,13.0,13.0,14.0,10.0,11.0,11.0,9.0,8.0,6.0,11.0,14.0,15.0,15.0,14.0,14.0,13.0,11.0,12.0,14.0,20.0,13.0,14.0,13.0,7.0,13.0,9.0,9.0,15.0,15.0,12.0,11.0,11.0,15.0,14.0,2.0,32.0,0.0,0.0,0.0,0.0,172.0,71.0,2.0,1.0,3.0,1.0,2.0,3.0,2.0,3.0,2.0,2.0,2.0,8.0,9.0,7.0,6.0,10.0,6.0,10.0,9.0,10.0,14.0,11.0,6.0,14.0,11.0,10.0,16.0,15.0,12.0,12.0,7.0,12.0,15.0,9.0,13.0,8.0,14.0,15.0,15.0,14.0,14.0,14.0,10.0,20.0,14.0,14.0,8.0,15.0,13.0,13.0,11.0,13.0,7.0,13.0,17.0,14.0,17.0,8.0,13.0,15.0,15.0,6.0,37.0,0.0,0.0,0.0,0.0,185.0,83.0,1.0,1.0,2.0,1.0,3.0,2.0,3.0,1.0,1.0,3.0,1.0,6.0,8.0,9.0,12.0,10.0,8.0,13.0,9.0,4.0,5.0,10.0,14.0,4.0,11.0,11.0,10.0,11.0,13.0,12.0,12.0,13.0,15.0,14.0,12.0,11.0,7.0,12.0,8.0,7.0,7.0,12.0,12.0,11.0,11.0,7.0,20.0,8.0,14.0,12.0,8.0,13.0,9.0,12.0,12.0,12.0,19.0,14.0,15.0,14.0,8.0,8.0,21.0,0.0,0.0,0.0,0.0,179.0,68.0,2.0,3.0,2.0,1.0,2.0,1.0,2.0,3.0,2.0,1.0,1.0,6.0,13.0,12.0,6.0,13.0,6.0,8.0,7.0,12.0,10.0,12.0,8.0,12.0,13.0,10.0,11.0,11.0,12.0,10.0,11.0,11.0,12.0,11.0,7.0,13.0,10.0,12.0,14.0,15.0,13.0,12.0,10.0,20.0,14.0,14.0,8.0,14.0,10.0,13.0,8.0,13.0,8.0,12.0,13.0,14.0,10.0,12.0,10.0,10.0,12.0,10.0,19.0,0.0,0.0,0.0,0.0,185.0,82.0,4.0,2.0,3.0,1.0,3.0,2.0,1.0,2.0,1.0,2.0,3.0,7.0,7.0,10.0,6.0,13.0,7.0,14.0,7.0,6.0,12.0,13.0,7.0,13.0,13.0,13.0,13.0,13.0,11.0,12.0,11.0,12.0,14.0,9.0,14.0,11.0,11.0,15.0,15.0,12.0,12.0,14.0,13.0,5.0,14.0,12.0,20.0,14.0,13.0,10.0,11.0,11.0,6.0,10.0,10.0,12.0,12.0,14.0,14.0,11.0,16.0,6.0,19.0,0.0,0.0,0.0,0.0,175.0,67.0,3.0,2.0,1.0,3.0,3.0,1.0,1.0,1.0,2.0,1.0,3.0,7.0,8.0,12.0,8.0,10.0,6.0,12.0,9.0,8.0,10.0,10.0,8.0,12.0,11.0,14.0,10.0,12.0,9.0,10.0,11.0,10.0,12.0,12.0,10.0,12.0,12.0,13.0,14.0,13.0,11.0,14.0,8.0,6.0,14.0,12.0,20.0,14.0,12.0,12.0,8.0,11.0,6.0,12.0,17.0,13.0,10.0,11.0,12.0,11.0,17.0,5.0,18.0,0.0,0.0,0.0,0.0,170.0,67.0,3.0,1.0,3.0,3.0,3.0,4.0,1.0,2.0,1.0,2.0,2.0,11.0,11.0,12.0,13.0,12.0,11.0,6.0,10.0,8.0,7.0,12.0,10.0,7.0,13.0,9.0,11.0,8.0,10.0,10.0,12.0,12.0,15.0,12.0,12.0,11.0,12.0,11.0,12.0,12.0,12.0,10.0,6.0,5.0,14.0,12.0,20.0,10.0,9.0,10.0,8.0,2.0,6.0,12.0,11.0,11.0,12.0,13.0,14.0,11.0,13.0,4.0,22.0,5.0,1.0,1.0,0.0,173.0,72.0,1.0,3.0,1.0,3.0,3.0,3.0,3.0,3.0,3.0,2.0,2.0,14.0,13.0,16.0,14.0,16.0,14.0,5.0,11.0,5.0,5.0,15.0,11.0,5.0,16.0,8.0,13.0,9.0,14.0,13.0,15.0,13.0,15.0,16.0,5.0,13.0,5.0,9.0,10.0,15.0,16.0,14.0,5.0,20.0,14.0,15.0,5.0,12.0,14.0,13.0,11.0,13.0,8.0,14.0,10.0,15.0,14.0,10.0,13.0,10.0,10.0,13.0,22.0,24.0,3.0,7.0,0.0,177.0,78.0,2.0,1.0,2.0,3.0,2.0,2.0,4.0,3.0,3.0,2.0,1.0,10.0,13.0,16.0,14.0,16.0,16.0,8.0,16.0,4.0,4.0,15.0,12.0,4.0,16.0,12.0,11.0,12.0,13.0,10.0,11.0,8.0,13.0,17.0,5.0,14.0,5.0,10.0,12.0,15.0,14.0,13.0,9.0,10.0,17.0,16.0,20.0,15.0,14.0,12.0,11.0,15.0,4.0,12.0,19.0,16.0,14.0,14.0,11.0,13.0,10.0,12.0,20.0,29.0,2.0,0.0,0.0,181.0,75.0,1.0,1.0,2.0,2.0,2.0,3.0,2.0,1.0,1.0,3.0,2.0,5.0,9.0,15.0,10.0,11.0,9.0,10.0,8.0,7.0,3.0,10.0,10.0,5.0,15.0,7.0,10.0,9.0,12.0,10.0,8.0,11.0,14.0,12.0,5.0,13.0,5.0,11.0,12.0,16.0,12.0,9.0,12.0,20.0,14.0,16.0,7.0,12.0,10.0,9.0,10.0,10.0,11.0,6.0,10.0,15.0,9.0,13.0,11.0,14.0,18.0,7.0
1,2,33.0,0.0,0.0,3.0,0.0,188.0,84.0,14.0,13.0,13.0,9.0,13.0,13.0,15.0,15.0,11.0,11.0,9.0,7.0,3.0,3.0,1.0,7.0,10.0,2.0,1.0,1.0,2.0,6.0,4.0,1.0,7.0,8.0,13.0,14.0,14.0,14.0,8.0,11.0,15.0,6.0,13.0,3.0,13.0,12.0,8.0,12.0,14.0,15.0,14.0,8.0,13.0,11.0,20.0,13.0,15.0,16.0,8.0,13.0,6.0,1.0,11.0,14.0,13.0,11.0,16.0,14.0,11.0,6.0,29.0,2.0,0.0,0.0,0.0,185.0,75.0,2.0,3.0,3.0,3.0,2.0,3.0,2.0,1.0,3.0,1.0,2.0,4.0,10.0,8.0,6.0,10.0,6.0,14.0,7.0,7.0,14.0,11.0,6.0,14.0,9.0,13.0,13.0,14.0,11.0,12.0,12.0,12.0,14.0,8.0,11.0,12.0,13.0,13.0,13.0,15.0,12.0,15.0,12.0,8.0,15.0,13.0,20.0,14.0,15.0,14.0,7.0,14.0,8.0,6.0,14.0,13.0,15.0,14.0,14.0,14.0,14.0,6.0,28.0,0.0,0.0,0.0,0.0,193.0,84.0,1.0,1.0,2.0,2.0,2.0,3.0,2.0,3.0,2.0,1.0,3.0,4.0,8.0,8.0,9.0,10.0,6.0,14.0,7.0,8.0,14.0,12.0,6.0,14.0,11.0,12.0,13.0,14.0,11.0,14.0,12.0,12.0,14.0,6.0,11.0,8.0,14.0,13.0,13.0,11.0,11.0,16.0,16.0,20.0,12.0,12.0,8.0,14.0,16.0,14.0,12.0,13.0,6.0,10.0,7.0,12.0,15.0,12.0,16.0,15.0,13.0,6.0,26.0,0.0,0.0,0.0,0.0,175.0,69.0,3.0,3.0,2.0,2.0,3.0,1.0,3.0,1.0,3.0,2.0,2.0,6.0,12.0,10.0,5.0,11.0,6.0,10.0,10.0,10.0,13.0,12.0,9.0,13.0,12.0,12.0,13.0,14.0,12.0,13.0,12.0,11.0,15.0,11.0,13.0,12.0,13.0,14.0,14.0,15.0,13.0,12.0,7.0,9.0,13.0,13.0,20.0,14.0,11.0,14.0,12.0,12.0,11.0,15.0,14.0,9.0,17.0,10.0,8.0,11.0,20.0,7.0,26.0,0.0,0.0,0.0,0.0,182.0,68.0,1.0,4.0,3.0,2.0,3.0,1.0,2.0,1.0,2.0,4.0,1.0,7.0,12.0,9.0,5.0,10.0,6.0,12.0,7.0,15.0,12.0,9.0,6.0,12.0,10.0,12.0,13.0,14.0,11.0,10.0,9.0,9.0,13.0,7.0,6.0,10.0,10.0,14.0,15.0,16.0,13.0,13.0,11.0,5.0,15.0,15.0,20.0,14.0,10.0,12.0,12.0,13.0,7.0,12.0,12.0,14.0,14.0,15.0,13.0,14.0,14.0,7.0,30.0,9.0,1.0,0.0,0.0,192.0,90.0,2.0,2.0,2.0,2.0,3.0,1.0,3.0,4.0,1.0,1.0,3.0,4.0,7.0,10.0,10.0,9.0,8.0,17.0,12.0,6.0,13.0,12.0,8.0,12.0,11.0,13.0,14.0,15.0,13.0,13.0,10.0,12.0,14.0,12.0,13.0,13.0,12.0,14.0,16.0,12.0,12.0,18.0,16.0,8.0,14.0,13.0,20.0,16.0,18.0,13.0,13.0,14.0,7.0,12.0,13.0,13.0,13.0,13.0,13.0,13.0,13.0,6.0,21.0,0.0,0.0,0.0,0.0,183.0,73.0,1.0,4.0,3.0,3.0,3.0,1.0,4.0,1.0,2.0,3.0,2.0,11.0,10.0,12.0,11.0,13.0,9.0,12.0,10.0,5.0,8.0,12.0,9.0,8.0,13.0,13.0,12.0,12.0,10.0,12.0,14.0,12.0,12.0,14.0,8.0,12.0,8.0,12.0,12.0,14.0,14.0,14.0,11.0,8.0,13.0,13.0,20.0,12.0,12.0,12.0,5.0,10.0,7.0,12.0,15.0,11.0,11.0,10.0,11.0,12.0,11.0,4.0,29.0,0.0,0.0,0.0,0.0,180.0,71.0,1.0,3.0,1.0,1.0,1.0,4.0,4.0,1.0,1.0,2.0,3.0,10.0,11.0,12.0,9.0,13.0,11.0,8.0,14.0,6.0,8.0,11.0,10.0,8.0,12.0,10.0,11.0,12.0,12.0,9.0,12.0,11.0,14.0,12.0,7.0,12.0,10.0,12.0,14.0,15.0,14.0,12.0,10.0,20.0,16.0,13.0,12.0,15.0,10.0,13.0,10.0,15.0,7.0,8.0,16.0,12.0,12.0,13.0,14.0,15.0,15.0,6.0,23.0,0.0,0.0,0.0,0.0,175.0,70.0,2.0,1.0,2.0,2.0,1.0,2.0,2.0,3.0,4.0,1.0,2.0,10.0,11.0,12.0,9.0,13.0,8.0,6.0,13.0,2.0,5.0,13.0,10.0,6.0,13.0,7.0,13.0,9.0,13.0,11.0,13.0,12.0,13.0,12.0,10.0,12.0,10.0,13.0,12.0,11.0,12.0,13.0,8.0,8.0,14.0,12.0,20.0,14.0,12.0,13.0,9.0,11.0,10.0,11.0,19.0,12.0,14.0,11.0,13.0,10.0,16.0,7.0,18.0,0.0,0.0,0.0,0.0,188.0,0.0,2.0,2.0,1.0,1.0,1.0,2.0,1.0,4.0,2.0,2.0,1.0,8.0,11.0,14.0,11.0,13.0,10.0,11.0,10.0,2.0,6.0,12.0,11.0,8.0,13.0,8.0,11.0,9.0,13.0,9.0,13.0,11.0,14.0,15.0,8.0,12.0,7.0,11.0,13.0,14.0,12.0,12.0,13.0,12.0,11.0,14.0,20.0,11.0,11.0,12.0,8.0,11.0,8.0,14.0,12.0,11.0,10.0,12.0,13.0,12.0,14.0,7.0,24.0,0.0,0.0,4.0,0.0,181.0,79.0,1.0,3.0,2.0,2.0,1.0,1.0,1.0,2.0,2.0,2.0,1.0,4.0,6.0,10.0,11.0,11.0,7.0,12.0,10.0,5.0,5.0,7.0,13.0,3.0,10.0,9.0,12.0,12.0,11.0,10.0,6.0,10.0,8.0,9.0,5.0,11.0,5.0,9.0,12.0,15.0,13.0,13.0,11.0,5.0,11.0,14.0,20.0,13.0,14.0,11.0,9.0,12.0,13.0,5.0,19.0,11.0,9.0,9.0,7.0,14.0,14.0,13.0,25.0,4.0,0.0,11.0,0.0,184.0,81.0,14.0,14.0,13.0,9.0,15.0,12.0,16.0,16.0,13.0,7.0,11.0,8.0,1.0,2.0,1.0,11.0,12.0,6.0,1.0,3.0,3.0,11.0,5.0,3.0,11.0,8.0,15.0,15.0,13.0,14.0,10.0,11.0,14.0,8.0,13.0,5.0,13.0,10.0,10.0,14.0,16.0,14.0,13.0,20.0,14.0,12.0,5.0,14.0,14.0,15.0,9.0,16.0,6.0,1.0,17.0,11.0,15.0,13.0,14.0,12.0,12.0,4.0,27.0,0.0,0.0,0.0,0.0,184.0,81.0,1.0,1.0,1.0,3.0,3.0,2.0,2.0,2.0,1.0,2.0,3.0,8.0,6.0,8.0,12.0,10.0,8.0,12.0,9.0,1.0,3.0,8.0,14.0,4.0,9.0,4.0,11.0,12.0,11.0,8.0,8.0,11.0,10.0,9.0,8.0,11.0,9.0,8.0,11.0,10.0,8.0,13.0,13.0,9.0,13.0,9.0,20.0,12.0,13.0,13.0,9.0,2.0,9.0,9.0,15.0,10.0,12.0,10.0,11.0,6.0,4.0,6.0,21.0,8.0,0.0,2.0,1.0,184.0,75.0,3.0,2.0,2.0,3.0,3.0,2.0,3.0,3.0,3.0,2.0,4.0,6.0,8.0,13.0,9.0,13.0,5.0,13.0,6.0,10.0,12.0,11.0,10.0,15.0,13.0,15.0,13.0,13.0,13.0,14.0,10.0,11.0,11.0,9.0,8.0,6.0,11.0,14.0,15.0,15.0,14.0,14.0,13.0,11.0,12.0,14.0,20.0,13.0,14.0,13.0,7.0,13.0,9.0,9.0,15.0,15.0,12.0,11.0,11.0,15.0,14.0,2.0,27.0,0.0,0.0,0.0,0.0,178.0,72.0,2.0,3.0,2.0,3.0,2.0,3.0,3.0,1.0,1.0,2.0,1.0,13.0,14.0,11.0,7.0,12.0,10.0,9.0,10.0,13.0,13.0,12.0,10.0,14.0,13.0,12.0,14.0,14.0,13.0,14.0,11.0,12.0,14.0,13.0,8.0,14.0,13.0,13.0,15.0,15.0,13.0,10.0,10.0,20.0,13.0,15.0,6.0,14.0,10.0,13.0,13.0,12.0,8.0,12.0,15.0,14.0,13.0,14.0,13.0,13.0,12.0,6.0,37.0,0.0,0.0,0.0,0.0,185.0,83.0,1.0,1.0,2.0,1.0,3.0,2.0,3.0,1.0,1.0,3.0,1.0,6.0,8.0,9.0,12.0,10.0,8.0,13.0,9.0,4.0,5.0,10.0,14.0,4.0,11.0,11.0,10.0,11.0,13.0,12.0,12.0,13.0,15.0,14.0,12.0,11.0,7.0,12.0,8.0,7.0,7.0,12.0,12.0,11.0,11.0,7.0,20.0,8.0,14.0,12.0,8.0,13.0,9.0,12.0,12.0,12.0,19.0,14.0,15.0,14.0,8.0,8.0,19.0,0.0,0.0,0.0,0.0,185.0,82.0,4.0,2.0,3.0,1.0,3.0,2.0,1.0,2.0,1.0,2.0,3.0,7.0,7.0,10.0,6.0,13.0,7.0,14.0,7.0,6.0,12.0,13.0,7.0,13.0,13.0,13.0,13.0,13.0,11.0,12.0,11.0,12.0,14.0,9.0,14.0,11.0,11.0,15.0,15.0,12.0,12.0,14.0,13.0,5.0,14.0,12.0,20.0,14.0,13.0,10.0,11.0,11.0,6.0,10.0,10.0,12.0,12.0,14.0,14.0,11.0,16.0,6.0,24.0,0.0,0.0,6.0,1.0,172.0,70.0,3.0,1.0,1.0,3.0,1.0,2.0,3.0,1.0,1.0,3.0,3.0,11.0,12.0,11.0,8.0,12.0,10.0,6.0,14.0,7.0,11.0,15.0,8.0,12.0,13.0,14.0,14.0,18.0,13.0,12.0,13.0,13.0,15.0,12.0,12.0,12.0,11.0,18.0,18.0,13.0,14.0,13.0,7.0,10.0,16.0,12.0,20.0,14.0,12.0,14.0,14.0,15.0,4.0,8.0,7.0,14.0,14.0,13.0,14.0,12.0,10.0,6.0,18.0,0.0,0.0,0.0,0.0,170.0,67.0,3.0,1.0,3.0,3.0,3.0,4.0,1.0,2.0,1.0,2.0,2.0,11.0,11.0,12.0,13.0,12.0,11.0,6.0,10.0,8.0,7.0,12.0,10.0,7.0,13.0,9.0,11.0,8.0,10.0,10.0,12.0,12.0,15.0,12.0,12.0,11.0,12.0,11.0,12.0,12.0,12.0,10.0,6.0,5.0,14.0,12.0,20.0,10.0,9.0,10.0,8.0,2.0,6.0,12.0,11.0,11.0,12.0,13.0,14.0,11.0,13.0,4.0,19.0,0.0,0.0,0.0,0.0,175.0,67.0,3.0,2.0,1.0,3.0,3.0,1.0,1.0,1.0,2.0,1.0,3.0,7.0,8.0,12.0,8.0,10.0,6.0,12.0,9.0,8.0,10.0,10.0,8.0,12.0,11.0,14.0,10.0,12.0,9.0,10.0,11.0,10.0,12.0,12.0,10.0,12.0,12.0,13.0,14.0,13.0,11.0,14.0,8.0,6.0,14.0,12.0,20.0,14.0,12.0,12.0,8.0,11.0,6.0,12.0,17.0,13.0,10.0,11.0,12.0,11.0,17.0,5.0,20.0,29.0,2.0,0.0,0.0,181.0,75.0,1.0,1.0,2.0,2.0,2.0,3.0,2.0,1.0,1.0,3.0,2.0,5.0,9.0,15.0,10.0,11.0,9.0,10.0,8.0,7.0,3.0,10.0,10.0,5.0,15.0,7.0,10.0,9.0,12.0,10.0,8.0,11.0,14.0,12.0,5.0,13.0,5.0,11.0,12.0,16.0,12.0,9.0,12.0,20.0,14.0,16.0,7.0,12.0,10.0,9.0,10.0,10.0,11.0,6.0,10.0,15.0,9.0,13.0,11.0,14.0,18.0,7.0,19.0,0.0,0.0,0.0,0.0,183.0,74.0,3.0,3.0,1.0,2.0,3.0,2.0,1.0,1.0,3.0,1.0,2.0,8.0,9.0,14.0,14.0,12.0,8.0,13.0,12.0,7.0,3.0,9.0,15.0,3.0,14.0,10.0,14.0,8.0,14.0,11.0,10.0,13.0,15.0,14.0,6.0,13.0,7.0,8.0,10.0,16.0,14.0,14.0,11.0,12.0,14.0,15.0,20.0,13.0,15.0,13.0,5.0,13.0,7.0,5.0,10.0,15.0,8.0,13.0,13.0,11.0,12.0,11.0
1,1,26.0,2.0,0.0,1.0,0.0,188.0,84.0,12.0,13.0,15.0,9.0,15.0,13.0,13.0,15.0,10.0,11.0,14.0,9.0,2.0,1.0,2.0,12.0,11.0,3.0,2.0,3.0,3.0,11.0,3.0,1.0,10.0,14.0,13.0,14.0,10.0,13.0,11.0,11.0,14.0,3.0,11.0,5.0,12.0,15.0,13.0,10.0,12.0,13.0,14.0,5.0,14.0,9.0,20.0,12.0,14.0,12.0,10.0,15.0,3.0,11.0,12.0,11.0,16.0,13.0,15.0,16.0,16.0,4.0,29.0,0.0,0.0,0.0,0.0,183.0,74.0,3.0,3.0,3.0,3.0,3.0,2.0,2.0,2.0,1.0,3.0,1.0,5.0,12.0,7.0,6.0,10.0,7.0,14.0,12.0,5.0,14.0,12.0,6.0,13.0,11.0,14.0,13.0,17.0,13.0,16.0,12.0,12.0,13.0,9.0,8.0,9.0,14.0,14.0,15.0,13.0,12.0,15.0,12.0,6.0,17.0,11.0,20.0,17.0,13.0,14.0,14.0,15.0,5.0,13.0,9.0,14.0,19.0,15.0,14.0,11.0,11.0,6.0,32.0,0.0,0.0,0.0,0.0,183.0,79.0,1.0,1.0,1.0,3.0,1.0,3.0,1.0,1.0,2.0,1.0,1.0,5.0,10.0,6.0,6.0,9.0,6.0,15.0,7.0,11.0,14.0,10.0,7.0,13.0,10.0,13.0,15.0,15.0,15.0,14.0,9.0,13.0,16.0,6.0,14.0,8.0,12.0,13.0,16.0,11.0,12.0,16.0,11.0,8.0,16.0,12.0,20.0,15.0,14.0,14.0,11.0,12.0,5.0,15.0,18.0,15.0,14.0,13.0,17.0,14.0,14.0,5.0,22.0,0.0,0.0,0.0,0.0,178.0,73.0,3.0,2.0,2.0,1.0,2.0,4.0,3.0,1.0,3.0,1.0,2.0,6.0,12.0,12.0,6.0,11.0,7.0,8.0,8.0,11.0,12.0,10.0,8.0,13.0,11.0,12.0,12.0,13.0,11.0,10.0,11.0,11.0,13.0,6.0,7.0,12.0,9.0,13.0,14.0,16.0,14.0,13.0,9.0,6.0,14.0,15.0,20.0,15.0,14.0,12.0,12.0,13.0,6.0,14.0,12.0,15.0,13.0,13.0,14.0,14.0,14.0,6.0,27.0,0.0,0.0,10.0,0.0,178.0,77.0,1.0,3.0,2.0,1.0,2.0,2.0,3.0,2.0,3.0,3.0,3.0,13.0,14.0,15.0,8.0,15.0,13.0,10.0,12.0,10.0,9.0,13.0,8.0,10.0,15.0,10.0,12.0,13.0,13.0,14.0,13.0,12.0,13.0,13.0,6.0,14.0,10.0,11.0,15.0,14.0,14.0,13.0,9.0,20.0,10.0,14.0,7.0,13.0,12.0,12.0,9.0,15.0,8.0,10.0,8.0,16.0,13.0,14.0,11.0,13.0,13.0,13.0,21.0,0.0,0.0,0.0,0.0,172.0,68.0,3.0,3.0,1.0,2.0,1.0,2.0,3.0,2.0,2.0,3.0,2.0,12.0,13.0,12.0,8.0,12.0,12.0,5.0,8.0,12.0,11.0,13.0,8.0,13.0,12.0,14.0,13.0,14.0,13.0,13.0,10.0,11.0,15.0,9.0,13.0,13.0,12.0,13.0,14.0,12.0,12.0,12.0,6.0,20.0,13.0,13.0,13.0,13.0,11.0,12.0,10.0,10.0,11.0,9.0,20.0,13.0,15.0,12.0,16.0,13.0,13.0,8.0,32.0,0.0,0.0,13.0,0.0,175.0,65.0,2.0,1.0,1.0,2.0,3.0,3.0,1.0,2.0,3.0,2.0,3.0,15.0,13.0,11.0,6.0,14.0,13.0,10.0,12.0,8.0,8.0,16.0,8.0,12.0,13.0,11.0,14.0,15.0,14.0,15.0,14.0,14.0,14.0,6.0,13.0,9.0,15.0,18.0,13.0,12.0,13.0,13.0,8.0,8.0,13.0,10.0,20.0,13.0,13.0,12.0,11.0,15.0,12.0,10.0,17.0,14.0,15.0,14.0,16.0,14.0,14.0,6.0,25.0,0.0,0.0,3.0,2.0,170.0,61.0,2.0,3.0,2.0,2.0,1.0,3.0,2.0,2.0,1.0,2.0,1.0,11.0,12.0,13.0,10.0,13.0,8.0,5.0,8.0,7.0,4.0,14.0,10.0,4.0,15.0,11.0,10.0,9.0,7.0,10.0,14.0,8.0,13.0,13.0,6.0,12.0,8.0,8.0,12.0,16.0,14.0,7.0,5.0,12.0,15.0,16.0,20.0,14.0,6.0,12.0,11.0,13.0,8.0,8.0,8.0,13.0,15.0,10.0,10.0,14.0,14.0,8.0,18.0,0.0,0.0,0.0,0.0,179.0,67.0,3.0,3.0,2.0,4.0,2.0,4.0,3.0,1.0,3.0,4.0,1.0,5.0,7.0,12.0,9.0,12.0,12.0,10.0,12.0,6.0,4.0,12.0,12.0,3.0,14.0,11.0,12.0,11.0,11.0,8.0,13.0,12.0,12.0,12.0,6.0,12.0,5.0,10.0,12.0,15.0,11.0,12.0,10.0,20.0,13.0,14.0,8.0,14.0,8.0,9.0,6.0,14.0,5.0,10.0,16.0,13.0,12.0,12.0,13.0,9.0,15.0,2.0,26.0,0.0,0.0,0.0,0.0,193.0,81.0,1.0,3.0,3.0,3.0,3.0,1.0,2.0,2.0,2.0,3.0,3.0,4.0,9.0,14.0,10.0,13.0,12.0,14.0,14.0,5.0,5.0,10.0,12.0,3.0,14.0,8.0,13.0,12.0,9.0,10.0,11.0,11.0,12.0,16.0,5.0,14.0,6.0,9.0,12.0,14.0,13.0,14.0,16.0,14.0,13.0,13.0,20.0,13.0,14.0,10.0,8.0,14.0,9.0,8.0,16.0,16.0,11.0,13.0,11.0,13.0,13.0,10.0,19.0,0.0,0.0,0.0,0.0,196.0,83.0,3.0,2.0,1.0,3.0,3.0,1.0,3.0,2.0,2.0,3.0,1.0,7.0,9.0,11.0,11.0,12.0,7.0,13.0,9.0,6.0,5.0,12.0,12.0,6.0,13.0,13.0,11.0,10.0,10.0,9.0,11.0,11.0,4.0,11.0,9.0,11.0,10.0,11.0,14.0,11.0,13.0,11.0,16.0,6.0,10.0,12.0,20.0,10.0,13.0,11.0,7.0,12.0,14.0,10.0,13.0,10.0,11.0,12.0,10.0,13.0,20.0,5.0,24.0,0.0,0.0,3.0,0.0,191.0,75.0,11.0,12.0,12.0,11.0,12.0,14.0,15.0,16.0,11.0,13.0,13.0,2.0,3.0,3.0,1.0,11.0,2.0,9.0,3.0,2.0,2.0,11.0,1.0,3.0,10.0,9.0,13.0,14.0,13.0,14.0,8.0,11.0,15.0,1.0,10.0,1.0,12.0,12.0,10.0,12.0,12.0,11.0,15.0,8.0,11.0,13.0,20.0,14.0,12.0,14.0,11.0,11.0,11.0,11.0,12.0,15.0,14.0,12.0,12.0,10.0,11.0,7.0,16.0,0.0,0.0,0.0,0.0,177.0,0.0,3.0,2.0,1.0,1.0,3.0,3.0,2.0,2.0,2.0,1.0,3.0,1.0,3.0,2.0,2.0,4.0,1.0,3.0,1.0,6.0,9.0,2.0,1.0,9.0,6.0,14.0,4.0,5.0,5.0,3.0,2.0,5.0,4.0,5.0,7.0,4.0,8.0,4.0,3.0,10.0,7.0,13.0,7.0,15.0,13.0,9.0,20.0,5.0,8.0,7.0,11.0,5.0,8.0,8.0,11.0,11.0,5.0,14.0,20.0,7.0,12.0,5.0,26.0,8.0,0.0,0.0,0.0,189.0,84.0,3.0,2.0,1.0,1.0,3.0,2.0,3.0,1.0,2.0,1.0,1.0,5.0,8.0,9.0,6.0,10.0,5.0,13.0,6.0,11.0,14.0,9.0,9.0,14.0,12.0,14.0,13.0,17.0,14.0,12.0,8.0,10.0,15.0,8.0,11.0,7.0,14.0,15.0,15.0,10.0,9.0,14.0,15.0,20.0,15.0,12.0,9.0,14.0,16.0,12.0,14.0,10.0,7.0,8.0,15.0,17.0,7.0,13.0,14.0,8.0,10.0,10.0,27.0,1.0,0.0,3.0,0.0,186.0,83.0,2.0,2.0,2.0,2.0,1.0,4.0,2.0,3.0,3.0,3.0,2.0,5.0,9.0,9.0,8.0,10.0,6.0,16.0,8.0,7.0,14.0,11.0,6.0,15.0,12.0,14.0,15.0,16.0,13.0,12.0,8.0,13.0,14.0,8.0,11.0,8.0,14.0,15.0,15.0,15.0,9.0,15.0,12.0,8.0,13.0,14.0,20.0,14.0,17.0,15.0,13.0,13.0,10.0,8.0,9.0,14.0,9.0,13.0,15.0,15.0,15.0,6.0,25.0,0.0,0.0,7.0,0.0,182.0,79.0,2.0,1.0,2.0,2.0,1.0,1.0,1.0,2.0,2.0,2.0,2.0,8.0,12.0,12.0,6.0,13.0,7.0,13.0,7.0,12.0,14.0,9.0,7.0,14.0,13.0,13.0,12.0,13.0,12.0,12.0,7.0,9.0,10.0,10.0,6.0,9.0,12.0,13.0,14.0,16.0,15.0,14.0,13.0,20.0,14.0,15.0,5.0,16.0,13.0,14.0,11.0,13.0,7.0,8.0,13.0,16.0,12.0,9.0,12.0,15.0,15.0,8.0,24.0,0.0,0.0,0.0,0.0,178.0,77.0,2.0,1.0,3.0,2.0,1.0,3.0,3.0,3.0,1.0,3.0,2.0,5.0,10.0,8.0,5.0,9.0,6.0,11.0,8.0,12.0,11.0,8.0,6.0,12.0,9.0,11.0,11.0,13.0,11.0,12.0,7.0,11.0,15.0,9.0,6.0,9.0,11.0,12.0,14.0,16.0,12.0,14.0,10.0,5.0,15.0,15.0,20.0,14.0,13.0,14.0,11.0,13.0,5.0,8.0,17.0,12.0,14.0,14.0,14.0,14.0,14.0,6.0,26.0,0.0,0.0,0.0,0.0,184.0,76.0,2.0,3.0,1.0,3.0,1.0,1.0,3.0,1.0,3.0,2.0,2.0,10.0,12.0,14.0,12.0,14.0,12.0,11.0,13.0,11.0,13.0,14.0,13.0,12.0,15.0,14.0,13.0,12.0,11.0,11.0,13.0,14.0,14.0,12.0,13.0,12.0,11.0,11.0,14.0,15.0,14.0,13.0,10.0,5.0,14.0,14.0,20.0,14.0,14.0,14.0,7.0,16.0,6.0,8.0,19.0,14.0,14.0,14.0,14.0,14.0,14.0,6.0,18.0,0.0,0.0,0.0,0.0,193.0,88.0,3.0,2.0,1.0,2.0,2.0,2.0,1.0,1.0,1.0,2.0,2.0,5.0,7.0,5.0,7.0,14.0,9.0,9.0,12.0,6.0,8.0,14.0,3.0,11.0,10.0,10.0,11.0,10.0,5.0,11.0,8.0,11.0,6.0,6.0,8.0,9.0,12.0,10.0,14.0,13.0,10.0,13.0,16.0,5.0,15.0,12.0,20.0,13.0,13.0,10.0,10.0,10.0,10.0,10.0,20.0,9.0,11.0,11.0,11.0,13.0,15.0,8.0,22.0,0.0,0.0,0.0,0.0,177.0,72.0,2.0,1.0,2.0,4.0,2.0,2.0,1.0,3.0,4.0,2.0,3.0,10.0,12.0,13.0,11.0,12.0,10.0,12.0,12.0,4.0,10.0,13.0,11.0,11.0,13.0,11.0,12.0,11.0,13.0,9.0,13.0,12.0,3.0,12.0,8.0,14.0,12.0,12.0,13.0,16.0,13.0,12.0,9.0,8.0,15.0,14.0,20.0,14.0,13.0,10.0,4.0,11.0,11.0,12.0,19.0,9.0,12.0,13.0,12.0,11.0,14.0,7.0,25.0,1.0,1.0,0.0,0.0,182.0,70.0,2.0,1.0,2.0,3.0,3.0,2.0,2.0,4.0,1.0,3.0,2.0,9.0,7.0,13.0,13.0,12.0,6.0,13.0,12.0,8.0,8.0,10.0,14.0,6.0,11.0,13.0,10.0,13.0,12.0,12.0,10.0,12.0,13.0,8.0,9.0,14.0,8.0,11.0,12.0,14.0,13.0,14.0,11.0,8.0,13.0,14.0,20.0,13.0,13.0,12.0,6.0,12.0,6.0,11.0,14.0,11.0,10.0,11.0,10.0,9.0,19.0,5.0,20.0,0.0,0.0,0.0,0.0,182.0,78.0,2.0,3.0,2.0,2.0,1.0,1.0,2.0,4.0,2.0,1.0,2.0,9.0,5.0,10.0,9.0,11.0,9.0,10.0,10.0,4.0,5.0,9.0,7.0,6.0,11.0,13.0,10.0,14.0,10.0,10.0,7.0,13.0,10.0,9.0,10.0,11.0,6.0,10.0,15.0,12.0,12.0,14.0,10.0,6.0,15.0,13.0,20.0,10.0,13.0,9.0,9.0,1.0,9.0,9.0,14.0,12.0,13.0,11.0,14.0,13.0,14.0,5.0
1,1,25.0,4.0,0.0,11.0,0.0,184.0,81.0,14.0,14.0,13.0,9.0,15.0,12.0,16.0,16.0,13.0,7.0,11.0,8.0,1.0,2.0,1.0,11.0,12.0,6.0,1.0,3.0,3.0,11.0,5.0,3.0,11.0,8.0,15.0,15.0,13.0,14.0,10.0,11.0,14.0,8.0,13.0,5.0,13.0,10.0,10.0,14.0,16.0,14.0,13.0,20.0,14.0,12.0,5.0,14.0,14.0,15.0,9.0,16.0,6.0,1.0,17.0,11.0,15.0,13.0,14.0,12.0,12.0,4.0,27.0,0.0,0.0,0.0,0.0,184.0,81.0,1.0,1.0,1.0,3.0,3.0,2.0,2.0,2.0,1.0,2.0,3.0,8.0,6.0,8.0,12.0,10.0,8.0,12.0,9.0,1.0,3.0,8.0,14.0,4.0,9.0,4.0,11.0,12.0,11.0,8.0,8.0,11.0,10.0,9.0,8.0,11.0,9.0,8.0,11.0,10.0,8.0,13.0,13.0,9.0,13.0,9.0,20.0,12.0,13.0,13.0,9.0,2.0,9.0,9.0,15.0,10.0,12.0,10.0,11.0,6.0,4.0,6.0,21.0,8.0,0.0,2.0,1.0,184.0,75.0,3.0,2.0,2.0,3.0,3.0,2.0,3.0,3.0,3.0,2.0,4.0,6.0,8.0,13.0,9.0,13.0,5.0,13.0,6.0,10.0,12.0,11.0,10.0,15.0,13.0,15.0,13.0,13.0,13.0,14.0,10.0,11.0,11.0,9.0,8.0,6.0,11.0,14.0,15.0,15.0,14.0,14.0,13.0,11.0,12.0,14.0,20.0,13.0,14.0,13.0,7.0,13.0,9.0,9.0,15.0,15.0,12.0,11.0,11.0,15.0,14.0,2.0,21.0,0.0,0.0,0.0,0.0,179.0,68.0,2.0,3.0,2.0,1.0,2.0,1.0,2.0,3.0,2.0,1.0,1.0,6.0,13.0,12.0,6.0,13.0,6.0,8.0,7.0,12.0,10.0,12.0,8.0,12.0,13.0,10.0,11.0,11.0,12.0,10.0,11.0,11.0,12.0,11.0,7.0,13.0,10.0,12.0,14.0,15.0,13.0,12.0,10.0,20.0,14.0,14.0,8.0,14.0,10.0,13.0,8.0,13.0,8.0,12.0,13.0,14.0,10.0,12.0,10.0,10.0,12.0,10.0,37.0,0.0,0.0,0.0,0.0,185.0,83.0,1.0,1.0,2.0,1.0,3.0,2.0,3.0,1.0,1.0,3.0,1.0,6.0,8.0,9.0,12.0,10.0,8.0,13.0,9.0,4.0,5.0,10.0,14.0,4.0,11.0,11.0,10.0,11.0,13.0,12.0,12.0,13.0,15.0,14.0,12.0,11.0,7.0,12.0,8.0,7.0,7.0,12.0,12.0,11.0,11.0,7.0,20.0,8.0,14.0,12.0,8.0,13.0,9.0,12.0,12.0,12.0,19.0,14.0,15.0,14.0,8.0,8.0,19.0,0.0,0.0,0.0,0.0,185.0,82.0,4.0,2.0,3.0,1.0,3.0,2.0,1.0,2.0,1.0,2.0,3.0,7.0,7.0,10.0,6.0,13.0,7.0,14.0,7.0,6.0,12.0,13.0,7.0,13.0,13.0,13.0,13.0,13.0,11.0,12.0,11.0,12.0,14.0,9.0,14.0,11.0,11.0,15.0,15.0,12.0,12.0,14.0,13.0,5.0,14.0,12.0,20.0,14.0,13.0,10.0,11.0,11.0,6.0,10.0,10.0,12.0,12.0,14.0,14.0,11.0,16.0,6.0,19.0,0.0,0.0,0.0,0.0,175.0,67.0,3.0,2.0,1.0,3.0,3.0,1.0,1.0,1.0,2.0,1.0,3.0,7.0,8.0,12.0,8.0,10.0,6.0,12.0,9.0,8.0,10.0,10.0,8.0,12.0,11.0,14.0,10.0,12.0,9.0,10.0,11.0,10.0,12.0,12.0,10.0,12.0,12.0,13.0,14.0,13.0,11.0,14.0,8.0,6.0,14.0,12.0,20.0,14.0,12.0,12.0,8.0,11.0,6.0,12.0,17.0,13.0,10.0,11.0,12.0,11.0,17.0,5.0,18.0,0.0,0.0,0.0,0.0,170.0,67.0,3.0,1.0,3.0,3.0,3.0,4.0,1.0,2.0,1.0,2.0,2.0,11.0,11.0,12.0,13.0,12.0,11.0,6.0,10.0,8.0,7.0,12.0,10.0,7.0,13.0,9.0,11.0,8.0,10.0,10.0,12.0,12.0,15.0,12.0,12.0,11.0,12.0,11.0,12.0,12.0,12.0,10.0,6.0,5.0,14.0,12.0,20.0,10.0,9.0,10.0,8.0,2.0,6.0,12.0,11.0,11.0,12.0,13.0,14.0,11.0,13.0,4.0,22.0,5.0,1.0,1.0,0.0,173.0,72.0,1.0,3.0,1.0,3.0,3.0,3.0,3.0,3.0,3.0,2.0,2.0,14.0,13.0,16.0,14.0,16.0,14.0,5.0,11.0,5.0,5.0,15.0,11.0,5.0,16.0,8.0,13.0,9.0,14.0,13.0,15.0,13.0,15.0,16.0,5.0,13.0,5.0,9.0,10.0,15.0,16.0,14.0,5.0,20.0,14.0,15.0,5.0,12.0,14.0,13.0,11.0,13.0,8.0,14.0,10.0,15.0,14.0,10.0,13.0,10.0,10.0,13.0,22.0,24.0,3.0,7.0,0.0,177.0,78.0,2.0,1.0,2.0,3.0,2.0,2.0,4.0,3.0,3.0,2.0,1.0,10.0,13.0,16.0,14.0,16.0,16.0,8.0,16.0,4.0,4.0,15.0,12.0,4.0,16.0,12.0,11.0,12.0,13.0,10.0,11.0,8.0,13.0,17.0,5.0,14.0,5.0,10.0,12.0,15.0,14.0,13.0,9.0,10.0,17.0,16.0,20.0,15.0,14.0,12.0,11.0,15.0,4.0,12.0,19.0,16.0,14.0,14.0,11.0,13.0,10.0,12.0,19.0,0.0,0.0,0.0,0.0,183.0,74.0,3.0,3.0,1.0,2.0,3.0,2.0,1.0,1.0,3.0,1.0,2.0,8.0,9.0,14.0,14.0,12.0,8.0,13.0,12.0,7.0,3.0,9.0,15.0,3.0,14.0,10.0,14.0,8.0,14.0,11.0,10.0,13.0,15.0,14.0,6.0,13.0,7.0,8.0,10.0,16.0,14.0,14.0,11.0,12.0,14.0,15.0,20.0,13.0,15.0,13.0,5.0,13.0,7.0,5.0,10.0,15.0,8.0,13.0,13.0,11.0,12.0,11.0,28.0,0.0,0.0,0.0,0.0,188.0,86.0,14.0,13.0,15.0,8.0,14.0,11.0,14.0,16.0,13.0,12.0,8.0,6.0,2.0,1.0,3.0,8.0,8.0,1.0,1.0,3.0,1.0,8.0,4.0,1.0,8.0,8.0,13.0,13.0,14.0,14.0,11.0,12.0,15.0,7.0,10.0,2.0,14.0,12.0,11.0,13.0,14.0,16.0,13.0,5.0,16.0,12.0,20.0,14.0,15.0,14.0,8.0,15.0,5.0,1.0,11.0,15.0,14.0,14.0,16.0,14.0,11.0,6.0,34.0,0.0,0.0,0.0,0.0,191.0,81.0,14.0,10.0,8.0,3.0,9.0,14.0,13.0,10.0,9.0,3.0,12.0,4.0,3.0,3.0,1.0,1.0,6.0,1.0,1.0,2.0,1.0,2.0,3.0,3.0,3.0,8.0,6.0,10.0,8.0,9.0,5.0,10.0,2.0,1.0,10.0,2.0,10.0,8.0,7.0,10.0,8.0,8.0,16.0,9.0,14.0,9.0,20.0,3.0,9.0,9.0,9.0,1.0,9.0,9.0,20.0,9.0,13.0,12.0,10.0,10.0,12.0,7.0,17.0,0.0,0.0,0.0,0.0,178.0,70.0,2.0,2.0,2.0,2.0,3.0,2.0,3.0,2.0,4.0,2.0,3.0,7.0,7.0,1.0,3.0,10.0,5.0,14.0,5.0,3.0,9.0,12.0,2.0,13.0,8.0,9.0,13.0,10.0,7.0,10.0,3.0,12.0,2.0,2.0,14.0,4.0,14.0,8.0,9.0,12.0,11.0,9.0,11.0,8.0,5.0,13.0,20.0,12.0,13.0,10.0,10.0,14.0,7.0,10.0,19.0,11.0,9.0,14.0,11.0,13.0,10.0,5.0,20.0,0.0,0.0,0.0,0.0,168.0,67.0,3.0,3.0,3.0,1.0,1.0,3.0,1.0,2.0,1.0,2.0,3.0,7.0,10.0,9.0,8.0,11.0,6.0,9.0,8.0,13.0,12.0,10.0,7.0,14.0,9.0,16.0,12.0,15.0,9.0,16.0,7.0,11.0,17.0,9.0,10.0,11.0,12.0,14.0,15.0,13.0,10.0,12.0,6.0,6.0,16.0,11.0,20.0,14.0,9.0,17.0,12.0,15.0,5.0,18.0,7.0,12.0,16.0,13.0,18.0,14.0,15.0,5.0,23.0,0.0,0.0,0.0,0.0,179.0,71.0,2.0,1.0,3.0,3.0,2.0,3.0,2.0,2.0,1.0,3.0,1.0,8.0,10.0,12.0,6.0,12.0,10.0,5.0,10.0,13.0,11.0,11.0,6.0,12.0,11.0,9.0,11.0,12.0,12.0,7.0,10.0,9.0,15.0,12.0,5.0,13.0,8.0,12.0,14.0,16.0,13.0,13.0,10.0,20.0,16.0,15.0,8.0,14.0,14.0,13.0,9.0,14.0,7.0,10.0,7.0,14.0,14.0,13.0,15.0,13.0,13.0,5.0,28.0,0.0,0.0,0.0,0.0,172.0,68.0,4.0,4.0,2.0,1.0,3.0,2.0,2.0,1.0,3.0,3.0,1.0,6.0,5.0,10.0,7.0,14.0,8.0,8.0,8.0,5.0,9.0,11.0,6.0,6.0,12.0,10.0,11.0,8.0,10.0,8.0,12.0,14.0,9.0,11.0,6.0,12.0,9.0,9.0,13.0,11.0,12.0,9.0,6.0,10.0,13.0,11.0,20.0,10.0,6.0,10.0,4.0,6.0,10.0,10.0,12.0,12.0,13.0,10.0,11.0,7.0,13.0,1.0,34.0,103.0,7.0,16.0,1.0,182.0,72.0,2.0,1.0,1.0,1.0,3.0,1.0,4.0,3.0,3.0,2.0,1.0,11.0,13.0,12.0,8.0,15.0,13.0,9.0,13.0,6.0,8.0,15.0,12.0,8.0,15.0,11.0,14.0,13.0,15.0,15.0,14.0,16.0,17.0,15.0,14.0,11.0,13.0,17.0,13.0,8.0,11.0,10.0,11.0,16.0,13.0,8.0,20.0,12.0,10.0,15.0,11.0,12.0,12.0,15.0,14.0,12.0,15.0,15.0,18.0,14.0,14.0,7.0,26.0,0.0,0.0,0.0,0.0,184.0,76.0,3.0,1.0,3.0,1.0,3.0,2.0,3.0,2.0,1.0,1.0,3.0,10.0,11.0,13.0,9.0,13.0,12.0,13.0,10.0,6.0,11.0,13.0,9.0,14.0,12.0,12.0,13.0,12.0,12.0,11.0,13.0,12.0,13.0,13.0,10.0,12.0,13.0,12.0,16.0,15.0,13.0,15.0,13.0,20.0,15.0,14.0,5.0,16.0,15.0,13.0,12.0,14.0,5.0,12.0,18.0,14.0,10.0,7.0,11.0,11.0,13.0,10.0,30.0,5.0,0.0,22.0,9.0,181.0,84.0,2.0,3.0,3.0,1.0,2.0,3.0,3.0,1.0,3.0,1.0,3.0,7.0,10.0,12.0,13.0,11.0,7.0,13.0,10.0,12.0,6.0,11.0,13.0,6.0,13.0,17.0,13.0,16.0,11.0,13.0,11.0,11.0,17.0,14.0,8.0,14.0,9.0,13.0,17.0,15.0,12.0,15.0,11.0,8.0,14.0,15.0,20.0,14.0,14.0,13.0,9.0,13.0,7.0,10.0,7.0,16.0,13.0,14.0,13.0,15.0,15.0,10.0,20.0,7.0,1.0,0.0,0.0,182.0,75.0,2.0,1.0,3.0,2.0,2.0,1.0,3.0,1.0,3.0,2.0,1.0,11.0,11.0,13.0,12.0,13.0,11.0,12.0,10.0,5.0,4.0,12.0,8.0,5.0,13.0,11.0,12.0,11.0,11.0,8.0,10.0,10.0,3.0,10.0,1.0,13.0,8.0,12.0,12.0,15.0,14.0,13.0,11.0,6.0,14.0,13.0,20.0,12.0,13.0,12.0,9.0,11.0,9.0,11.0,9.0,9.0,9.0,12.0,11.0,9.0,17.0,7.0,17.0,0.0,0.0,0.0,0.0,181.0,68.0,1.0,2.0,1.0,1.0,2.0,2.0,3.0,3.0,3.0,2.0,1.0,8.0,11.0,14.0,11.0,13.0,8.0,11.0,9.0,5.0,3.0,11.0,5.0,5.0,14.0,5.0,11.0,6.0,10.0,10.0,11.0,12.0,14.0,13.0,6.0,13.0,9.0,10.0,8.0,14.0,14.0,14.0,10.0,5.0,12.0,14.0,20.0,12.0,11.0,10.0,6.0,5.0,10.0,12.0,20.0,12.0,11.0,12.0,12.0,11.0,14.0,5.0
2,4,26.0,2.0,0.0,1.0,0.0,188.0,84.0,12.0,13.0,15.0,9.0,15.0,13.0,13.0,15.0,10.0,11.0,14.0,9.0,2.0,1.0,2.0,12.0,11.0,3.0,2.0,3.0,3.0,11.0,3.0,1.0,10.0,14.0,13.0,14.0,10.0,13.0,11.0,11.0,14.0,3.0,11.0,5.0,12.0,15.0,13.0,10.0,12.0,13.0,14.0,5.0,14.0,9.0,20.0,12.0,14.0,12.0,10.0,15.0,3.0,11.0,12.0,11.0,16.0,13.0,15.0,16.0,16.0,4.0,32.0,0.0,0.0,0.0,0.0,183.0,79.0,1.0,1.0,1.0,3.0,1.0,3.0,1.0,1.0,2.0,1.0,1.0,5.0,10.0,6.0,6.0,9.0,6.0,15.0,7.0,11.0,14.0,10.0,7.0,13.0,10.0,13.0,15.0,15.0,15.0,14.0,9.0,13.0,16.0,6.0,14.0,8.0,12.0,13.0,16.0,11.0,12.0,16.0,11.0,8.0,16.0,12.0,20.0,15.0,14.0,14.0,11.0,12.0,5.0,15.0,18.0,15.0,14.0,13.0,17.0,14.0,14.0,5.0,29.0,0.0,0.0,0.0,0.0,183.0,74.0,3.0,3.0,3.0,3.0,3.0,2.0,2.0,2.0,1.0,3.0,1.0,5.0,12.0,7.0,6.0,10.0,7.0,14.0,12.0,5.0,14.0,12.0,6.0,13.0,11.0,14.0,13.0,17.0,13.0,16.0,12.0,12.0,13.0,9.0,8.0,9.0,14.0,14.0,15.0,13.0,12.0,15.0,12.0,6.0,17.0,11.0,20.0,17.0,13.0,14.0,14.0,15.0,5.0,13.0,9.0,14.0,19.0,15.0,14.0,11.0,11.0,6.0,22.0,0.0,0.0,0.0,0.0,178.0,73.0,3.0,2.0,2.0,1.0,2.0,4.0,3.0,1.0,3.0,1.0,2.0,6.0,12.0,12.0,6.0,11.0,7.0,8.0,8.0,11.0,12.0,10.0,8.0,13.0,11.0,12.0,12.0,13.0,11.0,10.0,11.0,11.0,13.0,6.0,7.0,12.0,9.0,13.0,14.0,16.0,14.0,13.0,9.0,6.0,14.0,15.0,20.0,15.0,14.0,12.0,12.0,13.0,6.0,14.0,12.0,15.0,13.0,13.0,14.0,14.0,14.0,6.0,21.0,0.0,0.0,0.0,0.0,172.0,68.0,3.0,3.0,1.0,2.0,1.0,2.0,3.0,2.0,2.0,3.0,2.0,12.0,13.0,12.0,8.0,12.0,12.0,5.0,8.0,12.0,11.0,13.0,8.0,13.0,12.0,14.0,13.0,14.0,13.0,13.0,10.0,11.0,15.0,9.0,13.0,13.0,12.0,13.0,14.0,12.0,12.0,12.0,6.0,20.0,13.0,13.0,13.0,13.0,11.0,12.0,10.0,10.0,11.0,9.0,20.0,13.0,15.0,12.0,16.0,13.0,13.0,8.0,27.0,0.0,0.0,0.0,0.0,188.0,77.0,1.0,4.0,1.0,1.0,3.0,1.0,2.0,1.0,2.0,2.0,2.0,4.0,7.0,8.0,7.0,13.0,6.0,15.0,9.0,6.0,13.0,12.0,6.0,12.0,11.0,14.0,14.0,15.0,10.0,12.0,11.0,13.0,16.0,7.0,12.0,9.0,12.0,15.0,16.0,14.0,10.0,14.0,15.0,9.0,13.0,12.0,20.0,14.0,16.0,12.0,14.0,13.0,6.0,12.0,4.0,13.0,18.0,13.0,14.0,14.0,13.0,7.0,32.0,0.0,0.0,13.0,0.0,175.0,65.0,2.0,1.0,1.0,2.0,3.0,3.0,1.0,2.0,3.0,2.0,3.0,15.0,13.0,11.0,6.0,14.0,13.0,10.0,12.0,8.0,8.0,16.0,8.0,12.0,13.0,11.0,14.0,15.0,14.0,15.0,14.0,14.0,14.0,6.0,13.0,9.0,15.0,18.0,13.0,12.0,13.0,13.0,8.0,8.0,13.0,10.0,20.0,13.0,13.0,12.0,11.0,15.0,12.0,10.0,17.0,14.0,15.0,14.0,16.0,14.0,14.0,6.0,18.0,0.0,0.0,0.0,0.0,179.0,67.0,3.0,3.0,2.0,4.0,2.0,4.0,3.0,1.0,3.0,4.0,1.0,5.0,7.0,12.0,9.0,12.0,12.0,10.0,12.0,6.0,4.0,12.0,12.0,3.0,14.0,11.0,12.0,11.0,11.0,8.0,13.0,12.0,12.0,12.0,6.0,12.0,5.0,10.0,12.0,15.0,11.0,12.0,10.0,20.0,13.0,14.0,8.0,14.0,8.0,9.0,6.0,14.0,5.0,10.0,16.0,13.0,12.0,12.0,13.0,9.0,15.0,2.0,20.0,0.0,0.0,2.0,0.0,180.0,75.0,3.0,1.0,2.0,2.0,3.0,2.0,1.0,1.0,3.0,3.0,1.0,8.0,13.0,14.0,9.0,13.0,8.0,10.0,9.0,6.0,5.0,12.0,6.0,5.0,14.0,8.0,13.0,12.0,13.0,12.0,12.0,12.0,7.0,13.0,8.0,14.0,7.0,12.0,13.0,15.0,13.0,14.0,10.0,8.0,14.0,15.0,20.0,13.0,12.0,13.0,11.0,9.0,7.0,13.0,9.0,11.0,11.0,11.0,12.0,11.0,10.0,1.0,25.0,0.0,0.0,3.0,2.0,170.0,61.0,2.0,3.0,2.0,2.0,1.0,3.0,2.0,2.0,1.0,2.0,1.0,11.0,12.0,13.0,10.0,13.0,8.0,5.0,8.0,7.0,4.0,14.0,10.0,4.0,15.0,11.0,10.0,9.0,7.0,10.0,14.0,8.0,13.0,13.0,6.0,12.0,8.0,8.0,12.0,16.0,14.0,7.0,5.0,12.0,15.0,16.0,20.0,14.0,6.0,12.0,11.0,13.0,8.0,8.0,8.0,13.0,15.0,10.0,10.0,14.0,14.0,8.0,18.0,0.0,0.0,0.0,0.0,188.0,80.0,1.0,3.0,1.0,3.0,2.0,3.0,3.0,1.0,2.0,2.0,4.0,6.0,8.0,12.0,11.0,12.0,7.0,13.0,10.0,4.0,4.0,8.0,10.0,5.0,12.0,11.0,11.0,13.0,10.0,11.0,11.0,12.0,11.0,13.0,7.0,13.0,8.0,13.0,13.0,11.0,12.0,12.0,12.0,10.0,12.0,11.0,20.0,10.0,12.0,12.0,8.0,11.0,7.0,13.0,8.0,13.0,13.0,11.0,12.0,12.0,13.0,7.0,25.0,4.0,0.0,11.0,0.0,184.0,81.0,14.0,14.0,13.0,9.0,15.0,12.0,16.0,16.0,13.0,7.0,11.0,8.0,1.0,2.0,1.0,11.0,12.0,6.0,1.0,3.0,3.0,11.0,5.0,3.0,11.0,8.0,15.0,15.0,13.0,14.0,10.0,11.0,14.0,8.0,13.0,5.0,13.0,10.0,10.0,14.0,16.0,14.0,13.0,20.0,14.0,12.0,5.0,14.0,14.0,15.0,9.0,16.0,6.0,1.0,17.0,11.0,15.0,13.0,14.0,12.0,12.0,4.0,32.0,0.0,0.0,0.0,0.0,172.0,71.0,2.0,1.0,3.0,1.0,2.0,3.0,2.0,3.0,2.0,2.0,2.0,8.0,9.0,7.0,6.0,10.0,6.0,10.0,9.0,10.0,14.0,11.0,6.0,14.0,11.0,10.0,16.0,15.0,12.0,12.0,7.0,12.0,15.0,9.0,13.0,8.0,14.0,15.0,15.0,14.0,14.0,14.0,10.0,20.0,14.0,14.0,8.0,15.0,13.0,13.0,11.0,13.0,7.0,13.0,17.0,14.0,17.0,8.0,13.0,15.0,15.0,6.0,27.0,0.0,0.0,0.0,0.0,184.0,81.0,1.0,1.0,1.0,3.0,3.0,2.0,2.0,2.0,1.0,2.0,3.0,8.0,6.0,8.0,12.0,10.0,8.0,12.0,9.0,1.0,3.0,8.0,14.0,4.0,9.0,4.0,11.0,12.0,11.0,8.0,8.0,11.0,10.0,9.0,8.0,11.0,9.0,8.0,11.0,10.0,8.0,13.0,13.0,9.0,13.0,9.0,20.0,12.0,13.0,13.0,9.0,2.0,9.0,9.0,15.0,10.0,12.0,10.0,11.0,6.0,4.0,6.0,21.0,8.0,0.0,2.0,1.0,184.0,75.0,3.0,2.0,2.0,3.0,3.0,2.0,3.0,3.0,3.0,2.0,4.0,6.0,8.0,13.0,9.0,13.0,5.0,13.0,6.0,10.0,12.0,11.0,10.0,15.0,13.0,15.0,13.0,13.0,13.0,14.0,10.0,11.0,11.0,9.0,8.0,6.0,11.0,14.0,15.0,15.0,14.0,14.0,13.0,11.0,12.0,14.0,20.0,13.0,14.0,13.0,7.0,13.0,9.0,9.0,15.0,15.0,12.0,11.0,11.0,15.0,14.0,2.0,20.0,4.0,0.0,0.0,0.0,180.0,77.0,4.0,1.0,2.0,2.0,1.0,1.0,1.0,1.0,3.0,3.0,3.0,7.0,9.0,11.0,5.0,12.0,5.0,11.0,7.0,10.0,15.0,11.0,6.0,16.0,11.0,15.0,11.0,15.0,11.0,11.0,10.0,13.0,13.0,9.0,7.0,12.0,14.0,12.0,14.0,14.0,13.0,14.0,12.0,10.0,14.0,14.0,20.0,14.0,14.0,13.0,9.0,13.0,5.0,12.0,7.0,12.0,10.0,10.0,10.0,4.0,7.0,10.0,21.0,0.0,0.0,0.0,0.0,179.0,68.0,2.0,3.0,2.0,1.0,2.0,1.0,2.0,3.0,2.0,1.0,1.0,6.0,13.0,12.0,6.0,13.0,6.0,8.0,7.0,12.0,10.0,12.0,8.0,12.0,13.0,10.0,11.0,11.0,12.0,10.0,11.0,11.0,12.0,11.0,7.0,13.0,10.0,12.0,14.0,15.0,13.0,12.0,10.0,20.0,14.0,14.0,8.0,14.0,10.0,13.0,8.0,13.0,8.0,12.0,13.0,14.0,10.0,12.0,10.0,10.0,12.0,10.0,19.0,0.0,0.0,0.0,0.0,185.0,82.0,4.0,2.0,3.0,1.0,3.0,2.0,1.0,2.0,1.0,2.0,3.0,7.0,7.0,10.0,6.0,13.0,7.0,14.0,7.0,6.0,12.0,13.0,7.0,13.0,13.0,13.0,13.0,13.0,11.0,12.0,11.0,12.0,14.0,9.0,14.0,11.0,11.0,15.0,15.0,12.0,12.0,14.0,13.0,5.0,14.0,12.0,20.0,14.0,13.0,10.0,11.0,11.0,6.0,10.0,10.0,12.0,12.0,14.0,14.0,11.0,16.0,6.0,19.0,0.0,0.0,0.0,0.0,175.0,67.0,3.0,2.0,1.0,3.0,3.0,1.0,1.0,1.0,2.0,1.0,3.0,7.0,8.0,12.0,8.0,10.0,6.0,12.0,9.0,8.0,10.0,10.0,8.0,12.0,11.0,14.0,10.0,12.0,9.0,10.0,11.0,10.0,12.0,12.0,10.0,12.0,12.0,13.0,14.0,13.0,11.0,14.0,8.0,6.0,14.0,12.0,20.0,14.0,12.0,12.0,8.0,11.0,6.0,12.0,17.0,13.0,10.0,11.0,12.0,11.0,17.0,5.0,18.0,0.0,0.0,0.0,0.0,170.0,67.0,3.0,1.0,3.0,3.0,3.0,4.0,1.0,2.0,1.0,2.0,2.0,11.0,11.0,12.0,13.0,12.0,11.0,6.0,10.0,8.0,7.0,12.0,10.0,7.0,13.0,9.0,11.0,8.0,10.0,10.0,12.0,12.0,15.0,12.0,12.0,11.0,12.0,11.0,12.0,12.0,12.0,10.0,6.0,5.0,14.0,12.0,20.0,10.0,9.0,10.0,8.0,2.0,6.0,12.0,11.0,11.0,12.0,13.0,14.0,11.0,13.0,4.0,19.0,0.0,0.0,0.0,0.0,183.0,74.0,3.0,3.0,1.0,2.0,3.0,2.0,1.0,1.0,3.0,1.0,2.0,8.0,9.0,14.0,14.0,12.0,8.0,13.0,12.0,7.0,3.0,9.0,15.0,3.0,14.0,10.0,14.0,8.0,14.0,11.0,10.0,13.0,15.0,14.0,6.0,13.0,7.0,8.0,10.0,16.0,14.0,14.0,11.0,12.0,14.0,15.0,20.0,13.0,15.0,13.0,5.0,13.0,7.0,5.0,10.0,15.0,8.0,13.0,13.0,11.0,12.0,11.0,22.0,24.0,3.0,7.0,0.0,177.0,78.0,2.0,1.0,2.0,3.0,2.0,2.0,4.0,3.0,3.0,2.0,1.0,10.0,13.0,16.0,14.0,16.0,16.0,8.0,16.0,4.0,4.0,15.0,12.0,4.0,16.0,12.0,11.0,12.0,13.0,10.0,11.0,8.0,13.0,17.0,5.0,14.0,5.0,10.0,12.0,15.0,14.0,13.0,9.0,10.0,17.0,16.0,20.0,15.0,14.0,12.0,11.0,15.0,4.0,12.0,19.0,16.0,14.0,14.0,11.0,13.0,10.0,12.0
1,1,33.0,0.0,0.0,3.0,0.0,188.0,84.0,14.0,13.0,13.0,9.0,13.0,13.0,15.0,15.0,11.0,11.0,9.0,7.0,3.0,3.0,1.0,7.0,10.0,2.0,1.0,1.0,2.0,6.0,4.0,1.0,7.0,8.0,13.0,14.0,14.0,14.0,8.0,11.0,15.0,6.0,13.0,3.0,13.0,12.0,8.0,12.0,14.0,15.0,14.0,8.0,13.0,11.0,20.0,13.0,15.0,16.0,8.0,13.0,6.0,1.0,11.0,14.0,13.0,11.0,16.0,14.0,11.0,6.0,29.0,2.0,0.0,0.0,0.0,185.0,75.0,2.0,3.0,3.0,3.0,2.0,3.0,2.0,1.0,3.0,1.0,2.0,4.0,10.0,8.0,6.0,10.0,6.0,14.0,7.0,7.0,14.0,11.0,6.0,14.0,9.0,13.0,13.0,14.0,11.0,12.0,12.0,12.0,14.0,8.0,11.0,12.0,13.0,13.0,13.0,15.0,12.0,15.0,12.0,8.0,15.0,13.0,20.0,14.0,15.0,14.0,7.0,14.0,8.0,6.0,14.0,13.0,15.0,14.0,14.0,14.0,14.0,6.0,26.0,0.0,0.0,10.0,1.0,196.0,91.0,3.0,1.0,2.0,2.0,2.0,3.0,2.0,4.0,2.0,2.0,1.0,3.0,5.0,8.0,6.0,9.0,5.0,14.0,7.0,8.0,13.0,10.0,5.0,12.0,10.0,10.0,13.0,14.0,12.0,12.0,7.0,10.0,13.0,6.0,9.0,6.0,12.0,14.0,10.0,9.0,8.0,13.0,18.0,8.0,17.0,11.0,20.0,12.0,16.0,13.0,12.0,10.0,7.0,4.0,18.0,10.0,12.0,9.0,13.0,7.0,10.0,7.0,28.0,0.0,0.0,0.0,0.0,193.0,84.0,1.0,1.0,2.0,2.0,2.0,3.0,2.0,3.0,2.0,1.0,3.0,4.0,8.0,8.0,9.0,10.0,6.0,14.0,7.0,8.0,14.0,12.0,6.0,14.0,11.0,12.0,13.0,14.0,11.0,14.0,12.0,12.0,14.0,6.0,11.0,8.0,14.0,13.0,13.0,11.0,11.0,16.0,16.0,20.0,12.0,12.0,8.0,14.0,16.0,14.0,12.0,13.0,6.0,10.0,7.0,12.0,15.0,12.0,16.0,15.0,13.0,6.0,26.0,0.0,0.0,0.0,0.0,182.0,68.0,1.0,4.0,3.0,2.0,3.0,1.0,2.0,1.0,2.0,4.0,1.0,7.0,12.0,9.0,5.0,10.0,6.0,12.0,7.0,15.0,12.0,9.0,6.0,12.0,10.0,12.0,13.0,14.0,11.0,10.0,9.0,9.0,13.0,7.0,6.0,10.0,10.0,14.0,15.0,16.0,13.0,13.0,11.0,5.0,15.0,15.0,20.0,14.0,10.0,12.0,12.0,13.0,7.0,12.0,12.0,14.0,14.0,15.0,13.0,14.0,14.0,7.0,21.0,0.0,0.0,0.0,0.0,183.0,73.0,1.0,4.0,3.0,3.0,3.0,1.0,4.0,1.0,2.0,3.0,2.0,11.0,10.0,12.0,11.0,13.0,9.0,12.0,10.0,5.0,8.0,12.0,9.0,8.0,13.0,13.0,12.0,12.0,10.0,12.0,14.0,12.0,12.0,14.0,8.0,12.0,8.0,12.0,12.0,14.0,14.0,14.0,11.0,8.0,13.0,13.0,20.0,12.0,12.0,12.0,5.0,10.0,7.0,12.0,15.0,11.0,11.0,10.0,11.0,12.0,11.0,4.0,30.0,9.0,1.0,0.0,0.0,192.0,90.0,2.0,2.0,2.0,2.0,3.0,1.0,3.0,4.0,1.0,1.0,3.0,4.0,7.0,10.0,10.0,9.0,8.0,17.0,12.0,6.0,13.0,12.0,8.0,12.0,11.0,13.0,14.0,15.0,13.0,13.0,10.0,12.0,14.0,12.0,13.0,13.0,12.0,14.0,16.0,12.0,12.0,18.0,16.0,8.0,14.0,13.0,20.0,16.0,18.0,13.0,13.0,14.0,7.0,12.0,13.0,13.0,13.0,13.0,13.0,13.0,13.0,6.0,23.0,0.0,0.0,0.0,0.0,175.0,70.0,2.0,1.0,2.0,2.0,1.0,2.0,2.0,3.0,4.0,1.0,2.0,10.0,11.0,12.0,9.0,13.0,8.0,6.0,13.0,2.0,5.0,13.0,10.0,6.0,13.0,7.0,13.0,9.0,13.0,11.0,13.0,12.0,13.0,12.0,10.0,12.0,10.0,13.0,12.0,11.0,12.0,13.0,8.0,8.0,14.0,12.0,20.0,14.0,12.0,13.0,9.0,11.0,10.0,11.0,19.0,12.0,14.0,11.0,13.0,10.0,16.0,7.0,18.0,0.0,0.0,0.0,0.0,188.0,0.0,2.0,2.0,1.0,1.0,1.0,2.0,1.0,4.0,2.0,2.0,1.0,8.0,11.0,14.0,11.0,13.0,10.0,11.0,10.0,2.0,6.0,12.0,11.0,8.0,13.0,8.0,11.0,9.0,13.0,9.0,13.0,11.0,14.0,15.0,8.0,12.0,7.0,11.0,13.0,14.0,12.0,12.0,13.0,12.0,11.0,14.0,20.0,11.0,11.0,12.0,8.0,11.0,8.0,14.0,12.0,11.0,10.0,12.0,13.0,12.0,14.0,7.0,29.0,0.0,0.0,0.0,0.0,180.0,71.0,1.0,3.0,1.0,1.0,1.0,4.0,4.0,1.0,1.0,2.0,3.0,10.0,11.0,12.0,9.0,13.0,11.0,8.0,14.0,6.0,8.0,11.0,10.0,8.0,12.0,10.0,11.0,12.0,12.0,9.0,12.0,11.0,14.0,12.0,7.0,12.0,10.0,12.0,14.0,15.0,14.0,12.0,10.0,20.0,16.0,13.0,12.0,15.0,10.0,13.0,10.0,15.0,7.0,8.0,16.0,12.0,12.0,13.0,14.0,15.0,15.0,6.0,24.0,0.0,0.0,4.0,0.0,181.0,79.0,1.0,3.0,2.0,2.0,1.0,1.0,1.0,2.0,2.0,2.0,1.0,4.0,6.0,10.0,11.0,11.0,7.0,12.0,10.0,5.0,5.0,7.0,13.0,3.0,10.0,9.0,12.0,12.0,11.0,10.0,6.0,10.0,8.0,9.0,5.0,11.0,5.0,9.0,12.0,15.0,13.0,13.0,11.0,5.0,11.0,14.0,20.0,13.0,14.0,11.0,9.0,12.0,13.0,5.0,19.0,11.0,9.0,9.0,7.0,14.0,14.0,13.0,22.0,0.0,0.0,0.0,0.0,186.0,79.0,14.0,13.0,11.0,7.0,12.0,10.0,13.0,14.0,8.0,6.0,8.0,2.0,1.0,3.0,6.0,8.0,5.0,3.0,11.0,3.0,2.0,8.0,8.0,1.0,8.0,8.0,12.0,14.0,12.0,11.0,7.0,11.0,12.0,6.0,9.0,3.0,12.0,12.0,5.0,8.0,12.0,15.0,15.0,20.0,15.0,7.0,5.0,9.0,15.0,14.0,8.0,5.0,5.0,1.0,10.0,12.0,13.0,12.0,8.0,15.0,15.0,5.0,28.0,0.0,0.0,9.0,1.0,187.0,85.0,3.0,3.0,2.0,2.0,3.0,2.0,2.0,1.0,1.0,1.0,2.0,4.0,10.0,7.0,7.0,11.0,8.0,16.0,11.0,13.0,14.0,10.0,6.0,14.0,11.0,14.0,14.0,17.0,11.0,14.0,8.0,13.0,14.0,7.0,12.0,7.0,13.0,16.0,15.0,12.0,12.0,15.0,13.0,8.0,14.0,11.0,20.0,14.0,15.0,15.0,6.0,15.0,8.0,8.0,8.0,15.0,12.0,12.0,13.0,14.0,14.0,5.0,21.0,0.0,0.0,0.0,0.0,182.0,74.0,2.0,2.0,2.0,2.0,2.0,1.0,1.0,1.0,3.0,2.0,2.0,9.0,11.0,12.0,7.0,9.0,8.0,12.0,7.0,11.0,12.0,7.0,8.0,13.0,11.0,12.0,12.0,14.0,12.0,13.0,7.0,12.0,11.0,1.0,9.0,11.0,9.0,10.0,12.0,14.0,10.0,13.0,11.0,9.0,8.0,12.0,20.0,13.0,11.0,10.0,13.0,8.0,10.0,10.0,15.0,11.0,13.0,10.0,10.0,8.0,13.0,7.0,17.0,0.0,0.0,0.0,0.0,173.0,0.0,2.0,1.0,3.0,1.0,2.0,3.0,1.0,3.0,2.0,1.0,2.0,3.0,5.0,7.0,6.0,8.0,2.0,8.0,1.0,8.0,10.0,7.0,4.0,15.0,10.0,9.0,7.0,10.0,7.0,6.0,5.0,8.0,9.0,5.0,12.0,8.0,6.0,9.0,9.0,15.0,15.0,9.0,7.0,20.0,14.0,15.0,5.0,7.0,8.0,9.0,9.0,9.0,9.0,9.0,18.0,8.0,10.0,11.0,11.0,8.0,12.0,4.0,23.0,0.0,0.0,0.0,0.0,182.0,80.0,2.0,3.0,2.0,2.0,2.0,3.0,4.0,4.0,1.0,2.0,1.0,5.0,7.0,12.0,5.0,13.0,6.0,12.0,6.0,6.0,13.0,11.0,6.0,14.0,11.0,13.0,12.0,13.0,14.0,13.0,9.0,10.0,13.0,7.0,10.0,8.0,10.0,13.0,12.0,14.0,12.0,13.0,10.0,5.0,12.0,13.0,20.0,15.0,14.0,14.0,6.0,10.0,9.0,7.0,9.0,12.0,17.0,13.0,14.0,14.0,14.0,5.0,21.0,0.0,0.0,1.0,0.0,177.0,68.0,4.0,1.0,2.0,1.0,1.0,1.0,1.0,1.0,2.0,1.0,2.0,5.0,12.0,9.0,7.0,12.0,8.0,13.0,10.0,16.0,13.0,12.0,8.0,14.0,12.0,12.0,13.0,12.0,12.0,12.0,10.0,13.0,15.0,11.0,13.0,11.0,13.0,13.0,14.0,13.0,14.0,13.0,11.0,10.0,14.0,12.0,20.0,12.0,14.0,12.0,11.0,12.0,8.0,14.0,13.0,10.0,14.0,12.0,14.0,12.0,11.0,5.0,23.0,14.0,1.0,0.0,0.0,180.0,75.0,1.0,3.0,2.0,4.0,1.0,3.0,2.0,2.0,4.0,1.0,2.0,5.0,12.0,12.0,6.0,11.0,7.0,13.0,12.0,6.0,12.0,12.0,6.0,12.0,11.0,13.0,13.0,15.0,11.0,11.0,12.0,9.0,16.0,7.0,12.0,8.0,12.0,14.0,16.0,14.0,13.0,15.0,10.0,8.0,15.0,13.0,20.0,15.0,14.0,14.0,13.0,12.0,7.0,11.0,12.0,13.0,14.0,14.0,14.0,13.0,13.0,6.0,27.0,32.0,6.0,0.0,0.0,188.0,78.0,3.0,2.0,3.0,2.0,1.0,3.0,3.0,3.0,2.0,2.0,2.0,4.0,8.0,11.0,12.0,12.0,6.0,16.0,13.0,8.0,13.0,14.0,7.0,12.0,12.0,12.0,10.0,14.0,13.0,12.0,11.0,12.0,15.0,9.0,11.0,12.0,6.0,13.0,12.0,14.0,13.0,15.0,15.0,5.0,13.0,12.0,20.0,16.0,15.0,14.0,12.0,15.0,11.0,10.0,9.0,15.0,12.0,12.0,13.0,13.0,13.0,7.0,27.0,1.0,0.0,0.0,0.0,179.0,70.0,3.0,2.0,1.0,3.0,3.0,2.0,1.0,3.0,2.0,1.0,1.0,14.0,15.0,15.0,11.0,15.0,14.0,8.0,12.0,5.0,8.0,13.0,12.0,9.0,18.0,11.0,11.0,11.0,9.0,10.0,16.0,10.0,17.0,15.0,8.0,12.0,8.0,12.0,11.0,14.0,13.0,12.0,10.0,12.0,13.0,14.0,20.0,16.0,12.0,10.0,9.0,10.0,7.0,8.0,13.0,15.0,13.0,10.0,11.0,12.0,10.0,8.0,28.0,2.0,1.0,0.0,0.0,174.0,66.0,2.0,2.0,2.0,1.0,1.0,3.0,2.0,3.0,3.0,1.0,4.0,6.0,11.0,13.0,15.0,13.0,11.0,14.0,11.0,6.0,5.0,10.0,12.0,5.0,13.0,8.0,14.0,10.0,13.0,14.0,8.0,12.0,12.0,12.0,5.0,14.0,8.0,12.0,11.0,17.0,15.0,11.0,12.0,7.0,14.0,15.0,20.0,13.0,10.0,12.0,8.0,14.0,8.0,8.0,19.0,15.0,12.0,10.0,11.0,13.0,13.0,12.0,21.0,0.0,0.0,4.0,1.0,184.0,79.0,1.0,2.0,3.0,1.0,2.0,1.0,3.0,2.0,2.0,1.0,3.0,3.0,6.0,10.0,12.0,12.0,7.0,15.0,8.0,4.0,5.0,13.0,10.0,8.0,12.0,18.0,12.0,19.0,13.0,10.0,13.0,12.0,14.0,13.0,10.0,12.0,9.0,16.0,15.0,12.0,14.0,14.0,14.0,12.0,13.0,10.0,20.0,14.0,14.0,11.0,14.0,14.0,11.0,5.0,10.0,13.0,14.0,15.0,10.0,8.0,4.0,15.0
0,0,31.0,22.0,0.0,17.0,0.0,185.0,82.0,12.0,12.0,13.0,6.0,14.0,11.0,15.0,18.0,14.0,10.0,13.0,7.0,3.0,8.0,5.0,9.0,10.0,8.0,12.0,2.0,2.0,9.0,6.0,3.0,10.0,6.0,12.0,15.0,16.0,12.0,8.0,12.0,14.0,8.0,15.0,3.0,13.0,13.0,8.0,13.0,17.0,14.0,13.0,7.0,12.0,11.0,20.0,15.0,14.0,13.0,6.0,16.0,3.0,1.0,8.0,16.0,12.0,13.0,16.0,16.0,16.0,7.0,30.0,32.0,1.0,0.0,0.0,190.0,88.0,1.0,2.0,2.0,2.0,3.0,1.0,1.0,3.0,3.0,2.0,2.0,5.0,7.0,9.0,8.0,10.0,7.0,16.0,11.0,9.0,15.0,13.0,5.0,16.0,12.0,17.0,16.0,17.0,13.0,13.0,11.0,12.0,16.0,7.0,14.0,10.0,14.0,15.0,15.0,14.0,12.0,17.0,16.0,9.0,15.0,14.0,20.0,16.0,18.0,15.0,15.0,14.0,10.0,12.0,14.0,15.0,12.0,14.0,12.0,13.0,11.0,15.0,30.0,19.0,0.0,7.0,0.0,189.0,77.0,3.0,2.0,3.0,2.0,3.0,3.0,1.0,3.0,3.0,1.0,2.0,5.0,8.0,7.0,10.0,10.0,9.0,15.0,9.0,8.0,14.0,12.0,10.0,15.0,10.0,15.0,14.0,13.0,13.0,14.0,10.0,12.0,14.0,10.0,14.0,11.0,12.0,14.0,14.0,8.0,10.0,12.0,16.0,10.0,16.0,10.0,20.0,13.0,16.0,13.0,11.0,13.0,7.0,10.0,6.0,14.0,12.0,13.0,14.0,13.0,13.0,7.0,24.0,0.0,0.0,0.0,0.0,177.0,65.0,1.0,2.0,1.0,2.0,1.0,2.0,1.0,1.0,1.0,2.0,3.0,8.0,11.0,13.0,10.0,13.0,8.0,10.0,11.0,7.0,5.0,12.0,13.0,6.0,13.0,8.0,11.0,9.0,10.0,9.0,9.0,11.0,13.0,12.0,5.0,12.0,8.0,7.0,9.0,16.0,15.0,12.0,8.0,10.0,15.0,15.0,20.0,14.0,12.0,11.0,8.0,13.0,7.0,12.0,20.0,14.0,13.0,12.0,9.0,12.0,11.0,10.0,26.0,27.0,0.0,0.0,0.0,183.0,70.0,1.0,3.0,1.0,3.0,4.0,1.0,3.0,3.0,2.0,1.0,3.0,9.0,14.0,12.0,8.0,10.0,8.0,12.0,13.0,14.0,9.0,12.0,7.0,13.0,11.0,14.0,9.0,15.0,10.0,12.0,9.0,10.0,16.0,10.0,9.0,12.0,8.0,12.0,17.0,14.0,11.0,13.0,12.0,10.0,16.0,16.0,20.0,16.0,13.0,13.0,10.0,14.0,6.0,15.0,10.0,15.0,14.0,10.0,16.0,13.0,13.0,4.0,28.0,41.0,2.0,0.0,0.0,187.0,80.0,3.0,2.0,3.0,2.0,1.0,1.0,2.0,3.0,1.0,4.0,2.0,7.0,10.0,11.0,7.0,12.0,7.0,10.0,12.0,13.0,15.0,13.0,8.0,18.0,12.0,18.0,13.0,17.0,12.0,14.0,10.0,12.0,17.0,7.0,13.0,9.0,14.0,17.0,18.0,14.0,13.0,16.0,14.0,20.0,18.0,13.0,12.0,18.0,14.0,15.0,16.0,15.0,6.0,15.0,14.0,13.0,10.0,14.0,12.0,8.0,7.0,8.0,18.0,0.0,0.0,0.0,0.0,167.0,60.0,2.0,1.0,2.0,2.0,2.0,1.0,2.0,1.0,1.0,1.0,1.0,10.0,11.0,12.0,8.0,13.0,10.0,3.0,10.0,5.0,6.0,13.0,12.0,8.0,15.0,8.0,11.0,8.0,12.0,11.0,13.0,12.0,13.0,12.0,6.0,11.0,11.0,12.0,13.0,15.0,14.0,8.0,5.0,8.0,15.0,12.0,20.0,12.0,7.0,8.0,8.0,14.0,7.0,8.0,18.0,11.0,12.0,11.0,12.0,15.0,15.0,7.0,21.0,0.0,0.0,0.0,0.0,187.0,84.0,4.0,2.0,1.0,2.0,3.0,1.0,2.0,3.0,1.0,1.0,2.0,11.0,13.0,15.0,12.0,14.0,11.0,13.0,14.0,4.0,5.0,12.0,14.0,5.0,16.0,12.0,12.0,14.0,12.0,10.0,10.0,9.0,14.0,17.0,10.0,12.0,7.0,10.0,14.0,14.0,16.0,14.0,15.0,9.0,13.0,14.0,20.0,14.0,14.0,14.0,8.0,15.0,5.0,14.0,11.0,16.0,13.0,14.0,13.0,15.0,15.0,6.0,23.0,0.0,0.0,10.0,7.0,179.0,70.0,1.0,1.0,2.0,2.0,1.0,3.0,3.0,2.0,1.0,4.0,3.0,10.0,13.0,14.0,12.0,15.0,11.0,10.0,13.0,6.0,3.0,13.0,12.0,4.0,16.0,11.0,12.0,11.0,13.0,11.0,13.0,12.0,12.0,16.0,6.0,14.0,6.0,10.0,12.0,16.0,14.0,12.0,9.0,20.0,13.0,14.0,10.0,13.0,10.0,12.0,7.0,12.0,6.0,8.0,12.0,13.0,5.0,10.0,8.0,14.0,12.0,8.0,29.0,26.0,6.0,12.0,4.0,175.0,77.0,1.0,2.0,1.0,3.0,3.0,2.0,1.0,2.0,1.0,2.0,2.0,16.0,14.0,16.0,15.0,15.0,18.0,6.0,15.0,6.0,6.0,18.0,11.0,5.0,17.0,9.0,12.0,10.0,16.0,12.0,16.0,14.0,14.0,16.0,6.0,16.0,6.0,10.0,10.0,13.0,15.0,14.0,8.0,15.0,15.0,14.0,20.0,13.0,12.0,11.0,9.0,16.0,7.0,8.0,8.0,11.0,8.0,13.0,12.0,13.0,11.0,10.0,26.0,0.0,0.0,4.0,0.0,180.0,73.0,2.0,3.0,1.0,4.0,2.0,3.0,3.0,1.0,1.0,4.0,1.0,11.0,13.0,13.0,14.0,14.0,11.0,15.0,12.0,3.0,7.0,14.0,14.0,8.0,13.0,12.0,14.0,17.0,13.0,15.0,14.0,14.0,16.0,12.0,15.0,16.0,12.0,18.0,16.0,13.0,14.0,13.0,12.0,8.0,14.0,13.0,20.0,15.0,12.0,15.0,8.0,14.0,7.0,15.0,19.0,14.0,17.0,14.0,18.0,16.0,16.0,5.0,24.0,0.0,0.0,0.0,0.0,197.0,86.0,15.0,9.0,12.0,14.0,13.0,12.0,10.0,13.0,11.0,7.0,8.0,2.0,3.0,3.0,3.0,8.0,7.0,1.0,3.0,1.0,2.0,12.0,2.0,2.0,8.0,10.0,12.0,10.0,14.0,12.0,10.0,10.0,10.0,3.0,8.0,1.0,11.0,10.0,6.0,12.0,13.0,10.0,16.0,5.0,13.0,11.0,20.0,9.0,10.0,10.0,10.0,10.0,7.0,10.0,9.0,11.0,11.0,9.0,12.0,13.0,10.0,8.0,28.0,0.0,0.0,0.0,0.0,190.0,83.0,1.0,1.0,3.0,2.0,1.0,1.0,3.0,3.0,1.0,2.0,1.0,2.0,9.0,5.0,6.0,10.0,5.0,13.0,7.0,4.0,12.0,9.0,7.0,10.0,11.0,13.0,14.0,15.0,13.0,11.0,8.0,11.0,13.0,8.0,12.0,7.0,12.0,12.0,12.0,11.0,11.0,15.0,15.0,20.0,15.0,11.0,5.0,13.0,16.0,15.0,13.0,11.0,7.0,5.0,12.0,12.0,14.0,12.0,15.0,13.0,12.0,6.0,21.0,0.0,0.0,0.0,0.0,193.0,79.0,3.0,3.0,4.0,4.0,2.0,3.0,1.0,1.0,3.0,2.0,3.0,8.0,8.0,8.0,8.0,12.0,11.0,14.0,11.0,12.0,15.0,14.0,6.0,13.0,10.0,12.0,11.0,12.0,12.0,14.0,11.0,10.0,15.0,12.0,12.0,12.0,13.0,14.0,12.0,12.0,12.0,14.0,16.0,9.0,8.0,12.0,20.0,12.0,14.0,13.0,9.0,11.0,16.0,12.0,12.0,14.0,11.0,14.0,12.0,11.0,10.0,5.0,20.0,0.0,0.0,0.0,0.0,176.0,71.0,3.0,3.0,1.0,3.0,1.0,2.0,3.0,2.0,3.0,2.0,2.0,12.0,14.0,12.0,9.0,11.0,10.0,7.0,10.0,12.0,11.0,12.0,9.0,12.0,12.0,9.0,12.0,10.0,10.0,9.0,10.0,12.0,11.0,14.0,8.0,13.0,12.0,10.0,11.0,16.0,15.0,10.0,8.0,20.0,10.0,16.0,5.0,15.0,11.0,10.0,9.0,9.0,8.0,10.0,9.0,11.0,11.0,11.0,12.0,10.0,17.0,1.0,21.0,0.0,0.0,9.0,0.0,178.0,77.0,4.0,3.0,1.0,1.0,1.0,2.0,2.0,3.0,3.0,3.0,1.0,11.0,13.0,11.0,8.0,12.0,9.0,8.0,9.0,8.0,12.0,10.0,8.0,12.0,12.0,8.0,10.0,14.0,11.0,14.0,12.0,12.0,14.0,12.0,8.0,10.0,8.0,15.0,14.0,15.0,12.0,12.0,8.0,7.0,5.0,14.0,20.0,14.0,10.0,12.0,5.0,10.0,11.0,8.0,15.0,10.0,10.0,12.0,9.0,10.0,12.0,5.0,32.0,55.0,0.0,0.0,0.0,180.0,74.0,1.0,3.0,3.0,2.0,1.0,2.0,2.0,1.0,3.0,3.0,1.0,6.0,8.0,8.0,6.0,11.0,10.0,12.0,10.0,6.0,13.0,11.0,7.0,15.0,11.0,14.0,14.0,17.0,12.0,14.0,10.0,13.0,16.0,8.0,12.0,8.0,14.0,16.0,18.0,12.0,13.0,13.0,10.0,8.0,16.0,14.0,20.0,18.0,13.0,16.0,15.0,14.0,5.0,10.0,9.0,15.0,13.0,15.0,14.0,11.0,10.0,7.0,25.0,0.0,0.0,0.0,0.0,177.0,66.0,2.0,3.0,1.0,3.0,2.0,3.0,4.0,1.0,4.0,3.0,1.0,11.0,11.0,11.0,7.0,13.0,11.0,8.0,10.0,7.0,4.0,12.0,11.0,6.0,12.0,8.0,12.0,11.0,12.0,12.0,12.0,9.0,13.0,11.0,7.0,11.0,9.0,14.0,13.0,11.0,13.0,12.0,9.0,20.0,14.0,10.0,8.0,16.0,9.0,13.0,8.0,2.0,6.0,10.0,9.0,11.0,15.0,12.0,14.0,14.0,14.0,6.0,19.0,0.0,0.0,0.0,0.0,186.0,64.0,3.0,4.0,3.0,2.0,1.0,3.0,2.0,1.0,3.0,3.0,1.0,7.0,14.0,14.0,10.0,13.0,7.0,7.0,12.0,2.0,9.0,13.0,8.0,9.0,15.0,9.0,11.0,11.0,13.0,11.0,12.0,9.0,13.0,15.0,4.0,13.0,7.0,11.0,11.0,15.0,13.0,12.0,10.0,20.0,9.0,15.0,9.0,11.0,13.0,11.0,3.0,11.0,7.0,13.0,14.0,14.0,13.0,10.0,13.0,12.0,12.0,2.0,19.0,0.0,0.0,0.0,0.0,175.0,60.0,4.0,2.0,2.0,1.0,1.0,2.0,3.0,2.0,3.0,3.0,1.0,10.0,11.0,15.0,12.0,14.0,6.0,4.0,13.0,10.0,10.0,12.0,9.0,11.0,14.0,8.0,10.0,10.0,14.0,11.0,12.0,15.0,4.0,11.0,7.0,8.0,10.0,11.0,12.0,12.0,12.0,11.0,8.0,5.0,9.0,10.0,20.0,9.0,8.0,10.0,10.0,7.0,10.0,10.0,14.0,12.0,10.0,11.0,14.0,10.0,11.0,2.0,21.0,2.0,1.0,0.0,0.0,173.0,68.0,4.0,1.0,1.0,3.0,1.0,3.0,1.0,1.0,1.0,1.0,1.0,8.0,12.0,11.0,11.0,12.0,8.0,5.0,6.0,4.0,5.0,12.0,9.0,7.0,12.0,13.0,10.0,10.0,9.0,13.0,13.0,11.0,10.0,13.0,6.0,12.0,8.0,10.0,13.0,14.0,14.0,14.0,7.0,13.0,12.0,13.0,20.0,11.0,7.0,13.0,6.0,12.0,6.0,9.0,11.0,12.0,9.0,7.0,10.0,11.0,13.0,7.0,28.0,0.0,0.0,0.0,0.0,185.0,80.0,3.0,4.0,2.0,1.0,3.0,3.0,4.0,1.0,3.0,2.0,2.0,10.0,12.0,13.0,12.0,14.0,11.0,13.0,10.0,4.0,6.0,13.0,10.0,4.0,13.0,15.0,12.0,16.0,10.0,10.0,12.0,12.0,14.0,12.0,5.0,13.0,8.0,11.0,14.0,13.0,13.0,14.0,12.0,8.0,13.0,14.0,20.0,11.0,13.0,13.0,11.0,13.0,7.0,10.0,12.0,14.0,12.0,12.0,11.0,13.0,13.0,7.0
2,1,24.0,0.0,0.0,0.0,0.0,185.0,75.0,12.0,11.0,13.0,9.0,11.0,9.0,10.0,12.0,10.0,15.0,10.0,7.0,1.0,1.0,3.0,7.0,9.0,1.0,1.0,3.0,2.0,1.0,3.0,3.0,7.0,4.0,11.0,15.0,5.0,5.0,7.0,8.0,8.0,1.0,5.0,3.0,8.0,12.0,12.0,14.0,11.0,12.0,12.0,5.0,13.0,11.0,20.0,7.0,11.0,7.0,6.0,5.0,9.0,9.0,7.0,12.0,13.0,13.0,14.0,11.0,19.0,2.0,28.0,0.0,0.0,0.0,0.0,184.0,85.0,2.0,3.0,2.0,1.0,1.0,3.0,2.0,2.0,3.0,1.0,3.0,4.0,8.0,8.0,6.0,12.0,6.0,14.0,8.0,5.0,13.0,12.0,6.0,14.0,12.0,11.0,13.0,14.0,13.0,12.0,11.0,11.0,13.0,7.0,14.0,10.0,15.0,16.0,12.0,12.0,11.0,15.0,12.0,20.0,13.0,11.0,7.0,14.0,16.0,13.0,11.0,13.0,13.0,12.0,15.0,13.0,13.0,14.0,15.0,14.0,14.0,6.0,25.0,0.0,0.0,0.0,0.0,191.0,81.0,1.0,1.0,3.0,2.0,3.0,2.0,3.0,4.0,2.0,1.0,2.0,4.0,3.0,10.0,8.0,6.0,6.0,11.0,6.0,10.0,11.0,10.0,5.0,12.0,7.0,16.0,13.0,16.0,11.0,13.0,7.0,10.0,14.0,5.0,12.0,10.0,13.0,13.0,12.0,13.0,13.0,16.0,16.0,7.0,16.0,14.0,20.0,14.0,14.0,13.0,13.0,15.0,6.0,12.0,13.0,6.0,14.0,8.0,8.0,13.0,7.0,4.0,24.0,2.0,0.0,0.0,0.0,188.0,83.0,2.0,2.0,2.0,1.0,3.0,2.0,3.0,3.0,1.0,2.0,1.0,11.0,12.0,11.0,6.0,12.0,11.0,11.0,9.0,13.0,11.0,11.0,10.0,12.0,12.0,13.0,13.0,12.0,12.0,9.0,11.0,11.0,2.0,12.0,11.0,12.0,8.0,12.0,12.0,11.0,10.0,13.0,13.0,20.0,12.0,12.0,4.0,12.0,13.0,12.0,9.0,5.0,7.0,11.0,8.0,10.0,14.0,12.0,12.0,1.0,18.0,8.0,19.0,0.0,0.0,0.0,0.0,175.0,70.0,1.0,3.0,3.0,1.0,1.0,3.0,1.0,1.0,2.0,2.0,2.0,6.0,10.0,6.0,7.0,10.0,2.0,10.0,6.0,9.0,10.0,11.0,2.0,15.0,9.0,9.0,12.0,9.0,10.0,8.0,10.0,13.0,2.0,9.0,1.0,9.0,9.0,10.0,11.0,14.0,12.0,7.0,7.0,4.0,13.0,13.0,20.0,9.0,8.0,9.0,9.0,8.0,9.0,14.0,12.0,7.0,9.0,9.0,9.0,10.0,19.0,3.0,23.0,2.0,0.0,5.0,0.0,180.0,77.0,3.0,2.0,2.0,3.0,2.0,3.0,2.0,2.0,3.0,3.0,4.0,14.0,12.0,12.0,10.0,13.0,14.0,6.0,14.0,8.0,8.0,13.0,12.0,9.0,14.0,13.0,12.0,12.0,11.0,10.0,12.0,13.0,13.0,10.0,6.0,13.0,10.0,12.0,14.0,13.0,14.0,13.0,10.0,8.0,13.0,14.0,20.0,14.0,14.0,9.0,8.0,14.0,6.0,16.0,13.0,12.0,13.0,12.0,13.0,13.0,14.0,6.0,26.0,0.0,0.0,0.0,0.0,175.0,70.0,2.0,1.0,1.0,2.0,2.0,2.0,3.0,2.0,2.0,1.0,1.0,13.0,12.0,11.0,8.0,14.0,11.0,7.0,11.0,6.0,5.0,14.0,11.0,6.0,15.0,11.0,12.0,12.0,15.0,10.0,13.0,12.0,14.0,13.0,7.0,12.0,12.0,16.0,12.0,12.0,14.0,12.0,8.0,8.0,11.0,13.0,20.0,11.0,9.0,8.0,8.0,12.0,15.0,14.0,12.0,13.0,11.0,13.0,12.0,15.0,15.0,7.0,30.0,0.0,0.0,0.0,0.0,162.0,65.0,1.0,1.0,1.0,1.0,3.0,3.0,3.0,4.0,2.0,2.0,1.0,13.0,12.0,14.0,10.0,14.0,15.0,5.0,12.0,6.0,4.0,11.0,12.0,3.0,15.0,11.0,12.0,8.0,10.0,13.0,13.0,12.0,17.0,15.0,9.0,13.0,7.0,11.0,14.0,15.0,14.0,7.0,3.0,14.0,11.0,13.0,20.0,11.0,7.0,13.0,11.0,15.0,11.0,8.0,10.0,14.0,13.0,14.0,14.0,13.0,10.0,6.0,23.0,0.0,0.0,0.0,0.0,173.0,75.0,3.0,2.0,1.0,3.0,1.0,4.0,2.0,1.0,4.0,2.0,1.0,11.0,10.0,16.0,9.0,15.0,14.0,7.0,10.0,6.0,8.0,14.0,12.0,5.0,15.0,8.0,10.0,8.0,15.0,10.0,14.0,15.0,12.0,13.0,9.0,14.0,5.0,7.0,10.0,14.0,14.0,12.0,8.0,15.0,13.0,12.0,20.0,9.0,8.0,12.0,8.0,11.0,6.0,14.0,14.0,15.0,15.0,10.0,18.0,15.0,10.0,5.0,24.0,0.0,0.0,5.0,0.0,183.0,79.0,4.0,4.0,3.0,3.0,1.0,3.0,2.0,1.0,3.0,2.0,3.0,4.0,7.0,12.0,13.0,12.0,8.0,13.0,12.0,5.0,6.0,11.0,12.0,4.0,13.0,11.0,12.0,14.0,9.0,12.0,10.0,10.0,13.0,12.0,6.0,14.0,12.0,13.0,14.0,15.0,14.0,14.0,11.0,10.0,13.0,14.0,20.0,14.0,14.0,12.0,12.0,14.0,9.0,5.0,7.0,13.0,15.0,11.0,14.0,14.0,14.0,6.0,27.0,11.0,1.0,0.0,0.0,187.0,86.0,3.0,1.0,2.0,2.0,4.0,3.0,2.0,1.0,1.0,3.0,1.0,3.0,9.0,13.0,15.0,12.0,10.0,17.0,11.0,5.0,5.0,9.0,14.0,4.0,11.0,9.0,12.0,13.0,12.0,11.0,9.0,10.0,13.0,11.0,10.0,13.0,10.0,15.0,15.0,14.0,12.0,15.0,13.0,7.0,15.0,13.0,20.0,13.0,15.0,14.0,9.0,13.0,7.0,5.0,15.0,13.0,13.0,11.0,10.0,12.0,18.0,6.0,26.0,2.0,0.0,1.0,0.0,188.0,84.0,12.0,13.0,15.0,9.0,15.0,13.0,13.0,15.0,10.0,11.0,14.0,9.0,2.0,1.0,2.0,12.0,11.0,3.0,2.0,3.0,3.0,11.0,3.0,1.0,10.0,14.0,13.0,14.0,10.0,13.0,11.0,11.0,14.0,3.0,11.0,5.0,12.0,15.0,13.0,10.0,12.0,13.0,14.0,5.0,14.0,9.0,20.0,12.0,14.0,12.0,10.0,15.0,3.0,11.0,12.0,11.0,16.0,13.0,15.0,16.0,16.0,4.0,19.0,1.0,0.0,0.0,0.0,182.0,67.0,1.0,3.0,2.0,1.0,2.0,3.0,1.0,1.0,2.0,1.0,1.0,7.0,7.0,8.0,4.0,10.0,7.0,9.0,9.0,7.0,14.0,9.0,7.0,13.0,9.0,9.0,10.0,8.0,9.0,8.0,9.0,14.0,2.0,7.0,12.0,7.0,8.0,8.0,12.0,12.0,10.0,9.0,11.0,5.0,13.0,8.0,20.0,11.0,8.0,9.0,5.0,4.0,9.0,9.0,10.0,12.0,13.0,9.0,10.0,13.0,12.0,3.0,29.0,0.0,0.0,0.0,0.0,183.0,74.0,3.0,3.0,3.0,3.0,3.0,2.0,2.0,2.0,1.0,3.0,1.0,5.0,12.0,7.0,6.0,10.0,7.0,14.0,12.0,5.0,14.0,12.0,6.0,13.0,11.0,14.0,13.0,17.0,13.0,16.0,12.0,12.0,13.0,9.0,8.0,9.0,14.0,14.0,15.0,13.0,12.0,15.0,12.0,6.0,17.0,11.0,20.0,17.0,13.0,14.0,14.0,15.0,5.0,13.0,9.0,14.0,19.0,15.0,14.0,11.0,11.0,6.0,32.0,0.0,0.0,0.0,0.0,183.0,79.0,1.0,1.0,1.0,3.0,1.0,3.0,1.0,1.0,2.0,1.0,1.0,5.0,10.0,6.0,6.0,9.0,6.0,15.0,7.0,11.0,14.0,10.0,7.0,13.0,10.0,13.0,15.0,15.0,15.0,14.0,9.0,13.0,16.0,6.0,14.0,8.0,12.0,13.0,16.0,11.0,12.0,16.0,11.0,8.0,16.0,12.0,20.0,15.0,14.0,14.0,11.0,12.0,5.0,15.0,18.0,15.0,14.0,13.0,17.0,14.0,14.0,5.0,21.0,0.0,0.0,0.0,0.0,172.0,68.0,3.0,3.0,1.0,2.0,1.0,2.0,3.0,2.0,2.0,3.0,2.0,12.0,13.0,12.0,8.0,12.0,12.0,5.0,8.0,12.0,11.0,13.0,8.0,13.0,12.0,14.0,13.0,14.0,13.0,13.0,10.0,11.0,15.0,9.0,13.0,13.0,12.0,13.0,14.0,12.0,12.0,12.0,6.0,20.0,13.0,13.0,13.0,13.0,11.0,12.0,10.0,10.0,11.0,9.0,20.0,13.0,15.0,12.0,16.0,13.0,13.0,8.0,32.0,0.0,0.0,13.0,0.0,175.0,65.0,2.0,1.0,1.0,2.0,3.0,3.0,1.0,2.0,3.0,2.0,3.0,15.0,13.0,11.0,6.0,14.0,13.0,10.0,12.0,8.0,8.0,16.0,8.0,12.0,13.0,11.0,14.0,15.0,14.0,15.0,14.0,14.0,14.0,6.0,13.0,9.0,15.0,18.0,13.0,12.0,13.0,13.0,8.0,8.0,13.0,10.0,20.0,13.0,13.0,12.0,11.0,15.0,12.0,10.0,17.0,14.0,15.0,14.0,16.0,14.0,14.0,6.0,25.0,0.0,0.0,3.0,2.0,170.0,61.0,2.0,3.0,2.0,2.0,1.0,3.0,2.0,2.0,1.0,2.0,1.0,11.0,12.0,13.0,10.0,13.0,8.0,5.0,8.0,7.0,4.0,14.0,10.0,4.0,15.0,11.0,10.0,9.0,7.0,10.0,14.0,8.0,13.0,13.0,6.0,12.0,8.0,8.0,12.0,16.0,14.0,7.0,5.0,12.0,15.0,16.0,20.0,14.0,6.0,12.0,11.0,13.0,8.0,8.0,8.0,13.0,15.0,10.0,10.0,14.0,14.0,8.0,18.0,0.0,0.0,0.0,0.0,179.0,67.0,3.0,3.0,2.0,4.0,2.0,4.0,3.0,1.0,3.0,4.0,1.0,5.0,7.0,12.0,9.0,12.0,12.0,10.0,12.0,6.0,4.0,12.0,12.0,3.0,14.0,11.0,12.0,11.0,11.0,8.0,13.0,12.0,12.0,12.0,6.0,12.0,5.0,10.0,12.0,15.0,11.0,12.0,10.0,20.0,13.0,14.0,8.0,14.0,8.0,9.0,6.0,14.0,5.0,10.0,16.0,13.0,12.0,12.0,13.0,9.0,15.0,2.0,20.0,0.0,0.0,2.0,0.0,180.0,75.0,3.0,1.0,2.0,2.0,3.0,2.0,1.0,1.0,3.0,3.0,1.0,8.0,13.0,14.0,9.0,13.0,8.0,10.0,9.0,6.0,5.0,12.0,6.0,5.0,14.0,8.0,13.0,12.0,13.0,12.0,12.0,12.0,7.0,13.0,8.0,14.0,7.0,12.0,13.0,15.0,13.0,14.0,10.0,8.0,14.0,15.0,20.0,13.0,12.0,13.0,11.0,9.0,7.0,13.0,9.0,11.0,11.0,11.0,12.0,11.0,10.0,1.0,26.0,0.0,0.0,0.0,0.0,193.0,81.0,1.0,3.0,3.0,3.0,3.0,1.0,2.0,2.0,2.0,3.0,3.0,4.0,9.0,14.0,10.0,13.0,12.0,14.0,14.0,5.0,5.0,10.0,12.0,3.0,14.0,8.0,13.0,12.0,9.0,10.0,11.0,11.0,12.0,16.0,5.0,14.0,6.0,9.0,12.0,14.0,13.0,14.0,16.0,14.0,13.0,13.0,20.0,13.0,14.0,10.0,8.0,14.0,9.0,8.0,16.0,16.0,11.0,13.0,11.0,13.0,13.0,10.0,18.0,0.0,0.0,0.0,0.0,188.0,80.0,1.0,3.0,1.0,3.0,2.0,3.0,3.0,1.0,2.0,2.0,4.0,6.0,8.0,12.0,11.0,12.0,7.0,13.0,10.0,4.0,4.0,8.0,10.0,5.0,12.0,11.0,11.0,13.0,10.0,11.0,11.0,12.0,11.0,13.0,7.0,13.0,8.0,13.0,13.0,11.0,12.0,12.0,12.0,10.0,12.0,11.0,20.0,10.0,12.0,12.0,8.0,11.0,7.0,13.0,8.0,13.0,13.0,11.0,12.0,12.0,13.0,7.0
2,2,24.0,0.0,0.0,3.0,0.0,191.0,75.0,11.0,12.0,12.0,11.0,12.0,14.0,15.0,16.0,11.0,13.0,13.0,2.0,3.0,3.0,1.0,11.0,2.0,9.0,3.0,2.0,2.0,11.0,1.0,3.0,10.0,9.0,13.0,14.0,13.0,14.0,8.0,11.0,15.0,1.0,10.0,1.0,12.0,12.0,10.0,12.0,12.0,11.0,15.0,8.0,11.0,13.0,20.0,14.0,12.0,14.0,11.0,11.0,11.0,11.0,12.0,15.0,14.0,12.0,12.0,10.0,11.0,7.0,27.0,1.0,0.0,3.0,0.0,186.0,83.0,2.0,2.0,2.0,2.0,1.0,4.0,2.0,3.0,3.0,3.0,2.0,5.0,9.0,9.0,8.0,10.0,6.0,16.0,8.0,7.0,14.0,11.0,6.0,15.0,12.0,14.0,15.0,16.0,13.0,12.0,8.0,13.0,14.0,8.0,11.0,8.0,14.0,15.0,15.0,15.0,9.0,15.0,12.0,8.0,13.0,14.0,20.0,14.0,17.0,15.0,13.0,13.0,10.0,8.0,9.0,14.0,9.0,13.0,15.0,15.0,15.0,6.0,26.0,8.0,0.0,0.0,0.0,189.0,84.0,3.0,2.0,1.0,1.0,3.0,2.0,3.0,1.0,2.0,1.0,1.0,5.0,8.0,9.0,6.0,10.0,5.0,13.0,6.0,11.0,14.0,9.0,9.0,14.0,12.0,14.0,13.0,17.0,14.0,12.0,8.0,10.0,15.0,8.0,11.0,7.0,14.0,15.0,15.0,10.0,9.0,14.0,15.0,20.0,15.0,12.0,9.0,14.0,16.0,12.0,14.0,10.0,7.0,8.0,15.0,17.0,7.0,13.0,14.0,8.0,10.0,10.0,16.0,0.0,0.0,0.0,0.0,177.0,0.0,3.0,2.0,1.0,1.0,3.0,3.0,2.0,2.0,2.0,1.0,3.0,1.0,3.0,2.0,2.0,4.0,1.0,3.0,1.0,6.0,9.0,2.0,1.0,9.0,6.0,14.0,4.0,5.0,5.0,3.0,2.0,5.0,4.0,5.0,7.0,4.0,8.0,4.0,3.0,10.0,7.0,13.0,7.0,15.0,13.0,9.0,20.0,5.0,8.0,7.0,11.0,5.0,8.0,8.0,11.0,11.0,5.0,14.0,20.0,7.0,12.0,5.0,19.0,0.0,0.0,0.0,0.0,184.0,70.0,3.0,2.0,2.0,2.0,3.0,2.0,2.0,1.0,3.0,3.0,3.0,4.0,7.0,4.0,6.0,13.0,7.0,7.0,7.0,1.0,7.0,10.0,3.0,9.0,10.0,9.0,7.0,6.0,9.0,8.0,14.0,7.0,12.0,9.0,10.0,8.0,7.0,8.0,10.0,14.0,10.0,8.0,10.0,12.0,9.0,11.0,20.0,9.0,7.0,9.0,9.0,7.0,9.0,9.0,10.0,12.0,13.0,14.0,11.0,11.0,12.0,7.0,24.0,0.0,0.0,0.0,0.0,178.0,77.0,2.0,1.0,3.0,2.0,1.0,3.0,3.0,3.0,1.0,3.0,2.0,5.0,10.0,8.0,5.0,9.0,6.0,11.0,8.0,12.0,11.0,8.0,6.0,12.0,9.0,11.0,11.0,13.0,11.0,12.0,7.0,11.0,15.0,9.0,6.0,9.0,11.0,12.0,14.0,16.0,12.0,14.0,10.0,5.0,15.0,15.0,20.0,14.0,13.0,14.0,11.0,13.0,5.0,8.0,17.0,12.0,14.0,14.0,14.0,14.0,14.0,6.0,26.0,0.0,0.0,0.0,0.0,184.0,76.0,2.0,3.0,1.0,3.0,1.0,1.0,3.0,1.0,3.0,2.0,2.0,10.0,12.0,14.0,12.0,14.0,12.0,11.0,13.0,11.0,13.0,14.0,13.0,12.0,15.0,14.0,13.0,12.0,11.0,11.0,13.0,14.0,14.0,12.0,13.0,12.0,11.0,11.0,14.0,15.0,14.0,13.0,10.0,5.0,14.0,14.0,20.0,14.0,14.0,14.0,7.0,16.0,6.0,8.0,19.0,14.0,14.0,14.0,14.0,14.0,14.0,6.0,18.0,0.0,0.0,0.0,0.0,193.0,88.0,3.0,2.0,1.0,2.0,2.0,2.0,1.0,1.0,1.0,2.0,2.0,5.0,7.0,5.0,7.0,14.0,9.0,9.0,12.0,6.0,8.0,14.0,3.0,11.0,10.0,10.0,11.0,10.0,5.0,11.0,8.0,11.0,6.0,6.0,8.0,9.0,12.0,10.0,14.0,13.0,10.0,13.0,16.0,5.0,15.0,12.0,20.0,13.0,13.0,10.0,10.0,10.0,10.0,10.0,20.0,9.0,11.0,11.0,11.0,13.0,15.0,8.0,29.0,0.0,0.0,0.0,0.0,180.0,74.0,2.0,1.0,3.0,3.0,2.0,4.0,1.0,3.0,3.0,2.0,2.0,9.0,13.0,13.0,10.0,14.0,10.0,12.0,12.0,6.0,8.0,12.0,8.0,8.0,14.0,10.0,13.0,14.0,13.0,12.0,13.0,11.0,13.0,11.0,7.0,10.0,10.0,14.0,14.0,14.0,13.0,13.0,12.0,10.0,14.0,13.0,20.0,14.0,11.0,14.0,10.0,15.0,8.0,10.0,8.0,12.0,14.0,16.0,14.0,15.0,15.0,6.0,22.0,0.0,0.0,0.0,0.0,177.0,72.0,2.0,1.0,2.0,4.0,2.0,2.0,1.0,3.0,4.0,2.0,3.0,10.0,12.0,13.0,11.0,12.0,10.0,12.0,12.0,4.0,10.0,13.0,11.0,11.0,13.0,11.0,12.0,11.0,13.0,9.0,13.0,12.0,3.0,12.0,8.0,14.0,12.0,12.0,13.0,16.0,13.0,12.0,9.0,8.0,15.0,14.0,20.0,14.0,13.0,10.0,4.0,11.0,11.0,12.0,19.0,9.0,12.0,13.0,12.0,11.0,14.0,7.0,20.0,0.0,0.0,0.0,0.0,182.0,78.0,2.0,3.0,2.0,2.0,1.0,1.0,2.0,4.0,2.0,1.0,2.0,9.0,5.0,10.0,9.0,11.0,9.0,10.0,10.0,4.0,5.0,9.0,7.0,6.0,11.0,13.0,10.0,14.0,10.0,10.0,7.0,13.0,10.0,9.0,10.0,11.0,6.0,10.0,15.0,12.0,12.0,14.0,10.0,6.0,15.0,13.0,20.0,10.0,13.0,9.0,9.0,1.0,9.0,9.0,14.0,12.0,13.0,11.0,14.0,13.0,14.0,5.0,22.0,0.0,0.0,0.0,0.0,186.0,79.0,14.0,13.0,11.0,7.0,12.0,10.0,13.0,14.0,8.0,6.0,8.0,2.0,1.0,3.0,6.0,8.0,5.0,3.0,11.0,3.0,2.0,8.0,8.0,1.0,8.0,8.0,12.0,14.0,12.0,11.0,7.0,11.0,12.0,6.0,9.0,3.0,12.0,12.0,5.0,8.0,12.0,15.0,15.0,20.0,15.0,7.0,5.0,9.0,15.0,14.0,8.0,5.0,5.0,1.0,10.0,12.0,13.0,12.0,8.0,15.0,15.0,5.0,28.0,0.0,0.0,9.0,1.0,187.0,85.0,3.0,3.0,2.0,2.0,3.0,2.0,2.0,1.0,1.0,1.0,2.0,4.0,10.0,7.0,7.0,11.0,8.0,16.0,11.0,13.0,14.0,10.0,6.0,14.0,11.0,14.0,14.0,17.0,11.0,14.0,8.0,13.0,14.0,7.0,12.0,7.0,13.0,16.0,15.0,12.0,12.0,15.0,13.0,8.0,14.0,11.0,20.0,14.0,15.0,15.0,6.0,15.0,8.0,8.0,8.0,15.0,12.0,12.0,13.0,14.0,14.0,5.0,23.0,0.0,0.0,0.0,0.0,182.0,80.0,2.0,3.0,2.0,2.0,2.0,3.0,4.0,4.0,1.0,2.0,1.0,5.0,7.0,12.0,5.0,13.0,6.0,12.0,6.0,6.0,13.0,11.0,6.0,14.0,11.0,13.0,12.0,13.0,14.0,13.0,9.0,10.0,13.0,7.0,10.0,8.0,10.0,13.0,12.0,14.0,12.0,13.0,10.0,5.0,12.0,13.0,20.0,15.0,14.0,14.0,6.0,10.0,9.0,7.0,9.0,12.0,17.0,13.0,14.0,14.0,14.0,5.0,21.0,0.0,0.0,1.0,0.0,177.0,68.0,4.0,1.0,2.0,1.0,1.0,1.0,1.0,1.0,2.0,1.0,2.0,5.0,12.0,9.0,7.0,12.0,8.0,13.0,10.0,16.0,13.0,12.0,8.0,14.0,12.0,12.0,13.0,12.0,12.0,12.0,10.0,13.0,15.0,11.0,13.0,11.0,13.0,13.0,14.0,13.0,14.0,13.0,11.0,10.0,14.0,12.0,20.0,12.0,14.0,12.0,11.0,12.0,8.0,14.0,13.0,10.0,14.0,12.0,14.0,12.0,11.0,5.0,17.0,0.0,0.0,0.0,0.0,173.0,0.0,2.0,1.0,3.0,1.0,2.0,3.0,1.0,3.0,2.0,1.0,2.0,3.0,5.0,7.0,6.0,8.0,2.0,8.0,1.0,8.0,10.0,7.0,4.0,15.0,10.0,9.0,7.0,10.0,7.0,6.0,5.0,8.0,9.0,5.0,12.0,8.0,6.0,9.0,9.0,15.0,15.0,9.0,7.0,20.0,14.0,15.0,5.0,7.0,8.0,9.0,9.0,9.0,9.0,9.0,18.0,8.0,10.0,11.0,11.0,8.0,12.0,4.0,23.0,14.0,1.0,0.0,0.0,180.0,75.0,1.0,3.0,2.0,4.0,1.0,3.0,2.0,2.0,4.0,1.0,2.0,5.0,12.0,12.0,6.0,11.0,7.0,13.0,12.0,6.0,12.0,12.0,6.0,12.0,11.0,13.0,13.0,15.0,11.0,11.0,12.0,9.0,16.0,7.0,12.0,8.0,12.0,14.0,16.0,14.0,13.0,15.0,10.0,8.0,15.0,13.0,20.0,15.0,14.0,14.0,13.0,12.0,7.0,11.0,12.0,13.0,14.0,14.0,14.0,13.0,13.0,6.0,27.0,32.0,6.0,0.0,0.0,188.0,78.0,3.0,2.0,3.0,2.0,1.0,3.0,3.0,3.0,2.0,2.0,2.0,4.0,8.0,11.0,12.0,12.0,6.0,16.0,13.0,8.0,13.0,14.0,7.0,12.0,12.0,12.0,10.0,14.0,13.0,12.0,11.0,12.0,15.0,9.0,11.0,12.0,6.0,13.0,12.0,14.0,13.0,15.0,15.0,5.0,13.0,12.0,20.0,16.0,15.0,14.0,12.0,15.0,11.0,10.0,9.0,15.0,12.0,12.0,13.0,13.0,13.0,7.0,27.0,1.0,0.0,0.0,0.0,179.0,70.0,3.0,2.0,1.0,3.0,3.0,2.0,1.0,3.0,2.0,1.0,1.0,14.0,15.0,15.0,11.0,15.0,14.0,8.0,12.0,5.0,8.0,13.0,12.0,9.0,18.0,11.0,11.0,11.0,9.0,10.0,16.0,10.0,17.0,15.0,8.0,12.0,8.0,12.0,11.0,14.0,13.0,12.0,10.0,12.0,13.0,14.0,20.0,16.0,12.0,10.0,9.0,10.0,7.0,8.0,13.0,15.0,13.0,10.0,11.0,12.0,10.0,8.0,28.0,2.0,1.0,0.0,0.0,174.0,66.0,2.0,2.0,2.0,1.0,1.0,3.0,2.0,3.0,3.0,1.0,4.0,6.0,11.0,13.0,15.0,13.0,11.0,14.0,11.0,6.0,5.0,10.0,12.0,5.0,13.0,8.0,14.0,10.0,13.0,14.0,8.0,12.0,12.0,12.0,5.0,14.0,8.0,12.0,11.0,17.0,15.0,11.0,12.0,7.0,14.0,15.0,20.0,13.0,10.0,12.0,8.0,14.0,8.0,8.0,19.0,15.0,12.0,10.0,11.0,13.0,13.0,12.0,24.0,4.0,1.0,0.0,0.0,188.0,79.0,2.0,3.0,2.0,1.0,2.0,1.0,1.0,2.0,1.0,2.0,2.0,10.0,11.0,13.0,12.0,11.0,9.0,13.0,9.0,5.0,8.0,11.0,11.0,7.0,13.0,10.0,12.0,11.0,11.0,12.0,13.0,11.0,14.0,12.0,9.0,12.0,12.0,14.0,14.0,12.0,13.0,15.0,14.0,8.0,13.0,12.0,20.0,13.0,14.0,11.0,9.0,10.0,5.0,10.0,14.0,12.0,13.0,10.0,14.0,13.0,12.0,10.0,27.0,0.0,0.0,0.0,0.0,191.0,83.0,1.0,1.0,3.0,2.0,1.0,1.0,1.0,1.0,2.0,3.0,1.0,5.0,9.0,11.0,12.0,11.0,7.0,13.0,9.0,5.0,4.0,9.0,3.0,3.0,10.0,10.0,12.0,14.0,10.0,10.0,7.0,11.0,12.0,10.0,6.0,13.0,5.0,13.0,14.0,12.0,11.0,14.0,16.0,5.0,12.0,11.0,20.0,13.0,15.0,12.0,12.0,8.0,7.0,10.0,13.0,11.0,13.0,12.0,12.0,13.0,12.0,8.0
1,0,19.0,0.0,0.0,0.0,0.0,190.0,78.0,13.0,12.0,11.0,14.0,13.0,6.0,11.0,13.0,13.0,12.0,7.0,3.0,3.0,1.0,3.0,8.0,8.0,3.0,1.0,2.0,3.0,7.0,3.0,1.0,7.0,8.0,13.0,13.0,12.0,13.0,7.0,11.0,11.0,3.0,14.0,2.0,11.0,11.0,10.0,12.0,13.0,11.0,15.0,20.0,10.0,13.0,5.0,13.0,13.0,9.0,10.0,6.0,10.0,10.0,10.0,12.0,11.0,14.0,14.0,12.0,13.0,3.0,21.0,0.0,0.0,0.0,0.0,185.0,79.0,3.0,4.0,3.0,1.0,3.0,1.0,2.0,1.0,1.0,1.0,1.0,7.0,9.0,7.0,8.0,12.0,7.0,13.0,8.0,8.0,13.0,12.0,8.0,13.0,10.0,14.0,11.0,13.0,10.0,12.0,11.0,10.0,14.0,10.0,7.0,8.0,13.0,11.0,10.0,12.0,11.0,13.0,13.0,6.0,13.0,11.0,20.0,13.0,15.0,12.0,12.0,10.0,5.0,14.0,17.0,12.0,13.0,10.0,12.0,12.0,12.0,4.0,24.0,0.0,0.0,5.0,2.0,182.0,78.0,2.0,2.0,3.0,2.0,2.0,1.0,3.0,1.0,1.0,2.0,3.0,5.0,10.0,8.0,7.0,10.0,6.0,13.0,11.0,8.0,13.0,8.0,7.0,12.0,9.0,15.0,14.0,18.0,12.0,11.0,7.0,10.0,14.0,9.0,11.0,9.0,12.0,14.0,15.0,14.0,12.0,15.0,11.0,6.0,14.0,15.0,20.0,14.0,16.0,13.0,14.0,15.0,8.0,8.0,11.0,14.0,13.0,11.0,13.0,12.0,13.0,6.0,17.0,0.0,0.0,0.0,0.0,177.0,69.0,2.0,3.0,2.0,2.0,1.0,1.0,3.0,2.0,1.0,3.0,4.0,6.0,11.0,10.0,6.0,11.0,6.0,7.0,8.0,8.0,8.0,9.0,7.0,10.0,11.0,12.0,10.0,12.0,9.0,10.0,11.0,8.0,11.0,9.0,6.0,9.0,8.0,10.0,12.0,13.0,12.0,10.0,7.0,8.0,9.0,12.0,20.0,10.0,7.0,9.0,9.0,7.0,8.0,12.0,8.0,11.0,13.0,11.0,10.0,10.0,11.0,6.0,17.0,0.0,0.0,0.0,0.0,170.0,74.0,3.0,3.0,2.0,1.0,3.0,3.0,2.0,3.0,1.0,3.0,4.0,8.0,13.0,11.0,10.0,9.0,10.0,6.0,7.0,6.0,10.0,9.0,4.0,11.0,12.0,9.0,10.0,10.0,10.0,12.0,12.0,8.0,10.0,8.0,2.0,10.0,11.0,11.0,11.0,13.0,16.0,11.0,7.0,20.0,15.0,15.0,6.0,12.0,13.0,12.0,3.0,6.0,10.0,14.0,12.0,16.0,11.0,11.0,12.0,12.0,17.0,8.0,20.0,0.0,0.0,0.0,0.0,178.0,72.0,3.0,2.0,3.0,3.0,4.0,2.0,2.0,1.0,2.0,1.0,3.0,9.0,11.0,11.0,6.0,11.0,6.0,8.0,10.0,11.0,11.0,12.0,7.0,12.0,8.0,12.0,11.0,12.0,12.0,11.0,13.0,11.0,10.0,4.0,12.0,8.0,12.0,13.0,13.0,13.0,12.0,13.0,9.0,20.0,14.0,12.0,7.0,11.0,13.0,10.0,4.0,10.0,6.0,10.0,15.0,11.0,13.0,11.0,10.0,14.0,16.0,5.0,24.0,0.0,0.0,0.0,0.0,172.0,69.0,3.0,4.0,1.0,4.0,1.0,2.0,1.0,2.0,2.0,3.0,3.0,10.0,12.0,13.0,7.0,13.0,13.0,7.0,11.0,6.0,2.0,12.0,10.0,4.0,15.0,12.0,11.0,12.0,9.0,10.0,13.0,11.0,3.0,15.0,6.0,13.0,5.0,10.0,13.0,14.0,15.0,11.0,7.0,5.0,14.0,14.0,20.0,13.0,10.0,13.0,12.0,13.0,8.0,10.0,9.0,11.0,10.0,11.0,9.0,11.0,10.0,3.0,24.0,0.0,0.0,6.0,1.0,172.0,70.0,3.0,1.0,1.0,3.0,1.0,2.0,3.0,1.0,1.0,3.0,3.0,11.0,12.0,11.0,8.0,12.0,10.0,6.0,14.0,7.0,11.0,15.0,8.0,12.0,13.0,14.0,14.0,18.0,13.0,12.0,13.0,13.0,15.0,12.0,12.0,12.0,11.0,18.0,18.0,13.0,14.0,13.0,7.0,10.0,16.0,12.0,20.0,14.0,12.0,14.0,14.0,15.0,4.0,8.0,7.0,14.0,14.0,13.0,14.0,12.0,10.0,6.0,21.0,0.0,0.0,0.0,0.0,180.0,71.0,1.0,2.0,1.0,3.0,3.0,3.0,2.0,2.0,2.0,2.0,3.0,10.0,10.0,11.0,10.0,12.0,10.0,8.0,10.0,8.0,8.0,12.0,5.0,6.0,12.0,4.0,11.0,8.0,10.0,9.0,11.0,10.0,10.0,13.0,8.0,12.0,7.0,11.0,12.0,13.0,12.0,10.0,10.0,5.0,12.0,12.0,20.0,11.0,10.0,10.0,10.0,5.0,10.0,12.0,7.0,10.0,14.0,12.0,9.0,10.0,16.0,7.0,23.0,0.0,0.0,0.0,0.0,181.0,73.0,2.0,1.0,2.0,1.0,3.0,3.0,2.0,2.0,4.0,2.0,1.0,5.0,12.0,14.0,13.0,13.0,7.0,12.0,8.0,4.0,5.0,9.0,12.0,5.0,13.0,11.0,11.0,12.0,13.0,11.0,8.0,12.0,14.0,11.0,6.0,13.0,7.0,12.0,13.0,12.0,14.0,13.0,10.0,8.0,14.0,11.0,20.0,13.0,12.0,13.0,5.0,10.0,7.0,14.0,12.0,11.0,14.0,10.0,11.0,10.0,15.0,4.0,24.0,1.0,0.0,2.0,0.0,186.0,81.0,1.0,3.0,2.0,2.0,3.0,3.0,3.0,2.0,1.0,2.0,1.0,9.0,8.0,11.0,13.0,12.0,12.0,14.0,13.0,5.0,4.0,10.0,10.0,2.0,13.0,8.0,12.0,10.0,13.0,12.0,8.0,11.0,16.0,13.0,6.0,11.0,6.0,8.0,9.0,12.0,14.0,14.0,13.0,10.0,15.0,13.0,20.0,12.0,14.0,11.0,8.0,14.0,6.0,8.0,17.0,15.0,11.0,10.0,12.0,13.0,13.0,9.0,30.0,42.0,0.0,13.0,0.0,195.0,88.0,16.0,13.0,14.0,6.0,14.0,13.0,13.0,15.0,12.0,10.0,14.0,1.0,8.0,5.0,2.0,8.0,2.0,8.0,2.0,5.0,3.0,9.0,5.0,3.0,8.0,10.0,12.0,10.0,14.0,10.0,10.0,14.0,13.0,3.0,14.0,3.0,12.0,14.0,12.0,8.0,13.0,18.0,18.0,17.0,14.0,11.0,20.0,14.0,17.0,14.0,4.0,14.0,4.0,1.0,12.0,13.0,14.0,9.0,15.0,13.0,13.0,5.0,28.0,0.0,0.0,0.0,0.0,174.0,67.0,3.0,4.0,1.0,1.0,1.0,3.0,1.0,3.0,2.0,1.0,2.0,11.0,8.0,11.0,9.0,13.0,6.0,7.0,12.0,8.0,10.0,10.0,3.0,6.0,12.0,10.0,13.0,7.0,12.0,8.0,10.0,9.0,12.0,13.0,5.0,12.0,9.0,12.0,11.0,14.0,14.0,11.0,7.0,10.0,15.0,12.0,20.0,11.0,6.0,9.0,6.0,10.0,10.0,9.0,11.0,14.0,9.0,11.0,12.0,8.0,8.0,8.0,28.0,0.0,0.0,0.0,0.0,190.0,85.0,3.0,2.0,3.0,3.0,2.0,2.0,2.0,4.0,3.0,1.0,2.0,5.0,9.0,8.0,9.0,8.0,7.0,14.0,10.0,9.0,15.0,9.0,6.0,14.0,9.0,16.0,13.0,16.0,10.0,13.0,10.0,12.0,15.0,6.0,13.0,7.0,13.0,14.0,16.0,12.0,11.0,17.0,13.0,20.0,15.0,13.0,8.0,15.0,15.0,12.0,14.0,14.0,9.0,8.0,14.0,13.0,14.0,11.0,12.0,13.0,16.0,14.0,19.0,0.0,0.0,0.0,0.0,183.0,79.0,3.0,1.0,3.0,3.0,3.0,2.0,1.0,2.0,3.0,1.0,2.0,5.0,10.0,9.0,7.0,10.0,4.0,10.0,9.0,6.0,12.0,11.0,7.0,12.0,8.0,10.0,12.0,11.0,11.0,11.0,12.0,11.0,13.0,11.0,9.0,12.0,12.0,12.0,14.0,12.0,13.0,13.0,11.0,8.0,13.0,12.0,20.0,13.0,12.0,12.0,10.0,11.0,5.0,9.0,12.0,12.0,13.0,11.0,14.0,12.0,10.0,10.0,21.0,0.0,0.0,0.0,0.0,177.0,0.0,1.0,1.0,1.0,2.0,3.0,3.0,2.0,3.0,2.0,2.0,3.0,6.0,4.0,13.0,13.0,13.0,6.0,13.0,7.0,3.0,5.0,7.0,6.0,1.0,11.0,9.0,7.0,8.0,7.0,7.0,7.0,8.0,7.0,11.0,8.0,13.0,7.0,6.0,7.0,12.0,13.0,7.0,6.0,8.0,8.0,13.0,20.0,5.0,5.0,9.0,5.0,9.0,9.0,9.0,10.0,10.0,12.0,12.0,11.0,10.0,9.0,6.0,26.0,25.0,1.0,7.0,0.0,189.0,78.0,1.0,1.0,1.0,1.0,1.0,1.0,1.0,1.0,1.0,1.0,1.0,8.0,9.0,10.0,6.0,12.0,8.0,13.0,14.0,7.0,11.0,14.0,11.0,13.0,13.0,13.0,13.0,16.0,13.0,13.0,12.0,13.0,14.0,10.0,10.0,12.0,13.0,15.0,15.0,12.0,11.0,9.0,15.0,10.0,14.0,13.0,20.0,14.0,14.0,12.0,13.0,11.0,14.0,12.0,14.0,11.0,14.0,12.0,16.0,15.0,13.0,5.0,19.0,0.0,0.0,0.0,0.0,174.0,61.0,1.0,3.0,2.0,3.0,2.0,1.0,2.0,2.0,3.0,1.0,1.0,5.0,9.0,10.0,6.0,12.0,6.0,8.0,8.0,5.0,9.0,10.0,7.0,9.0,13.0,11.0,12.0,12.0,11.0,9.0,11.0,11.0,8.0,9.0,10.0,8.0,10.0,12.0,16.0,13.0,13.0,10.0,8.0,20.0,15.0,11.0,8.0,13.0,9.0,15.0,11.0,10.0,6.0,13.0,10.0,9.0,14.0,11.0,12.0,14.0,14.0,8.0,22.0,0.0,0.0,0.0,0.0,187.0,84.0,2.0,2.0,1.0,2.0,3.0,2.0,2.0,3.0,3.0,2.0,2.0,4.0,7.0,10.0,6.0,9.0,10.0,13.0,12.0,5.0,11.0,11.0,7.0,10.0,12.0,12.0,11.0,13.0,10.0,9.0,11.0,9.0,15.0,8.0,7.0,9.0,11.0,11.0,14.0,13.0,10.0,15.0,14.0,8.0,15.0,11.0,20.0,14.0,15.0,11.0,12.0,7.0,9.0,8.0,7.0,13.0,15.0,13.0,11.0,14.0,14.0,7.0,21.0,0.0,0.0,0.0,0.0,172.0,66.0,2.0,3.0,2.0,2.0,1.0,1.0,1.0,3.0,2.0,1.0,1.0,10.0,10.0,13.0,9.0,14.0,9.0,8.0,10.0,7.0,13.0,13.0,9.0,12.0,13.0,10.0,12.0,13.0,13.0,12.0,14.0,13.0,13.0,11.0,9.0,14.0,13.0,14.0,14.0,14.0,13.0,12.0,8.0,8.0,12.0,12.0,20.0,13.0,12.0,14.0,10.0,11.0,8.0,12.0,15.0,10.0,15.0,8.0,11.0,14.0,14.0,6.0,24.0,24.0,4.0,0.0,0.0,172.0,74.0,2.0,4.0,3.0,2.0,2.0,1.0,2.0,2.0,3.0,2.0,4.0,8.0,9.0,14.0,13.0,14.0,9.0,11.0,10.0,7.0,5.0,12.0,12.0,3.0,13.0,10.0,12.0,12.0,13.0,12.0,11.0,10.0,14.0,13.0,7.0,14.0,9.0,9.0,13.0,16.0,15.0,13.0,6.0,8.0,13.0,16.0,20.0,14.0,12.0,11.0,11.0,13.0,9.0,8.0,9.0,13.0,9.0,11.0,12.0,13.0,10.0,9.0,24.0,2.0,0.0,0.0,0.0,195.0,84.0,1.0,4.0,1.0,2.0,3.0,1.0,2.0,1.0,2.0,1.0,1.0,6.0,6.0,9.0,11.0,10.0,8.0,14.0,11.0,5.0,8.0,10.0,11.0,2.0,11.0,11.0,12.0,14.0,11.0,14.0,8.0,12.0,13.0,8.0,6.0,11.0,7.0,13.0,14.0,13.0,12.0,18.0,18.0,8.0,13.0,14.0,20.0,14.0,17.0,12.0,11.0,10.0,7.0,5.0,8.0,12.0,9.0,12.0,13.0,12.0,14.0,2.0
1,1,25.0,4.0,0.0,11.0,0.0,184.0,81.0,14.0,14.0,13.0,9.0,15.0,12.0,16.0,16.0,13.0,7.0,11.0,8.0,1.0,2.0,1.0,11.0,12.0,6.0,1.0,3.0,3.0,11.0,5.0,3.0,11.0,8.0,15.0,15.0,13.0,14.0,10.0,11.0,14.0,8.0,13.0,5.0,13.0,10.0,10.0,14.0,16.0,14.0,13.0,20.0,14.0,12.0,5.0,14.0,14.0,15.0,9.0,16.0,6.0,1.0,17.0,11.0,15.0,13.0,14.0,12.0,12.0,4.0,21.0,8.0,0.0,2.0,1.0,184.0,75.0,3.0,2.0,2.0,3.0,3.0,2.0,3.0,3.0,3.0,2.0,4.0,6.0,8.0,13.0,9.0,13.0,5.0,13.0,6.0,10.0,12.0,11.0,10.0,15.0,13.0,15.0,13.0,13.0,13.0,14.0,10.0,11.0,11.0,9.0,8.0,6.0,11.0,14.0,15.0,15.0,14.0,14.0,13.0,11.0,12.0,14.0,20.0,13.0,14.0,13.0,7.0,13.0,9.0,9.0,15.0,15.0,12.0,11.0,11.0,15.0,14.0,2.0,27.0,0.0,0.0,0.0,0.0,184.0,81.0,1.0,1.0,1.0,3.0,3.0,2.0,2.0,2.0,1.0,2.0,3.0,8.0,6.0,8.0,12.0,10.0,8.0,12.0,9.0,1.0,3.0,8.0,14.0,4.0,9.0,4.0,11.0,12.0,11.0,8.0,8.0,11.0,10.0,9.0,8.0,11.0,9.0,8.0,11.0,10.0,8.0,13.0,13.0,9.0,13.0,9.0,20.0,12.0,13.0,13.0,9.0,2.0,9.0,9.0,15.0,10.0,12.0,10.0,11.0,6.0,4.0,6.0,27.0,0.0,0.0,0.0,0.0,178.0,72.0,2.0,3.0,2.0,3.0,2.0,3.0,3.0,1.0,1.0,2.0,1.0,13.0,14.0,11.0,7.0,12.0,10.0,9.0,10.0,13.0,13.0,12.0,10.0,14.0,13.0,12.0,14.0,14.0,13.0,14.0,11.0,12.0,14.0,13.0,8.0,14.0,13.0,13.0,15.0,15.0,13.0,10.0,10.0,20.0,13.0,15.0,6.0,14.0,10.0,13.0,13.0,12.0,8.0,12.0,15.0,14.0,13.0,14.0,13.0,13.0,12.0,6.0,21.0,0.0,0.0,0.0,0.0,178.0,65.0,2.0,3.0,3.0,3.0,3.0,1.0,1.0,1.0,1.0,3.0,1.0,9.0,13.0,11.0,6.0,12.0,7.0,9.0,8.0,8.0,13.0,12.0,7.0,13.0,12.0,8.0,12.0,13.0,12.0,12.0,13.0,13.0,14.0,9.0,8.0,12.0,12.0,13.0,13.0,12.0,14.0,13.0,11.0,8.0,15.0,12.0,20.0,13.0,12.0,14.0,8.0,11.0,7.0,10.0,19.0,10.0,13.0,10.0,11.0,15.0,15.0,6.0,21.0,0.0,0.0,0.0,0.0,179.0,68.0,2.0,3.0,2.0,1.0,2.0,1.0,2.0,3.0,2.0,1.0,1.0,6.0,13.0,12.0,6.0,13.0,6.0,8.0,7.0,12.0,10.0,12.0,8.0,12.0,13.0,10.0,11.0,11.0,12.0,10.0,11.0,11.0,12.0,11.0,7.0,13.0,10.0,12.0,14.0,15.0,13.0,12.0,10.0,20.0,14.0,14.0,8.0,14.0,10.0,13.0,8.0,13.0,8.0,12.0,13.0,14.0,10.0,12.0,10.0,10.0,12.0,10.0,18.0,0.0,0.0,0.0,0.0,170.0,67.0,3.0,1.0,3.0,3.0,3.0,4.0,1.0,2.0,1.0,2.0,2.0,11.0,11.0,12.0,13.0,12.0,11.0,6.0,10.0,8.0,7.0,12.0,10.0,7.0,13.0,9.0,11.0,8.0,10.0,10.0,12.0,12.0,15.0,12.0,12.0,11.0,12.0,11.0,12.0,12.0,12.0,10.0,6.0,5.0,14.0,12.0,20.0,10.0,9.0,10.0,8.0,2.0,6.0,12.0,11.0,11.0,12.0,13.0,14.0,11.0,13.0,4.0,19.0,0.0,0.0,0.0,0.0,175.0,67.0,3.0,2.0,1.0,3.0,3.0,1.0,1.0,1.0,2.0,1.0,3.0,7.0,8.0,12.0,8.0,10.0,6.0,12.0,9.0,8.0,10.0,10.0,8.0,12.0,11.0,14.0,10.0,12.0,9.0,10.0,11.0,10.0,12.0,12.0,10.0,12.0,12.0,13.0,14.0,13.0,11.0,14.0,8.0,6.0,14.0,12.0,20.0,14.0,12.0,12.0,8.0,11.0,6.0,12.0,17.0,13.0,10.0,11.0,12.0,11.0,17.0,5.0,20.0,29.0,2.0,0.0,0.0,181.0,75.0,1.0,1.0,2.0,2.0,2.0,3.0,2.0,1.0,1.0,3.0,2.0,5.0,9.0,15.0,10.0,11.0,9.0,10.0,8.0,7.0,3.0,10.0,10.0,5.0,15.0,7.0,10.0,9.0,12.0,10.0,8.0,11.0,14.0,12.0,5.0,13.0,5.0,11.0,12.0,16.0,12.0,9.0,12.0,20.0,14.0,16.0,7.0,12.0,10.0,9.0,10.0,10.0,11.0,6.0,10.0,15.0,9.0,13.0,11.0,14.0,18.0,7.0,22.0,5.0,1.0,1.0,0.0,173.0,72.0,1.0,3.0,1.0,3.0,3.0,3.0,3.0,3.0,3.0,2.0,2.0,14.0,13.0,16.0,14.0,16.0,14.0,5.0,11.0,5.0,5.0,15.0,11.0,5.0,16.0,8.0,13.0,9.0,14.0,13.0,15.0,13.0,15.0,16.0,5.0,13.0,5.0,9.0,10.0,15.0,16.0,14.0,5.0,20.0,14.0,15.0,5.0,12.0,14.0,13.0,11.0,13.0,8.0,14.0,10.0,15.0,14.0,10.0,13.0,10.0,10.0,13.0,22.0,24.0,3.0,7.0,0.0,177.0,78.0,2.0,1.0,2.0,3.0,2.0,2.0,4.0,3.0,3.0,2.0,1.0,10.0,13.0,16.0,14.0,16.0,16.0,8.0,16.0,4.0,4.0,15.0,12.0,4.0,16.0,12.0,11.0,12.0,13.0,10.0,11.0,8.0,13.0,17.0,5.0,14.0,5.0,10.0,12.0,15.0,14.0,13.0,9.0,10.0,17.0,16.0,20.0,15.0,14.0,12.0,11.0,15.0,4.0,12.0,19.0,16.0,14.0,14.0,11.0,13.0,10.0,12.0,24.0,0.0,0.0,0.0,0.0,197.0,86.0,15.0,9.0,12.0,14.0,13.0,12.0,10.0,13.0,11.0,7.0,8.0,2.0,3.0,3.0,3.0,8.0,7.0,1.0,3.0,1.0,2.0,12.0,2.0,2.0,8.0,10.0,12.0,10.0,14.0,12.0,10.0,10.0,10.0,3.0,8.0,1.0,11.0,10.0,6.0,12.0,13.0,10.0,16.0,5.0,13.0,11.0,20.0,9.0,10.0,10.0,10.0,10.0,7.0,10.0,9.0,11.0,11.0,9.0,12.0,13.0,10.0,8.0,28.0,0.0,0.0,0.0,0.0,190.0,83.0,1.0,1.0,3.0,2.0,1.0,1.0,3.0,3.0,1.0,2.0,1.0,2.0,9.0,5.0,6.0,10.0,5.0,13.0,7.0,4.0,12.0,9.0,7.0,10.0,11.0,13.0,14.0,15.0,13.0,11.0,8.0,11.0,13.0,8.0,12.0,7.0,12.0,12.0,12.0,11.0,11.0,15.0,15.0,20.0,15.0,11.0,5.0,13.0,16.0,15.0,13.0,11.0,7.0,5.0,12.0,12.0,14.0,12.0,15.0,13.0,12.0,6.0,21.0,0.0,0.0,0.0,0.0,193.0,79.0,3.0,3.0,4.0,4.0,2.0,3.0,1.0,1.0,3.0,2.0,3.0,8.0,8.0,8.0,8.0,12.0,11.0,14.0,11.0,12.0,15.0,14.0,6.0,13.0,10.0,12.0,11.0,12.0,12.0,14.0,11.0,10.0,15.0,12.0,12.0,12.0,13.0,14.0,12.0,12.0,12.0,14.0,16.0,9.0,8.0,12.0,20.0,12.0,14.0,13.0,9.0,11.0,16.0,12.0,12.0,14.0,11.0,14.0,12.0,11.0,10.0,5.0,21.0,0.0,0.0,9.0,0.0,178.0,77.0,4.0,3.0,1.0,1.0,1.0,2.0,2.0,3.0,3.0,3.0,1.0,11.0,13.0,11.0,8.0,12.0,9.0,8.0,9.0,8.0,12.0,10.0,8.0,12.0,12.0,8.0,10.0,14.0,11.0,14.0,12.0,12.0,14.0,12.0,8.0,10.0,8.0,15.0,14.0,15.0,12.0,12.0,8.0,7.0,5.0,14.0,20.0,14.0,10.0,12.0,5.0,10.0,11.0,8.0,15.0,10.0,10.0,12.0,9.0,10.0,12.0,5.0,20.0,0.0,0.0,0.0,0.0,176.0,71.0,3.0,3.0,1.0,3.0,1.0,2.0,3.0,2.0,3.0,2.0,2.0,12.0,14.0,12.0,9.0,11.0,10.0,7.0,10.0,12.0,11.0,12.0,9.0,12.0,12.0,9.0,12.0,10.0,10.0,9.0,10.0,12.0,11.0,14.0,8.0,13.0,12.0,10.0,11.0,16.0,15.0,10.0,8.0,20.0,10.0,16.0,5.0,15.0,11.0,10.0,9.0,9.0,8.0,10.0,9.0,11.0,11.0,11.0,12.0,10.0,17.0,1.0,32.0,55.0,0.0,0.0,0.0,180.0,74.0,1.0,3.0,3.0,2.0,1.0,2.0,2.0,1.0,3.0,3.0,1.0,6.0,8.0,8.0,6.0,11.0,10.0,12.0,10.0,6.0,13.0,11.0,7.0,15.0,11.0,14.0,14.0,17.0,12.0,14.0,10.0,13.0,16.0,8.0,12.0,8.0,14.0,16.0,18.0,12.0,13.0,13.0,10.0,8.0,16.0,14.0,20.0,18.0,13.0,16.0,15.0,14.0,5.0,10.0,9.0,15.0,13.0,15.0,14.0,11.0,10.0,7.0,21.0,0.0,0.0,0.0,0.0,181.0,72.0,2.0,3.0,3.0,2.0,2.0,3.0,3.0,3.0,2.0,2.0,3.0,10.0,10.0,12.0,11.0,13.0,11.0,8.0,11.0,5.0,7.0,12.0,12.0,7.0,14.0,10.0,11.0,8.0,11.0,8.0,13.0,8.0,10.0,12.0,7.0,11.0,6.0,11.0,11.0,14.0,12.0,12.0,10.0,10.0,13.0,13.0,20.0,13.0,12.0,14.0,5.0,9.0,9.0,10.0,9.0,11.0,13.0,11.0,11.0,12.0,19.0,1.0,25.0,0.0,0.0,0.0,0.0,177.0,66.0,2.0,3.0,1.0,3.0,2.0,3.0,4.0,1.0,4.0,3.0,1.0,11.0,11.0,11.0,7.0,13.0,11.0,8.0,10.0,7.0,4.0,12.0,11.0,6.0,12.0,8.0,12.0,11.0,12.0,12.0,12.0,9.0,13.0,11.0,7.0,11.0,9.0,14.0,13.0,11.0,13.0,12.0,9.0,20.0,14.0,10.0,8.0,16.0,9.0,13.0,8.0,2.0,6.0,10.0,9.0,11.0,15.0,12.0,14.0,14.0,14.0,6.0,19.0,0.0,0.0,0.0,0.0,175.0,60.0,4.0,2.0,2.0,1.0,1.0,2.0,3.0,2.0,3.0,3.0,1.0,10.0,11.0,15.0,12.0,14.0,6.0,4.0,13.0,10.0,10.0,12.0,9.0,11.0,14.0,8.0,10.0,10.0,14.0,11.0,12.0,15.0,4.0,11.0,7.0,8.0,10.0,11.0,12.0,12.0,12.0,11.0,8.0,5.0,9.0,10.0,20.0,9.0,8.0,10.0,10.0,7.0,10.0,10.0,14.0,12.0,10.0,11.0,14.0,10.0,11.0,2.0,28.0,0.0,0.0,0.0,0.0,185.0,80.0,3.0,4.0,2.0,1.0,3.0,3.0,4.0,1.0,3.0,2.0,2.0,10.0,12.0,13.0,12.0,14.0,11.0,13.0,10.0,4.0,6.0,13.0,10.0,4.0,13.0,15.0,12.0,16.0,10.0,10.0,12.0,12.0,14.0,12.0,5.0,13.0,8.0,11.0,14.0,13.0,13.0,14.0,12.0,8.0,13.0,14.0,20.0,11.0,13.0,13.0,11.0,13.0,7.0,10.0,12.0,14.0,12.0,12.0,11.0,13.0,13.0,7.0,19.0,0.0,0.0,0.0,0.0,185.0,79.0,2.0,3.0,3.0,1.0,2.0,1.0,2.0,3.0,3.0,3.0,2.0,11.0,11.0,11.0,12.0,11.0,10.0,12.0,12.0,5.0,6.0,11.0,12.0,6.0,12.0,15.0,12.0,13.0,11.0,10.0,12.0,11.0,10.0,13.0,12.0,12.0,8.0,10.0,12.0,10.0,13.0,12.0,12.0,20.0,10.0,9.0,10.0,10.0,7.0,10.0,12.0,10.0,5.0,9.0,11.0,12.0,13.0,10.0,13.0,14.0,18.0,3.0
3,1,19.0,0.0,0.0,0.0,0.0,190.0,78.0,13.0,12.0,11.0,14.0,13.0,6.0,11.0,13.0,13.0,12.0,7.0,3.0,3.0,1.0,3.0,8.0,8.0,3.0,1.0,2.0,3.0,7.0,3.0,1.0,7.0,8.0,13.0,13.0,12.0,13.0,7.0,11.0,11.0,3.0,14.0,2.0,11.0,11.0,10.0,12.0,13.0,11.0,15.0,20.0,10.0,13.0,5.0,13.0,13.0,9.0,10.0,6.0,10.0,10.0,10.0,12.0,11.0,14.0,14.0,12.0,13.0,3.0,24.0,0.0,0.0,5.0,2.0,182.0,78.0,2.0,2.0,3.0,2.0,2.0,1.0,3.0,1.0,1.0,2.0,3.0,5.0,10.0,8.0,7.0,10.0,6.0,13.0,11.0,8.0,13.0,8.0,7.0,12.0,9.0,15.0,14.0,18.0,12.0,11.0,7.0,10.0,14.0,9.0,11.0,9.0,12.0,14.0,15.0,14.0,12.0,15.0,11.0,6.0,14.0,15.0,20.0,14.0,16.0,13.0,14.0,15.0,8.0,8.0,11.0,14.0,13.0,11.0,13.0,12.0,13.0,6.0,21.0,0.0,0.0,0.0,0.0,185.0,79.0,3.0,4.0,3.0,1.0,3.0,1.0,2.0,1.0,1.0,1.0,1.0,7.0,9.0,7.0,8.0,12.0,7.0,13.0,8.0,8.0,13.0,12.0,8.0,13.0,10.0,14.0,11.0,13.0,10.0,12.0,11.0,10.0,14.0,10.0,7.0,8.0,13.0,11.0,10.0,12.0,11.0,13.0,13.0,6.0,13.0,11.0,20.0,13.0,15.0,12.0,12.0,10.0,5.0,14.0,17.0,12.0,13.0,10.0,12.0,12.0,12.0,4.0,17.0,0.0,0.0,0.0,0.0,170.0,74.0,3.0,3.0,2.0,1.0,3.0,3.0,2.0,3.0,1.0,3.0,4.0,8.0,13.0,11.0,10.0,9.0,10.0,6.0,7.0,6.0,10.0,9.0,4.0,11.0,12.0,9.0,10.0,10.0,10.0,12.0,12.0,8.0,10.0,8.0,2.0,10.0,11.0,11.0,11.0,13.0,16.0,11.0,7.0,20.0,15.0,15.0,6.0,12.0,13.0,12.0,3.0,6.0,10.0,14.0,12.0,16.0,11.0,11.0,12.0,12.0,17.0,8.0,17.0,0.0,0.0,0.0,0.0,177.0,69.0,2.0,3.0,2.0,2.0,1.0,1.0,3.0,2.0,1.0,3.0,4.0,6.0,11.0,10.0,6.0,11.0,6.0,7.0,8.0,8.0,8.0,9.0,7.0,10.0,11.0,12.0,10.0,12.0,9.0,10.0,11.0,8.0,11.0,9.0,6.0,9.0,8.0,10.0,12.0,13.0,12.0,10.0,7.0,8.0,9.0,12.0,20.0,10.0,7.0,9.0,9.0,7.0,8.0,12.0,8.0,11.0,13.0,11.0,10.0,10.0,11.0,6.0,24.0,0.0,0.0,0.0,0.0,172.0,69.0,3.0,4.0,1.0,4.0,1.0,2.0,1.0,2.0,2.0,3.0,3.0,10.0,12.0,13.0,7.0,13.0,13.0,7.0,11.0,6.0,2.0,12.0,10.0,4.0,15.0,12.0,11.0,12.0,9.0,10.0,13.0,11.0,3.0,15.0,6.0,13.0,5.0,10.0,13.0,14.0,15.0,11.0,7.0,5.0,14.0,14.0,20.0,13.0,10.0,13.0,12.0,13.0,8.0,10.0,9.0,11.0,10.0,11.0,9.0,11.0,10.0,3.0,20.0,0.0,0.0,0.0,0.0,180.0,73.0,4.0,1.0,1.0,1.0,2.0,1.0,3.0,1.0,1.0,1.0,3.0,9.0,11.0,12.0,10.0,12.0,7.0,11.0,10.0,8.0,6.0,10.0,11.0,5.0,10.0,9.0,8.0,9.0,10.0,8.0,10.0,11.0,9.0,7.0,1.0,10.0,7.0,7.0,10.0,13.0,9.0,13.0,10.0,5.0,6.0,13.0,20.0,9.0,11.0,9.0,9.0,9.0,9.0,9.0,13.0,8.0,12.0,12.0,12.0,11.0,13.0,1.0,24.0,0.0,0.0,6.0,1.0,172.0,70.0,3.0,1.0,1.0,3.0,1.0,2.0,3.0,1.0,1.0,3.0,3.0,11.0,12.0,11.0,8.0,12.0,10.0,6.0,14.0,7.0,11.0,15.0,8.0,12.0,13.0,14.0,14.0,18.0,13.0,12.0,13.0,13.0,15.0,12.0,12.0,12.0,11.0,18.0,18.0,13.0,14.0,13.0,7.0,10.0,16.0,12.0,20.0,14.0,12.0,14.0,14.0,15.0,4.0,8.0,7.0,14.0,14.0,13.0,14.0,12.0,10.0,6.0,21.0,0.0,0.0,0.0,0.0,188.0,80.0,2.0,3.0,3.0,2.0,1.0,1.0,1.0,1.0,3.0,3.0,3.0,8.0,8.0,11.0,12.0,10.0,10.0,11.0,7.0,5.0,6.0,8.0,12.0,5.0,11.0,8.0,12.0,7.0,10.0,10.0,8.0,11.0,8.0,10.0,9.0,12.0,11.0,10.0,12.0,12.0,11.0,13.0,14.0,5.0,10.0,10.0,20.0,8.0,14.0,10.0,3.0,8.0,10.0,10.0,7.0,11.0,10.0,9.0,11.0,9.0,16.0,4.0,23.0,0.0,0.0,0.0,0.0,181.0,73.0,2.0,1.0,2.0,1.0,3.0,3.0,2.0,2.0,4.0,2.0,1.0,5.0,12.0,14.0,13.0,13.0,7.0,12.0,8.0,4.0,5.0,9.0,12.0,5.0,13.0,11.0,11.0,12.0,13.0,11.0,8.0,12.0,14.0,11.0,6.0,13.0,7.0,12.0,13.0,12.0,14.0,13.0,10.0,8.0,14.0,11.0,20.0,13.0,12.0,13.0,5.0,10.0,7.0,14.0,12.0,11.0,14.0,10.0,11.0,10.0,15.0,4.0,21.0,0.0,0.0,0.0,0.0,179.0,75.0,3.0,3.0,2.0,2.0,1.0,3.0,3.0,3.0,1.0,1.0,1.0,5.0,9.0,13.0,11.0,11.0,8.0,10.0,11.0,5.0,2.0,9.0,12.0,2.0,12.0,7.0,11.0,12.0,10.0,9.0,10.0,10.0,13.0,12.0,5.0,13.0,7.0,7.0,11.0,14.0,13.0,13.0,9.0,6.0,12.0,15.0,20.0,13.0,14.0,11.0,10.0,10.0,5.0,10.0,16.0,11.0,10.0,12.0,9.0,13.0,13.0,9.0,33.0,0.0,0.0,3.0,0.0,188.0,84.0,14.0,13.0,13.0,9.0,13.0,13.0,15.0,15.0,11.0,11.0,9.0,7.0,3.0,3.0,1.0,7.0,10.0,2.0,1.0,1.0,2.0,6.0,4.0,1.0,7.0,8.0,13.0,14.0,14.0,14.0,8.0,11.0,15.0,6.0,13.0,3.0,13.0,12.0,8.0,12.0,14.0,15.0,14.0,8.0,13.0,11.0,20.0,13.0,15.0,16.0,8.0,13.0,6.0,1.0,11.0,14.0,13.0,11.0,16.0,14.0,11.0,6.0,28.0,0.0,0.0,0.0,0.0,193.0,84.0,1.0,1.0,2.0,2.0,2.0,3.0,2.0,3.0,2.0,1.0,3.0,4.0,8.0,8.0,9.0,10.0,6.0,14.0,7.0,8.0,14.0,12.0,6.0,14.0,11.0,12.0,13.0,14.0,11.0,14.0,12.0,12.0,14.0,6.0,11.0,8.0,14.0,13.0,13.0,11.0,11.0,16.0,16.0,20.0,12.0,12.0,8.0,14.0,16.0,14.0,12.0,13.0,6.0,10.0,7.0,12.0,15.0,12.0,16.0,15.0,13.0,6.0,26.0,0.0,0.0,10.0,1.0,196.0,91.0,3.0,1.0,2.0,2.0,2.0,3.0,2.0,4.0,2.0,2.0,1.0,3.0,5.0,8.0,6.0,9.0,5.0,14.0,7.0,8.0,13.0,10.0,5.0,12.0,10.0,10.0,13.0,14.0,12.0,12.0,7.0,10.0,13.0,6.0,9.0,6.0,12.0,14.0,10.0,9.0,8.0,13.0,18.0,8.0,17.0,11.0,20.0,12.0,16.0,13.0,12.0,10.0,7.0,4.0,18.0,10.0,12.0,9.0,13.0,7.0,10.0,7.0,26.0,0.0,0.0,0.0,0.0,182.0,68.0,1.0,4.0,3.0,2.0,3.0,1.0,2.0,1.0,2.0,4.0,1.0,7.0,12.0,9.0,5.0,10.0,6.0,12.0,7.0,15.0,12.0,9.0,6.0,12.0,10.0,12.0,13.0,14.0,11.0,10.0,9.0,9.0,13.0,7.0,6.0,10.0,10.0,14.0,15.0,16.0,13.0,13.0,11.0,5.0,15.0,15.0,20.0,14.0,10.0,12.0,12.0,13.0,7.0,12.0,12.0,14.0,14.0,15.0,13.0,14.0,14.0,7.0,26.0,0.0,0.0,0.0,0.0,175.0,69.0,3.0,3.0,2.0,2.0,3.0,1.0,3.0,1.0,3.0,2.0,2.0,6.0,12.0,10.0,5.0,11.0,6.0,10.0,10.0,10.0,13.0,12.0,9.0,13.0,12.0,12.0,13.0,14.0,12.0,13.0,12.0,11.0,15.0,11.0,13.0,12.0,13.0,14.0,14.0,15.0,13.0,12.0,7.0,9.0,13.0,13.0,20.0,14.0,11.0,14.0,12.0,12.0,11.0,15.0,14.0,9.0,17.0,10.0,8.0,11.0,20.0,7.0,21.0,0.0,0.0,0.0,0.0,183.0,73.0,1.0,4.0,3.0,3.0,3.0,1.0,4.0,1.0,2.0,3.0,2.0,11.0,10.0,12.0,11.0,13.0,9.0,12.0,10.0,5.0,8.0,12.0,9.0,8.0,13.0,13.0,12.0,12.0,10.0,12.0,14.0,12.0,12.0,14.0,8.0,12.0,8.0,12.0,12.0,14.0,14.0,14.0,11.0,8.0,13.0,13.0,20.0,12.0,12.0,12.0,5.0,10.0,7.0,12.0,15.0,11.0,11.0,10.0,11.0,12.0,11.0,4.0,30.0,9.0,1.0,0.0,0.0,192.0,90.0,2.0,2.0,2.0,2.0,3.0,1.0,3.0,4.0,1.0,1.0,3.0,4.0,7.0,10.0,10.0,9.0,8.0,17.0,12.0,6.0,13.0,12.0,8.0,12.0,11.0,13.0,14.0,15.0,13.0,13.0,10.0,12.0,14.0,12.0,13.0,13.0,12.0,14.0,16.0,12.0,12.0,18.0,16.0,8.0,14.0,13.0,20.0,16.0,18.0,13.0,13.0,14.0,7.0,12.0,13.0,13.0,13.0,13.0,13.0,13.0,13.0,6.0,29.0,0.0,0.0,0.0,0.0,180.0,71.0,1.0,3.0,1.0,1.0,1.0,4.0,4.0,1.0,1.0,2.0,3.0,10.0,11.0,12.0,9.0,13.0,11.0,8.0,14.0,6.0,8.0,11.0,10.0,8.0,12.0,10.0,11.0,12.0,12.0,9.0,12.0,11.0,14.0,12.0,7.0,12.0,10.0,12.0,14.0,15.0,14.0,12.0,10.0,20.0,16.0,13.0,12.0,15.0,10.0,13.0,10.0,15.0,7.0,8.0,16.0,12.0,12.0,13.0,14.0,15.0,15.0,6.0,19.0,0.0,0.0,0.0,0.0,185.0,80.0,3.0,2.0,2.0,3.0,3.0,4.0,3.0,3.0,3.0,2.0,1.0,8.0,12.0,13.0,8.0,12.0,13.0,12.0,9.0,6.0,12.0,13.0,9.0,13.0,12.0,12.0,13.0,12.0,12.0,10.0,12.0,12.0,4.0,13.0,8.0,12.0,8.0,12.0,14.0,13.0,14.0,12.0,11.0,5.0,15.0,14.0,20.0,13.0,13.0,12.0,10.0,9.0,11.0,15.0,15.0,9.0,10.0,9.0,12.0,11.0,10.0,5.0,23.0,0.0,0.0,0.0,0.0,175.0,70.0,2.0,1.0,2.0,2.0,1.0,2.0,2.0,3.0,4.0,1.0,2.0,10.0,11.0,12.0,9.0,13.0,8.0,6.0,13.0,2.0,5.0,13.0,10.0,6.0,13.0,7.0,13.0,9.0,13.0,11.0,13.0,12.0,13.0,12.0,10.0,12.0,10.0,13.0,12.0,11.0,12.0,13.0,8.0,8.0,14.0,12.0,20.0,14.0,12.0,13.0,9.0,11.0,10.0,11.0,19.0,12.0,14.0,11.0,13.0,10.0,16.0,7.0,34.0,0.0,0.0,0.0,0.0,187.0,78.0,3.0,2.0,1.0,3.0,2.0,2.0,1.0,2.0,3.0,1.0,2.0,8.0,5.0,4.0,8.0,12.0,8.0,8.0,8.0,2.0,12.0,13.0,4.0,14.0,10.0,8.0,11.0,9.0,10.0,9.0,7.0,14.0,4.0,8.0,11.0,8.0,13.0,9.0,11.0,10.0,10.0,9.0,10.0,4.0,8.0,11.0,20.0,9.0,10.0,10.0,10.0,7.0,7.0,10.0,16.0,11.0,10.0,10.0,11.0,12.0,13.0,6.0
0,1,22.0,0.0,0.0,0.0,0.0,186.0,79.0,14.0,13.0,11.0,7.0,12.0,10.0,13.0,14.0,8.0,6.0,8.0,2.0,1.0,3.0,6.0,8.0,5.0,3.0,11.0,3.0,2.0,8.0,8.0,1.0,8.0,8.0,12.0,14.0,12.0,11.0,7.0,11.0,12.0,6.0,9.0,3.0,12.0,12.0,5.0,8.0,12.0,15.0,15.0,20.0,15.0,7.0,5.0,9.0,15.0,14.0,8.0,5.0,5.0,1.0,10.0,12.0,13.0,12.0,8.0,15.0,15.0,5.0,28.0,0.0,0.0,9.0,1.0,187.0,85.0,3.0,3.0,2.0,2.0,3.0,2.0,2.0,1.0,1.0,1.0,2.0,4.0,10.0,7.0,7.0,11.0,8.0,16.0,11.0,13.0,14.0,10.0,6.0,14.0,11.0,14.0,14.0,17.0,11.0,14.0,8.0,13.0,14.0,7.0,12.0,7.0,13.0,16.0,15.0,12.0,12.0,15.0,13.0,8.0,14.0,11.0,20.0,14.0,15.0,15.0,6.0,15.0,8.0,8.0,8.0,15.0,12.0,12.0,13.0,14.0,14.0,5.0,21.0,0.0,0.0,0.0,0.0,182.0,74.0,2.0,2.0,2.0,2.0,2.0,1.0,1.0,1.0,3.0,2.0,2.0,9.0,11.0,12.0,7.0,9.0,8.0,12.0,7.0,11.0,12.0,7.0,8.0,13.0,11.0,12.0,12.0,14.0,12.0,13.0,7.0,12.0,11.0,1.0,9.0,11.0,9.0,10.0,12.0,14.0,10.0,13.0,11.0,9.0,8.0,12.0,20.0,13.0,11.0,10.0,13.0,8.0,10.0,10.0,15.0,11.0,13.0,10.0,10.0,8.0,13.0,7.0,21.0,0.0,0.0,1.0,0.0,177.0,68.0,4.0,1.0,2.0,1.0,1.0,1.0,1.0,1.0,2.0,1.0,2.0,5.0,12.0,9.0,7.0,12.0,8.0,13.0,10.0,16.0,13.0,12.0,8.0,14.0,12.0,12.0,13.0,12.0,12.0,12.0,10.0,13.0,15.0,11.0,13.0,11.0,13.0,13.0,14.0,13.0,14.0,13.0,11.0,10.0,14.0,12.0,20.0,12.0,14.0,12.0,11.0,12.0,8.0,14.0,13.0,10.0,14.0,12.0,14.0,12.0,11.0,5.0,17.0,0.0,0.0,0.0,0.0,173.0,0.0,2.0,1.0,3.0,1.0,2.0,3.0,1.0,3.0,2.0,1.0,2.0,3.0,5.0,7.0,6.0,8.0,2.0,8.0,1.0,8.0,10.0,7.0,4.0,15.0,10.0,9.0,7.0,10.0,7.0,6.0,5.0,8.0,9.0,5.0,12.0,8.0,6.0,9.0,9.0,15.0,15.0,9.0,7.0,20.0,14.0,15.0,5.0,7.0,8.0,9.0,9.0,9.0,9.0,9.0,18.0,8.0,10.0,11.0,11.0,8.0,12.0,4.0,23.0,14.0,1.0,0.0,0.0,180.0,75.0,1.0,3.0,2.0,4.0,1.0,3.0,2.0,2.0,4.0,1.0,2.0,5.0,12.0,12.0,6.0,11.0,7.0,13.0,12.0,6.0,12.0,12.0,6.0,12.0,11.0,13.0,13.0,15.0,11.0,11.0,12.0,9.0,16.0,7.0,12.0,8.0,12.0,14.0,16.0,14.0,13.0,15.0,10.0,8.0,15.0,13.0,20.0,15.0,14.0,14.0,13.0,12.0,7.0,11.0,12.0,13.0,14.0,14.0,14.0,13.0,13.0,6.0,27.0,1.0,0.0,0.0,0.0,179.0,70.0,3.0,2.0,1.0,3.0,3.0,2.0,1.0,3.0,2.0,1.0,1.0,14.0,15.0,15.0,11.0,15.0,14.0,8.0,12.0,5.0,8.0,13.0,12.0,9.0,18.0,11.0,11.0,11.0,9.0,10.0,16.0,10.0,17.0,15.0,8.0,12.0,8.0,12.0,11.0,14.0,13.0,12.0,10.0,12.0,13.0,14.0,20.0,16.0,12.0,10.0,9.0,10.0,7.0,8.0,13.0,15.0,13.0,10.0,11.0,12.0,10.0,8.0,27.0,0.0,0.0,0.0,0.0,191.0,83.0,1.0,1.0,3.0,2.0,1.0,1.0,1.0,1.0,2.0,3.0,1.0,5.0,9.0,11.0,12.0,11.0,7.0,13.0,9.0,5.0,4.0,9.0,3.0,3.0,10.0,10.0,12.0,14.0,10.0,10.0,7.0,11.0,12.0,10.0,6.0,13.0,5.0,13.0,14.0,12.0,11.0,14.0,16.0,5.0,12.0,11.0,20.0,13.0,15.0,12.0,12.0,8.0,7.0,10.0,13.0,11.0,13.0,12.0,12.0,13.0,12.0,8.0,24.0,4.0,1.0,0.0,0.0,188.0,79.0,2.0,3.0,2.0,1.0,2.0,1.0,1.0,2.0,1.0,2.0,2.0,10.0,11.0,13.0,12.0,11.0,9.0,13.0,9.0,5.0,8.0,11.0,11.0,7.0,13.0,10.0,12.0,11.0,11.0,12.0,13.0,11.0,14.0,12.0,9.0,12.0,12.0,14.0,14.0,12.0,13.0,15.0,14.0,8.0,13.0,12.0,20.0,13.0,14.0,11.0,9.0,10.0,5.0,10.0,14.0,12.0,13.0,10.0,14.0,13.0,12.0,10.0,23.0,15.0,5.0,0.0,0.0,186.0,81.0,3.0,1.0,1.0,4.0,1.0,1.0,2.0,2.0,3.0,3.0,4.0,5.0,10.0,13.0,14.0,10.0,5.0,11.0,13.0,5.0,4.0,9.0,10.0,4.0,10.0,13.0,11.0,14.0,12.0,9.0,8.0,8.0,15.0,13.0,7.0,8.0,7.0,10.0,10.0,15.0,12.0,15.0,12.0,7.0,10.0,18.0,20.0,17.0,15.0,8.0,8.0,11.0,12.0,12.0,12.0,15.0,13.0,12.0,15.0,13.0,13.0,6.0,21.0,0.0,0.0,4.0,1.0,184.0,79.0,1.0,2.0,3.0,1.0,2.0,1.0,3.0,2.0,2.0,1.0,3.0,3.0,6.0,10.0,12.0,12.0,7.0,15.0,8.0,4.0,5.0,13.0,10.0,8.0,12.0,18.0,12.0,19.0,13.0,10.0,13.0,12.0,14.0,13.0,10.0,12.0,9.0,16.0,15.0,12.0,14.0,14.0,14.0,12.0,13.0,10.0,20.0,14.0,14.0,11.0,14.0,14.0,11.0,5.0,10.0,13.0,14.0,15.0,10.0,8.0,4.0,15.0,31.0,22.0,0.0,17.0,0.0,185.0,82.0,12.0,12.0,13.0,6.0,14.0,11.0,15.0,18.0,14.0,10.0,13.0,7.0,3.0,8.0,5.0,9.0,10.0,8.0,12.0,2.0,2.0,9.0,6.0,3.0,10.0,6.0,12.0,15.0,16.0,12.0,8.0,12.0,14.0,8.0,15.0,3.0,13.0,13.0,8.0,13.0,17.0,14.0,13.0,7.0,12.0,11.0,20.0,15.0,14.0,13.0,6.0,16.0,3.0,1.0,8.0,16.0,12.0,13.0,16.0,16.0,16.0,7.0,30.0,19.0,0.0,7.0,0.0,189.0,77.0,3.0,2.0,3.0,2.0,3.0,3.0,1.0,3.0,3.0,1.0,2.0,5.0,8.0,7.0,10.0,10.0,9.0,15.0,9.0,8.0,14.0,12.0,10.0,15.0,10.0,15.0,14.0,13.0,13.0,14.0,10.0,12.0,14.0,10.0,14.0,11.0,12.0,14.0,14.0,8.0,10.0,12.0,16.0,10.0,16.0,10.0,20.0,13.0,16.0,13.0,11.0,13.0,7.0,10.0,6.0,14.0,12.0,13.0,14.0,13.0,13.0,7.0,16.0,0.0,0.0,0.0,0.0,192.0,0.0,2.0,3.0,1.0,2.0,3.0,1.0,1.0,1.0,2.0,3.0,3.0,6.0,8.0,8.0,6.0,10.0,6.0,12.0,6.0,7.0,12.0,10.0,7.0,12.0,10.0,13.0,12.0,14.0,11.0,10.0,8.0,10.0,10.0,8.0,6.0,8.0,9.0,10.0,13.0,13.0,11.0,12.0,13.0,6.0,14.0,12.0,20.0,10.0,10.0,10.0,7.0,8.0,8.0,10.0,9.0,13.0,10.0,11.0,11.0,10.0,15.0,9.0,22.0,0.0,0.0,3.0,0.0,176.0,70.0,1.0,1.0,1.0,3.0,2.0,1.0,2.0,3.0,1.0,3.0,3.0,10.0,15.0,14.0,6.0,13.0,10.0,13.0,10.0,9.0,9.0,13.0,8.0,11.0,14.0,10.0,11.0,12.0,10.0,13.0,11.0,13.0,14.0,13.0,7.0,13.0,9.0,11.0,13.0,17.0,13.0,12.0,10.0,20.0,14.0,16.0,5.0,15.0,11.0,13.0,10.0,14.0,8.0,10.0,11.0,13.0,16.0,11.0,15.0,14.0,13.0,7.0,24.0,0.0,0.0,0.0,0.0,177.0,65.0,1.0,2.0,1.0,2.0,1.0,2.0,1.0,1.0,1.0,2.0,3.0,8.0,11.0,13.0,10.0,13.0,8.0,10.0,11.0,7.0,5.0,12.0,13.0,6.0,13.0,8.0,11.0,9.0,10.0,9.0,9.0,11.0,13.0,12.0,5.0,12.0,8.0,7.0,9.0,16.0,15.0,12.0,8.0,10.0,15.0,15.0,20.0,14.0,12.0,11.0,8.0,13.0,7.0,12.0,20.0,14.0,13.0,12.0,9.0,12.0,11.0,10.0,26.0,28.0,3.0,12.0,1.0,186.0,78.0,1.0,3.0,1.0,3.0,2.0,1.0,3.0,2.0,1.0,1.0,3.0,10.0,12.0,10.0,11.0,13.0,10.0,10.0,13.0,5.0,10.0,17.0,13.0,15.0,13.0,17.0,16.0,15.0,18.0,16.0,15.0,16.0,19.0,8.0,16.0,14.0,15.0,17.0,16.0,12.0,13.0,15.0,11.0,20.0,7.0,14.0,9.0,14.0,16.0,15.0,12.0,15.0,16.0,10.0,16.0,16.0,14.0,17.0,17.0,13.0,15.0,8.0,18.0,0.0,0.0,0.0,0.0,167.0,60.0,2.0,1.0,2.0,2.0,2.0,1.0,2.0,1.0,1.0,1.0,1.0,10.0,11.0,12.0,8.0,13.0,10.0,3.0,10.0,5.0,6.0,13.0,12.0,8.0,15.0,8.0,11.0,8.0,12.0,11.0,13.0,12.0,13.0,12.0,6.0,11.0,11.0,12.0,13.0,15.0,14.0,8.0,5.0,8.0,15.0,12.0,20.0,12.0,7.0,8.0,8.0,14.0,7.0,8.0,18.0,11.0,12.0,11.0,12.0,15.0,15.0,7.0,29.0,26.0,6.0,12.0,4.0,175.0,77.0,1.0,2.0,1.0,3.0,3.0,2.0,1.0,2.0,1.0,2.0,2.0,16.0,14.0,16.0,15.0,15.0,18.0,6.0,15.0,6.0,6.0,18.0,11.0,5.0,17.0,9.0,12.0,10.0,16.0,12.0,16.0,14.0,14.0,16.0,6.0,16.0,6.0,10.0,10.0,13.0,15.0,14.0,8.0,15.0,15.0,14.0,20.0,13.0,12.0,11.0,9.0,16.0,7.0,8.0,8.0,11.0,8.0,13.0,12.0,13.0,11.0,10.0,21.0,0.0,0.0,0.0,0.0,187.0,84.0,4.0,2.0,1.0,2.0,3.0,1.0,2.0,3.0,1.0,1.0,2.0,11.0,13.0,15.0,12.0,14.0,11.0,13.0,14.0,4.0,5.0,12.0,14.0,5.0,16.0,12.0,12.0,14.0,12.0,10.0,10.0,9.0,14.0,17.0,10.0,12.0,7.0,10.0,14.0,14.0,16.0,14.0,15.0,9.0,13.0,14.0,20.0,14.0,14.0,14.0,8.0,15.0,5.0,14.0,11.0,16.0,13.0,14.0,13.0,15.0,15.0,6.0,23.0,0.0,0.0,10.0,7.0,179.0,70.0,1.0,1.0,2.0,2.0,1.0,3.0,3.0,2.0,1.0,4.0,3.0,10.0,13.0,14.0,12.0,15.0,11.0,10.0,13.0,6.0,3.0,13.0,12.0,4.0,16.0,11.0,12.0,11.0,13.0,11.0,13.0,12.0,12.0,16.0,6.0,14.0,6.0,10.0,12.0,16.0,14.0,12.0,9.0,20.0,13.0,14.0,10.0,13.0,10.0,12.0,7.0,12.0,6.0,8.0,12.0,13.0,5.0,10.0,8.0,14.0,12.0,8.0,26.0,0.0,0.0,4.0,0.0,180.0,73.0,2.0,3.0,1.0,4.0,2.0,3.0,3.0,1.0,1.0,4.0,1.0,11.0,13.0,13.0,14.0,14.0,11.0,15.0,12.0,3.0,7.0,14.0,14.0,8.0,13.0,12.0,14.0,17.0,13.0,15.0,14.0,14.0,16.0,12.0,15.0,16.0,12.0,18.0,16.0,13.0,14.0,13.0,12.0,8.0,14.0,13.0,20.0,15.0,12.0,15.0,8.0,14.0,7.0,15.0,19.0,14.0,17.0,14.0,18.0,16.0,16.0,5.0
0,1,22.0,0.0,0.0,0.0,0.0,191.0,86.0,14.0,11.0,10.0,12.0,13.0,9.0,14.0,13.0,10.0,13.0,12.0,4.0,2.0,2.0,1.0,5.0,6.0,10.0,3.0,3.0,3.0,7.0,5.0,3.0,6.0,12.0,10.0,12.0,13.0,10.0,6.0,12.0,11.0,11.0,11.0,5.0,9.0,8.0,6.0,10.0,12.0,16.0,15.0,6.0,14.0,9.0,20.0,11.0,15.0,11.0,11.0,13.0,7.0,1.0,18.0,10.0,11.0,13.0,14.0,11.0,20.0,4.0,29.0,0.0,0.0,0.0,0.0,183.0,74.0,3.0,3.0,3.0,3.0,3.0,2.0,2.0,2.0,1.0,3.0,1.0,5.0,12.0,7.0,6.0,10.0,7.0,14.0,12.0,5.0,14.0,12.0,6.0,13.0,11.0,14.0,13.0,17.0,13.0,16.0,12.0,12.0,13.0,9.0,8.0,9.0,14.0,14.0,15.0,13.0,12.0,15.0,12.0,6.0,17.0,11.0,20.0,17.0,13.0,14.0,14.0,15.0,5.0,13.0,9.0,14.0,19.0,15.0,14.0,11.0,11.0,6.0,27.0,15.0,0.0,0.0,0.0,193.0,82.0,4.0,1.0,3.0,1.0,1.0,4.0,2.0,4.0,3.0,3.0,2.0,5.0,9.0,9.0,8.0,10.0,8.0,12.0,11.0,8.0,12.0,12.0,7.0,15.0,13.0,14.0,11.0,17.0,14.0,14.0,10.0,11.0,16.0,8.0,13.0,10.0,10.0,8.0,12.0,13.0,12.0,17.0,17.0,20.0,15.0,15.0,14.0,13.0,16.0,14.0,14.0,14.0,7.0,8.0,12.0,17.0,12.0,15.0,14.0,10.0,9.0,10.0,19.0,1.0,0.0,0.0,0.0,182.0,67.0,1.0,3.0,2.0,1.0,2.0,3.0,1.0,1.0,2.0,1.0,1.0,7.0,7.0,8.0,4.0,10.0,7.0,9.0,9.0,7.0,14.0,9.0,7.0,13.0,9.0,9.0,10.0,8.0,9.0,8.0,9.0,14.0,2.0,7.0,12.0,7.0,8.0,8.0,12.0,12.0,10.0,9.0,11.0,5.0,13.0,8.0,20.0,11.0,8.0,9.0,5.0,4.0,9.0,9.0,10.0,12.0,13.0,9.0,10.0,13.0,12.0,3.0,21.0,0.0,0.0,0.0,0.0,172.0,68.0,3.0,3.0,1.0,2.0,1.0,2.0,3.0,2.0,2.0,3.0,2.0,12.0,13.0,12.0,8.0,12.0,12.0,5.0,8.0,12.0,11.0,13.0,8.0,13.0,12.0,14.0,13.0,14.0,13.0,13.0,10.0,11.0,15.0,9.0,13.0,13.0,12.0,13.0,14.0,12.0,12.0,12.0,6.0,20.0,13.0,13.0,13.0,13.0,11.0,12.0,10.0,10.0,11.0,9.0,20.0,13.0,15.0,12.0,16.0,13.0,13.0,8.0,21.0,4.0,1.0,0.0,0.0,176.0,60.0,1.0,1.0,3.0,2.0,3.0,2.0,1.0,3.0,3.0,4.0,2.0,9.0,10.0,13.0,9.0,13.0,8.0,7.0,12.0,7.0,11.0,13.0,7.0,12.0,11.0,9.0,14.0,12.0,9.0,11.0,12.0,11.0,10.0,9.0,5.0,10.0,12.0,12.0,15.0,15.0,14.0,13.0,7.0,12.0,10.0,12.0,20.0,14.0,4.0,9.0,9.0,9.0,7.0,5.0,15.0,16.0,12.0,10.0,9.0,16.0,8.0,3.0,27.0,0.0,0.0,0.0,0.0,188.0,77.0,1.0,4.0,1.0,1.0,3.0,1.0,2.0,1.0,2.0,2.0,2.0,4.0,7.0,8.0,7.0,13.0,6.0,15.0,9.0,6.0,13.0,12.0,6.0,12.0,11.0,14.0,14.0,15.0,10.0,12.0,11.0,13.0,16.0,7.0,12.0,9.0,12.0,15.0,16.0,14.0,10.0,14.0,15.0,9.0,13.0,12.0,20.0,14.0,16.0,12.0,14.0,13.0,6.0,12.0,4.0,13.0,18.0,13.0,14.0,14.0,13.0,7.0,20.0,0.0,0.0,2.0,0.0,180.0,75.0,3.0,1.0,2.0,2.0,3.0,2.0,1.0,1.0,3.0,3.0,1.0,8.0,13.0,14.0,9.0,13.0,8.0,10.0,9.0,6.0,5.0,12.0,6.0,5.0,14.0,8.0,13.0,12.0,13.0,12.0,12.0,12.0,7.0,13.0,8.0,14.0,7.0,12.0,13.0,15.0,13.0,14.0,10.0,8.0,14.0,15.0,20.0,13.0,12.0,13.0,11.0,9.0,7.0,13.0,9.0,11.0,11.0,11.0,12.0,11.0,10.0,1.0,18.0,0.0,0.0,0.0,0.0,179.0,67.0,3.0,3.0,2.0,4.0,2.0,4.0,3.0,1.0,3.0,4.0,1.0,5.0,7.0,12.0,9.0,12.0,12.0,10.0,12.0,6.0,4.0,12.0,12.0,3.0,14.0,11.0,12.0,11.0,11.0,8.0,13.0,12.0,12.0,12.0,6.0,12.0,5.0,10.0,12.0,15.0,11.0,12.0,10.0,20.0,13.0,14.0,8.0,14.0,8.0,9.0,6.0,14.0,5.0,10.0,16.0,13.0,12.0,12.0,13.0,9.0,15.0,2.0,28.0,0.0,0.0,2.0,2.0,182.0,79.0,1.0,1.0,2.0,2.0,3.0,1.0,2.0,3.0,1.0,2.0,2.0,8.0,11.0,14.0,12.0,14.0,11.0,12.0,13.0,6.0,4.0,11.0,13.0,5.0,14.0,11.0,12.0,13.0,10.0,12.0,11.0,11.0,15.0,13.0,7.0,14.0,7.0,12.0,14.0,15.0,14.0,14.0,12.0,8.0,15.0,14.0,20.0,15.0,14.0,12.0,11.0,15.0,8.0,8.0,16.0,15.0,12.0,11.0,14.0,13.0,12.0,8.0,18.0,0.0,0.0,0.0,0.0,188.0,80.0,1.0,3.0,1.0,3.0,2.0,3.0,3.0,1.0,2.0,2.0,4.0,6.0,8.0,12.0,11.0,12.0,7.0,13.0,10.0,4.0,4.0,8.0,10.0,5.0,12.0,11.0,11.0,13.0,10.0,11.0,11.0,12.0,11.0,13.0,7.0,13.0,8.0,13.0,13.0,11.0,12.0,12.0,12.0,10.0,12.0,11.0,20.0,10.0,12.0,12.0,8.0,11.0,7.0,13.0,8.0,13.0,13.0,11.0,12.0,12.0,13.0,7.0,24.0,0.0,0.0,0.0,0.0,197.0,86.0,15.0,9.0,12.0,14.0,13.0,12.0,10.0,13.0,11.0,7.0,8.0,2.0,3.0,3.0,3.0,8.0,7.0,1.0,3.0,1.0,2.0,12.0,2.0,2.0,8.0,10.0,12.0,10.0,14.0,12.0,10.0,10.0,10.0,3.0,8.0,1.0,11.0,10.0,6.0,12.0,13.0,10.0,16.0,5.0,13.0,11.0,20.0,9.0,10.0,10.0,10.0,10.0,7.0,10.0,9.0,11.0,11.0,9.0,12.0,13.0,10.0,8.0,28.0,0.0,0.0,0.0,0.0,190.0,83.0,1.0,1.0,3.0,2.0,1.0,1.0,3.0,3.0,1.0,2.0,1.0,2.0,9.0,5.0,6.0,10.0,5.0,13.0,7.0,4.0,12.0,9.0,7.0,10.0,11.0,13.0,14.0,15.0,13.0,11.0,8.0,11.0,13.0,8.0,12.0,7.0,12.0,12.0,12.0,11.0,11.0,15.0,15.0,20.0,15.0,11.0,5.0,13.0,16.0,15.0,13.0,11.0,7.0,5.0,12.0,12.0,14.0,12.0,15.0,13.0,12.0,6.0,21.0,0.0,0.0,0.0,0.0,193.0,79.0,3.0,3.0,4.0,4.0,2.0,3.0,1.0,1.0,3.0,2.0,3.0,8.0,8.0,8.0,8.0,12.0,11.0,14.0,11.0,12.0,15.0,14.0,6.0,13.0,10.0,12.0,11.0,12.0,12.0,14.0,11.0,10.0,15.0,12.0,12.0,12.0,13.0,14.0,12.0,12.0,12.0,14.0,16.0,9.0,8.0,12.0,20.0,12.0,14.0,13.0,9.0,11.0,16.0,12.0,12.0,14.0,11.0,14.0,12.0,11.0,10.0,5.0,21.0,0.0,0.0,9.0,0.0,178.0,77.0,4.0,3.0,1.0,1.0,1.0,2.0,2.0,3.0,3.0,3.0,1.0,11.0,13.0,11.0,8.0,12.0,9.0,8.0,9.0,8.0,12.0,10.0,8.0,12.0,12.0,8.0,10.0,14.0,11.0,14.0,12.0,12.0,14.0,12.0,8.0,10.0,8.0,15.0,14.0,15.0,12.0,12.0,8.0,7.0,5.0,14.0,20.0,14.0,10.0,12.0,5.0,10.0,11.0,8.0,15.0,10.0,10.0,12.0,9.0,10.0,12.0,5.0,22.0,0.0,0.0,0.0,0.0,168.0,67.0,1.0,1.0,3.0,3.0,3.0,3.0,3.0,2.0,3.0,3.0,3.0,9.0,10.0,12.0,10.0,12.0,10.0,5.0,12.0,6.0,10.0,12.0,8.0,9.0,13.0,11.0,11.0,13.0,11.0,10.0,12.0,12.0,11.0,12.0,5.0,11.0,8.0,10.0,13.0,14.0,14.0,10.0,6.0,20.0,12.0,13.0,6.0,11.0,8.0,12.0,10.0,4.0,5.0,10.0,16.0,11.0,11.0,8.0,12.0,10.0,14.0,6.0,32.0,55.0,0.0,0.0,0.0,180.0,74.0,1.0,3.0,3.0,2.0,1.0,2.0,2.0,1.0,3.0,3.0,1.0,6.0,8.0,8.0,6.0,11.0,10.0,12.0,10.0,6.0,13.0,11.0,7.0,15.0,11.0,14.0,14.0,17.0,12.0,14.0,10.0,13.0,16.0,8.0,12.0,8.0,14.0,16.0,18.0,12.0,13.0,13.0,10.0,8.0,16.0,14.0,20.0,18.0,13.0,16.0,15.0,14.0,5.0,10.0,9.0,15.0,13.0,15.0,14.0,11.0,10.0,7.0,25.0,0.0,0.0,0.0,0.0,174.0,73.0,1.0,1.0,3.0,2.0,1.0,1.0,1.0,2.0,3.0,3.0,3.0,11.0,12.0,12.0,6.0,13.0,11.0,7.0,11.0,10.0,9.0,13.0,9.0,10.0,14.0,11.0,13.0,13.0,12.0,11.0,15.0,11.0,14.0,13.0,7.0,11.0,12.0,15.0,16.0,12.0,14.0,12.0,8.0,20.0,14.0,13.0,7.0,12.0,11.0,12.0,11.0,13.0,9.0,12.0,8.0,13.0,13.0,12.0,15.0,15.0,15.0,6.0,25.0,0.0,0.0,0.0,0.0,177.0,66.0,2.0,3.0,1.0,3.0,2.0,3.0,4.0,1.0,4.0,3.0,1.0,11.0,11.0,11.0,7.0,13.0,11.0,8.0,10.0,7.0,4.0,12.0,11.0,6.0,12.0,8.0,12.0,11.0,12.0,12.0,12.0,9.0,13.0,11.0,7.0,11.0,9.0,14.0,13.0,11.0,13.0,12.0,9.0,20.0,14.0,10.0,8.0,16.0,9.0,13.0,8.0,2.0,6.0,10.0,9.0,11.0,15.0,12.0,14.0,14.0,14.0,6.0,19.0,0.0,0.0,0.0,0.0,175.0,60.0,4.0,2.0,2.0,1.0,1.0,2.0,3.0,2.0,3.0,3.0,1.0,10.0,11.0,15.0,12.0,14.0,6.0,4.0,13.0,10.0,10.0,12.0,9.0,11.0,14.0,8.0,10.0,10.0,14.0,11.0,12.0,15.0,4.0,11.0,7.0,8.0,10.0,11.0,12.0,12.0,12.0,11.0,8.0,5.0,9.0,10.0,20.0,9.0,8.0,10.0,10.0,7.0,10.0,10.0,14.0,12.0,10.0,11.0,14.0,10.0,11.0,2.0,19.0,0.0,0.0,0.0,0.0,185.0,79.0,2.0,3.0,3.0,1.0,2.0,1.0,2.0,3.0,3.0,3.0,2.0,11.0,11.0,11.0,12.0,11.0,10.0,12.0,12.0,5.0,6.0,11.0,12.0,6.0,12.0,15.0,12.0,13.0,11.0,10.0,12.0,11.0,10.0,13.0,12.0,12.0,8.0,10.0,12.0,10.0,13.0,12.0,12.0,20.0,10.0,9.0,10.0,10.0,7.0,10.0,12.0,10.0,5.0,9.0,11.0,12.0,13.0,10.0,13.0,14.0,18.0,3.0,28.0,0.0,0.0,0.0,0.0,185.0,80.0,3.0,4.0,2.0,1.0,3.0,3.0,4.0,1.0,3.0,2.0,2.0,10.0,12.0,13.0,12.0,14.0,11.0,13.0,10.0,4.0,6.0,13.0,10.0,4.0,13.0,15.0,12.0,16.0,10.0,10.0,12.0,12.0,14.0,12.0,5.0,13.0,8.0,11.0,14.0,13.0,13.0,14.0,12.0,8.0,13.0,14.0,20.0,11.0,13.0,13.0,11.0,13.0,7.0,10.0,12.0,14.0,12.0,12.0,11.0,13.0,13.0,7.0
0,1,22.0,0.0,0.0,0.0,0.0,186.0,79.0,14.0,13.0,11.0,7.0,12.0,10.0,13.0,14.0,8.0,6.0,8.0,2.0,1.0,3.0,6.0,8.0,5.0,3.0,11.0,3.0,2.0,8.0,8.0,1.0,8.0,8.0,12.0,14.0,12.0,11.0,7.0,11.0,12.0,6.0,9.0,3.0,12.0,12.0,5.0,8.0,12.0,15.0,15.0,20.0,15.0,7.0,5.0,9.0,15.0,14.0,8.0,5.0,5.0,1.0,10.0,12.0,13.0,12.0,8.0,15.0,15.0,5.0,21.0,0.0,0.0,0.0,0.0,182.0,74.0,2.0,2.0,2.0,2.0,2.0,1.0,1.0,1.0,3.0,2.0,2.0,9.0,11.0,12.0,7.0,9.0,8.0,12.0,7.0,11.0,12.0,7.0,8.0,13.0,11.0,12.0,12.0,14.0,12.0,13.0,7.0,12.0,11.0,1.0,9.0,11.0,9.0,10.0,12.0,14.0,10.0,13.0,11.0,9.0,8.0,12.0,20.0,13.0,11.0,10.0,13.0,8.0,10.0,10.0,15.0,11.0,13.0,10.0,10.0,8.0,13.0,7.0,23.0,0.0,0.0,0.0,0.0,182.0,80.0,2.0,3.0,2.0,2.0,2.0,3.0,4.0,4.0,1.0,2.0,1.0,5.0,7.0,12.0,5.0,13.0,6.0,12.0,6.0,6.0,13.0,11.0,6.0,14.0,11.0,13.0,12.0,13.0,14.0,13.0,9.0,10.0,13.0,7.0,10.0,8.0,10.0,13.0,12.0,14.0,12.0,13.0,10.0,5.0,12.0,13.0,20.0,15.0,14.0,14.0,6.0,10.0,9.0,7.0,9.0,12.0,17.0,13.0,14.0,14.0,14.0,5.0,21.0,0.0,0.0,1.0,0.0,177.0,68.0,4.0,1.0,2.0,1.0,1.0,1.0,1.0,1.0,2.0,1.0,2.0,5.0,12.0,9.0,7.0,12.0,8.0,13.0,10.0,16.0,13.0,12.0,8.0,14.0,12.0,12.0,13.0,12.0,12.0,12.0,10.0,13.0,15.0,11.0,13.0,11.0,13.0,13.0,14.0,13.0,14.0,13.0,11.0,10.0,14.0,12.0,20.0,12.0,14.0,12.0,11.0,12.0,8.0,14.0,13.0,10.0,14.0,12.0,14.0,12.0,11.0,5.0,17.0,0.0,0.0,0.0,0.0,173.0,0.0,2.0,1.0,3.0,1.0,2.0,3.0,1.0,3.0,2.0,1.0,2.0,3.0,5.0,7.0,6.0,8.0,2.0,8.0,1.0,8.0,10.0,7.0,4.0,15.0,10.0,9.0,7.0,10.0,7.0,6.0,5.0,8.0,9.0,5.0,12.0,8.0,6.0,9.0,9.0,15.0,15.0,9.0,7.0,20.0,14.0,15.0,5.0,7.0,8.0,9.0,9.0,9.0,9.0,9.0,18.0,8.0,10.0,11.0,11.0,8.0,12.0,4.0,23.0,14.0,1.0,0.0,0.0,180.0,75.0,1.0,3.0,2.0,4.0,1.0,3.0,2.0,2.0,4.0,1.0,2.0,5.0,12.0,12.0,6.0,11.0,7.0,13.0,12.0,6.0,12.0,12.0,6.0,12.0,11.0,13.0,13.0,15.0,11.0,11.0,12.0,9.0,16.0,7.0,12.0,8.0,12.0,14.0,16.0,14.0,13.0,15.0,10.0,8.0,15.0,13.0,20.0,15.0,14.0,14.0,13.0,12.0,7.0,11.0,12.0,13.0,14.0,14.0,14.0,13.0,13.0,6.0,27.0,32.0,6.0,0.0,0.0,188.0,78.0,3.0,2.0,3.0,2.0,1.0,3.0,3.0,3.0,2.0,2.0,2.0,4.0,8.0,11.0,12.0,12.0,6.0,16.0,13.0,8.0,13.0,14.0,7.0,12.0,12.0,12.0,10.0,14.0,13.0,12.0,11.0,12.0,15.0,9.0,11.0,12.0,6.0,13.0,12.0,14.0,13.0,15.0,15.0,5.0,13.0,12.0,20.0,16.0,15.0,14.0,12.0,15.0,11.0,10.0,9.0,15.0,12.0,12.0,13.0,13.0,13.0,7.0,27.0,1.0,0.0,0.0,0.0,179.0,70.0,3.0,2.0,1.0,3.0,3.0,2.0,1.0,3.0,2.0,1.0,1.0,14.0,15.0,15.0,11.0,15.0,14.0,8.0,12.0,5.0,8.0,13.0,12.0,9.0,18.0,11.0,11.0,11.0,9.0,10.0,16.0,10.0,17.0,15.0,8.0,12.0,8.0,12.0,11.0,14.0,13.0,12.0,10.0,12.0,13.0,14.0,20.0,16.0,12.0,10.0,9.0,10.0,7.0,8.0,13.0,15.0,13.0,10.0,11.0,12.0,10.0,8.0,28.0,2.0,1.0,0.0,0.0,174.0,66.0,2.0,2.0,2.0,1.0,1.0,3.0,2.0,3.0,3.0,1.0,4.0,6.0,11.0,13.0,15.0,13.0,11.0,14.0,11.0,6.0,5.0,10.0,12.0,5.0,13.0,8.0,14.0,10.0,13.0,14.0,8.0,12.0,12.0,12.0,5.0,14.0,8.0,12.0,11.0,17.0,15.0,11.0,12.0,7.0,14.0,15.0,20.0,13.0,10.0,12.0,8.0,14.0,8.0,8.0,19.0,15.0,12.0,10.0,11.0,13.0,13.0,12.0,16.0,0.0,0.0,0.0,0.0,177.0,71.0,1.0,1.0,3.0,2.0,1.0,2.0,1.0,2.0,2.0,1.0,2.0,5.0,5.0,13.0,14.0,7.0,6.0,14.0,5.0,4.0,6.0,7.0,7.0,1.0,10.0,8.0,7.0,7.0,7.0,5.0,7.0,5.0,6.0,9.0,10.0,12.0,3.0,6.0,7.0,14.0,14.0,7.0,6.0,5.0,8.0,14.0,20.0,6.0,6.0,5.0,4.0,8.0,8.0,8.0,15.0,14.0,11.0,12.0,12.0,11.0,17.0,8.0,24.0,4.0,1.0,0.0,0.0,188.0,79.0,2.0,3.0,2.0,1.0,2.0,1.0,1.0,2.0,1.0,2.0,2.0,10.0,11.0,13.0,12.0,11.0,9.0,13.0,9.0,5.0,8.0,11.0,11.0,7.0,13.0,10.0,12.0,11.0,11.0,12.0,13.0,11.0,14.0,12.0,9.0,12.0,12.0,14.0,14.0,12.0,13.0,15.0,14.0,8.0,13.0,12.0,20.0,13.0,14.0,11.0,9.0,10.0,5.0,10.0,14.0,12.0,13.0,10.0,14.0,13.0,12.0,10.0,30.0,42.0,0.0,13.0,0.0,195.0,88.0,16.0,13.0,14.0,6.0,14.0,13.0,13.0,15.0,12.0,10.0,14.0,1.0,8.0,5.0,2.0,8.0,2.0,8.0,2.0,5.0,3.0,9.0,5.0,3.0,8.0,10.0,12.0,10.0,14.0,10.0,10.0,14.0,13.0,3.0,14.0,3.0,12.0,14.0,12.0,8.0,13.0,18.0,18.0,17.0,14.0,11.0,20.0,14.0,17.0,14.0,4.0,14.0,4.0,1.0,12.0,13.0,14.0,9.0,15.0,13.0,13.0,5.0,28.0,0.0,0.0,0.0,0.0,190.0,85.0,3.0,2.0,3.0,3.0,2.0,2.0,2.0,4.0,3.0,1.0,2.0,5.0,9.0,8.0,9.0,8.0,7.0,14.0,10.0,9.0,15.0,9.0,6.0,14.0,9.0,16.0,13.0,16.0,10.0,13.0,10.0,12.0,15.0,6.0,13.0,7.0,13.0,14.0,16.0,12.0,11.0,17.0,13.0,20.0,15.0,13.0,8.0,15.0,15.0,12.0,14.0,14.0,9.0,8.0,14.0,13.0,14.0,11.0,12.0,13.0,16.0,14.0,22.0,0.0,0.0,3.0,1.0,180.0,80.0,1.0,1.0,2.0,3.0,1.0,2.0,3.0,3.0,3.0,3.0,1.0,7.0,9.0,10.0,6.0,10.0,8.0,12.0,8.0,10.0,11.0,10.0,9.0,14.0,12.0,13.0,11.0,11.0,11.0,10.0,8.0,10.0,3.0,9.0,9.0,9.0,10.0,12.0,11.0,14.0,15.0,10.0,10.0,8.0,12.0,12.0,20.0,11.0,9.0,13.0,12.0,10.0,10.0,16.0,14.0,15.0,10.0,12.0,12.0,11.0,11.0,5.0,28.0,0.0,0.0,0.0,0.0,174.0,67.0,3.0,4.0,1.0,1.0,1.0,3.0,1.0,3.0,2.0,1.0,2.0,11.0,8.0,11.0,9.0,13.0,6.0,7.0,12.0,8.0,10.0,10.0,3.0,6.0,12.0,10.0,13.0,7.0,12.0,8.0,10.0,9.0,12.0,13.0,5.0,12.0,9.0,12.0,11.0,14.0,14.0,11.0,7.0,10.0,15.0,12.0,20.0,11.0,6.0,9.0,6.0,10.0,10.0,9.0,11.0,14.0,9.0,11.0,12.0,8.0,8.0,8.0,24.0,0.0,0.0,0.0,0.0,185.0,77.0,1.0,1.0,3.0,2.0,1.0,1.0,3.0,1.0,3.0,3.0,1.0,7.0,10.0,12.0,11.0,12.0,12.0,14.0,13.0,7.0,13.0,12.0,8.0,14.0,12.0,10.0,13.0,11.0,13.0,13.0,12.0,13.0,16.0,10.0,8.0,12.0,13.0,13.0,13.0,14.0,14.0,12.0,14.0,12.0,14.0,13.0,20.0,11.0,12.0,12.0,12.0,10.0,11.0,7.0,17.0,11.0,10.0,10.0,10.0,7.0,8.0,5.0,19.0,0.0,0.0,0.0,0.0,183.0,79.0,3.0,1.0,3.0,3.0,3.0,2.0,1.0,2.0,3.0,1.0,2.0,5.0,10.0,9.0,7.0,10.0,4.0,10.0,9.0,6.0,12.0,11.0,7.0,12.0,8.0,10.0,12.0,11.0,11.0,11.0,12.0,11.0,13.0,11.0,9.0,12.0,12.0,12.0,14.0,12.0,13.0,13.0,11.0,8.0,13.0,12.0,20.0,13.0,12.0,12.0,10.0,11.0,5.0,9.0,12.0,12.0,13.0,11.0,14.0,12.0,10.0,10.0,24.0,0.0,0.0,0.0,0.0,175.0,72.0,3.0,2.0,4.0,3.0,2.0,4.0,1.0,1.0,1.0,2.0,2.0,8.0,12.0,12.0,6.0,11.0,7.0,10.0,9.0,12.0,11.0,12.0,8.0,12.0,11.0,11.0,12.0,13.0,10.0,10.0,9.0,9.0,3.0,9.0,9.0,11.0,12.0,11.0,11.0,14.0,13.0,11.0,8.0,20.0,12.0,13.0,6.0,12.0,11.0,10.0,10.0,10.0,9.0,10.0,10.0,13.0,10.0,11.0,10.0,13.0,18.0,1.0,21.0,0.0,0.0,0.0,0.0,172.0,66.0,2.0,3.0,2.0,2.0,1.0,1.0,1.0,3.0,2.0,1.0,1.0,10.0,10.0,13.0,9.0,14.0,9.0,8.0,10.0,7.0,13.0,13.0,9.0,12.0,13.0,10.0,12.0,13.0,13.0,12.0,14.0,13.0,13.0,11.0,9.0,14.0,13.0,14.0,14.0,14.0,13.0,12.0,8.0,8.0,12.0,12.0,20.0,13.0,12.0,14.0,10.0,11.0,8.0,12.0,15.0,10.0,15.0,8.0,11.0,14.0,14.0,6.0,24.0,0.0,0.0,4.0,0.0,181.0,73.0,3.0,2.0,2.0,2.0,2.0,2.0,3.0,2.0,1.0,2.0,2.0,13.0,12.0,13.0,8.0,14.0,13.0,8.0,13.0,7.0,4.0,13.0,12.0,3.0,14.0,8.0,12.0,9.0,13.0,11.0,13.0,12.0,13.0,14.0,6.0,14.0,6.0,10.0,11.0,15.0,14.0,12.0,11.0,12.0,12.0,14.0,20.0,13.0,11.0,13.0,8.0,10.0,9.0,8.0,7.0,14.0,13.0,12.0,12.0,13.0,13.0,9.0,24.0,24.0,4.0,0.0,0.0,172.0,74.0,2.0,4.0,3.0,2.0,2.0,1.0,2.0,2.0,3.0,2.0,4.0,8.0,9.0,14.0,13.0,14.0,9.0,11.0,10.0,7.0,5.0,12.0,12.0,3.0,13.0,10.0,12.0,12.0,13.0,12.0,11.0,10.0,14.0,13.0,7.0,14.0,9.0,9.0,13.0,16.0,15.0,13.0,6.0,8.0,13.0,16.0,20.0,14.0,12.0,11.0,11.0,13.0,9.0,8.0,9.0,13.0,9.0,11.0,12.0,13.0,10.0,9.0,24.0,2.0,0.0,0.0,0.0,195.0,84.0,1.0,4.0,1.0,2.0,3.0,1.0,2.0,1.0,2.0,1.0,1.0,6.0,6.0,9.0,11.0,10.0,8.0,14.0,11.0,5.0,8.0,10.0,11.0,2.0,11.0,11.0,12.0,14.0,11.0,14.0,8.0,12.0,13.0,8.0,6.0,11.0,7.0,13.0,14.0,13.0,12.0,18.0,18.0,8.0,13.0,14.0,20.0,14.0,17.0,12.0,11.0,10.0,7.0,5.0,8.0,12.0,9.0,12.0,13.0,12.0,14.0,2.0
2,4,30.0,42.0,0.0,13.0,0.0,195.0,88.0,16.0,13.0,14.0,6.0,14.0,13.0,13.0,15.0,12.0,10.0,14.0,1.0,8.0,5.0,2.0,8.0,2.0,8.0,2.0,5.0,3.0,9.0,5.0,3.0,8.0,10.0,12.0,10.0,14.0,10.0,10.0,14.0,13.0,3.0,14.0,3.0,12.0,14.0,12.0,8.0,13.0,18.0,18.0,17.0,14.0,11.0,20.0,14.0,17.0,14.0,4.0,14.0,4.0,1.0,12.0,13.0,14.0,9.0,15.0,13.0,13.0,5.0,28.0,0.0,0.0,0.0,0.0,190.0,85.0,3.0,2.0,3.0,3.0,2.0,2.0,2.0,4.0,3.0,1.0,2.0,5.0,9.0,8.0,9.0,8.0,7.0,14.0,10.0,9.0,15.0,9.0,6.0,14.0,9.0,16.0,13.0,16.0,10.0,13.0,10.0,12.0,15.0,6.0,13.0,7.0,13.0,14.0,16.0,12.0,11.0,17.0,13.0,20.0,15.0,13.0,8.0,15.0,15.0,12.0,14.0,14.0,9.0,8.0,14.0,13.0,14.0,11.0,12.0,13.0,16.0,14.0,24.0,0.0,0.0,0.0,0.0,185.0,77.0,1.0,1.0,3.0,2.0,1.0,1.0,3.0,1.0,3.0,3.0,1.0,7.0,10.0,12.0,11.0,12.0,12.0,14.0,13.0,7.0,13.0,12.0,8.0,14.0,12.0,10.0,13.0,11.0,13.0,13.0,12.0,13.0,16.0,10.0,8.0,12.0,13.0,13.0,13.0,14.0,14.0,12.0,14.0,12.0,14.0,13.0,20.0,11.0,12.0,12.0,12.0,10.0,11.0,7.0,17.0,11.0,10.0,10.0,10.0,7.0,8.0,5.0,28.0,0.0,0.0,0.0,0.0,174.0,67.0,3.0,4.0,1.0,1.0,1.0,3.0,1.0,3.0,2.0,1.0,2.0,11.0,8.0,11.0,9.0,13.0,6.0,7.0,12.0,8.0,10.0,10.0,3.0,6.0,12.0,10.0,13.0,7.0,12.0,8.0,10.0,9.0,12.0,13.0,5.0,12.0,9.0,12.0,11.0,14.0,14.0,11.0,7.0,10.0,15.0,12.0,20.0,11.0,6.0,9.0,6.0,10.0,10.0,9.0,11.0,14.0,9.0,11.0,12.0,8.0,8.0,8.0,39.0,0.0,0.0,0.0,0.0,187.0,75.0,1.0,1.0,2.0,1.0,2.0,3.0,4.0,1.0,3.0,3.0,1.0,7.0,6.0,9.0,11.0,11.0,7.0,14.0,10.0,4.0,7.0,11.0,2.0,10.0,10.0,8.0,11.0,8.0,7.0,9.0,6.0,7.0,11.0,8.0,6.0,6.0,8.0,14.0,14.0,7.0,10.0,9.0,15.0,3.0,13.0,8.0,20.0,6.0,10.0,8.0,13.0,7.0,8.0,7.0,7.0,11.0,17.0,9.0,15.0,11.0,8.0,2.0,21.0,0.0,0.0,0.0,0.0,177.0,0.0,1.0,1.0,1.0,2.0,3.0,3.0,2.0,3.0,2.0,2.0,3.0,6.0,4.0,13.0,13.0,13.0,6.0,13.0,7.0,3.0,5.0,7.0,6.0,1.0,11.0,9.0,7.0,8.0,7.0,7.0,7.0,8.0,7.0,11.0,8.0,13.0,7.0,6.0,7.0,12.0,13.0,7.0,6.0,8.0,8.0,13.0,20.0,5.0,5.0,9.0,5.0,9.0,9.0,9.0,10.0,10.0,12.0,12.0,11.0,10.0,9.0,6.0,22.0,0.0,0.0,0.0,0.0,187.0,84.0,2.0,2.0,1.0,2.0,3.0,2.0,2.0,3.0,3.0,2.0,2.0,4.0,7.0,10.0,6.0,9.0,10.0,13.0,12.0,5.0,11.0,11.0,7.0,10.0,12.0,12.0,11.0,13.0,10.0,9.0,11.0,9.0,15.0,8.0,7.0,9.0,11.0,11.0,14.0,13.0,10.0,15.0,14.0,8.0,15.0,11.0,20.0,14.0,15.0,11.0,12.0,7.0,9.0,8.0,7.0,13.0,15.0,13.0,11.0,14.0,14.0,7.0,21.0,0.0,0.0,0.0,0.0,172.0,66.0,2.0,3.0,2.0,2.0,1.0,1.0,1.0,3.0,2.0,1.0,1.0,10.0,10.0,13.0,9.0,14.0,9.0,8.0,10.0,7.0,13.0,13.0,9.0,12.0,13.0,10.0,12.0,13.0,13.0,12.0,14.0,13.0,13.0,11.0,9.0,14.0,13.0,14.0,14.0,14.0,13.0,12.0,8.0,8.0,12.0,12.0,20.0,13.0,12.0,14.0,10.0,11.0,8.0,12.0,15.0,10.0,15.0,8.0,11.0,14.0,14.0,6.0,22.0,0.0,0.0,0.0,0.0,177.0,69.0,2.0,2.0,4.0,1.0,2.0,3.0,1.0,3.0,1.0,3.0,2.0,7.0,11.0,14.0,8.0,14.0,10.0,4.0,10.0,11.0,3.0,10.0,4.0,5.0,14.0,11.0,10.0,16.0,11.0,10.0,7.0,11.0,6.0,12.0,4.0,14.0,4.0,9.0,11.0,16.0,14.0,6.0,9.0,8.0,6.0,16.0,20.0,10.0,6.0,11.0,8.0,12.0,10.0,11.0,12.0,16.0,8.0,10.0,5.0,12.0,5.0,14.0,24.0,2.0,0.0,0.0,0.0,195.0,84.0,1.0,4.0,1.0,2.0,3.0,1.0,2.0,1.0,2.0,1.0,1.0,6.0,6.0,9.0,11.0,10.0,8.0,14.0,11.0,5.0,8.0,10.0,11.0,2.0,11.0,11.0,12.0,14.0,11.0,14.0,8.0,12.0,13.0,8.0,6.0,11.0,7.0,13.0,14.0,13.0,12.0,18.0,18.0,8.0,13.0,14.0,20.0,14.0,17.0,12.0,11.0,10.0,7.0,5.0,8.0,12.0,9.0,12.0,13.0,12.0,14.0,2.0,24.0,24.0,4.0,0.0,0.0,172.0,74.0,2.0,4.0,3.0,2.0,2.0,1.0,2.0,2.0,3.0,2.0,4.0,8.0,9.0,14.0,13.0,14.0,9.0,11.0,10.0,7.0,5.0,12.0,12.0,3.0,13.0,10.0,12.0,12.0,13.0,12.0,11.0,10.0,14.0,13.0,7.0,14.0,9.0,9.0,13.0,16.0,15.0,13.0,6.0,8.0,13.0,16.0,20.0,14.0,12.0,11.0,11.0,13.0,9.0,8.0,9.0,13.0,9.0,11.0,12.0,13.0,10.0,9.0,19.0,0.0,0.0,0.0,0.0,190.0,78.0,13.0,12.0,11.0,14.0,13.0,6.0,11.0,13.0,13.0,12.0,7.0,3.0,3.0,1.0,3.0,8.0,8.0,3.0,1.0,2.0,3.0,7.0,3.0,1.0,7.0,8.0,13.0,13.0,12.0,13.0,7.0,11.0,11.0,3.0,14.0,2.0,11.0,11.0,10.0,12.0,13.0,11.0,15.0,20.0,10.0,13.0,5.0,13.0,13.0,9.0,10.0,6.0,10.0,10.0,10.0,12.0,11.0,14.0,14.0,12.0,13.0,3.0,32.0,0.0,0.0,0.0,0.0,187.0,90.0,3.0,1.0,1.0,1.0,1.0,1.0,3.0,1.0,2.0,3.0,1.0,4.0,8.0,6.0,6.0,8.0,6.0,14.0,7.0,6.0,13.0,8.0,7.0,13.0,8.0,14.0,12.0,16.0,10.0,13.0,6.0,11.0,14.0,6.0,14.0,8.0,12.0,14.0,13.0,9.0,8.0,17.0,13.0,20.0,14.0,11.0,5.0,13.0,15.0,13.0,14.0,14.0,7.0,6.0,14.0,12.0,13.0,13.0,13.0,11.0,13.0,7.0,24.0,0.0,0.0,5.0,2.0,182.0,78.0,2.0,2.0,3.0,2.0,2.0,1.0,3.0,1.0,1.0,2.0,3.0,5.0,10.0,8.0,7.0,10.0,6.0,13.0,11.0,8.0,13.0,8.0,7.0,12.0,9.0,15.0,14.0,18.0,12.0,11.0,7.0,10.0,14.0,9.0,11.0,9.0,12.0,14.0,15.0,14.0,12.0,15.0,11.0,6.0,14.0,15.0,20.0,14.0,16.0,13.0,14.0,15.0,8.0,8.0,11.0,14.0,13.0,11.0,13.0,12.0,13.0,6.0,22.0,0.0,0.0,0.0,0.0,182.0,71.0,3.0,2.0,1.0,1.0,3.0,1.0,3.0,2.0,3.0,2.0,1.0,8.0,9.0,11.0,7.0,11.0,7.0,12.0,12.0,12.0,10.0,12.0,5.0,11.0,8.0,13.0,11.0,13.0,8.0,11.0,8.0,11.0,15.0,11.0,7.0,6.0,11.0,13.0,13.0,13.0,12.0,13.0,10.0,5.0,15.0,13.0,20.0,14.0,12.0,10.0,6.0,10.0,5.0,10.0,9.0,11.0,11.0,14.0,10.0,11.0,11.0,1.0,17.0,0.0,0.0,0.0,0.0,170.0,74.0,3.0,3.0,2.0,1.0,3.0,3.0,2.0,3.0,1.0,3.0,4.0,8.0,13.0,11.0,10.0,9.0,10.0,6.0,7.0,6.0,10.0,9.0,4.0,11.0,12.0,9.0,10.0,10.0,10.0,12.0,12.0,8.0,10.0,8.0,2.0,10.0,11.0,11.0,11.0,13.0,16.0,11.0,7.0,20.0,15.0,15.0,6.0,12.0,13.0,12.0,3.0,6.0,10.0,14.0,12.0,16.0,11.0,11.0,12.0,12.0,17.0,8.0,24.0,0.0,0.0,0.0,0.0,172.0,69.0,3.0,4.0,1.0,4.0,1.0,2.0,1.0,2.0,2.0,3.0,3.0,10.0,12.0,13.0,7.0,13.0,13.0,7.0,11.0,6.0,2.0,12.0,10.0,4.0,15.0,12.0,11.0,12.0,9.0,10.0,13.0,11.0,3.0,15.0,6.0,13.0,5.0,10.0,13.0,14.0,15.0,11.0,7.0,5.0,14.0,14.0,20.0,13.0,10.0,13.0,12.0,13.0,8.0,10.0,9.0,11.0,10.0,11.0,9.0,11.0,10.0,3.0,20.0,0.0,0.0,0.0,0.0,180.0,73.0,4.0,1.0,1.0,1.0,2.0,1.0,3.0,1.0,1.0,1.0,3.0,9.0,11.0,12.0,10.0,12.0,7.0,11.0,10.0,8.0,6.0,10.0,11.0,5.0,10.0,9.0,8.0,9.0,10.0,8.0,10.0,11.0,9.0,7.0,1.0,10.0,7.0,7.0,10.0,13.0,9.0,13.0,10.0,5.0,6.0,13.0,20.0,9.0,11.0,9.0,9.0,9.0,9.0,9.0,13.0,8.0,12.0,12.0,12.0,11.0,13.0,1.0,24.0,0.0,0.0,6.0,1.0,172.0,70.0,3.0,1.0,1.0,3.0,1.0,2.0,3.0,1.0,1.0,3.0,3.0,11.0,12.0,11.0,8.0,12.0,10.0,6.0,14.0,7.0,11.0,15.0,8.0,12.0,13.0,14.0,14.0,18.0,13.0,12.0,13.0,13.0,15.0,12.0,12.0,12.0,11.0,18.0,18.0,13.0,14.0,13.0,7.0,10.0,16.0,12.0,20.0,14.0,12.0,14.0,14.0,15.0,4.0,8.0,7.0,14.0,14.0,13.0,14.0,12.0,10.0,6.0,23.0,0.0,0.0,0.0,0.0,181.0,73.0,2.0,1.0,2.0,1.0,3.0,3.0,2.0,2.0,4.0,2.0,1.0,5.0,12.0,14.0,13.0,13.0,7.0,12.0,8.0,4.0,5.0,9.0,12.0,5.0,13.0,11.0,11.0,12.0,13.0,11.0,8.0,12.0,14.0,11.0,6.0,13.0,7.0,12.0,13.0,12.0,14.0,13.0,10.0,8.0,14.0,11.0,20.0,13.0,12.0,13.0,5.0,10.0,7.0,14.0,12.0,11.0,14.0,10.0,11.0,10.0,15.0,4.0,21.0,0.0,0.0,0.0,0.0,189.0,77.0,2.0,1.0,1.0,1.0,3.0,3.0,3.0,3.0,3.0,3.0,1.0,5.0,11.0,12.0,10.0,13.0,6.0,13.0,11.0,6.0,5.0,12.0,11.0,5.0,12.0,8.0,12.0,13.0,11.0,10.0,10.0,10.0,13.0,10.0,6.0,13.0,8.0,13.0,14.0,12.0,12.0,15.0,14.0,7.0,14.0,13.0,20.0,13.0,14.0,12.0,8.0,10.0,8.0,8.0,8.0,14.0,13.0,11.0,14.0,15.0,16.0,6.0,21.0,0.0,0.0,0.0,0.0,180.0,71.0,1.0,2.0,1.0,3.0,3.0,3.0,2.0,2.0,2.0,2.0,3.0,10.0,10.0,11.0,10.0,12.0,10.0,8.0,10.0,8.0,8.0,12.0,5.0,6.0,12.0,4.0,11.0,8.0,10.0,9.0,11.0,10.0,10.0,13.0,8.0,12.0,7.0,11.0,12.0,13.0,12.0,10.0,10.0,5.0,12.0,12.0,20.0,11.0,10.0,10.0,10.0,5.0,10.0,12.0,7.0,10.0,14.0,12.0,9.0,10.0,16.0,7.0
2,1,25.0,4.0,0.0,11.0,0.0,184.0,81.0,14.0,14.0,13.0,9.0,15.0,12.0,16.0,16.0,13.0,7.0,11.0,8.0,1.0,2.0,1.0,11.0,12.0,6.0,1.0,3.0,3.0,11.0,5.0,3.0,11.0,8.0,15.0,15.0,13.0,14.0,10.0,11.0,14.0,8.0,13.0,5.0,13.0,10.0,10.0,14.0,16.0,14.0,13.0,20.0,14.0,12.0,5.0,14.0,14.0,15.0,9.0,16.0,6.0,1.0,17.0,11.0,15.0,13.0,14.0,12.0,12.0,4.0,21.0,8.0,0.0,2.0,1.0,184.0,75.0,3.0,2.0,2.0,3.0,3.0,2.0,3.0,3.0,3.0,2.0,4.0,6.0,8.0,13.0,9.0,13.0,5.0,13.0,6.0,10.0,12.0,11.0,10.0,15.0,13.0,15.0,13.0,13.0,13.0,14.0,10.0,11.0,11.0,9.0,8.0,6.0,11.0,14.0,15.0,15.0,14.0,14.0,13.0,11.0,12.0,14.0,20.0,13.0,14.0,13.0,7.0,13.0,9.0,9.0,15.0,15.0,12.0,11.0,11.0,15.0,14.0,2.0,27.0,0.0,0.0,0.0,0.0,184.0,81.0,1.0,1.0,1.0,3.0,3.0,2.0,2.0,2.0,1.0,2.0,3.0,8.0,6.0,8.0,12.0,10.0,8.0,12.0,9.0,1.0,3.0,8.0,14.0,4.0,9.0,4.0,11.0,12.0,11.0,8.0,8.0,11.0,10.0,9.0,8.0,11.0,9.0,8.0,11.0,10.0,8.0,13.0,13.0,9.0,13.0,9.0,20.0,12.0,13.0,13.0,9.0,2.0,9.0,9.0,15.0,10.0,12.0,10.0,11.0,6.0,4.0,6.0,27.0,0.0,0.0,0.0,0.0,178.0,72.0,2.0,3.0,2.0,3.0,2.0,3.0,3.0,1.0,1.0,2.0,1.0,13.0,14.0,11.0,7.0,12.0,10.0,9.0,10.0,13.0,13.0,12.0,10.0,14.0,13.0,12.0,14.0,14.0,13.0,14.0,11.0,12.0,14.0,13.0,8.0,14.0,13.0,13.0,15.0,15.0,13.0,10.0,10.0,20.0,13.0,15.0,6.0,14.0,10.0,13.0,13.0,12.0,8.0,12.0,15.0,14.0,13.0,14.0,13.0,13.0,12.0,6.0,21.0,0.0,0.0,0.0,0.0,178.0,65.0,2.0,3.0,3.0,3.0,3.0,1.0,1.0,1.0,1.0,3.0,1.0,9.0,13.0,11.0,6.0,12.0,7.0,9.0,8.0,8.0,13.0,12.0,7.0,13.0,12.0,8.0,12.0,13.0,12.0,12.0,13.0,13.0,14.0,9.0,8.0,12.0,12.0,13.0,13.0,12.0,14.0,13.0,11.0,8.0,15.0,12.0,20.0,13.0,12.0,14.0,8.0,11.0,7.0,10.0,19.0,10.0,13.0,10.0,11.0,15.0,15.0,6.0,19.0,0.0,0.0,0.0,0.0,185.0,82.0,4.0,2.0,3.0,1.0,3.0,2.0,1.0,2.0,1.0,2.0,3.0,7.0,7.0,10.0,6.0,13.0,7.0,14.0,7.0,6.0,12.0,13.0,7.0,13.0,13.0,13.0,13.0,13.0,11.0,12.0,11.0,12.0,14.0,9.0,14.0,11.0,11.0,15.0,15.0,12.0,12.0,14.0,13.0,5.0,14.0,12.0,20.0,14.0,13.0,10.0,11.0,11.0,6.0,10.0,10.0,12.0,12.0,14.0,14.0,11.0,16.0,6.0,18.0,0.0,0.0,0.0,0.0,170.0,67.0,3.0,1.0,3.0,3.0,3.0,4.0,1.0,2.0,1.0,2.0,2.0,11.0,11.0,12.0,13.0,12.0,11.0,6.0,10.0,8.0,7.0,12.0,10.0,7.0,13.0,9.0,11.0,8.0,10.0,10.0,12.0,12.0,15.0,12.0,12.0,11.0,12.0,11.0,12.0,12.0,12.0,10.0,6.0,5.0,14.0,12.0,20.0,10.0,9.0,10.0,8.0,2.0,6.0,12.0,11.0,11.0,12.0,13.0,14.0,11.0,13.0,4.0,20.0,29.0,2.0,0.0,0.0,181.0,75.0,1.0,1.0,2.0,2.0,2.0,3.0,2.0,1.0,1.0,3.0,2.0,5.0,9.0,15.0,10.0,11.0,9.0,10.0,8.0,7.0,3.0,10.0,10.0,5.0,15.0,7.0,10.0,9.0,12.0,10.0,8.0,11.0,14.0,12.0,5.0,13.0,5.0,11.0,12.0,16.0,12.0,9.0,12.0,20.0,14.0,16.0,7.0,12.0,10.0,9.0,10.0,10.0,11.0,6.0,10.0,15.0,9.0,13.0,11.0,14.0,18.0,7.0,19.0,0.0,0.0,0.0,0.0,183.0,74.0,3.0,3.0,1.0,2.0,3.0,2.0,1.0,1.0,3.0,1.0,2.0,8.0,9.0,14.0,14.0,12.0,8.0,13.0,12.0,7.0,3.0,9.0,15.0,3.0,14.0,10.0,14.0,8.0,14.0,11.0,10.0,13.0,15.0,14.0,6.0,13.0,7.0,8.0,10.0,16.0,14.0,14.0,11.0,12.0,14.0,15.0,20.0,13.0,15.0,13.0,5.0,13.0,7.0,5.0,10.0,15.0,8.0,13.0,13.0,11.0,12.0,11.0,22.0,5.0,1.0,1.0,0.0,173.0,72.0,1.0,3.0,1.0,3.0,3.0,3.0,3.0,3.0,3.0,2.0,2.0,14.0,13.0,16.0,14.0,16.0,14.0,5.0,11.0,5.0,5.0,15.0,11.0,5.0,16.0,8.0,13.0,9.0,14.0,13.0,15.0,13.0,15.0,16.0,5.0,13.0,5.0,9.0,10.0,15.0,16.0,14.0,5.0,20.0,14.0,15.0,5.0,12.0,14.0,13.0,11.0,13.0,8.0,14.0,10.0,15.0,14.0,10.0,13.0,10.0,10.0,13.0,18.0,0.0,0.0,0.0,0.0,184.0,71.0,2.0,3.0,2.0,3.0,1.0,2.0,1.0,3.0,2.0,1.0,3.0,8.0,10.0,14.0,10.0,12.0,8.0,5.0,10.0,3.0,5.0,12.0,7.0,6.0,13.0,8.0,8.0,8.0,11.0,8.0,11.0,14.0,12.0,10.0,11.0,10.0,9.0,9.0,13.0,14.0,13.0,5.0,10.0,10.0,13.0,14.0,20.0,12.0,8.0,10.0,8.0,10.0,4.0,10.0,11.0,12.0,11.0,12.0,13.0,11.0,13.0,6.0,22.0,0.0,0.0,0.0,0.0,191.0,86.0,14.0,11.0,10.0,12.0,13.0,9.0,14.0,13.0,10.0,13.0,12.0,4.0,2.0,2.0,1.0,5.0,6.0,10.0,3.0,3.0,3.0,7.0,5.0,3.0,6.0,12.0,10.0,12.0,13.0,10.0,6.0,12.0,11.0,11.0,11.0,5.0,9.0,8.0,6.0,10.0,12.0,16.0,15.0,6.0,14.0,9.0,20.0,11.0,15.0,11.0,11.0,13.0,7.0,1.0,18.0,10.0,11.0,13.0,14.0,11.0,20.0,4.0,19.0,1.0,0.0,0.0,0.0,182.0,67.0,1.0,3.0,2.0,1.0,2.0,3.0,1.0,1.0,2.0,1.0,1.0,7.0,7.0,8.0,4.0,10.0,7.0,9.0,9.0,7.0,14.0,9.0,7.0,13.0,9.0,9.0,10.0,8.0,9.0,8.0,9.0,14.0,2.0,7.0,12.0,7.0,8.0,8.0,12.0,12.0,10.0,9.0,11.0,5.0,13.0,8.0,20.0,11.0,8.0,9.0,5.0,4.0,9.0,9.0,10.0,12.0,13.0,9.0,10.0,13.0,12.0,3.0,32.0,0.0,0.0,0.0,0.0,183.0,79.0,1.0,1.0,1.0,3.0,1.0,3.0,1.0,1.0,2.0,1.0,1.0,5.0,10.0,6.0,6.0,9.0,6.0,15.0,7.0,11.0,14.0,10.0,7.0,13.0,10.0,13.0,15.0,15.0,15.0,14.0,9.0,13.0,16.0,6.0,14.0,8.0,12.0,13.0,16.0,11.0,12.0,16.0,11.0,8.0,16.0,12.0,20.0,15.0,14.0,14.0,11.0,12.0,5.0,15.0,18.0,15.0,14.0,13.0,17.0,14.0,14.0,5.0,21.0,0.0,0.0,0.0,0.0,172.0,68.0,3.0,3.0,1.0,2.0,1.0,2.0,3.0,2.0,2.0,3.0,2.0,12.0,13.0,12.0,8.0,12.0,12.0,5.0,8.0,12.0,11.0,13.0,8.0,13.0,12.0,14.0,13.0,14.0,13.0,13.0,10.0,11.0,15.0,9.0,13.0,13.0,12.0,13.0,14.0,12.0,12.0,12.0,6.0,20.0,13.0,13.0,13.0,13.0,11.0,12.0,10.0,10.0,11.0,9.0,20.0,13.0,15.0,12.0,16.0,13.0,13.0,8.0,21.0,0.0,0.0,0.0,0.0,174.0,72.0,3.0,3.0,3.0,3.0,2.0,1.0,3.0,3.0,2.0,4.0,1.0,5.0,7.0,7.0,6.0,9.0,2.0,8.0,10.0,9.0,9.0,10.0,7.0,11.0,8.0,11.0,11.0,13.0,10.0,10.0,10.0,10.0,12.0,7.0,6.0,9.0,9.0,11.0,14.0,14.0,11.0,11.0,8.0,5.0,14.0,12.0,20.0,12.0,11.0,9.0,9.0,9.0,8.0,9.0,13.0,10.0,10.0,10.0,13.0,11.0,14.0,4.0,21.0,4.0,1.0,0.0,0.0,176.0,60.0,1.0,1.0,3.0,2.0,3.0,2.0,1.0,3.0,3.0,4.0,2.0,9.0,10.0,13.0,9.0,13.0,8.0,7.0,12.0,7.0,11.0,13.0,7.0,12.0,11.0,9.0,14.0,12.0,9.0,11.0,12.0,11.0,10.0,9.0,5.0,10.0,12.0,12.0,15.0,15.0,14.0,13.0,7.0,12.0,10.0,12.0,20.0,14.0,4.0,9.0,9.0,9.0,7.0,5.0,15.0,16.0,12.0,10.0,9.0,16.0,8.0,3.0,22.0,18.0,0.0,0.0,0.0,179.0,75.0,1.0,4.0,2.0,1.0,1.0,1.0,3.0,1.0,1.0,3.0,2.0,7.0,8.0,12.0,8.0,13.0,10.0,11.0,12.0,11.0,11.0,11.0,10.0,14.0,13.0,15.0,12.0,15.0,8.0,12.0,10.0,12.0,14.0,12.0,10.0,13.0,12.0,13.0,17.0,14.0,14.0,13.0,10.0,9.0,15.0,15.0,20.0,15.0,14.0,13.0,13.0,12.0,11.0,12.0,13.0,15.0,9.0,10.0,12.0,10.0,10.0,4.0,18.0,0.0,0.0,0.0,0.0,179.0,67.0,3.0,3.0,2.0,4.0,2.0,4.0,3.0,1.0,3.0,4.0,1.0,5.0,7.0,12.0,9.0,12.0,12.0,10.0,12.0,6.0,4.0,12.0,12.0,3.0,14.0,11.0,12.0,11.0,11.0,8.0,13.0,12.0,12.0,12.0,6.0,12.0,5.0,10.0,12.0,15.0,11.0,12.0,10.0,20.0,13.0,14.0,8.0,14.0,8.0,9.0,6.0,14.0,5.0,10.0,16.0,13.0,12.0,12.0,13.0,9.0,15.0,2.0,20.0,0.0,0.0,2.0,0.0,180.0,75.0,3.0,1.0,2.0,2.0,3.0,2.0,1.0,1.0,3.0,3.0,1.0,8.0,13.0,14.0,9.0,13.0,8.0,10.0,9.0,6.0,5.0,12.0,6.0,5.0,14.0,8.0,13.0,12.0,13.0,12.0,12.0,12.0,7.0,13.0,8.0,14.0,7.0,12.0,13.0,15.0,13.0,14.0,10.0,8.0,14.0,15.0,20.0,13.0,12.0,13.0,11.0,9.0,7.0,13.0,9.0,11.0,11.0,11.0,12.0,11.0,10.0,1.0,32.0,0.0,0.0,0.0,0.0,187.0,76.0,1.0,3.0,1.0,2.0,3.0,2.0,3.0,3.0,2.0,1.0,2.0,5.0,8.0,11.0,6.0,12.0,6.0,9.0,8.0,8.0,11.0,12.0,8.0,13.0,14.0,8.0,14.0,12.0,11.0,10.0,10.0,10.0,12.0,14.0,5.0,11.0,8.0,13.0,15.0,11.0,11.0,13.0,13.0,7.0,10.0,13.0,20.0,9.0,11.0,13.0,4.0,12.0,6.0,15.0,17.0,9.0,11.0,11.0,14.0,17.0,16.0,2.0,18.0,0.0,0.0,0.0,0.0,188.0,80.0,1.0,3.0,1.0,3.0,2.0,3.0,3.0,1.0,2.0,2.0,4.0,6.0,8.0,12.0,11.0,12.0,7.0,13.0,10.0,4.0,4.0,8.0,10.0,5.0,12.0,11.0,11.0,13.0,10.0,11.0,11.0,12.0,11.0,13.0,7.0,13.0,8.0,13.0,13.0,11.0,12.0,12.0,12.0,10.0,12.0,11.0,20.0,10.0,12.0,12.0,8.0,11.0,7.0,13.0,8.0,13.0,13.0,11.0,12.0,12.0,13.0,7.0
0,0,22.0,0.0,0.0,0.0,0.0,186.0,79.0,14.0,13.0,11.0,7.0,12.0,10.0,13.0,14.0,8.0,6.0,8.0,2.0,1.0,3.0,6.0,8.0,5.0,3.0,11.0,3.0,2.0,8.0,8.0,1.0,8.0,8.0,12.0,14.0,12.0,11.0,7.0,11.0,12.0,6.0,9.0,3.0,12.0,12.0,5.0,8.0,12.0,15.0,15.0,20.0,15.0,7.0,5.0,9.0,15.0,14.0,8.0,5.0,5.0,1.0,10.0,12.0,13.0,12.0,8.0,15.0,15.0,5.0,21.0,0.0,0.0,0.0,0.0,182.0,74.0,2.0,2.0,2.0,2.0,2.0,1.0,1.0,1.0,3.0,2.0,2.0,9.0,11.0,12.0,7.0,9.0,8.0,12.0,7.0,11.0,12.0,7.0,8.0,13.0,11.0,12.0,12.0,14.0,12.0,13.0,7.0,12.0,11.0,1.0,9.0,11.0,9.0,10.0,12.0,14.0,10.0,13.0,11.0,9.0,8.0,12.0,20.0,13.0,11.0,10.0,13.0,8.0,10.0,10.0,15.0,11.0,13.0,10.0,10.0,8.0,13.0,7.0,28.0,0.0,0.0,9.0,1.0,187.0,85.0,3.0,3.0,2.0,2.0,3.0,2.0,2.0,1.0,1.0,1.0,2.0,4.0,10.0,7.0,7.0,11.0,8.0,16.0,11.0,13.0,14.0,10.0,6.0,14.0,11.0,14.0,14.0,17.0,11.0,14.0,8.0,13.0,14.0,7.0,12.0,7.0,13.0,16.0,15.0,12.0,12.0,15.0,13.0,8.0,14.0,11.0,20.0,14.0,15.0,15.0,6.0,15.0,8.0,8.0,8.0,15.0,12.0,12.0,13.0,14.0,14.0,5.0,23.0,0.0,0.0,0.0,0.0,182.0,80.0,2.0,3.0,2.0,2.0,2.0,3.0,4.0,4.0,1.0,2.0,1.0,5.0,7.0,12.0,5.0,13.0,6.0,12.0,6.0,6.0,13.0,11.0,6.0,14.0,11.0,13.0,12.0,13.0,14.0,13.0,9.0,10.0,13.0,7.0,10.0,8.0,10.0,13.0,12.0,14.0,12.0,13.0,10.0,5.0,12.0,13.0,20.0,15.0,14.0,14.0,6.0,10.0,9.0,7.0,9.0,12.0,17.0,13.0,14.0,14.0,14.0,5.0,21.0,0.0,0.0,1.0,0.0,177.0,68.0,4.0,1.0,2.0,1.0,1.0,1.0,1.0,1.0,2.0,1.0,2.0,5.0,12.0,9.0,7.0,12.0,8.0,13.0,10.0,16.0,13.0,12.0,8.0,14.0,12.0,12.0,13.0,12.0,12.0,12.0,10.0,13.0,15.0,11.0,13.0,11.0,13.0,13.0,14.0,13.0,14.0,13.0,11.0,10.0,14.0,12.0,20.0,12.0,14.0,12.0,11.0,12.0,8.0,14.0,13.0,10.0,14.0,12.0,14.0,12.0,11.0,5.0,17.0,0.0,0.0,0.0,0.0,173.0,0.0,2.0,1.0,3.0,1.0,2.0,3.0,1.0,3.0,2.0,1.0,2.0,3.0,5.0,7.0,6.0,8.0,2.0,8.0,1.0,8.0,10.0,7.0,4.0,15.0,10.0,9.0,7.0,10.0,7.0,6.0,5.0,8.0,9.0,5.0,12.0,8.0,6.0,9.0,9.0,15.0,15.0,9.0,7.0,20.0,14.0,15.0,5.0,7.0,8.0,9.0,9.0,9.0,9.0,9.0,18.0,8.0,10.0,11.0,11.0,8.0,12.0,4.0,27.0,32.0,6.0,0.0,0.0,188.0,78.0,3.0,2.0,3.0,2.0,1.0,3.0,3.0,3.0,2.0,2.0,2.0,4.0,8.0,11.0,12.0,12.0,6.0,16.0,13.0,8.0,13.0,14.0,7.0,12.0,12.0,12.0,10.0,14.0,13.0,12.0,11.0,12.0,15.0,9.0,11.0,12.0,6.0,13.0,12.0,14.0,13.0,15.0,15.0,5.0,13.0,12.0,20.0,16.0,15.0,14.0,12.0,15.0,11.0,10.0,9.0,15.0,12.0,12.0,13.0,13.0,13.0,7.0,21.0,0.0,0.0,0.0,0.0,180.0,68.0,4.0,1.0,1.0,1.0,1.0,3.0,1.0,2.0,2.0,2.0,3.0,10.0,10.0,13.0,9.0,13.0,9.0,8.0,8.0,6.0,11.0,13.0,10.0,10.0,12.0,8.0,8.0,8.0,11.0,10.0,13.0,10.0,20.0,13.0,6.0,9.0,9.0,7.0,10.0,14.0,14.0,13.0,10.0,10.0,10.0,14.0,20.0,12.0,11.0,10.0,10.0,7.0,6.0,13.0,17.0,12.0,10.0,12.0,12.0,8.0,10.0,2.0,27.0,1.0,0.0,0.0,0.0,179.0,70.0,3.0,2.0,1.0,3.0,3.0,2.0,1.0,3.0,2.0,1.0,1.0,14.0,15.0,15.0,11.0,15.0,14.0,8.0,12.0,5.0,8.0,13.0,12.0,9.0,18.0,11.0,11.0,11.0,9.0,10.0,16.0,10.0,17.0,15.0,8.0,12.0,8.0,12.0,11.0,14.0,13.0,12.0,10.0,12.0,13.0,14.0,20.0,16.0,12.0,10.0,9.0,10.0,7.0,8.0,13.0,15.0,13.0,10.0,11.0,12.0,10.0,8.0,21.0,0.0,0.0,4.0,1.0,184.0,79.0,1.0,2.0,3.0,1.0,2.0,1.0,3.0,2.0,2.0,1.0,3.0,3.0,6.0,10.0,12.0,12.0,7.0,15.0,8.0,4.0,5.0,13.0,10.0,8.0,12.0,18.0,12.0,19.0,13.0,10.0,13.0,12.0,14.0,13.0,10.0,12.0,9.0,16.0,15.0,12.0,14.0,14.0,14.0,12.0,13.0,10.0,20.0,14.0,14.0,11.0,14.0,14.0,11.0,5.0,10.0,13.0,14.0,15.0,10.0,8.0,4.0,15.0,23.0,15.0,5.0,0.0,0.0,186.0,81.0,3.0,1.0,1.0,4.0,1.0,1.0,2.0,2.0,3.0,3.0,4.0,5.0,10.0,13.0,14.0,10.0,5.0,11.0,13.0,5.0,4.0,9.0,10.0,4.0,10.0,13.0,11.0,14.0,12.0,9.0,8.0,8.0,15.0,13.0,7.0,8.0,7.0,10.0,10.0,15.0,12.0,15.0,12.0,7.0,10.0,18.0,20.0,17.0,15.0,8.0,8.0,11.0,12.0,12.0,12.0,15.0,13.0,12.0,15.0,13.0,13.0,6.0,24.0,0.0,0.0,3.0,0.0,191.0,75.0,11.0,12.0,12.0,11.0,12.0,14.0,15.0,16.0,11.0,13.0,13.0,2.0,3.0,3.0,1.0,11.0,2.0,9.0,3.0,2.0,2.0,11.0,1.0,3.0,10.0,9.0,13.0,14.0,13.0,14.0,8.0,11.0,15.0,1.0,10.0,1.0,12.0,12.0,10.0,12.0,12.0,11.0,15.0,8.0,11.0,13.0,20.0,14.0,12.0,14.0,11.0,11.0,11.0,11.0,12.0,15.0,14.0,12.0,12.0,10.0,11.0,7.0,26.0,8.0,0.0,0.0,0.0,189.0,84.0,3.0,2.0,1.0,1.0,3.0,2.0,3.0,1.0,2.0,1.0,1.0,5.0,8.0,9.0,6.0,10.0,5.0,13.0,6.0,11.0,14.0,9.0,9.0,14.0,12.0,14.0,13.0,17.0,14.0,12.0,8.0,10.0,15.0,8.0,11.0,7.0,14.0,15.0,15.0,10.0,9.0,14.0,15.0,20.0,15.0,12.0,9.0,14.0,16.0,12.0,14.0,10.0,7.0,8.0,15.0,17.0,7.0,13.0,14.0,8.0,10.0,10.0,16.0,0.0,0.0,0.0,0.0,177.0,0.0,3.0,2.0,1.0,1.0,3.0,3.0,2.0,2.0,2.0,1.0,3.0,1.0,3.0,2.0,2.0,4.0,1.0,3.0,1.0,6.0,9.0,2.0,1.0,9.0,6.0,14.0,4.0,5.0,5.0,3.0,2.0,5.0,4.0,5.0,7.0,4.0,8.0,4.0,3.0,10.0,7.0,13.0,7.0,15.0,13.0,9.0,20.0,5.0,8.0,7.0,11.0,5.0,8.0,8.0,11.0,11.0,5.0,14.0,20.0,7.0,12.0,5.0,24.0,0.0,0.0,0.0,0.0,178.0,77.0,2.0,1.0,3.0,2.0,1.0,3.0,3.0,3.0,1.0,3.0,2.0,5.0,10.0,8.0,5.0,9.0,6.0,11.0,8.0,12.0,11.0,8.0,6.0,12.0,9.0,11.0,11.0,13.0,11.0,12.0,7.0,11.0,15.0,9.0,6.0,9.0,11.0,12.0,14.0,16.0,12.0,14.0,10.0,5.0,15.0,15.0,20.0,14.0,13.0,14.0,11.0,13.0,5.0,8.0,17.0,12.0,14.0,14.0,14.0,14.0,14.0,6.0,19.0,0.0,0.0,0.0,0.0,184.0,70.0,3.0,2.0,2.0,2.0,3.0,2.0,2.0,1.0,3.0,3.0,3.0,4.0,7.0,4.0,6.0,13.0,7.0,7.0,7.0,1.0,7.0,10.0,3.0,9.0,10.0,9.0,7.0,6.0,9.0,8.0,14.0,7.0,12.0,9.0,10.0,8.0,7.0,8.0,10.0,14.0,10.0,8.0,10.0,12.0,9.0,11.0,20.0,9.0,7.0,9.0,9.0,7.0,9.0,9.0,10.0,12.0,13.0,14.0,11.0,11.0,12.0,7.0,22.0,5.0,0.0,9.0,2.0,181.0,73.0,3.0,1.0,2.0,1.0,3.0,2.0,2.0,3.0,3.0,1.0,1.0,12.0,13.0,12.0,7.0,14.0,12.0,9.0,11.0,6.0,7.0,14.0,10.0,8.0,15.0,13.0,11.0,12.0,13.0,12.0,15.0,12.0,12.0,11.0,10.0,11.0,11.0,14.0,13.0,11.0,13.0,14.0,10.0,10.0,16.0,12.0,20.0,14.0,12.0,12.0,11.0,14.0,9.0,8.0,12.0,13.0,16.0,12.0,14.0,13.0,14.0,5.0,18.0,0.0,0.0,0.0,0.0,193.0,88.0,3.0,2.0,1.0,2.0,2.0,2.0,1.0,1.0,1.0,2.0,2.0,5.0,7.0,5.0,7.0,14.0,9.0,9.0,12.0,6.0,8.0,14.0,3.0,11.0,10.0,10.0,11.0,10.0,5.0,11.0,8.0,11.0,6.0,6.0,8.0,9.0,12.0,10.0,14.0,13.0,10.0,13.0,16.0,5.0,15.0,12.0,20.0,13.0,13.0,10.0,10.0,10.0,10.0,10.0,20.0,9.0,11.0,11.0,11.0,13.0,15.0,8.0,29.0,0.0,0.0,0.0,0.0,180.0,74.0,2.0,1.0,3.0,3.0,2.0,4.0,1.0,3.0,3.0,2.0,2.0,9.0,13.0,13.0,10.0,14.0,10.0,12.0,12.0,6.0,8.0,12.0,8.0,8.0,14.0,10.0,13.0,14.0,13.0,12.0,13.0,11.0,13.0,11.0,7.0,10.0,10.0,14.0,14.0,14.0,13.0,13.0,12.0,10.0,14.0,13.0,20.0,14.0,11.0,14.0,10.0,15.0,8.0,10.0,8.0,12.0,14.0,16.0,14.0,15.0,15.0,6.0,22.0,0.0,0.0,0.0,0.0,177.0,72.0,2.0,1.0,2.0,4.0,2.0,2.0,1.0,3.0,4.0,2.0,3.0,10.0,12.0,13.0,11.0,12.0,10.0,12.0,12.0,4.0,10.0,13.0,11.0,11.0,13.0,11.0,12.0,11.0,13.0,9.0,13.0,12.0,3.0,12.0,8.0,14.0,12.0,12.0,13.0,16.0,13.0,12.0,9.0,8.0,15.0,14.0,20.0,14.0,13.0,10.0,4.0,11.0,11.0,12.0,19.0,9.0,12.0,13.0,12.0,11.0,14.0,7.0,28.0,0.0,0.0,0.0,0.0,181.0,75.0,4.0,2.0,1.0,3.0,3.0,3.0,2.0,2.0,2.0,2.0,2.0,13.0,12.0,12.0,9.0,12.0,13.0,7.0,11.0,7.0,7.0,13.0,5.0,7.0,13.0,9.0,13.0,3.0,12.0,11.0,12.0,12.0,3.0,12.0,14.0,12.0,9.0,12.0,13.0,13.0,13.0,10.0,11.0,20.0,13.0,12.0,6.0,13.0,9.0,13.0,6.0,13.0,8.0,10.0,20.0,12.0,14.0,11.0,13.0,10.0,11.0,4.0,22.0,0.0,0.0,0.0,0.0,194.0,80.0,3.0,2.0,2.0,3.0,2.0,3.0,3.0,2.0,2.0,2.0,2.0,3.0,7.0,9.0,12.0,11.0,6.0,13.0,10.0,5.0,5.0,9.0,13.0,2.0,11.0,8.0,13.0,5.0,12.0,10.0,8.0,11.0,5.0,13.0,7.0,10.0,6.0,13.0,12.0,11.0,10.0,14.0,16.0,20.0,14.0,10.0,6.0,13.0,14.0,10.0,8.0,7.0,8.0,8.0,18.0,12.0,12.0,9.0,13.0,11.0,11.0,8.0
1,0,22.0,0.0,0.0,0.0,0.0,191.0,86.0,14.0,11.0,10.0,12.0,13.0,9.0,14.0,13.0,10.0,13.0,12.0,4.0,2.0,2.0,1.0,5.0,6.0,10.0,3.0,3.0,3.0,7.0,5.0,3.0,6.0,12.0,10.0,12.0,13.0,10.0,6.0,12.0,11.0,11.0,11.0,5.0,9.0,8.0,6.0,10.0,12.0,16.0,15.0,6.0,14.0,9.0,20.0,11.0,15.0,11.0,11.0,13.0,7.0,1.0,18.0,10.0,11.0,13.0,14.0,11.0,20.0,4.0,32.0,0.0,0.0,0.0,0.0,183.0,79.0,1.0,1.0,1.0,3.0,1.0,3.0,1.0,1.0,2.0,1.0,1.0,5.0,10.0,6.0,6.0,9.0,6.0,15.0,7.0,11.0,14.0,10.0,7.0,13.0,10.0,13.0,15.0,15.0,15.0,14.0,9.0,13.0,16.0,6.0,14.0,8.0,12.0,13.0,16.0,11.0,12.0,16.0,11.0,8.0,16.0,12.0,20.0,15.0,14.0,14.0,11.0,12.0,5.0,15.0,18.0,15.0,14.0,13.0,17.0,14.0,14.0,5.0,19.0,1.0,0.0,0.0,0.0,182.0,67.0,1.0,3.0,2.0,1.0,2.0,3.0,1.0,1.0,2.0,1.0,1.0,7.0,7.0,8.0,4.0,10.0,7.0,9.0,9.0,7.0,14.0,9.0,7.0,13.0,9.0,9.0,10.0,8.0,9.0,8.0,9.0,14.0,2.0,7.0,12.0,7.0,8.0,8.0,12.0,12.0,10.0,9.0,11.0,5.0,13.0,8.0,20.0,11.0,8.0,9.0,5.0,4.0,9.0,9.0,10.0,12.0,13.0,9.0,10.0,13.0,12.0,3.0,21.0,0.0,0.0,0.0,0.0,172.0,68.0,3.0,3.0,1.0,2.0,1.0,2.0,3.0,2.0,2.0,3.0,2.0,12.0,13.0,12.0,8.0,12.0,12.0,5.0,8.0,12.0,11.0,13.0,8.0,13.0,12.0,14.0,13.0,14.0,13.0,13.0,10.0,11.0,15.0,9.0,13.0,13.0,12.0,13.0,14.0,12.0,12.0,12.0,6.0,20.0,13.0,13.0,13.0,13.0,11.0,12.0,10.0,10.0,11.0,9.0,20.0,13.0,15.0,12.0,16.0,13.0,13.0,8.0,21.0,0.0,0.0,0.0,0.0,174.0,72.0,3.0,3.0,3.0,3.0,2.0,1.0,3.0,3.0,2.0,4.0,1.0,5.0,7.0,7.0,6.0,9.0,2.0,8.0,10.0,9.0,9.0,10.0,7.0,11.0,8.0,11.0,11.0,13.0,10.0,10.0,10.0,10.0,12.0,7.0,6.0,9.0,9.0,11.0,14.0,14.0,11.0,11.0,8.0,5.0,14.0,12.0,20.0,12.0,11.0,9.0,9.0,9.0,8.0,9.0,13.0,10.0,10.0,10.0,13.0,11.0,14.0,4.0,21.0,4.0,1.0,0.0,0.0,176.0,60.0,1.0,1.0,3.0,2.0,3.0,2.0,1.0,3.0,3.0,4.0,2.0,9.0,10.0,13.0,9.0,13.0,8.0,7.0,12.0,7.0,11.0,13.0,7.0,12.0,11.0,9.0,14.0,12.0,9.0,11.0,12.0,11.0,10.0,9.0,5.0,10.0,12.0,12.0,15.0,15.0,14.0,13.0,7.0,12.0,10.0,12.0,20.0,14.0,4.0,9.0,9.0,9.0,7.0,5.0,15.0,16.0,12.0,10.0,9.0,16.0,8.0,3.0,22.0,18.0,0.0,0.0,0.0,179.0,75.0,1.0,4.0,2.0,1.0,1.0,1.0,3.0,1.0,1.0,3.0,2.0,7.0,8.0,12.0,8.0,13.0,10.0,11.0,12.0,11.0,11.0,11.0,10.0,14.0,13.0,15.0,12.0,15.0,8.0,12.0,10.0,12.0,14.0,12.0,10.0,13.0,12.0,13.0,17.0,14.0,14.0,13.0,10.0,9.0,15.0,15.0,20.0,15.0,14.0,13.0,13.0,12.0,11.0,12.0,13.0,15.0,9.0,10.0,12.0,10.0,10.0,4.0,27.0,0.0,0.0,0.0,0.0,188.0,77.0,1.0,4.0,1.0,1.0,3.0,1.0,2.0,1.0,2.0,2.0,2.0,4.0,7.0,8.0,7.0,13.0,6.0,15.0,9.0,6.0,13.0,12.0,6.0,12.0,11.0,14.0,14.0,15.0,10.0,12.0,11.0,13.0,16.0,7.0,12.0,9.0,12.0,15.0,16.0,14.0,10.0,14.0,15.0,9.0,13.0,12.0,20.0,14.0,16.0,12.0,14.0,13.0,6.0,12.0,4.0,13.0,18.0,13.0,14.0,14.0,13.0,7.0,25.0,0.0,0.0,3.0,2.0,170.0,61.0,2.0,3.0,2.0,2.0,1.0,3.0,2.0,2.0,1.0,2.0,1.0,11.0,12.0,13.0,10.0,13.0,8.0,5.0,8.0,7.0,4.0,14.0,10.0,4.0,15.0,11.0,10.0,9.0,7.0,10.0,14.0,8.0,13.0,13.0,6.0,12.0,8.0,8.0,12.0,16.0,14.0,7.0,5.0,12.0,15.0,16.0,20.0,14.0,6.0,12.0,11.0,13.0,8.0,8.0,8.0,13.0,15.0,10.0,10.0,14.0,14.0,8.0,32.0,0.0,0.0,0.0,0.0,187.0,76.0,1.0,3.0,1.0,2.0,3.0,2.0,3.0,3.0,2.0,1.0,2.0,5.0,8.0,11.0,6.0,12.0,6.0,9.0,8.0,8.0,11.0,12.0,8.0,13.0,14.0,8.0,14.0,12.0,11.0,10.0,10.0,10.0,12.0,14.0,5.0,11.0,8.0,13.0,15.0,11.0,11.0,13.0,13.0,7.0,10.0,13.0,20.0,9.0,11.0,13.0,4.0,12.0,6.0,15.0,17.0,9.0,11.0,11.0,14.0,17.0,16.0,2.0,18.0,0.0,0.0,0.0,0.0,188.0,80.0,1.0,3.0,1.0,3.0,2.0,3.0,3.0,1.0,2.0,2.0,4.0,6.0,8.0,12.0,11.0,12.0,7.0,13.0,10.0,4.0,4.0,8.0,10.0,5.0,12.0,11.0,11.0,13.0,10.0,11.0,11.0,12.0,11.0,13.0,7.0,13.0,8.0,13.0,13.0,11.0,12.0,12.0,12.0,10.0,12.0,11.0,20.0,10.0,12.0,12.0,8.0,11.0,7.0,13.0,8.0,13.0,13.0,11.0,12.0,12.0,13.0,7.0,33.0,0.0,0.0,3.0,0.0,188.0,84.0,14.0,13.0,13.0,9.0,13.0,13.0,15.0,15.0,11.0,11.0,9.0,7.0,3.0,3.0,1.0,7.0,10.0,2.0,1.0,1.0,2.0,6.0,4.0,1.0,7.0,8.0,13.0,14.0,14.0,14.0,8.0,11.0,15.0,6.0,13.0,3.0,13.0,12.0,8.0,12.0,14.0,15.0,14.0,8.0,13.0,11.0,20.0,13.0,15.0,16.0,8.0,13.0,6.0,1.0,11.0,14.0,13.0,11.0,16.0,14.0,11.0,6.0,29.0,2.0,0.0,0.0,0.0,185.0,75.0,2.0,3.0,3.0,3.0,2.0,3.0,2.0,1.0,3.0,1.0,2.0,4.0,10.0,8.0,6.0,10.0,6.0,14.0,7.0,7.0,14.0,11.0,6.0,14.0,9.0,13.0,13.0,14.0,11.0,12.0,12.0,12.0,14.0,8.0,11.0,12.0,13.0,13.0,13.0,15.0,12.0,15.0,12.0,8.0,15.0,13.0,20.0,14.0,15.0,14.0,7.0,14.0,8.0,6.0,14.0,13.0,15.0,14.0,14.0,14.0,14.0,6.0,26.0,0.0,0.0,10.0,1.0,196.0,91.0,3.0,1.0,2.0,2.0,2.0,3.0,2.0,4.0,2.0,2.0,1.0,3.0,5.0,8.0,6.0,9.0,5.0,14.0,7.0,8.0,13.0,10.0,5.0,12.0,10.0,10.0,13.0,14.0,12.0,12.0,7.0,10.0,13.0,6.0,9.0,6.0,12.0,14.0,10.0,9.0,8.0,13.0,18.0,8.0,17.0,11.0,20.0,12.0,16.0,13.0,12.0,10.0,7.0,4.0,18.0,10.0,12.0,9.0,13.0,7.0,10.0,7.0,28.0,0.0,0.0,0.0,0.0,193.0,84.0,1.0,1.0,2.0,2.0,2.0,3.0,2.0,3.0,2.0,1.0,3.0,4.0,8.0,8.0,9.0,10.0,6.0,14.0,7.0,8.0,14.0,12.0,6.0,14.0,11.0,12.0,13.0,14.0,11.0,14.0,12.0,12.0,14.0,6.0,11.0,8.0,14.0,13.0,13.0,11.0,11.0,16.0,16.0,20.0,12.0,12.0,8.0,14.0,16.0,14.0,12.0,13.0,6.0,10.0,7.0,12.0,15.0,12.0,16.0,15.0,13.0,6.0,26.0,0.0,0.0,0.0,0.0,175.0,69.0,3.0,3.0,2.0,2.0,3.0,1.0,3.0,1.0,3.0,2.0,2.0,6.0,12.0,10.0,5.0,11.0,6.0,10.0,10.0,10.0,13.0,12.0,9.0,13.0,12.0,12.0,13.0,14.0,12.0,13.0,12.0,11.0,15.0,11.0,13.0,12.0,13.0,14.0,14.0,15.0,13.0,12.0,7.0,9.0,13.0,13.0,20.0,14.0,11.0,14.0,12.0,12.0,11.0,15.0,14.0,9.0,17.0,10.0,8.0,11.0,20.0,7.0,26.0,0.0,0.0,0.0,0.0,182.0,68.0,1.0,4.0,3.0,2.0,3.0,1.0,2.0,1.0,2.0,4.0,1.0,7.0,12.0,9.0,5.0,10.0,6.0,12.0,7.0,15.0,12.0,9.0,6.0,12.0,10.0,12.0,13.0,14.0,11.0,10.0,9.0,9.0,13.0,7.0,6.0,10.0,10.0,14.0,15.0,16.0,13.0,13.0,11.0,5.0,15.0,15.0,20.0,14.0,10.0,12.0,12.0,13.0,7.0,12.0,12.0,14.0,14.0,15.0,13.0,14.0,14.0,7.0,21.0,0.0,0.0,0.0,0.0,183.0,73.0,1.0,4.0,3.0,3.0,3.0,1.0,4.0,1.0,2.0,3.0,2.0,11.0,10.0,12.0,11.0,13.0,9.0,12.0,10.0,5.0,8.0,12.0,9.0,8.0,13.0,13.0,12.0,12.0,10.0,12.0,14.0,12.0,12.0,14.0,8.0,12.0,8.0,12.0,12.0,14.0,14.0,14.0,11.0,8.0,13.0,13.0,20.0,12.0,12.0,12.0,5.0,10.0,7.0,12.0,15.0,11.0,11.0,10.0,11.0,12.0,11.0,4.0,30.0,9.0,1.0,0.0,0.0,192.0,90.0,2.0,2.0,2.0,2.0,3.0,1.0,3.0,4.0,1.0,1.0,3.0,4.0,7.0,10.0,10.0,9.0,8.0,17.0,12.0,6.0,13.0,12.0,8.0,12.0,11.0,13.0,14.0,15.0,13.0,13.0,10.0,12.0,14.0,12.0,13.0,13.0,12.0,14.0,16.0,12.0,12.0,18.0,16.0,8.0,14.0,13.0,20.0,16.0,18.0,13.0,13.0,14.0,7.0,12.0,13.0,13.0,13.0,13.0,13.0,13.0,13.0,6.0,19.0,0.0,0.0,0.0,0.0,185.0,80.0,3.0,2.0,2.0,3.0,3.0,4.0,3.0,3.0,3.0,2.0,1.0,8.0,12.0,13.0,8.0,12.0,13.0,12.0,9.0,6.0,12.0,13.0,9.0,13.0,12.0,12.0,13.0,12.0,12.0,10.0,12.0,12.0,4.0,13.0,8.0,12.0,8.0,12.0,14.0,13.0,14.0,12.0,11.0,5.0,15.0,14.0,20.0,13.0,13.0,12.0,10.0,9.0,11.0,15.0,15.0,9.0,10.0,9.0,12.0,11.0,10.0,5.0,23.0,0.0,0.0,0.0,0.0,175.0,70.0,2.0,1.0,2.0,2.0,1.0,2.0,2.0,3.0,4.0,1.0,2.0,10.0,11.0,12.0,9.0,13.0,8.0,6.0,13.0,2.0,5.0,13.0,10.0,6.0,13.0,7.0,13.0,9.0,13.0,11.0,13.0,12.0,13.0,12.0,10.0,12.0,10.0,13.0,12.0,11.0,12.0,13.0,8.0,8.0,14.0,12.0,20.0,14.0,12.0,13.0,9.0,11.0,10.0,11.0,19.0,12.0,14.0,11.0,13.0,10.0,16.0,7.0,24.0,0.0,0.0,4.0,0.0,181.0,79.0,1.0,3.0,2.0,2.0,1.0,1.0,1.0,2.0,2.0,2.0,1.0,4.0,6.0,10.0,11.0,11.0,7.0,12.0,10.0,5.0,5.0,7.0,13.0,3.0,10.0,9.0,12.0,12.0,11.0,10.0,6.0,10.0,8.0,9.0,5.0,11.0,5.0,9.0,12.0,15.0,13.0,13.0,11.0,5.0,11.0,14.0,20.0,13.0,14.0,11.0,9.0,12.0,13.0,5.0,19.0,11.0,9.0,9.0,7.0,14.0,14.0,13.0
0,0,22.0,0.0,0.0,0.0,0.0,191.0,86.0,14.0,11.0,10.0,12.0,13.0,9.0,14.0,13.0,10.0,13.0,12.0,4.0,2.0,2.0,1.0,5.0,6.0,10.0,3.0,3.0,3.0,7.0,5.0,3.0,6.0,12.0,10.0,12.0,13.0,10.0,6.0,12.0,11.0,11.0,11.0,5.0,9.0,8.0,6.0,10.0,12.0,16.0,15.0,6.0,14.0,9.0,20.0,11.0,15.0,11.0,11.0,13.0,7.0,1.0,18.0,10.0,11.0,13.0,14.0,11.0,20.0,4.0,32.0,0.0,0.0,0.0,0.0,183.0,79.0,1.0,1.0,1.0,3.0,1.0,3.0,1.0,1.0,2.0,1.0,1.0,5.0,10.0,6.0,6.0,9.0,6.0,15.0,7.0,11.0,14.0,10.0,7.0,13.0,10.0,13.0,15.0,15.0,15.0,14.0,9.0,13.0,16.0,6.0,14.0,8.0,12.0,13.0,16.0,11.0,12.0,16.0,11.0,8.0,16.0,12.0,20.0,15.0,14.0,14.0,11.0,12.0,5.0,15.0,18.0,15.0,14.0,13.0,17.0,14.0,14.0,5.0,19.0,1.0,0.0,0.0,0.0,182.0,67.0,1.0,3.0,2.0,1.0,2.0,3.0,1.0,1.0,2.0,1.0,1.0,7.0,7.0,8.0,4.0,10.0,7.0,9.0,9.0,7.0,14.0,9.0,7.0,13.0,9.0,9.0,10.0,8.0,9.0,8.0,9.0,14.0,2.0,7.0,12.0,7.0,8.0,8.0,12.0,12.0,10.0,9.0,11.0,5.0,13.0,8.0,20.0,11.0,8.0,9.0,5.0,4.0,9.0,9.0,10.0,12.0,13.0,9.0,10.0,13.0,12.0,3.0,21.0,0.0,0.0,0.0,0.0,172.0,68.0,3.0,3.0,1.0,2.0,1.0,2.0,3.0,2.0,2.0,3.0,2.0,12.0,13.0,12.0,8.0,12.0,12.0,5.0,8.0,12.0,11.0,13.0,8.0,13.0,12.0,14.0,13.0,14.0,13.0,13.0,10.0,11.0,15.0,9.0,13.0,13.0,12.0,13.0,14.0,12.0,12.0,12.0,6.0,20.0,13.0,13.0,13.0,13.0,11.0,12.0,10.0,10.0,11.0,9.0,20.0,13.0,15.0,12.0,16.0,13.0,13.0,8.0,21.0,0.0,0.0,0.0,0.0,174.0,72.0,3.0,3.0,3.0,3.0,2.0,1.0,3.0,3.0,2.0,4.0,1.0,5.0,7.0,7.0,6.0,9.0,2.0,8.0,10.0,9.0,9.0,10.0,7.0,11.0,8.0,11.0,11.0,13.0,10.0,10.0,10.0,10.0,12.0,7.0,6.0,9.0,9.0,11.0,14.0,14.0,11.0,11.0,8.0,5.0,14.0,12.0,20.0,12.0,11.0,9.0,9.0,9.0,8.0,9.0,13.0,10.0,10.0,10.0,13.0,11.0,14.0,4.0,21.0,4.0,1.0,0.0,0.0,176.0,60.0,1.0,1.0,3.0,2.0,3.0,2.0,1.0,3.0,3.0,4.0,2.0,9.0,10.0,13.0,9.0,13.0,8.0,7.0,12.0,7.0,11.0,13.0,7.0,12.0,11.0,9.0,14.0,12.0,9.0,11.0,12.0,11.0,10.0,9.0,5.0,10.0,12.0,12.0,15.0,15.0,14.0,13.0,7.0,12.0,10.0,12.0,20.0,14.0,4.0,9.0,9.0,9.0,7.0,5.0,15.0,16.0,12.0,10.0,9.0,16.0,8.0,3.0,27.0,0.0,0.0,0.0,0.0,188.0,77.0,1.0,4.0,1.0,1.0,3.0,1.0,2.0,1.0,2.0,2.0,2.0,4.0,7.0,8.0,7.0,13.0,6.0,15.0,9.0,6.0,13.0,12.0,6.0,12.0,11.0,14.0,14.0,15.0,10.0,12.0,11.0,13.0,16.0,7.0,12.0,9.0,12.0,15.0,16.0,14.0,10.0,14.0,15.0,9.0,13.0,12.0,20.0,14.0,16.0,12.0,14.0,13.0,6.0,12.0,4.0,13.0,18.0,13.0,14.0,14.0,13.0,7.0,20.0,0.0,0.0,2.0,0.0,180.0,75.0,3.0,1.0,2.0,2.0,3.0,2.0,1.0,1.0,3.0,3.0,1.0,8.0,13.0,14.0,9.0,13.0,8.0,10.0,9.0,6.0,5.0,12.0,6.0,5.0,14.0,8.0,13.0,12.0,13.0,12.0,12.0,12.0,7.0,13.0,8.0,14.0,7.0,12.0,13.0,15.0,13.0,14.0,10.0,8.0,14.0,15.0,20.0,13.0,12.0,13.0,11.0,9.0,7.0,13.0,9.0,11.0,11.0,11.0,12.0,11.0,10.0,1.0,25.0,0.0,0.0,3.0,2.0,170.0,61.0,2.0,3.0,2.0,2.0,1.0,3.0,2.0,2.0,1.0,2.0,1.0,11.0,12.0,13.0,10.0,13.0,8.0,5.0,8.0,7.0,4.0,14.0,10.0,4.0,15.0,11.0,10.0,9.0,7.0,10.0,14.0,8.0,13.0,13.0,6.0,12.0,8.0,8.0,12.0,16.0,14.0,7.0,5.0,12.0,15.0,16.0,20.0,14.0,6.0,12.0,11.0,13.0,8.0,8.0,8.0,13.0,15.0,10.0,10.0,14.0,14.0,8.0,18.0,0.0,0.0,0.0,0.0,179.0,67.0,3.0,3.0,2.0,4.0,2.0,4.0,3.0,1.0,3.0,4.0,1.0,5.0,7.0,12.0,9.0,12.0,12.0,10.0,12.0,6.0,4.0,12.0,12.0,3.0,14.0,11.0,12.0,11.0,11.0,8.0,13.0,12.0,12.0,12.0,6.0,12.0,5.0,10.0,12.0,15.0,11.0,12.0,10.0,20.0,13.0,14.0,8.0,14.0,8.0,9.0,6.0,14.0,5.0,10.0,16.0,13.0,12.0,12.0,13.0,9.0,15.0,2.0,28.0,0.0,0.0,2.0,2.0,182.0,79.0,1.0,1.0,2.0,2.0,3.0,1.0,2.0,3.0,1.0,2.0,2.0,8.0,11.0,14.0,12.0,14.0,11.0,12.0,13.0,6.0,4.0,11.0,13.0,5.0,14.0,11.0,12.0,13.0,10.0,12.0,11.0,11.0,15.0,13.0,7.0,14.0,7.0,12.0,14.0,15.0,14.0,14.0,12.0,8.0,15.0,14.0,20.0,15.0,14.0,12.0,11.0,15.0,8.0,8.0,16.0,15.0,12.0,11.0,14.0,13.0,12.0,8.0,30.0,42.0,0.0,13.0,0.0,195.0,88.0,16.0,13.0,14.0,6.0,14.0,13.0,13.0,15.0,12.0,10.0,14.0,1.0,8.0,5.0,2.0,8.0,2.0,8.0,2.0,5.0,3.0,9.0,5.0,3.0,8.0,10.0,12.0,10.0,14.0,10.0,10.0,14.0,13.0,3.0,14.0,3.0,12.0,14.0,12.0,8.0,13.0,18.0,18.0,17.0,14.0,11.0,20.0,14.0,17.0,14.0,4.0,14.0,4.0,1.0,12.0,13.0,14.0,9.0,15.0,13.0,13.0,5.0,22.0,0.0,0.0,3.0,1.0,180.0,80.0,1.0,1.0,2.0,3.0,1.0,2.0,3.0,3.0,3.0,3.0,1.0,7.0,9.0,10.0,6.0,10.0,8.0,12.0,8.0,10.0,11.0,10.0,9.0,14.0,12.0,13.0,11.0,11.0,11.0,10.0,8.0,10.0,3.0,9.0,9.0,9.0,10.0,12.0,11.0,14.0,15.0,10.0,10.0,8.0,12.0,12.0,20.0,11.0,9.0,13.0,12.0,10.0,10.0,16.0,14.0,15.0,10.0,12.0,12.0,11.0,11.0,5.0,28.0,0.0,0.0,0.0,0.0,190.0,85.0,3.0,2.0,3.0,3.0,2.0,2.0,2.0,4.0,3.0,1.0,2.0,5.0,9.0,8.0,9.0,8.0,7.0,14.0,10.0,9.0,15.0,9.0,6.0,14.0,9.0,16.0,13.0,16.0,10.0,13.0,10.0,12.0,15.0,6.0,13.0,7.0,13.0,14.0,16.0,12.0,11.0,17.0,13.0,20.0,15.0,13.0,8.0,15.0,15.0,12.0,14.0,14.0,9.0,8.0,14.0,13.0,14.0,11.0,12.0,13.0,16.0,14.0,24.0,0.0,0.0,0.0,0.0,185.0,77.0,1.0,1.0,3.0,2.0,1.0,1.0,3.0,1.0,3.0,3.0,1.0,7.0,10.0,12.0,11.0,12.0,12.0,14.0,13.0,7.0,13.0,12.0,8.0,14.0,12.0,10.0,13.0,11.0,13.0,13.0,12.0,13.0,16.0,10.0,8.0,12.0,13.0,13.0,13.0,14.0,14.0,12.0,14.0,12.0,14.0,13.0,20.0,11.0,12.0,12.0,12.0,10.0,11.0,7.0,17.0,11.0,10.0,10.0,10.0,7.0,8.0,5.0,28.0,0.0,0.0,0.0,0.0,174.0,67.0,3.0,4.0,1.0,1.0,1.0,3.0,1.0,3.0,2.0,1.0,2.0,11.0,8.0,11.0,9.0,13.0,6.0,7.0,12.0,8.0,10.0,10.0,3.0,6.0,12.0,10.0,13.0,7.0,12.0,8.0,10.0,9.0,12.0,13.0,5.0,12.0,9.0,12.0,11.0,14.0,14.0,11.0,7.0,10.0,15.0,12.0,20.0,11.0,6.0,9.0,6.0,10.0,10.0,9.0,11.0,14.0,9.0,11.0,12.0,8.0,8.0,8.0,19.0,0.0,0.0,0.0,0.0,183.0,79.0,3.0,1.0,3.0,3.0,3.0,2.0,1.0,2.0,3.0,1.0,2.0,5.0,10.0,9.0,7.0,10.0,4.0,10.0,9.0,6.0,12.0,11.0,7.0,12.0,8.0,10.0,12.0,11.0,11.0,11.0,12.0,11.0,13.0,11.0,9.0,12.0,12.0,12.0,14.0,12.0,13.0,13.0,11.0,8.0,13.0,12.0,20.0,13.0,12.0,12.0,10.0,11.0,5.0,9.0,12.0,12.0,13.0,11.0,14.0,12.0,10.0,10.0,24.0,0.0,0.0,0.0,0.0,175.0,72.0,3.0,2.0,4.0,3.0,2.0,4.0,1.0,1.0,1.0,2.0,2.0,8.0,12.0,12.0,6.0,11.0,7.0,10.0,9.0,12.0,11.0,12.0,8.0,12.0,11.0,11.0,12.0,13.0,10.0,10.0,9.0,9.0,3.0,9.0,9.0,11.0,12.0,11.0,11.0,14.0,13.0,11.0,8.0,20.0,12.0,13.0,6.0,12.0,11.0,10.0,10.0,10.0,9.0,10.0,10.0,13.0,10.0,11.0,10.0,13.0,18.0,1.0,26.0,25.0,1.0,7.0,0.0,189.0,78.0,1.0,1.0,1.0,1.0,1.0,1.0,1.0,1.0,1.0,1.0,1.0,8.0,9.0,10.0,6.0,12.0,8.0,13.0,14.0,7.0,11.0,14.0,11.0,13.0,13.0,13.0,13.0,16.0,13.0,13.0,12.0,13.0,14.0,10.0,10.0,12.0,13.0,15.0,15.0,12.0,11.0,9.0,15.0,10.0,14.0,13.0,20.0,14.0,14.0,12.0,13.0,11.0,14.0,12.0,14.0,11.0,14.0,12.0,16.0,15.0,13.0,5.0,19.0,0.0,0.0,0.0,0.0,174.0,61.0,1.0,3.0,2.0,3.0,2.0,1.0,2.0,2.0,3.0,1.0,1.0,5.0,9.0,10.0,6.0,12.0,6.0,8.0,8.0,5.0,9.0,10.0,7.0,9.0,13.0,11.0,12.0,12.0,11.0,9.0,11.0,11.0,8.0,9.0,10.0,8.0,10.0,12.0,16.0,13.0,13.0,10.0,8.0,20.0,15.0,11.0,8.0,13.0,9.0,15.0,11.0,10.0,6.0,13.0,10.0,9.0,14.0,11.0,12.0,14.0,14.0,8.0,21.0,0.0,0.0,0.0,0.0,172.0,66.0,2.0,3.0,2.0,2.0,1.0,1.0,1.0,3.0,2.0,1.0,1.0,10.0,10.0,13.0,9.0,14.0,9.0,8.0,10.0,7.0,13.0,13.0,9.0,12.0,13.0,10.0,12.0,13.0,13.0,12.0,14.0,13.0,13.0,11.0,9.0,14.0,13.0,14.0,14.0,14.0,13.0,12.0,8.0,8.0,12.0,12.0,20.0,13.0,12.0,14.0,10.0,11.0,8.0,12.0,15.0,10.0,15.0,8.0,11.0,14.0,14.0,6.0,24.0,2.0,0.0,0.0,0.0,195.0,84.0,1.0,4.0,1.0,2.0,3.0,1.0,2.0,1.0,2.0,1.0,1.0,6.0,6.0,9.0,11.0,10.0,8.0,14.0,11.0,5.0,8.0,10.0,11.0,2.0,11.0,11.0,12.0,14.0,11.0,14.0,8.0,12.0,13.0,8.0,6.0,11.0,7.0,13.0,14.0,13.0,12.0,18.0,18.0,8.0,13.0,14.0,20.0,14.0,17.0,12.0,11.0,10.0,7.0,5.0,8.0,12.0,9.0,12.0,13.0,12.0,14.0,2.0
1,0,22.0,0.0,0.0,0.0,0.0,191.0,86.0,14.0,11.0,10.0,12.0,13.0,9.0,14.0,13.0,10.0,13.0,12.0,4.0,2.0,2.0,1.0,5.0,6.0,10.0,3.0,3.0,3.0,7.0,5.0,3.0,6.0,12.0,10.0,12.0,13.0,10.0,6.0,12.0,11.0,11.0,11.0,5.0,9.0,8.0,6.0,10.0,12.0,16.0,15.0,6.0,14.0,9.0,20.0,11.0,15.0,11.0,11.0,13.0,7.0,1.0,18.0,10.0,11.0,13.0,14.0,11.0,20.0,4.0,32.0,0.0,0.0,0.0,0.0,183.0,79.0,1.0,1.0,1.0,3.0,1.0,3.0,1.0,1.0,2.0,1.0,1.0,5.0,10.0,6.0,6.0,9.0,6.0,15.0,7.0,11.0,14.0,10.0,7.0,13.0,10.0,13.0,15.0,15.0,15.0,14.0,9.0,13.0,16.0,6.0,14.0,8.0,12.0,13.0,16.0,11.0,12.0,16.0,11.0,8.0,16.0,12.0,20.0,15.0,14.0,14.0,11.0,12.0,5.0,15.0,18.0,15.0,14.0,13.0,17.0,14.0,14.0,5.0,29.0,0.0,0.0,0.0,0.0,183.0,74.0,3.0,3.0,3.0,3.0,3.0,2.0,2.0,2.0,1.0,3.0,1.0,5.0,12.0,7.0,6.0,10.0,7.0,14.0,12.0,5.0,14.0,12.0,6.0,13.0,11.0,14.0,13.0,17.0,13.0,16.0,12.0,12.0,13.0,9.0,8.0,9.0,14.0,14.0,15.0,13.0,12.0,15.0,12.0,6.0,17.0,11.0,20.0,17.0,13.0,14.0,14.0,15.0,5.0,13.0,9.0,14.0,19.0,15.0,14.0,11.0,11.0,6.0,21.0,0.0,0.0,0.0,0.0,172.0,68.0,3.0,3.0,1.0,2.0,1.0,2.0,3.0,2.0,2.0,3.0,2.0,12.0,13.0,12.0,8.0,12.0,12.0,5.0,8.0,12.0,11.0,13.0,8.0,13.0,12.0,14.0,13.0,14.0,13.0,13.0,10.0,11.0,15.0,9.0,13.0,13.0,12.0,13.0,14.0,12.0,12.0,12.0,6.0,20.0,13.0,13.0,13.0,13.0,11.0,12.0,10.0,10.0,11.0,9.0,20.0,13.0,15.0,12.0,16.0,13.0,13.0,8.0,21.0,0.0,0.0,0.0,0.0,174.0,72.0,3.0,3.0,3.0,3.0,2.0,1.0,3.0,3.0,2.0,4.0,1.0,5.0,7.0,7.0,6.0,9.0,2.0,8.0,10.0,9.0,9.0,10.0,7.0,11.0,8.0,11.0,11.0,13.0,10.0,10.0,10.0,10.0,12.0,7.0,6.0,9.0,9.0,11.0,14.0,14.0,11.0,11.0,8.0,5.0,14.0,12.0,20.0,12.0,11.0,9.0,9.0,9.0,8.0,9.0,13.0,10.0,10.0,10.0,13.0,11.0,14.0,4.0,21.0,4.0,1.0,0.0,0.0,176.0,60.0,1.0,1.0,3.0,2.0,3.0,2.0,1.0,3.0,3.0,4.0,2.0,9.0,10.0,13.0,9.0,13.0,8.0,7.0,12.0,7.0,11.0,13.0,7.0,12.0,11.0,9.0,14.0,12.0,9.0,11.0,12.0,11.0,10.0,9.0,5.0,10.0,12.0,12.0,15.0,15.0,14.0,13.0,7.0,12.0,10.0,12.0,20.0,14.0,4.0,9.0,9.0,9.0,7.0,5.0,15.0,16.0,12.0,10.0,9.0,16.0,8.0,3.0,27.0,0.0,0.0,0.0,0.0,188.0,77.0,1.0,4.0,1.0,1.0,3.0,1.0,2.0,1.0,2.0,2.0,2.0,4.0,7.0,8.0,7.0,13.0,6.0,15.0,9.0,6.0,13.0,12.0,6.0,12.0,11.0,14.0,14.0,15.0,10.0,12.0,11.0,13.0,16.0,7.0,12.0,9.0,12.0,15.0,16.0,14.0,10.0,14.0,15.0,9.0,13.0,12.0,20.0,14.0,16.0,12.0,14.0,13.0,6.0,12.0,4.0,13.0,18.0,13.0,14.0,14.0,13.0,7.0,18.0,0.0,0.0,0.0,0.0,178.0,70.0,1.0,2.0,3.0,2.0,4.0,2.0,3.0,1.0,1.0,2.0,3.0,11.0,7.0,10.0,10.0,14.0,12.0,9.0,10.0,6.0,7.0,15.0,5.0,10.0,12.0,9.0,10.0,9.0,8.0,10.0,9.0,12.0,7.0,4.0,3.0,12.0,9.0,10.0,14.0,15.0,12.0,10.0,8.0,6.0,5.0,11.0,20.0,10.0,9.0,12.0,8.0,2.0,10.0,10.0,11.0,10.0,12.0,12.0,11.0,12.0,19.0,6.0,25.0,0.0,0.0,3.0,2.0,170.0,61.0,2.0,3.0,2.0,2.0,1.0,3.0,2.0,2.0,1.0,2.0,1.0,11.0,12.0,13.0,10.0,13.0,8.0,5.0,8.0,7.0,4.0,14.0,10.0,4.0,15.0,11.0,10.0,9.0,7.0,10.0,14.0,8.0,13.0,13.0,6.0,12.0,8.0,8.0,12.0,16.0,14.0,7.0,5.0,12.0,15.0,16.0,20.0,14.0,6.0,12.0,11.0,13.0,8.0,8.0,8.0,13.0,15.0,10.0,10.0,14.0,14.0,8.0,18.0,0.0,0.0,0.0,0.0,188.0,80.0,1.0,3.0,1.0,3.0,2.0,3.0,3.0,1.0,2.0,2.0,4.0,6.0,8.0,12.0,11.0,12.0,7.0,13.0,10.0,4.0,4.0,8.0,10.0,5.0,12.0,11.0,11.0,13.0,10.0,11.0,11.0,12.0,11.0,13.0,7.0,13.0,8.0,13.0,13.0,11.0,12.0,12.0,12.0,10.0,12.0,11.0,20.0,10.0,12.0,12.0,8.0,11.0,7.0,13.0,8.0,13.0,13.0,11.0,12.0,12.0,13.0,7.0,28.0,0.0,0.0,2.0,2.0,182.0,79.0,1.0,1.0,2.0,2.0,3.0,1.0,2.0,3.0,1.0,2.0,2.0,8.0,11.0,14.0,12.0,14.0,11.0,12.0,13.0,6.0,4.0,11.0,13.0,5.0,14.0,11.0,12.0,13.0,10.0,12.0,11.0,11.0,15.0,13.0,7.0,14.0,7.0,12.0,14.0,15.0,14.0,14.0,12.0,8.0,15.0,14.0,20.0,15.0,14.0,12.0,11.0,15.0,8.0,8.0,16.0,15.0,12.0,11.0,14.0,13.0,12.0,8.0,24.0,0.0,0.0,0.0,0.0,185.0,75.0,12.0,11.0,13.0,9.0,11.0,9.0,10.0,12.0,10.0,15.0,10.0,7.0,1.0,1.0,3.0,7.0,9.0,1.0,1.0,3.0,2.0,1.0,3.0,3.0,7.0,4.0,11.0,15.0,5.0,5.0,7.0,8.0,8.0,1.0,5.0,3.0,8.0,12.0,12.0,14.0,11.0,12.0,12.0,5.0,13.0,11.0,20.0,7.0,11.0,7.0,6.0,5.0,9.0,9.0,7.0,12.0,13.0,13.0,14.0,11.0,19.0,2.0,28.0,0.0,0.0,0.0,0.0,184.0,85.0,2.0,3.0,2.0,1.0,1.0,3.0,2.0,2.0,3.0,1.0,3.0,4.0,8.0,8.0,6.0,12.0,6.0,14.0,8.0,5.0,13.0,12.0,6.0,14.0,12.0,11.0,13.0,14.0,13.0,12.0,11.0,11.0,13.0,7.0,14.0,10.0,15.0,16.0,12.0,12.0,11.0,15.0,12.0,20.0,13.0,11.0,7.0,14.0,16.0,13.0,11.0,13.0,13.0,12.0,15.0,13.0,13.0,14.0,15.0,14.0,14.0,6.0,25.0,0.0,0.0,0.0,0.0,191.0,81.0,1.0,1.0,3.0,2.0,3.0,2.0,3.0,4.0,2.0,1.0,2.0,4.0,3.0,10.0,8.0,6.0,6.0,11.0,6.0,10.0,11.0,10.0,5.0,12.0,7.0,16.0,13.0,16.0,11.0,13.0,7.0,10.0,14.0,5.0,12.0,10.0,13.0,13.0,12.0,13.0,13.0,16.0,16.0,7.0,16.0,14.0,20.0,14.0,14.0,13.0,13.0,15.0,6.0,12.0,13.0,6.0,14.0,8.0,8.0,13.0,7.0,4.0,24.0,2.0,0.0,0.0,0.0,188.0,83.0,2.0,2.0,2.0,1.0,3.0,2.0,3.0,3.0,1.0,2.0,1.0,11.0,12.0,11.0,6.0,12.0,11.0,11.0,9.0,13.0,11.0,11.0,10.0,12.0,12.0,13.0,13.0,12.0,12.0,9.0,11.0,11.0,2.0,12.0,11.0,12.0,8.0,12.0,12.0,11.0,10.0,13.0,13.0,20.0,12.0,12.0,4.0,12.0,13.0,12.0,9.0,5.0,7.0,11.0,8.0,10.0,14.0,12.0,12.0,1.0,18.0,8.0,29.0,6.0,0.0,0.0,0.0,183.0,72.0,3.0,3.0,3.0,4.0,1.0,3.0,3.0,3.0,1.0,3.0,3.0,2.0,13.0,13.0,8.0,14.0,8.0,10.0,12.0,10.0,12.0,13.0,8.0,14.0,10.0,14.0,13.0,10.0,12.0,12.0,10.0,12.0,4.0,12.0,4.0,14.0,12.0,13.0,14.0,14.0,13.0,13.0,11.0,5.0,14.0,15.0,20.0,14.0,11.0,13.0,2.0,12.0,7.0,8.0,16.0,10.0,11.0,13.0,10.0,3.0,19.0,8.0,23.0,2.0,0.0,5.0,0.0,180.0,77.0,3.0,2.0,2.0,3.0,2.0,3.0,2.0,2.0,3.0,3.0,4.0,14.0,12.0,12.0,10.0,13.0,14.0,6.0,14.0,8.0,8.0,13.0,12.0,9.0,14.0,13.0,12.0,12.0,11.0,10.0,12.0,13.0,13.0,10.0,6.0,13.0,10.0,12.0,14.0,13.0,14.0,13.0,10.0,8.0,13.0,14.0,20.0,14.0,14.0,9.0,8.0,14.0,6.0,16.0,13.0,12.0,13.0,12.0,13.0,13.0,14.0,6.0,24.0,0.0,0.0,0.0,0.0,177.0,70.0,2.0,4.0,2.0,1.0,1.0,3.0,1.0,3.0,4.0,2.0,1.0,6.0,10.0,11.0,7.0,13.0,6.0,9.0,13.0,7.0,12.0,14.0,7.0,13.0,13.0,13.0,13.0,13.0,11.0,11.0,11.0,12.0,13.0,10.0,7.0,11.0,11.0,14.0,15.0,13.0,13.0,14.0,9.0,6.0,15.0,14.0,20.0,15.0,12.0,13.0,11.0,13.0,7.0,12.0,19.0,12.0,17.0,10.0,13.0,13.0,13.0,6.0,26.0,0.0,0.0,0.0,0.0,175.0,70.0,2.0,1.0,1.0,2.0,2.0,2.0,3.0,2.0,2.0,1.0,1.0,13.0,12.0,11.0,8.0,14.0,11.0,7.0,11.0,6.0,5.0,14.0,11.0,6.0,15.0,11.0,12.0,12.0,15.0,10.0,13.0,12.0,14.0,13.0,7.0,12.0,12.0,16.0,12.0,12.0,14.0,12.0,8.0,8.0,11.0,13.0,20.0,11.0,9.0,8.0,8.0,12.0,15.0,14.0,12.0,13.0,11.0,13.0,12.0,15.0,15.0,7.0,23.0,0.0,0.0,0.0,0.0,173.0,75.0,3.0,2.0,1.0,3.0,1.0,4.0,2.0,1.0,4.0,2.0,1.0,11.0,10.0,16.0,9.0,15.0,14.0,7.0,10.0,6.0,8.0,14.0,12.0,5.0,15.0,8.0,10.0,8.0,15.0,10.0,14.0,15.0,12.0,13.0,9.0,14.0,5.0,7.0,10.0,14.0,14.0,12.0,8.0,15.0,13.0,12.0,20.0,9.0,8.0,12.0,8.0,11.0,6.0,14.0,14.0,15.0,15.0,10.0,18.0,15.0,10.0,5.0,27.0,11.0,1.0,0.0,0.0,187.0,86.0,3.0,1.0,2.0,2.0,4.0,3.0,2.0,1.0,1.0,3.0,1.0,3.0,9.0,13.0,15.0,12.0,10.0,17.0,11.0,5.0,5.0,9.0,14.0,4.0,11.0,9.0,12.0,13.0,12.0,11.0,9.0,10.0,13.0,11.0,10.0,13.0,10.0,15.0,15.0,14.0,12.0,15.0,13.0,7.0,15.0,13.0,20.0,13.0,15.0,14.0,9.0,13.0,7.0,5.0,15.0,13.0,13.0,11.0,10.0,12.0,18.0,6.0,24.0,0.0,0.0,5.0,0.0,183.0,79.0,4.0,4.0,3.0,3.0,1.0,3.0,2.0,1.0,3.0,2.0,3.0,4.0,7.0,12.0,13.0,12.0,8.0,13.0,12.0,5.0,6.0,11.0,12.0,4.0,13.0,11.0,12.0,14.0,9.0,12.0,10.0,10.0,13.0,12.0,6.0,14.0,12.0,13.0,14.0,15.0,14.0,14.0,11.0,10.0,13.0,14.0,20.0,14.0,14.0,12.0,12.0,14.0,9.0,5.0,7.0,13.0,15.0,11.0,14.0,14.0,14.0,6.0
2,2,33.0,0.0,0.0,2.0,0.0,196.0,89.0,15.0,13.0,12.0,7.0,14.0,10.0,14.0,14.0,11.0,9.0,12.0,4.0,3.0,1.0,1.0,9.0,7.0,2.0,2.0,1.0,1.0,10.0,2.0,2.0,9.0,10.0,14.0,14.0,13.0,12.0,11.0,12.0,14.0,6.0,12.0,1.0,13.0,11.0,6.0,9.0,13.0,16.0,18.0,5.0,12.0,10.0,20.0,12.0,16.0,14.0,10.0,15.0,13.0,1.0,8.0,14.0,14.0,14.0,10.0,15.0,15.0,9.0,19.0,0.0,0.0,7.0,2.0,188.0,85.0,1.0,3.0,2.0,1.0,2.0,3.0,3.0,2.0,2.0,3.0,1.0,10.0,6.0,9.0,8.0,10.0,12.0,15.0,8.0,7.0,14.0,11.0,10.0,13.0,10.0,14.0,11.0,13.0,9.0,11.0,10.0,10.0,9.0,1.0,8.0,12.0,13.0,13.0,14.0,13.0,10.0,13.0,15.0,9.0,12.0,13.0,20.0,14.0,14.0,9.0,11.0,4.0,9.0,11.0,14.0,13.0,12.0,12.0,12.0,1.0,13.0,2.0,30.0,32.0,1.0,0.0,0.0,190.0,88.0,1.0,2.0,2.0,2.0,3.0,1.0,1.0,3.0,3.0,2.0,2.0,5.0,7.0,9.0,8.0,10.0,7.0,16.0,11.0,9.0,15.0,13.0,5.0,16.0,12.0,17.0,16.0,17.0,13.0,13.0,11.0,12.0,16.0,7.0,14.0,10.0,14.0,15.0,15.0,14.0,12.0,17.0,16.0,9.0,15.0,14.0,20.0,16.0,18.0,15.0,15.0,14.0,10.0,12.0,14.0,15.0,12.0,14.0,12.0,13.0,11.0,15.0,24.0,0.0,0.0,0.0,0.0,177.0,65.0,1.0,2.0,1.0,2.0,1.0,2.0,1.0,1.0,1.0,2.0,3.0,8.0,11.0,13.0,10.0,13.0,8.0,10.0,11.0,7.0,5.0,12.0,13.0,6.0,13.0,8.0,11.0,9.0,10.0,9.0,9.0,11.0,13.0,12.0,5.0,12.0,8.0,7.0,9.0,16.0,15.0,12.0,8.0,10.0,15.0,15.0,20.0,14.0,12.0,11.0,8.0,13.0,7.0,12.0,20.0,14.0,13.0,12.0,9.0,12.0,11.0,10.0,22.0,0.0,0.0,3.0,0.0,176.0,70.0,1.0,1.0,1.0,3.0,2.0,1.0,2.0,3.0,1.0,3.0,3.0,10.0,15.0,14.0,6.0,13.0,10.0,13.0,10.0,9.0,9.0,13.0,8.0,11.0,14.0,10.0,11.0,12.0,10.0,13.0,11.0,13.0,14.0,13.0,7.0,13.0,9.0,11.0,13.0,17.0,13.0,12.0,10.0,20.0,14.0,16.0,5.0,15.0,11.0,13.0,10.0,14.0,8.0,10.0,11.0,13.0,16.0,11.0,15.0,14.0,13.0,7.0,21.0,0.0,0.0,11.0,2.0,180.0,72.0,2.0,3.0,3.0,3.0,3.0,2.0,2.0,1.0,3.0,2.0,3.0,12.0,13.0,14.0,9.0,14.0,13.0,8.0,12.0,5.0,8.0,14.0,10.0,9.0,14.0,12.0,12.0,9.0,13.0,12.0,15.0,13.0,14.0,15.0,8.0,13.0,10.0,16.0,14.0,15.0,14.0,12.0,9.0,8.0,15.0,14.0,20.0,13.0,12.0,12.0,8.0,11.0,10.0,11.0,10.0,14.0,16.0,14.0,15.0,15.0,15.0,6.0,18.0,0.0,0.0,0.0,0.0,167.0,60.0,2.0,1.0,2.0,2.0,2.0,1.0,2.0,1.0,1.0,1.0,1.0,10.0,11.0,12.0,8.0,13.0,10.0,3.0,10.0,5.0,6.0,13.0,12.0,8.0,15.0,8.0,11.0,8.0,12.0,11.0,13.0,12.0,13.0,12.0,6.0,11.0,11.0,12.0,13.0,15.0,14.0,8.0,5.0,8.0,15.0,12.0,20.0,12.0,7.0,8.0,8.0,14.0,7.0,8.0,18.0,11.0,12.0,11.0,12.0,15.0,15.0,7.0,23.0,0.0,0.0,10.0,7.0,179.0,70.0,1.0,1.0,2.0,2.0,1.0,3.0,3.0,2.0,1.0,4.0,3.0,10.0,13.0,14.0,12.0,15.0,11.0,10.0,13.0,6.0,3.0,13.0,12.0,4.0,16.0,11.0,12.0,11.0,13.0,11.0,13.0,12.0,12.0,16.0,6.0,14.0,6.0,10.0,12.0,16.0,14.0,12.0,9.0,20.0,13.0,14.0,10.0,13.0,10.0,12.0,7.0,12.0,6.0,8.0,12.0,13.0,5.0,10.0,8.0,14.0,12.0,8.0,21.0,0.0,0.0,0.0,0.0,187.0,84.0,4.0,2.0,1.0,2.0,3.0,1.0,2.0,3.0,1.0,1.0,2.0,11.0,13.0,15.0,12.0,14.0,11.0,13.0,14.0,4.0,5.0,12.0,14.0,5.0,16.0,12.0,12.0,14.0,12.0,10.0,10.0,9.0,14.0,17.0,10.0,12.0,7.0,10.0,14.0,14.0,16.0,14.0,15.0,9.0,13.0,14.0,20.0,14.0,14.0,14.0,8.0,15.0,5.0,14.0,11.0,16.0,13.0,14.0,13.0,15.0,15.0,6.0,25.0,33.0,13.0,16.0,6.0,189.0,88.0,2.0,4.0,1.0,2.0,3.0,1.0,2.0,3.0,2.0,1.0,2.0,12.0,13.0,15.0,15.0,15.0,17.0,16.0,16.0,8.0,5.0,14.0,19.0,7.0,16.0,13.0,14.0,12.0,16.0,9.0,14.0,12.0,7.0,15.0,8.0,12.0,5.0,2.0,4.0,13.0,15.0,14.0,14.0,12.0,12.0,15.0,20.0,13.0,15.0,7.0,16.0,13.0,14.0,11.0,8.0,13.0,4.0,11.0,8.0,3.0,4.0,16.0,26.0,0.0,0.0,4.0,0.0,180.0,73.0,2.0,3.0,1.0,4.0,2.0,3.0,3.0,1.0,1.0,4.0,1.0,11.0,13.0,13.0,14.0,14.0,11.0,15.0,12.0,3.0,7.0,14.0,14.0,8.0,13.0,12.0,14.0,17.0,13.0,15.0,14.0,14.0,16.0,12.0,15.0,16.0,12.0,18.0,16.0,13.0,14.0,13.0,12.0,8.0,14.0,13.0,20.0,15.0,12.0,15.0,8.0,14.0,7.0,15.0,19.0,14.0,17.0,14.0,18.0,16.0,16.0,5.0,33.0,0.0,0.0,3.0,0.0,188.0,84.0,14.0,13.0,13.0,9.0,13.0,13.0,15.0,15.0,11.0,11.0,9.0,7.0,3.0,3.0,1.0,7.0,10.0,2.0,1.0,1.0,2.0,6.0,4.0,1.0,7.0,8.0,13.0,14.0,14.0,14.0,8.0,11.0,15.0,6.0,13.0,3.0,13.0,12.0,8.0,12.0,14.0,15.0,14.0,8.0,13.0,11.0,20.0,13.0,15.0,16.0,8.0,13.0,6.0,1.0,11.0,14.0,13.0,11.0,16.0,14.0,11.0,6.0,28.0,0.0,0.0,0.0,0.0,193.0,84.0,1.0,1.0,2.0,2.0,2.0,3.0,2.0,3.0,2.0,1.0,3.0,4.0,8.0,8.0,9.0,10.0,6.0,14.0,7.0,8.0,14.0,12.0,6.0,14.0,11.0,12.0,13.0,14.0,11.0,14.0,12.0,12.0,14.0,6.0,11.0,8.0,14.0,13.0,13.0,11.0,11.0,16.0,16.0,20.0,12.0,12.0,8.0,14.0,16.0,14.0,12.0,13.0,6.0,10.0,7.0,12.0,15.0,12.0,16.0,15.0,13.0,6.0,29.0,2.0,0.0,0.0,0.0,185.0,75.0,2.0,3.0,3.0,3.0,2.0,3.0,2.0,1.0,3.0,1.0,2.0,4.0,10.0,8.0,6.0,10.0,6.0,14.0,7.0,7.0,14.0,11.0,6.0,14.0,9.0,13.0,13.0,14.0,11.0,12.0,12.0,12.0,14.0,8.0,11.0,12.0,13.0,13.0,13.0,15.0,12.0,15.0,12.0,8.0,15.0,13.0,20.0,14.0,15.0,14.0,7.0,14.0,8.0,6.0,14.0,13.0,15.0,14.0,14.0,14.0,14.0,6.0,26.0,0.0,0.0,0.0,0.0,182.0,68.0,1.0,4.0,3.0,2.0,3.0,1.0,2.0,1.0,2.0,4.0,1.0,7.0,12.0,9.0,5.0,10.0,6.0,12.0,7.0,15.0,12.0,9.0,6.0,12.0,10.0,12.0,13.0,14.0,11.0,10.0,9.0,9.0,13.0,7.0,6.0,10.0,10.0,14.0,15.0,16.0,13.0,13.0,11.0,5.0,15.0,15.0,20.0,14.0,10.0,12.0,12.0,13.0,7.0,12.0,12.0,14.0,14.0,15.0,13.0,14.0,14.0,7.0,25.0,0.0,0.0,15.0,1.0,176.0,64.0,2.0,2.0,3.0,3.0,1.0,1.0,3.0,3.0,2.0,1.0,3.0,9.0,9.0,11.0,7.0,13.0,11.0,14.0,9.0,6.0,12.0,14.0,6.0,13.0,13.0,13.0,14.0,15.0,14.0,14.0,13.0,13.0,15.0,8.0,11.0,9.0,12.0,15.0,18.0,14.0,14.0,12.0,10.0,5.0,15.0,11.0,20.0,16.0,10.0,15.0,13.0,15.0,5.0,10.0,11.0,14.0,14.0,14.0,17.0,13.0,13.0,5.0,21.0,0.0,0.0,0.0,0.0,183.0,73.0,1.0,4.0,3.0,3.0,3.0,1.0,4.0,1.0,2.0,3.0,2.0,11.0,10.0,12.0,11.0,13.0,9.0,12.0,10.0,5.0,8.0,12.0,9.0,8.0,13.0,13.0,12.0,12.0,10.0,12.0,14.0,12.0,12.0,14.0,8.0,12.0,8.0,12.0,12.0,14.0,14.0,14.0,11.0,8.0,13.0,13.0,20.0,12.0,12.0,12.0,5.0,10.0,7.0,12.0,15.0,11.0,11.0,10.0,11.0,12.0,11.0,4.0,29.0,0.0,0.0,0.0,0.0,183.0,78.0,1.0,3.0,3.0,3.0,3.0,1.0,2.0,3.0,3.0,1.0,1.0,13.0,8.0,9.0,6.0,12.0,14.0,13.0,10.0,12.0,11.0,12.0,8.0,13.0,12.0,12.0,15.0,13.0,13.0,13.0,11.0,13.0,15.0,6.0,12.0,7.0,13.0,16.0,18.0,12.0,11.0,14.0,12.0,20.0,14.0,11.0,8.0,16.0,14.0,14.0,12.0,14.0,6.0,12.0,10.0,12.0,13.0,11.0,15.0,15.0,15.0,5.0,19.0,0.0,0.0,0.0,0.0,185.0,80.0,3.0,2.0,2.0,3.0,3.0,4.0,3.0,3.0,3.0,2.0,1.0,8.0,12.0,13.0,8.0,12.0,13.0,12.0,9.0,6.0,12.0,13.0,9.0,13.0,12.0,12.0,13.0,12.0,12.0,10.0,12.0,12.0,4.0,13.0,8.0,12.0,8.0,12.0,14.0,13.0,14.0,12.0,11.0,5.0,15.0,14.0,20.0,13.0,13.0,12.0,10.0,9.0,11.0,15.0,15.0,9.0,10.0,9.0,12.0,11.0,10.0,5.0,23.0,0.0,0.0,0.0,0.0,175.0,70.0,2.0,1.0,2.0,2.0,1.0,2.0,2.0,3.0,4.0,1.0,2.0,10.0,11.0,12.0,9.0,13.0,8.0,6.0,13.0,2.0,5.0,13.0,10.0,6.0,13.0,7.0,13.0,9.0,13.0,11.0,13.0,12.0,13.0,12.0,10.0,12.0,10.0,13.0,12.0,11.0,12.0,13.0,8.0,8.0,14.0,12.0,20.0,14.0,12.0,13.0,9.0,11.0,10.0,11.0,19.0,12.0,14.0,11.0,13.0,10.0,16.0,7.0,29.0,0.0,0.0,0.0,0.0,180.0,71.0,1.0,3.0,1.0,1.0,1.0,4.0,4.0,1.0,1.0,2.0,3.0,10.0,11.0,12.0,9.0,13.0,11.0,8.0,14.0,6.0,8.0,11.0,10.0,8.0,12.0,10.0,11.0,12.0,12.0,9.0,12.0,11.0,14.0,12.0,7.0,12.0,10.0,12.0,14.0,15.0,14.0,12.0,10.0,20.0,16.0,13.0,12.0,15.0,10.0,13.0,10.0,15.0,7.0,8.0,16.0,12.0,12.0,13.0,14.0,15.0,15.0,6.0,18.0,0.0,0.0,0.0,0.0,188.0,0.0,2.0,2.0,1.0,1.0,1.0,2.0,1.0,4.0,2.0,2.0,1.0,8.0,11.0,14.0,11.0,13.0,10.0,11.0,10.0,2.0,6.0,12.0,11.0,8.0,13.0,8.0,11.0,9.0,13.0,9.0,13.0,11.0,14.0,15.0,8.0,12.0,7.0,11.0,13.0,14.0,12.0,12.0,13.0,12.0,11.0,14.0,20.0,11.0,11.0,12.0,8.0,11.0,8.0,14.0,12.0,11.0,10.0,12.0,13.0,12.0,14.0,7.0
2,0,19.0,0.0,0.0,0.0,0.0,190.0,78.0,13.0,12.0,11.0,14.0,13.0,6.0,11.0,13.0,13.0,12.0,7.0,3.0,3.0,1.0,3.0,8.0,8.0,3.0,1.0,2.0,3.0,7.0,3.0,1.0,7.0,8.0,13.0,13.0,12.0,13.0,7.0,11.0,11.0,3.0,14.0,2.0,11.0,11.0,10.0,12.0,13.0,11.0,15.0,20.0,10.0,13.0,5.0,13.0,13.0,9.0,10.0,6.0,10.0,10.0,10.0,12.0,11.0,14.0,14.0,12.0,13.0,3.0,21.0,0.0,0.0,0.0,0.0,185.0,79.0,3.0,4.0,3.0,1.0,3.0,1.0,2.0,1.0,1.0,1.0,1.0,7.0,9.0,7.0,8.0,12.0,7.0,13.0,8.0,8.0,13.0,12.0,8.0,13.0,10.0,14.0,11.0,13.0,10.0,12.0,11.0,10.0,14.0,10.0,7.0,8.0,13.0,11.0,10.0,12.0,11.0,13.0,13.0,6.0,13.0,11.0,20.0,13.0,15.0,12.0,12.0,10.0,5.0,14.0,17.0,12.0,13.0,10.0,12.0,12.0,12.0,4.0,32.0,0.0,0.0,0.0,0.0,187.0,90.0,3.0,1.0,1.0,1.0,1.0,1.0,3.0,1.0,2.0,3.0,1.0,4.0,8.0,6.0,6.0,8.0,6.0,14.0,7.0,6.0,13.0,8.0,7.0,13.0,8.0,14.0,12.0,16.0,10.0,13.0,6.0,11.0,14.0,6.0,14.0,8.0,12.0,14.0,13.0,9.0,8.0,17.0,13.0,20.0,14.0,11.0,5.0,13.0,15.0,13.0,14.0,14.0,7.0,6.0,14.0,12.0,13.0,13.0,13.0,11.0,13.0,7.0,22.0,0.0,0.0,0.0,0.0,182.0,71.0,3.0,2.0,1.0,1.0,3.0,1.0,3.0,2.0,3.0,2.0,1.0,8.0,9.0,11.0,7.0,11.0,7.0,12.0,12.0,12.0,10.0,12.0,5.0,11.0,8.0,13.0,11.0,13.0,8.0,11.0,8.0,11.0,15.0,11.0,7.0,6.0,11.0,13.0,13.0,13.0,12.0,13.0,10.0,5.0,15.0,13.0,20.0,14.0,12.0,10.0,6.0,10.0,5.0,10.0,9.0,11.0,11.0,14.0,10.0,11.0,11.0,1.0,17.0,0.0,0.0,0.0,0.0,170.0,74.0,3.0,3.0,2.0,1.0,3.0,3.0,2.0,3.0,1.0,3.0,4.0,8.0,13.0,11.0,10.0,9.0,10.0,6.0,7.0,6.0,10.0,9.0,4.0,11.0,12.0,9.0,10.0,10.0,10.0,12.0,12.0,8.0,10.0,8.0,2.0,10.0,11.0,11.0,11.0,13.0,16.0,11.0,7.0,20.0,15.0,15.0,6.0,12.0,13.0,12.0,3.0,6.0,10.0,14.0,12.0,16.0,11.0,11.0,12.0,12.0,17.0,8.0,20.0,0.0,0.0,0.0,0.0,178.0,72.0,3.0,2.0,3.0,3.0,4.0,2.0,2.0,1.0,2.0,1.0,3.0,9.0,11.0,11.0,6.0,11.0,6.0,8.0,10.0,11.0,11.0,12.0,7.0,12.0,8.0,12.0,11.0,12.0,12.0,11.0,13.0,11.0,10.0,4.0,12.0,8.0,12.0,13.0,13.0,13.0,12.0,13.0,9.0,20.0,14.0,12.0,7.0,11.0,13.0,10.0,4.0,10.0,6.0,10.0,15.0,11.0,13.0,11.0,10.0,14.0,16.0,5.0,20.0,0.0,0.0,0.0,0.0,180.0,73.0,4.0,1.0,1.0,1.0,2.0,1.0,3.0,1.0,1.0,1.0,3.0,9.0,11.0,12.0,10.0,12.0,7.0,11.0,10.0,8.0,6.0,10.0,11.0,5.0,10.0,9.0,8.0,9.0,10.0,8.0,10.0,11.0,9.0,7.0,1.0,10.0,7.0,7.0,10.0,13.0,9.0,13.0,10.0,5.0,6.0,13.0,20.0,9.0,11.0,9.0,9.0,9.0,9.0,9.0,13.0,8.0,12.0,12.0,12.0,11.0,13.0,1.0,24.0,0.0,0.0,0.0,0.0,172.0,69.0,3.0,4.0,1.0,4.0,1.0,2.0,1.0,2.0,2.0,3.0,3.0,10.0,12.0,13.0,7.0,13.0,13.0,7.0,11.0,6.0,2.0,12.0,10.0,4.0,15.0,12.0,11.0,12.0,9.0,10.0,13.0,11.0,3.0,15.0,6.0,13.0,5.0,10.0,13.0,14.0,15.0,11.0,7.0,5.0,14.0,14.0,20.0,13.0,10.0,13.0,12.0,13.0,8.0,10.0,9.0,11.0,10.0,11.0,9.0,11.0,10.0,3.0,21.0,0.0,0.0,0.0,0.0,189.0,77.0,2.0,1.0,1.0,1.0,3.0,3.0,3.0,3.0,3.0,3.0,1.0,5.0,11.0,12.0,10.0,13.0,6.0,13.0,11.0,6.0,5.0,12.0,11.0,5.0,12.0,8.0,12.0,13.0,11.0,10.0,10.0,10.0,13.0,10.0,6.0,13.0,8.0,13.0,14.0,12.0,12.0,15.0,14.0,7.0,14.0,13.0,20.0,13.0,14.0,12.0,8.0,10.0,8.0,8.0,8.0,14.0,13.0,11.0,14.0,15.0,16.0,6.0,23.0,0.0,0.0,0.0,0.0,181.0,73.0,2.0,1.0,2.0,1.0,3.0,3.0,2.0,2.0,4.0,2.0,1.0,5.0,12.0,14.0,13.0,13.0,7.0,12.0,8.0,4.0,5.0,9.0,12.0,5.0,13.0,11.0,11.0,12.0,13.0,11.0,8.0,12.0,14.0,11.0,6.0,13.0,7.0,12.0,13.0,12.0,14.0,13.0,10.0,8.0,14.0,11.0,20.0,13.0,12.0,13.0,5.0,10.0,7.0,14.0,12.0,11.0,14.0,10.0,11.0,10.0,15.0,4.0,21.0,0.0,0.0,0.0,0.0,180.0,71.0,1.0,2.0,1.0,3.0,3.0,3.0,2.0,2.0,2.0,2.0,3.0,10.0,10.0,11.0,10.0,12.0,10.0,8.0,10.0,8.0,8.0,12.0,5.0,6.0,12.0,4.0,11.0,8.0,10.0,9.0,11.0,10.0,10.0,13.0,8.0,12.0,7.0,11.0,12.0,13.0,12.0,10.0,10.0,5.0,12.0,12.0,20.0,11.0,10.0,10.0,10.0,5.0,10.0,12.0,7.0,10.0,14.0,12.0,9.0,10.0,16.0,7.0,22.0,0.0,0.0,0.0,0.0,186.0,79.0,14.0,13.0,11.0,7.0,12.0,10.0,13.0,14.0,8.0,6.0,8.0,2.0,1.0,3.0,6.0,8.0,5.0,3.0,11.0,3.0,2.0,8.0,8.0,1.0,8.0,8.0,12.0,14.0,12.0,11.0,7.0,11.0,12.0,6.0,9.0,3.0,12.0,12.0,5.0,8.0,12.0,15.0,15.0,20.0,15.0,7.0,5.0,9.0,15.0,14.0,8.0,5.0,5.0,1.0,10.0,12.0,13.0,12.0,8.0,15.0,15.0,5.0,17.0,0.0,0.0,0.0,0.0,191.0,79.0,1.0,1.0,2.0,3.0,2.0,1.0,1.0,3.0,3.0,3.0,2.0,2.0,1.0,1.0,1.0,4.0,1.0,10.0,5.0,2.0,14.0,6.0,4.0,12.0,1.0,6.0,7.0,5.0,4.0,6.0,1.0,14.0,1.0,1.0,11.0,4.0,14.0,6.0,7.0,6.0,12.0,7.0,11.0,5.0,8.0,8.0,20.0,7.0,11.0,8.0,6.0,7.0,8.0,8.0,14.0,11.0,11.0,14.0,10.0,9.0,12.0,5.0,21.0,0.0,0.0,0.0,0.0,182.0,74.0,2.0,2.0,2.0,2.0,2.0,1.0,1.0,1.0,3.0,2.0,2.0,9.0,11.0,12.0,7.0,9.0,8.0,12.0,7.0,11.0,12.0,7.0,8.0,13.0,11.0,12.0,12.0,14.0,12.0,13.0,7.0,12.0,11.0,1.0,9.0,11.0,9.0,10.0,12.0,14.0,10.0,13.0,11.0,9.0,8.0,12.0,20.0,13.0,11.0,10.0,13.0,8.0,10.0,10.0,15.0,11.0,13.0,10.0,10.0,8.0,13.0,7.0,21.0,0.0,0.0,1.0,0.0,177.0,68.0,4.0,1.0,2.0,1.0,1.0,1.0,1.0,1.0,2.0,1.0,2.0,5.0,12.0,9.0,7.0,12.0,8.0,13.0,10.0,16.0,13.0,12.0,8.0,14.0,12.0,12.0,13.0,12.0,12.0,12.0,10.0,13.0,15.0,11.0,13.0,11.0,13.0,13.0,14.0,13.0,14.0,13.0,11.0,10.0,14.0,12.0,20.0,12.0,14.0,12.0,11.0,12.0,8.0,14.0,13.0,10.0,14.0,12.0,14.0,12.0,11.0,5.0,27.0,10.0,0.0,0.0,0.0,181.0,69.0,1.0,1.0,3.0,3.0,3.0,3.0,2.0,3.0,3.0,3.0,1.0,5.0,13.0,10.0,7.0,13.0,9.0,10.0,10.0,12.0,12.0,11.0,7.0,12.0,11.0,11.0,13.0,12.0,11.0,13.0,9.0,9.0,12.0,8.0,7.0,12.0,11.0,11.0,13.0,15.0,13.0,13.0,10.0,20.0,12.0,15.0,8.0,15.0,12.0,13.0,11.0,14.0,13.0,12.0,10.0,14.0,12.0,10.0,11.0,15.0,15.0,7.0,23.0,0.0,0.0,0.0,0.0,182.0,80.0,2.0,3.0,2.0,2.0,2.0,3.0,4.0,4.0,1.0,2.0,1.0,5.0,7.0,12.0,5.0,13.0,6.0,12.0,6.0,6.0,13.0,11.0,6.0,14.0,11.0,13.0,12.0,13.0,14.0,13.0,9.0,10.0,13.0,7.0,10.0,8.0,10.0,13.0,12.0,14.0,12.0,13.0,10.0,5.0,12.0,13.0,20.0,15.0,14.0,14.0,6.0,10.0,9.0,7.0,9.0,12.0,17.0,13.0,14.0,14.0,14.0,5.0,18.0,0.0,0.0,0.0,0.0,177.0,66.0,2.0,2.0,1.0,2.0,1.0,3.0,3.0,2.0,3.0,2.0,3.0,8.0,6.0,8.0,7.0,12.0,6.0,5.0,9.0,5.0,1.0,10.0,4.0,4.0,12.0,5.0,4.0,6.0,6.0,3.0,13.0,7.0,8.0,12.0,6.0,10.0,6.0,8.0,12.0,15.0,10.0,7.0,7.0,20.0,14.0,11.0,5.0,13.0,5.0,8.0,8.0,7.0,8.0,8.0,13.0,10.0,11.0,11.0,11.0,9.0,18.0,3.0,27.0,32.0,6.0,0.0,0.0,188.0,78.0,3.0,2.0,3.0,2.0,1.0,3.0,3.0,3.0,2.0,2.0,2.0,4.0,8.0,11.0,12.0,12.0,6.0,16.0,13.0,8.0,13.0,14.0,7.0,12.0,12.0,12.0,10.0,14.0,13.0,12.0,11.0,12.0,15.0,9.0,11.0,12.0,6.0,13.0,12.0,14.0,13.0,15.0,15.0,5.0,13.0,12.0,20.0,16.0,15.0,14.0,12.0,15.0,11.0,10.0,9.0,15.0,12.0,12.0,13.0,13.0,13.0,7.0,27.0,1.0,0.0,0.0,0.0,179.0,70.0,3.0,2.0,1.0,3.0,3.0,2.0,1.0,3.0,2.0,1.0,1.0,14.0,15.0,15.0,11.0,15.0,14.0,8.0,12.0,5.0,8.0,13.0,12.0,9.0,18.0,11.0,11.0,11.0,9.0,10.0,16.0,10.0,17.0,15.0,8.0,12.0,8.0,12.0,11.0,14.0,13.0,12.0,10.0,12.0,13.0,14.0,20.0,16.0,12.0,10.0,9.0,10.0,7.0,8.0,13.0,15.0,13.0,10.0,11.0,12.0,10.0,8.0,21.0,0.0,0.0,4.0,1.0,184.0,79.0,1.0,2.0,3.0,1.0,2.0,1.0,3.0,2.0,2.0,1.0,3.0,3.0,6.0,10.0,12.0,12.0,7.0,15.0,8.0,4.0,5.0,13.0,10.0,8.0,12.0,18.0,12.0,19.0,13.0,10.0,13.0,12.0,14.0,13.0,10.0,12.0,9.0,16.0,15.0,12.0,14.0,14.0,14.0,12.0,13.0,10.0,20.0,14.0,14.0,11.0,14.0,14.0,11.0,5.0,10.0,13.0,14.0,15.0,10.0,8.0,4.0,15.0,23.0,15.0,5.0,0.0,0.0,186.0,81.0,3.0,1.0,1.0,4.0,1.0,1.0,2.0,2.0,3.0,3.0,4.0,5.0,10.0,13.0,14.0,10.0,5.0,11.0,13.0,5.0,4.0,9.0,10.0,4.0,10.0,13.0,11.0,14.0,12.0,9.0,8.0,8.0,15.0,13.0,7.0,8.0,7.0,10.0,10.0,15.0,12.0,15.0,12.0,7.0,10.0,18.0,20.0,17.0,15.0,8.0,8.0,11.0,12.0,12.0,12.0,15.0,13.0,12.0,15.0,13.0,13.0,6.0
2,1,30.0,42.0,0.0,13.0,0.0,195.0,88.0,16.0,13.0,14.0,6.0,14.0,13.0,13.0,15.0,12.0,10.0,14.0,1.0,8.0,5.0,2.0,8.0,2.0,8.0,2.0,5.0,3.0,9.0,5.0,3.0,8.0,10.0,12.0,10.0,14.0,10.0,10.0,14.0,13.0,3.0,14.0,3.0,12.0,14.0,12.0,8.0,13.0,18.0,18.0,17.0,14.0,11.0,20.0,14.0,17.0,14.0,4.0,14.0,4.0,1.0,12.0,13.0,14.0,9.0,15.0,13.0,13.0,5.0,28.0,0.0,0.0,0.0,0.0,174.0,67.0,3.0,4.0,1.0,1.0,1.0,3.0,1.0,3.0,2.0,1.0,2.0,11.0,8.0,11.0,9.0,13.0,6.0,7.0,12.0,8.0,10.0,10.0,3.0,6.0,12.0,10.0,13.0,7.0,12.0,8.0,10.0,9.0,12.0,13.0,5.0,12.0,9.0,12.0,11.0,14.0,14.0,11.0,7.0,10.0,15.0,12.0,20.0,11.0,6.0,9.0,6.0,10.0,10.0,9.0,11.0,14.0,9.0,11.0,12.0,8.0,8.0,8.0,17.0,0.0,0.0,0.0,0.0,185.0,0.0,3.0,3.0,1.0,2.0,1.0,2.0,1.0,2.0,3.0,2.0,1.0,4.0,7.0,8.0,7.0,10.0,6.0,12.0,8.0,4.0,12.0,9.0,9.0,12.0,10.0,9.0,10.0,10.0,10.0,8.0,10.0,11.0,13.0,11.0,10.0,11.0,12.0,10.0,12.0,9.0,11.0,12.0,11.0,8.0,12.0,10.0,20.0,12.0,11.0,11.0,8.0,12.0,4.0,10.0,16.0,11.0,12.0,14.0,14.0,12.0,18.0,3.0,39.0,0.0,0.0,0.0,0.0,187.0,75.0,1.0,1.0,2.0,1.0,2.0,3.0,4.0,1.0,3.0,3.0,1.0,7.0,6.0,9.0,11.0,11.0,7.0,14.0,10.0,4.0,7.0,11.0,2.0,10.0,10.0,8.0,11.0,8.0,7.0,9.0,6.0,7.0,11.0,8.0,6.0,6.0,8.0,14.0,14.0,7.0,10.0,9.0,15.0,3.0,13.0,8.0,20.0,6.0,10.0,8.0,13.0,7.0,8.0,7.0,7.0,11.0,17.0,9.0,15.0,11.0,8.0,2.0,24.0,0.0,0.0,0.0,0.0,175.0,72.0,3.0,2.0,4.0,3.0,2.0,4.0,1.0,1.0,1.0,2.0,2.0,8.0,12.0,12.0,6.0,11.0,7.0,10.0,9.0,12.0,11.0,12.0,8.0,12.0,11.0,11.0,12.0,13.0,10.0,10.0,9.0,9.0,3.0,9.0,9.0,11.0,12.0,11.0,11.0,14.0,13.0,11.0,8.0,20.0,12.0,13.0,6.0,12.0,11.0,10.0,10.0,10.0,9.0,10.0,10.0,13.0,10.0,11.0,10.0,13.0,18.0,1.0,19.0,0.0,0.0,0.0,0.0,174.0,61.0,1.0,3.0,2.0,3.0,2.0,1.0,2.0,2.0,3.0,1.0,1.0,5.0,9.0,10.0,6.0,12.0,6.0,8.0,8.0,5.0,9.0,10.0,7.0,9.0,13.0,11.0,12.0,12.0,11.0,9.0,11.0,11.0,8.0,9.0,10.0,8.0,10.0,12.0,16.0,13.0,13.0,10.0,8.0,20.0,15.0,11.0,8.0,13.0,9.0,15.0,11.0,10.0,6.0,13.0,10.0,9.0,14.0,11.0,12.0,14.0,14.0,8.0,22.0,0.0,0.0,0.0,0.0,187.0,84.0,2.0,2.0,1.0,2.0,3.0,2.0,2.0,3.0,3.0,2.0,2.0,4.0,7.0,10.0,6.0,9.0,10.0,13.0,12.0,5.0,11.0,11.0,7.0,10.0,12.0,12.0,11.0,13.0,10.0,9.0,11.0,9.0,15.0,8.0,7.0,9.0,11.0,11.0,14.0,13.0,10.0,15.0,14.0,8.0,15.0,11.0,20.0,14.0,15.0,11.0,12.0,7.0,9.0,8.0,7.0,13.0,15.0,13.0,11.0,14.0,14.0,7.0,21.0,0.0,0.0,0.0,0.0,172.0,66.0,2.0,3.0,2.0,2.0,1.0,1.0,1.0,3.0,2.0,1.0,1.0,10.0,10.0,13.0,9.0,14.0,9.0,8.0,10.0,7.0,13.0,13.0,9.0,12.0,13.0,10.0,12.0,13.0,13.0,12.0,14.0,13.0,13.0,11.0,9.0,14.0,13.0,14.0,14.0,14.0,13.0,12.0,8.0,8.0,12.0,12.0,20.0,13.0,12.0,14.0,10.0,11.0,8.0,12.0,15.0,10.0,15.0,8.0,11.0,14.0,14.0,6.0,24.0,24.0,4.0,0.0,0.0,172.0,74.0,2.0,4.0,3.0,2.0,2.0,1.0,2.0,2.0,3.0,2.0,4.0,8.0,9.0,14.0,13.0,14.0,9.0,11.0,10.0,7.0,5.0,12.0,12.0,3.0,13.0,10.0,12.0,12.0,13.0,12.0,11.0,10.0,14.0,13.0,7.0,14.0,9.0,9.0,13.0,16.0,15.0,13.0,6.0,8.0,13.0,16.0,20.0,14.0,12.0,11.0,11.0,13.0,9.0,8.0,9.0,13.0,9.0,11.0,12.0,13.0,10.0,9.0,22.0,0.0,0.0,0.0,0.0,177.0,69.0,2.0,2.0,4.0,1.0,2.0,3.0,1.0,3.0,1.0,3.0,2.0,7.0,11.0,14.0,8.0,14.0,10.0,4.0,10.0,11.0,3.0,10.0,4.0,5.0,14.0,11.0,10.0,16.0,11.0,10.0,7.0,11.0,6.0,12.0,4.0,14.0,4.0,9.0,11.0,16.0,14.0,6.0,9.0,8.0,6.0,16.0,20.0,10.0,6.0,11.0,8.0,12.0,10.0,11.0,12.0,16.0,8.0,10.0,5.0,12.0,5.0,14.0,24.0,2.0,0.0,0.0,0.0,195.0,84.0,1.0,4.0,1.0,2.0,3.0,1.0,2.0,1.0,2.0,1.0,1.0,6.0,6.0,9.0,11.0,10.0,8.0,14.0,11.0,5.0,8.0,10.0,11.0,2.0,11.0,11.0,12.0,14.0,11.0,14.0,8.0,12.0,13.0,8.0,6.0,11.0,7.0,13.0,14.0,13.0,12.0,18.0,18.0,8.0,13.0,14.0,20.0,14.0,17.0,12.0,11.0,10.0,7.0,5.0,8.0,12.0,9.0,12.0,13.0,12.0,14.0,2.0,25.0,4.0,0.0,11.0,0.0,184.0,81.0,14.0,14.0,13.0,9.0,15.0,12.0,16.0,16.0,13.0,7.0,11.0,8.0,1.0,2.0,1.0,11.0,12.0,6.0,1.0,3.0,3.0,11.0,5.0,3.0,11.0,8.0,15.0,15.0,13.0,14.0,10.0,11.0,14.0,8.0,13.0,5.0,13.0,10.0,10.0,14.0,16.0,14.0,13.0,20.0,14.0,12.0,5.0,14.0,14.0,15.0,9.0,16.0,6.0,1.0,17.0,11.0,15.0,13.0,14.0,12.0,12.0,4.0,21.0,8.0,0.0,2.0,1.0,184.0,75.0,3.0,2.0,2.0,3.0,3.0,2.0,3.0,3.0,3.0,2.0,4.0,6.0,8.0,13.0,9.0,13.0,5.0,13.0,6.0,10.0,12.0,11.0,10.0,15.0,13.0,15.0,13.0,13.0,13.0,14.0,10.0,11.0,11.0,9.0,8.0,6.0,11.0,14.0,15.0,15.0,14.0,14.0,13.0,11.0,12.0,14.0,20.0,13.0,14.0,13.0,7.0,13.0,9.0,9.0,15.0,15.0,12.0,11.0,11.0,15.0,14.0,2.0,27.0,0.0,0.0,0.0,0.0,178.0,72.0,2.0,3.0,2.0,3.0,2.0,3.0,3.0,1.0,1.0,2.0,1.0,13.0,14.0,11.0,7.0,12.0,10.0,9.0,10.0,13.0,13.0,12.0,10.0,14.0,13.0,12.0,14.0,14.0,13.0,14.0,11.0,12.0,14.0,13.0,8.0,14.0,13.0,13.0,15.0,15.0,13.0,10.0,10.0,20.0,13.0,15.0,6.0,14.0,10.0,13.0,13.0,12.0,8.0,12.0,15.0,14.0,13.0,14.0,13.0,13.0,12.0,6.0,19.0,0.0,0.0,3.0,1.0,181.0,69.0,3.0,2.0,3.0,3.0,2.0,1.0,1.0,1.0,3.0,3.0,4.0,10.0,10.0,12.0,12.0,12.0,7.0,8.0,11.0,5.0,7.0,10.0,10.0,7.0,11.0,8.0,10.0,10.0,12.0,8.0,11.0,8.0,14.0,13.0,6.0,14.0,8.0,13.0,13.0,16.0,14.0,13.0,9.0,20.0,15.0,16.0,10.0,15.0,13.0,12.0,8.0,11.0,7.0,12.0,11.0,11.0,15.0,10.0,12.0,14.0,14.0,1.0,21.0,0.0,0.0,0.0,0.0,178.0,65.0,2.0,3.0,3.0,3.0,3.0,1.0,1.0,1.0,1.0,3.0,1.0,9.0,13.0,11.0,6.0,12.0,7.0,9.0,8.0,8.0,13.0,12.0,7.0,13.0,12.0,8.0,12.0,13.0,12.0,12.0,13.0,13.0,14.0,9.0,8.0,12.0,12.0,13.0,13.0,12.0,14.0,13.0,11.0,8.0,15.0,12.0,20.0,13.0,12.0,14.0,8.0,11.0,7.0,10.0,19.0,10.0,13.0,10.0,11.0,15.0,15.0,6.0,20.0,4.0,0.0,0.0,0.0,180.0,77.0,4.0,1.0,2.0,2.0,1.0,1.0,1.0,1.0,3.0,3.0,3.0,7.0,9.0,11.0,5.0,12.0,5.0,11.0,7.0,10.0,15.0,11.0,6.0,16.0,11.0,15.0,11.0,15.0,11.0,11.0,10.0,13.0,13.0,9.0,7.0,12.0,14.0,12.0,14.0,14.0,13.0,14.0,12.0,10.0,14.0,14.0,20.0,14.0,14.0,13.0,9.0,13.0,5.0,12.0,7.0,12.0,10.0,10.0,10.0,4.0,7.0,10.0,19.0,0.0,0.0,0.0,0.0,185.0,82.0,4.0,2.0,3.0,1.0,3.0,2.0,1.0,2.0,1.0,2.0,3.0,7.0,7.0,10.0,6.0,13.0,7.0,14.0,7.0,6.0,12.0,13.0,7.0,13.0,13.0,13.0,13.0,13.0,11.0,12.0,11.0,12.0,14.0,9.0,14.0,11.0,11.0,15.0,15.0,12.0,12.0,14.0,13.0,5.0,14.0,12.0,20.0,14.0,13.0,10.0,11.0,11.0,6.0,10.0,10.0,12.0,12.0,14.0,14.0,11.0,16.0,6.0,18.0,0.0,0.0,0.0,0.0,170.0,67.0,3.0,1.0,3.0,3.0,3.0,4.0,1.0,2.0,1.0,2.0,2.0,11.0,11.0,12.0,13.0,12.0,11.0,6.0,10.0,8.0,7.0,12.0,10.0,7.0,13.0,9.0,11.0,8.0,10.0,10.0,12.0,12.0,15.0,12.0,12.0,11.0,12.0,11.0,12.0,12.0,12.0,10.0,6.0,5.0,14.0,12.0,20.0,10.0,9.0,10.0,8.0,2.0,6.0,12.0,11.0,11.0,12.0,13.0,14.0,11.0,13.0,4.0,19.0,0.0,0.0,0.0,0.0,175.0,67.0,3.0,2.0,1.0,3.0,3.0,1.0,1.0,1.0,2.0,1.0,3.0,7.0,8.0,12.0,8.0,10.0,6.0,12.0,9.0,8.0,10.0,10.0,8.0,12.0,11.0,14.0,10.0,12.0,9.0,10.0,11.0,10.0,12.0,12.0,10.0,12.0,12.0,13.0,14.0,13.0,11.0,14.0,8.0,6.0,14.0,12.0,20.0,14.0,12.0,12.0,8.0,11.0,6.0,12.0,17.0,13.0,10.0,11.0,12.0,11.0,17.0,5.0,19.0,0.0,0.0,0.0,0.0,183.0,74.0,3.0,3.0,1.0,2.0,3.0,2.0,1.0,1.0,3.0,1.0,2.0,8.0,9.0,14.0,14.0,12.0,8.0,13.0,12.0,7.0,3.0,9.0,15.0,3.0,14.0,10.0,14.0,8.0,14.0,11.0,10.0,13.0,15.0,14.0,6.0,13.0,7.0,8.0,10.0,16.0,14.0,14.0,11.0,12.0,14.0,15.0,20.0,13.0,15.0,13.0,5.0,13.0,7.0,5.0,10.0,15.0,8.0,13.0,13.0,11.0,12.0,11.0,18.0,0.0,0.0,0.0,0.0,184.0,71.0,2.0,3.0,2.0,3.0,1.0,2.0,1.0,3.0,2.0,1.0,3.0,8.0,10.0,14.0,10.0,12.0,8.0,5.0,10.0,3.0,5.0,12.0,7.0,6.0,13.0,8.0,8.0,8.0,11.0,8.0,11.0,14.0,12.0,10.0,11.0,10.0,9.0,9.0,13.0,14.0,13.0,5.0,10.0,10.0,13.0,14.0,20.0,12.0,8.0,10.0,8.0,10.0,4.0,10.0,11.0,12.0,11.0,12.0,13.0,11.0,13.0,6.0
2,1,31.0,22.0,0.0,17.0,0.0,185.0,82.0,12.0,12.0,13.0,6.0,14.0,11.0,15.0,18.0,14.0,10.0,13.0,7.0,3.0,8.0,5.0,9.0,10.0,8.0,12.0,2.0,2.0,9.0,6.0,3.0,10.0,6.0,12.0,15.0,16.0,12.0,8.0,12.0,14.0,8.0,15.0,3.0,13.0,13.0,8.0,13.0,17.0,14.0,13.0,7.0,12.0,11.0,20.0,15.0,14.0,13.0,6.0,16.0,3.0,1.0,8.0,16.0,12.0,13.0,16.0,16.0,16.0,7.0,19.0,0.0,0.0,7.0,2.0,188.0,85.0,1.0,3.0,2.0,1.0,2.0,3.0,3.0,2.0,2.0,3.0,1.0,10.0,6.0,9.0,8.0,10.0,12.0,15.0,8.0,7.0,14.0,11.0,10.0,13.0,10.0,14.0,11.0,13.0,9.0,11.0,10.0,10.0,9.0,1.0,8.0,12.0,13.0,13.0,14.0,13.0,10.0,13.0,15.0,9.0,12.0,13.0,20.0,14.0,14.0,9.0,11.0,4.0,9.0,11.0,14.0,13.0,12.0,12.0,12.0,1.0,13.0,2.0,16.0,0.0,0.0,0.0,0.0,192.0,0.0,2.0,3.0,1.0,2.0,3.0,1.0,1.0,1.0,2.0,3.0,3.0,6.0,8.0,8.0,6.0,10.0,6.0,12.0,6.0,7.0,12.0,10.0,7.0,12.0,10.0,13.0,12.0,14.0,11.0,10.0,8.0,10.0,10.0,8.0,6.0,8.0,9.0,10.0,13.0,13.0,11.0,12.0,13.0,6.0,14.0,12.0,20.0,10.0,10.0,10.0,7.0,8.0,8.0,10.0,9.0,13.0,10.0,11.0,11.0,10.0,15.0,9.0,24.0,0.0,0.0,0.0,0.0,177.0,65.0,1.0,2.0,1.0,2.0,1.0,2.0,1.0,1.0,1.0,2.0,3.0,8.0,11.0,13.0,10.0,13.0,8.0,10.0,11.0,7.0,5.0,12.0,13.0,6.0,13.0,8.0,11.0,9.0,10.0,9.0,9.0,11.0,13.0,12.0,5.0,12.0,8.0,7.0,9.0,16.0,15.0,12.0,8.0,10.0,15.0,15.0,20.0,14.0,12.0,11.0,8.0,13.0,7.0,12.0,20.0,14.0,13.0,12.0,9.0,12.0,11.0,10.0,26.0,27.0,0.0,0.0,0.0,183.0,70.0,1.0,3.0,1.0,3.0,4.0,1.0,3.0,3.0,2.0,1.0,3.0,9.0,14.0,12.0,8.0,10.0,8.0,12.0,13.0,14.0,9.0,12.0,7.0,13.0,11.0,14.0,9.0,15.0,10.0,12.0,9.0,10.0,16.0,10.0,9.0,12.0,8.0,12.0,17.0,14.0,11.0,13.0,12.0,10.0,16.0,16.0,20.0,16.0,13.0,13.0,10.0,14.0,6.0,15.0,10.0,15.0,14.0,10.0,16.0,13.0,13.0,4.0,28.0,41.0,2.0,0.0,0.0,187.0,80.0,3.0,2.0,3.0,2.0,1.0,1.0,2.0,3.0,1.0,4.0,2.0,7.0,10.0,11.0,7.0,12.0,7.0,10.0,12.0,13.0,15.0,13.0,8.0,18.0,12.0,18.0,13.0,17.0,12.0,14.0,10.0,12.0,17.0,7.0,13.0,9.0,14.0,17.0,18.0,14.0,13.0,16.0,14.0,20.0,18.0,13.0,12.0,18.0,14.0,15.0,16.0,15.0,6.0,15.0,14.0,13.0,10.0,14.0,12.0,8.0,7.0,8.0,18.0,0.0,0.0,0.0,0.0,167.0,60.0,2.0,1.0,2.0,2.0,2.0,1.0,2.0,1.0,1.0,1.0,1.0,10.0,11.0,12.0,8.0,13.0,10.0,3.0,10.0,5.0,6.0,13.0,12.0,8.0,15.0,8.0,11.0,8.0,12.0,11.0,13.0,12.0,13.0,12.0,6.0,11.0,11.0,12.0,13.0,15.0,14.0,8.0,5.0,8.0,15.0,12.0,20.0,12.0,7.0,8.0,8.0,14.0,7.0,8.0,18.0,11.0,12.0,11.0,12.0,15.0,15.0,7.0,23.0,0.0,0.0,10.0,7.0,179.0,70.0,1.0,1.0,2.0,2.0,1.0,3.0,3.0,2.0,1.0,4.0,3.0,10.0,13.0,14.0,12.0,15.0,11.0,10.0,13.0,6.0,3.0,13.0,12.0,4.0,16.0,11.0,12.0,11.0,13.0,11.0,13.0,12.0,12.0,16.0,6.0,14.0,6.0,10.0,12.0,16.0,14.0,12.0,9.0,20.0,13.0,14.0,10.0,13.0,10.0,12.0,7.0,12.0,6.0,8.0,12.0,13.0,5.0,10.0,8.0,14.0,12.0,8.0,29.0,26.0,6.0,12.0,4.0,175.0,77.0,1.0,2.0,1.0,3.0,3.0,2.0,1.0,2.0,1.0,2.0,2.0,16.0,14.0,16.0,15.0,15.0,18.0,6.0,15.0,6.0,6.0,18.0,11.0,5.0,17.0,9.0,12.0,10.0,16.0,12.0,16.0,14.0,14.0,16.0,6.0,16.0,6.0,10.0,10.0,13.0,15.0,14.0,8.0,15.0,15.0,14.0,20.0,13.0,12.0,11.0,9.0,16.0,7.0,8.0,8.0,11.0,8.0,13.0,12.0,13.0,11.0,10.0,20.0,0.0,0.0,0.0,0.0,178.0,81.0,2.0,1.0,3.0,3.0,2.0,2.0,3.0,3.0,2.0,3.0,3.0,11.0,12.0,15.0,12.0,14.0,8.0,7.0,14.0,5.0,3.0,10.0,10.0,3.0,14.0,16.0,12.0,10.0,12.0,8.0,11.0,8.0,11.0,15.0,8.0,13.0,5.0,7.0,6.0,14.0,14.0,12.0,8.0,8.0,8.0,14.0,20.0,9.0,10.0,11.0,14.0,10.0,6.0,9.0,6.0,14.0,4.0,11.0,4.0,7.0,4.0,18.0,25.0,33.0,13.0,16.0,6.0,189.0,88.0,2.0,4.0,1.0,2.0,3.0,1.0,2.0,3.0,2.0,1.0,2.0,12.0,13.0,15.0,15.0,15.0,17.0,16.0,16.0,8.0,5.0,14.0,19.0,7.0,16.0,13.0,14.0,12.0,16.0,9.0,14.0,12.0,7.0,15.0,8.0,12.0,5.0,2.0,4.0,13.0,15.0,14.0,14.0,12.0,12.0,15.0,20.0,13.0,15.0,7.0,16.0,13.0,14.0,11.0,8.0,13.0,4.0,11.0,8.0,3.0,4.0,16.0,19.0,0.0,0.0,0.0,0.0,190.0,78.0,13.0,12.0,11.0,14.0,13.0,6.0,11.0,13.0,13.0,12.0,7.0,3.0,3.0,1.0,3.0,8.0,8.0,3.0,1.0,2.0,3.0,7.0,3.0,1.0,7.0,8.0,13.0,13.0,12.0,13.0,7.0,11.0,11.0,3.0,14.0,2.0,11.0,11.0,10.0,12.0,13.0,11.0,15.0,20.0,10.0,13.0,5.0,13.0,13.0,9.0,10.0,6.0,10.0,10.0,10.0,12.0,11.0,14.0,14.0,12.0,13.0,3.0,32.0,0.0,0.0,0.0,0.0,187.0,90.0,3.0,1.0,1.0,1.0,1.0,1.0,3.0,1.0,2.0,3.0,1.0,4.0,8.0,6.0,6.0,8.0,6.0,14.0,7.0,6.0,13.0,8.0,7.0,13.0,8.0,14.0,12.0,16.0,10.0,13.0,6.0,11.0,14.0,6.0,14.0,8.0,12.0,14.0,13.0,9.0,8.0,17.0,13.0,20.0,14.0,11.0,5.0,13.0,15.0,13.0,14.0,14.0,7.0,6.0,14.0,12.0,13.0,13.0,13.0,11.0,13.0,7.0,17.0,0.0,0.0,0.0,0.0,170.0,74.0,3.0,3.0,2.0,1.0,3.0,3.0,2.0,3.0,1.0,3.0,4.0,8.0,13.0,11.0,10.0,9.0,10.0,6.0,7.0,6.0,10.0,9.0,4.0,11.0,12.0,9.0,10.0,10.0,10.0,12.0,12.0,8.0,10.0,8.0,2.0,10.0,11.0,11.0,11.0,13.0,16.0,11.0,7.0,20.0,15.0,15.0,6.0,12.0,13.0,12.0,3.0,6.0,10.0,14.0,12.0,16.0,11.0,11.0,12.0,12.0,17.0,8.0,19.0,0.0,0.0,0.0,0.0,179.0,70.0,2.0,1.0,2.0,4.0,3.0,1.0,3.0,3.0,4.0,2.0,3.0,8.0,10.0,8.0,7.0,12.0,6.0,11.0,6.0,5.0,12.0,10.0,8.0,13.0,10.0,12.0,12.0,12.0,11.0,11.0,7.0,12.0,10.0,7.0,9.0,10.0,10.0,10.0,12.0,12.0,12.0,13.0,10.0,20.0,10.0,13.0,10.0,12.0,14.0,14.0,10.0,3.0,7.0,10.0,13.0,10.0,9.0,10.0,8.0,9.0,15.0,7.0,20.0,0.0,0.0,0.0,0.0,180.0,73.0,4.0,1.0,1.0,1.0,2.0,1.0,3.0,1.0,1.0,1.0,3.0,9.0,11.0,12.0,10.0,12.0,7.0,11.0,10.0,8.0,6.0,10.0,11.0,5.0,10.0,9.0,8.0,9.0,10.0,8.0,10.0,11.0,9.0,7.0,1.0,10.0,7.0,7.0,10.0,13.0,9.0,13.0,10.0,5.0,6.0,13.0,20.0,9.0,11.0,9.0,9.0,9.0,9.0,9.0,13.0,8.0,12.0,12.0,12.0,11.0,13.0,1.0,24.0,0.0,0.0,0.0,0.0,172.0,69.0,3.0,4.0,1.0,4.0,1.0,2.0,1.0,2.0,2.0,3.0,3.0,10.0,12.0,13.0,7.0,13.0,13.0,7.0,11.0,6.0,2.0,12.0,10.0,4.0,15.0,12.0,11.0,12.0,9.0,10.0,13.0,11.0,3.0,15.0,6.0,13.0,5.0,10.0,13.0,14.0,15.0,11.0,7.0,5.0,14.0,14.0,20.0,13.0,10.0,13.0,12.0,13.0,8.0,10.0,9.0,11.0,10.0,11.0,9.0,11.0,10.0,3.0,24.0,0.0,0.0,6.0,1.0,172.0,70.0,3.0,1.0,1.0,3.0,1.0,2.0,3.0,1.0,1.0,3.0,3.0,11.0,12.0,11.0,8.0,12.0,10.0,6.0,14.0,7.0,11.0,15.0,8.0,12.0,13.0,14.0,14.0,18.0,13.0,12.0,13.0,13.0,15.0,12.0,12.0,12.0,11.0,18.0,18.0,13.0,14.0,13.0,7.0,10.0,16.0,12.0,20.0,14.0,12.0,14.0,14.0,15.0,4.0,8.0,7.0,14.0,14.0,13.0,14.0,12.0,10.0,6.0,24.0,1.0,0.0,2.0,0.0,186.0,81.0,1.0,3.0,2.0,2.0,3.0,3.0,3.0,2.0,1.0,2.0,1.0,9.0,8.0,11.0,13.0,12.0,12.0,14.0,13.0,5.0,4.0,10.0,10.0,2.0,13.0,8.0,12.0,10.0,13.0,12.0,8.0,11.0,16.0,13.0,6.0,11.0,6.0,8.0,9.0,12.0,14.0,14.0,13.0,10.0,15.0,13.0,20.0,12.0,14.0,11.0,8.0,14.0,6.0,8.0,17.0,15.0,11.0,10.0,12.0,13.0,13.0,9.0,23.0,0.0,0.0,0.0,0.0,181.0,73.0,2.0,1.0,2.0,1.0,3.0,3.0,2.0,2.0,4.0,2.0,1.0,5.0,12.0,14.0,13.0,13.0,7.0,12.0,8.0,4.0,5.0,9.0,12.0,5.0,13.0,11.0,11.0,12.0,13.0,11.0,8.0,12.0,14.0,11.0,6.0,13.0,7.0,12.0,13.0,12.0,14.0,13.0,10.0,8.0,14.0,11.0,20.0,13.0,12.0,13.0,5.0,10.0,7.0,14.0,12.0,11.0,14.0,10.0,11.0,10.0,15.0,4.0,21.0,0.0,0.0,0.0,0.0,179.0,75.0,3.0,3.0,2.0,2.0,1.0,3.0,3.0,3.0,1.0,1.0,1.0,5.0,9.0,13.0,11.0,11.0,8.0,10.0,11.0,5.0,2.0,9.0,12.0,2.0,12.0,7.0,11.0,12.0,10.0,9.0,10.0,10.0,13.0,12.0,5.0,13.0,7.0,7.0,11.0,14.0,13.0,13.0,9.0,6.0,12.0,15.0,20.0,13.0,14.0,11.0,10.0,10.0,5.0,10.0,16.0,11.0,10.0,12.0,9.0,13.0,13.0,9.0,21.0,0.0,0.0,0.0,0.0,180.0,71.0,1.0,2.0,1.0,3.0,3.0,3.0,2.0,2.0,2.0,2.0,3.0,10.0,10.0,11.0,10.0,12.0,10.0,8.0,10.0,8.0,8.0,12.0,5.0,6.0,12.0,4.0,11.0,8.0,10.0,9.0,11.0,10.0,10.0,13.0,8.0,12.0,7.0,11.0,12.0,13.0,12.0,10.0,10.0,5.0,12.0,12.0,20.0,11.0,10.0,10.0,10.0,5.0,10.0,12.0,7.0,10.0,14.0,12.0,9.0,10.0,16.0,7.0
0,1,22.0,0.0,0.0,0.0,0.0,186.0,79.0,14.0,13.0,11.0,7.0,12.0,10.0,13.0,14.0,8.0,6.0,8.0,2.0,1.0,3.0,6.0,8.0,5.0,3.0,11.0,3.0,2.0,8.0,8.0,1.0,8.0,8.0,12.0,14.0,12.0,11.0,7.0,11.0,12.0,6.0,9.0,3.0,12.0,12.0,5.0,8.0,12.0,15.0,15.0,20.0,15.0,7.0,5.0,9.0,15.0,14.0,8.0,5.0,5.0,1.0,10.0,12.0,13.0,12.0,8.0,15.0,15.0,5.0,21.0,0.0,0.0,0.0,0.0,182.0,74.0,2.0,2.0,2.0,2.0,2.0,1.0,1.0,1.0,3.0,2.0,2.0,9.0,11.0,12.0,7.0,9.0,8.0,12.0,7.0,11.0,12.0,7.0,8.0,13.0,11.0,12.0,12.0,14.0,12.0,13.0,7.0,12.0,11.0,1.0,9.0,11.0,9.0,10.0,12.0,14.0,10.0,13.0,11.0,9.0,8.0,12.0,20.0,13.0,11.0,10.0,13.0,8.0,10.0,10.0,15.0,11.0,13.0,10.0,10.0,8.0,13.0,7.0,21.0,0.0,0.0,1.0,0.0,177.0,68.0,4.0,1.0,2.0,1.0,1.0,1.0,1.0,1.0,2.0,1.0,2.0,5.0,12.0,9.0,7.0,12.0,8.0,13.0,10.0,16.0,13.0,12.0,8.0,14.0,12.0,12.0,13.0,12.0,12.0,12.0,10.0,13.0,15.0,11.0,13.0,11.0,13.0,13.0,14.0,13.0,14.0,13.0,11.0,10.0,14.0,12.0,20.0,12.0,14.0,12.0,11.0,12.0,8.0,14.0,13.0,10.0,14.0,12.0,14.0,12.0,11.0,5.0,27.0,10.0,0.0,0.0,0.0,181.0,69.0,1.0,1.0,3.0,3.0,3.0,3.0,2.0,3.0,3.0,3.0,1.0,5.0,13.0,10.0,7.0,13.0,9.0,10.0,10.0,12.0,12.0,11.0,7.0,12.0,11.0,11.0,13.0,12.0,11.0,13.0,9.0,9.0,12.0,8.0,7.0,12.0,11.0,11.0,13.0,15.0,13.0,13.0,10.0,20.0,12.0,15.0,8.0,15.0,12.0,13.0,11.0,14.0,13.0,12.0,10.0,14.0,12.0,10.0,11.0,15.0,15.0,7.0,23.0,0.0,0.0,0.0,0.0,182.0,80.0,2.0,3.0,2.0,2.0,2.0,3.0,4.0,4.0,1.0,2.0,1.0,5.0,7.0,12.0,5.0,13.0,6.0,12.0,6.0,6.0,13.0,11.0,6.0,14.0,11.0,13.0,12.0,13.0,14.0,13.0,9.0,10.0,13.0,7.0,10.0,8.0,10.0,13.0,12.0,14.0,12.0,13.0,10.0,5.0,12.0,13.0,20.0,15.0,14.0,14.0,6.0,10.0,9.0,7.0,9.0,12.0,17.0,13.0,14.0,14.0,14.0,5.0,27.0,32.0,6.0,0.0,0.0,188.0,78.0,3.0,2.0,3.0,2.0,1.0,3.0,3.0,3.0,2.0,2.0,2.0,4.0,8.0,11.0,12.0,12.0,6.0,16.0,13.0,8.0,13.0,14.0,7.0,12.0,12.0,12.0,10.0,14.0,13.0,12.0,11.0,12.0,15.0,9.0,11.0,12.0,6.0,13.0,12.0,14.0,13.0,15.0,15.0,5.0,13.0,12.0,20.0,16.0,15.0,14.0,12.0,15.0,11.0,10.0,9.0,15.0,12.0,12.0,13.0,13.0,13.0,7.0,18.0,0.0,0.0,0.0,0.0,177.0,66.0,2.0,2.0,1.0,2.0,1.0,3.0,3.0,2.0,3.0,2.0,3.0,8.0,6.0,8.0,7.0,12.0,6.0,5.0,9.0,5.0,1.0,10.0,4.0,4.0,12.0,5.0,4.0,6.0,6.0,3.0,13.0,7.0,8.0,12.0,6.0,10.0,6.0,8.0,12.0,15.0,10.0,7.0,7.0,20.0,14.0,11.0,5.0,13.0,5.0,8.0,8.0,7.0,8.0,8.0,13.0,10.0,11.0,11.0,11.0,9.0,18.0,3.0,21.0,0.0,0.0,0.0,0.0,180.0,68.0,4.0,1.0,1.0,1.0,1.0,3.0,1.0,2.0,2.0,2.0,3.0,10.0,10.0,13.0,9.0,13.0,9.0,8.0,8.0,6.0,11.0,13.0,10.0,10.0,12.0,8.0,8.0,8.0,11.0,10.0,13.0,10.0,20.0,13.0,6.0,9.0,9.0,7.0,10.0,14.0,14.0,13.0,10.0,10.0,10.0,14.0,20.0,12.0,11.0,10.0,10.0,7.0,6.0,13.0,17.0,12.0,10.0,12.0,12.0,8.0,10.0,2.0,27.0,1.0,0.0,0.0,0.0,179.0,70.0,3.0,2.0,1.0,3.0,3.0,2.0,1.0,3.0,2.0,1.0,1.0,14.0,15.0,15.0,11.0,15.0,14.0,8.0,12.0,5.0,8.0,13.0,12.0,9.0,18.0,11.0,11.0,11.0,9.0,10.0,16.0,10.0,17.0,15.0,8.0,12.0,8.0,12.0,11.0,14.0,13.0,12.0,10.0,12.0,13.0,14.0,20.0,16.0,12.0,10.0,9.0,10.0,7.0,8.0,13.0,15.0,13.0,10.0,11.0,12.0,10.0,8.0,23.0,15.0,5.0,0.0,0.0,186.0,81.0,3.0,1.0,1.0,4.0,1.0,1.0,2.0,2.0,3.0,3.0,4.0,5.0,10.0,13.0,14.0,10.0,5.0,11.0,13.0,5.0,4.0,9.0,10.0,4.0,10.0,13.0,11.0,14.0,12.0,9.0,8.0,8.0,15.0,13.0,7.0,8.0,7.0,10.0,10.0,15.0,12.0,15.0,12.0,7.0,10.0,18.0,20.0,17.0,15.0,8.0,8.0,11.0,12.0,12.0,12.0,15.0,13.0,12.0,15.0,13.0,13.0,6.0,21.0,0.0,0.0,4.0,1.0,184.0,79.0,1.0,2.0,3.0,1.0,2.0,1.0,3.0,2.0,2.0,1.0,3.0,3.0,6.0,10.0,12.0,12.0,7.0,15.0,8.0,4.0,5.0,13.0,10.0,8.0,12.0,18.0,12.0,19.0,13.0,10.0,13.0,12.0,14.0,13.0,10.0,12.0,9.0,16.0,15.0,12.0,14.0,14.0,14.0,12.0,13.0,10.0,20.0,14.0,14.0,11.0,14.0,14.0,11.0,5.0,10.0,13.0,14.0,15.0,10.0,8.0,4.0,15.0,33.0,0.0,0.0,3.0,0.0,188.0,84.0,14.0,13.0,13.0,9.0,13.0,13.0,15.0,15.0,11.0,11.0,9.0,7.0,3.0,3.0,1.0,7.0,10.0,2.0,1.0,1.0,2.0,6.0,4.0,1.0,7.0,8.0,13.0,14.0,14.0,14.0,8.0,11.0,15.0,6.0,13.0,3.0,13.0,12.0,8.0,12.0,14.0,15.0,14.0,8.0,13.0,11.0,20.0,13.0,15.0,16.0,8.0,13.0,6.0,1.0,11.0,14.0,13.0,11.0,16.0,14.0,11.0,6.0,28.0,0.0,0.0,0.0,0.0,193.0,84.0,1.0,1.0,2.0,2.0,2.0,3.0,2.0,3.0,2.0,1.0,3.0,4.0,8.0,8.0,9.0,10.0,6.0,14.0,7.0,8.0,14.0,12.0,6.0,14.0,11.0,12.0,13.0,14.0,11.0,14.0,12.0,12.0,14.0,6.0,11.0,8.0,14.0,13.0,13.0,11.0,11.0,16.0,16.0,20.0,12.0,12.0,8.0,14.0,16.0,14.0,12.0,13.0,6.0,10.0,7.0,12.0,15.0,12.0,16.0,15.0,13.0,6.0,26.0,0.0,0.0,10.0,1.0,196.0,91.0,3.0,1.0,2.0,2.0,2.0,3.0,2.0,4.0,2.0,2.0,1.0,3.0,5.0,8.0,6.0,9.0,5.0,14.0,7.0,8.0,13.0,10.0,5.0,12.0,10.0,10.0,13.0,14.0,12.0,12.0,7.0,10.0,13.0,6.0,9.0,6.0,12.0,14.0,10.0,9.0,8.0,13.0,18.0,8.0,17.0,11.0,20.0,12.0,16.0,13.0,12.0,10.0,7.0,4.0,18.0,10.0,12.0,9.0,13.0,7.0,10.0,7.0,26.0,0.0,0.0,0.0,0.0,175.0,69.0,3.0,3.0,2.0,2.0,3.0,1.0,3.0,1.0,3.0,2.0,2.0,6.0,12.0,10.0,5.0,11.0,6.0,10.0,10.0,10.0,13.0,12.0,9.0,13.0,12.0,12.0,13.0,14.0,12.0,13.0,12.0,11.0,15.0,11.0,13.0,12.0,13.0,14.0,14.0,15.0,13.0,12.0,7.0,9.0,13.0,13.0,20.0,14.0,11.0,14.0,12.0,12.0,11.0,15.0,14.0,9.0,17.0,10.0,8.0,11.0,20.0,7.0,25.0,0.0,0.0,15.0,1.0,176.0,64.0,2.0,2.0,3.0,3.0,1.0,1.0,3.0,3.0,2.0,1.0,3.0,9.0,9.0,11.0,7.0,13.0,11.0,14.0,9.0,6.0,12.0,14.0,6.0,13.0,13.0,13.0,14.0,15.0,14.0,14.0,13.0,13.0,15.0,8.0,11.0,9.0,12.0,15.0,18.0,14.0,14.0,12.0,10.0,5.0,15.0,11.0,20.0,16.0,10.0,15.0,13.0,15.0,5.0,10.0,11.0,14.0,14.0,14.0,17.0,13.0,13.0,5.0,29.0,0.0,0.0,0.0,0.0,183.0,78.0,1.0,3.0,3.0,3.0,3.0,1.0,2.0,3.0,3.0,1.0,1.0,13.0,8.0,9.0,6.0,12.0,14.0,13.0,10.0,12.0,11.0,12.0,8.0,13.0,12.0,12.0,15.0,13.0,13.0,13.0,11.0,13.0,15.0,6.0,12.0,7.0,13.0,16.0,18.0,12.0,11.0,14.0,12.0,20.0,14.0,11.0,8.0,16.0,14.0,14.0,12.0,14.0,6.0,12.0,10.0,12.0,13.0,11.0,15.0,15.0,15.0,5.0,21.0,0.0,0.0,0.0,0.0,183.0,73.0,1.0,4.0,3.0,3.0,3.0,1.0,4.0,1.0,2.0,3.0,2.0,11.0,10.0,12.0,11.0,13.0,9.0,12.0,10.0,5.0,8.0,12.0,9.0,8.0,13.0,13.0,12.0,12.0,10.0,12.0,14.0,12.0,12.0,14.0,8.0,12.0,8.0,12.0,12.0,14.0,14.0,14.0,11.0,8.0,13.0,13.0,20.0,12.0,12.0,12.0,5.0,10.0,7.0,12.0,15.0,11.0,11.0,10.0,11.0,12.0,11.0,4.0,18.0,0.0,0.0,0.0,0.0,188.0,0.0,2.0,2.0,1.0,1.0,1.0,2.0,1.0,4.0,2.0,2.0,1.0,8.0,11.0,14.0,11.0,13.0,10.0,11.0,10.0,2.0,6.0,12.0,11.0,8.0,13.0,8.0,11.0,9.0,13.0,9.0,13.0,11.0,14.0,15.0,8.0,12.0,7.0,11.0,13.0,14.0,12.0,12.0,13.0,12.0,11.0,14.0,20.0,11.0,11.0,12.0,8.0,11.0,8.0,14.0,12.0,11.0,10.0,12.0,13.0,12.0,14.0,7.0,29.0,0.0,0.0,0.0,0.0,180.0,71.0,1.0,3.0,1.0,1.0,1.0,4.0,4.0,1.0,1.0,2.0,3.0,10.0,11.0,12.0,9.0,13.0,11.0,8.0,14.0,6.0,8.0,11.0,10.0,8.0,12.0,10.0,11.0,12.0,12.0,9.0,12.0,11.0,14.0,12.0,7.0,12.0,10.0,12.0,14.0,15.0,14.0,12.0,10.0,20.0,16.0,13.0,12.0,15.0,10.0,13.0,10.0,15.0,7.0,8.0,16.0,12.0,12.0,13.0,14.0,15.0,15.0,6.0,23.0,0.0,0.0,0.0,0.0,175.0,70.0,2.0,1.0,2.0,2.0,1.0,2.0,2.0,3.0,4.0,1.0,2.0,10.0,11.0,12.0,9.0,13.0,8.0,6.0,13.0,2.0,5.0,13.0,10.0,6.0,13.0,7.0,13.0,9.0,13.0,11.0,13.0,12.0,13.0,12.0,10.0,12.0,10.0,13.0,12.0,11.0,12.0,13.0,8.0,8.0,14.0,12.0,20.0,14.0,12.0,13.0,9.0,11.0,10.0,11.0,19.0,12.0,14.0,11.0,13.0,10.0,16.0,7.0,34.0,0.0,0.0,0.0,0.0,187.0,78.0,3.0,2.0,1.0,3.0,2.0,2.0,1.0,2.0,3.0,1.0,2.0,8.0,5.0,4.0,8.0,12.0,8.0,8.0,8.0,2.0,12.0,13.0,4.0,14.0,10.0,8.0,11.0,9.0,10.0,9.0,7.0,14.0,4.0,8.0,11.0,8.0,13.0,9.0,11.0,10.0,10.0,9.0,10.0,4.0,8.0,11.0,20.0,9.0,10.0,10.0,10.0,7.0,7.0,10.0,16.0,11.0,10.0,10.0,11.0,12.0,13.0,6.0
1,1,33.0,0.0,0.0,3.0,0.0,188.0,84.0,14.0,13.0,13.0,9.0,13.0,13.0,15.0,15.0,11.0,11.0,9.0,7.0,3.0,3.0,1.0,7.0,10.0,2.0,1.0,1.0,2.0,6.0,4.0,1.0,7.0,8.0,13.0,14.0,14.0,14.0,8.0,11.0,15.0,6.0,13.0,3.0,13.0,12.0,8.0,12.0,14.0,15.0,14.0,8.0,13.0,11.0,20.0,13.0,15.0,16.0,8.0,13.0,6.0,1.0,11.0,14.0,13.0,11.0,16.0,14.0,11.0,6.0,28.0,0.0,0.0,0.0,0.0,193.0,84.0,1.0,1.0,2.0,2.0,2.0,3.0,2.0,3.0,2.0,1.0,3.0,4.0,8.0,8.0,9.0,10.0,6.0,14.0,7.0,8.0,14.0,12.0,6.0,14.0,11.0,12.0,13.0,14.0,11.0,14.0,12.0,12.0,14.0,6.0,11.0,8.0,14.0,13.0,13.0,11.0,11.0,16.0,16.0,20.0,12.0,12.0,8.0,14.0,16.0,14.0,12.0,13.0,6.0,10.0,7.0,12.0,15.0,12.0,16.0,15.0,13.0,6.0,29.0,2.0,0.0,0.0,0.0,185.0,75.0,2.0,3.0,3.0,3.0,2.0,3.0,2.0,1.0,3.0,1.0,2.0,4.0,10.0,8.0,6.0,10.0,6.0,14.0,7.0,7.0,14.0,11.0,6.0,14.0,9.0,13.0,13.0,14.0,11.0,12.0,12.0,12.0,14.0,8.0,11.0,12.0,13.0,13.0,13.0,15.0,12.0,15.0,12.0,8.0,15.0,13.0,20.0,14.0,15.0,14.0,7.0,14.0,8.0,6.0,14.0,13.0,15.0,14.0,14.0,14.0,14.0,6.0,22.0,0.0,0.0,0.0,0.0,182.0,71.0,1.0,3.0,1.0,1.0,1.0,2.0,4.0,1.0,3.0,3.0,1.0,10.0,13.0,12.0,6.0,12.0,11.0,12.0,5.0,7.0,12.0,10.0,5.0,13.0,11.0,12.0,13.0,12.0,10.0,11.0,13.0,12.0,19.0,13.0,2.0,10.0,9.0,11.0,12.0,14.0,12.0,12.0,12.0,20.0,7.0,13.0,5.0,13.0,9.0,10.0,14.0,4.0,10.0,10.0,12.0,12.0,11.0,10.0,10.0,12.0,14.0,3.0,26.0,0.0,0.0,0.0,0.0,175.0,69.0,3.0,3.0,2.0,2.0,3.0,1.0,3.0,1.0,3.0,2.0,2.0,6.0,12.0,10.0,5.0,11.0,6.0,10.0,10.0,10.0,13.0,12.0,9.0,13.0,12.0,12.0,13.0,14.0,12.0,13.0,12.0,11.0,15.0,11.0,13.0,12.0,13.0,14.0,14.0,15.0,13.0,12.0,7.0,9.0,13.0,13.0,20.0,14.0,11.0,14.0,12.0,12.0,11.0,15.0,14.0,9.0,17.0,10.0,8.0,11.0,20.0,7.0,29.0,0.0,0.0,0.0,0.0,183.0,78.0,1.0,3.0,3.0,3.0,3.0,1.0,2.0,3.0,3.0,1.0,1.0,13.0,8.0,9.0,6.0,12.0,14.0,13.0,10.0,12.0,11.0,12.0,8.0,13.0,12.0,12.0,15.0,13.0,13.0,13.0,11.0,13.0,15.0,6.0,12.0,7.0,13.0,16.0,18.0,12.0,11.0,14.0,12.0,20.0,14.0,11.0,8.0,16.0,14.0,14.0,12.0,14.0,6.0,12.0,10.0,12.0,13.0,11.0,15.0,15.0,15.0,5.0,21.0,0.0,0.0,0.0,0.0,183.0,73.0,1.0,4.0,3.0,3.0,3.0,1.0,4.0,1.0,2.0,3.0,2.0,11.0,10.0,12.0,11.0,13.0,9.0,12.0,10.0,5.0,8.0,12.0,9.0,8.0,13.0,13.0,12.0,12.0,10.0,12.0,14.0,12.0,12.0,14.0,8.0,12.0,8.0,12.0,12.0,14.0,14.0,14.0,11.0,8.0,13.0,13.0,20.0,12.0,12.0,12.0,5.0,10.0,7.0,12.0,15.0,11.0,11.0,10.0,11.0,12.0,11.0,4.0,23.0,0.0,0.0,0.0,0.0,175.0,70.0,2.0,1.0,2.0,2.0,1.0,2.0,2.0,3.0,4.0,1.0,2.0,10.0,11.0,12.0,9.0,13.0,8.0,6.0,13.0,2.0,5.0,13.0,10.0,6.0,13.0,7.0,13.0,9.0,13.0,11.0,13.0,12.0,13.0,12.0,10.0,12.0,10.0,13.0,12.0,11.0,12.0,13.0,8.0,8.0,14.0,12.0,20.0,14.0,12.0,13.0,9.0,11.0,10.0,11.0,19.0,12.0,14.0,11.0,13.0,10.0,16.0,7.0,19.0,0.0,0.0,0.0,0.0,185.0,80.0,3.0,2.0,2.0,3.0,3.0,4.0,3.0,3.0,3.0,2.0,1.0,8.0,12.0,13.0,8.0,12.0,13.0,12.0,9.0,6.0,12.0,13.0,9.0,13.0,12.0,12.0,13.0,12.0,12.0,10.0,12.0,12.0,4.0,13.0,8.0,12.0,8.0,12.0,14.0,13.0,14.0,12.0,11.0,5.0,15.0,14.0,20.0,13.0,13.0,12.0,10.0,9.0,11.0,15.0,15.0,9.0,10.0,9.0,12.0,11.0,10.0,5.0,18.0,0.0,0.0,0.0,0.0,188.0,0.0,2.0,2.0,1.0,1.0,1.0,2.0,1.0,4.0,2.0,2.0,1.0,8.0,11.0,14.0,11.0,13.0,10.0,11.0,10.0,2.0,6.0,12.0,11.0,8.0,13.0,8.0,11.0,9.0,13.0,9.0,13.0,11.0,14.0,15.0,8.0,12.0,7.0,11.0,13.0,14.0,12.0,12.0,13.0,12.0,11.0,14.0,20.0,11.0,11.0,12.0,8.0,11.0,8.0,14.0,12.0,11.0,10.0,12.0,13.0,12.0,14.0,7.0,24.0,0.0,0.0,4.0,0.0,181.0,79.0,1.0,3.0,2.0,2.0,1.0,1.0,1.0,2.0,2.0,2.0,1.0,4.0,6.0,10.0,11.0,11.0,7.0,12.0,10.0,5.0,5.0,7.0,13.0,3.0,10.0,9.0,12.0,12.0,11.0,10.0,6.0,10.0,8.0,9.0,5.0,11.0,5.0,9.0,12.0,15.0,13.0,13.0,11.0,5.0,11.0,14.0,20.0,13.0,14.0,11.0,9.0,12.0,13.0,5.0,19.0,11.0,9.0,9.0,7.0,14.0,14.0,13.0,24.0,0.0,0.0,0.0,0.0,197.0,86.0,15.0,9.0,12.0,14.0,13.0,12.0,10.0,13.0,11.0,7.0,8.0,2.0,3.0,3.0,3.0,8.0,7.0,1.0,3.0,1.0,2.0,12.0,2.0,2.0,8.0,10.0,12.0,10.0,14.0,12.0,10.0,10.0,10.0,3.0,8.0,1.0,11.0,10.0,6.0,12.0,13.0,10.0,16.0,5.0,13.0,11.0,20.0,9.0,10.0,10.0,10.0,10.0,7.0,10.0,9.0,11.0,11.0,9.0,12.0,13.0,10.0,8.0,28.0,0.0,0.0,0.0,0.0,190.0,83.0,1.0,1.0,3.0,2.0,1.0,1.0,3.0,3.0,1.0,2.0,1.0,2.0,9.0,5.0,6.0,10.0,5.0,13.0,7.0,4.0,12.0,9.0,7.0,10.0,11.0,13.0,14.0,15.0,13.0,11.0,8.0,11.0,13.0,8.0,12.0,7.0,12.0,12.0,12.0,11.0,11.0,15.0,15.0,20.0,15.0,11.0,5.0,13.0,16.0,15.0,13.0,11.0,7.0,5.0,12.0,12.0,14.0,12.0,15.0,13.0,12.0,6.0,21.0,0.0,0.0,0.0,0.0,193.0,79.0,3.0,3.0,4.0,4.0,2.0,3.0,1.0,1.0,3.0,2.0,3.0,8.0,8.0,8.0,8.0,12.0,11.0,14.0,11.0,12.0,15.0,14.0,6.0,13.0,10.0,12.0,11.0,12.0,12.0,14.0,11.0,10.0,15.0,12.0,12.0,12.0,13.0,14.0,12.0,12.0,12.0,14.0,16.0,9.0,8.0,12.0,20.0,12.0,14.0,13.0,9.0,11.0,16.0,12.0,12.0,14.0,11.0,14.0,12.0,11.0,10.0,5.0,21.0,0.0,0.0,9.0,0.0,178.0,77.0,4.0,3.0,1.0,1.0,1.0,2.0,2.0,3.0,3.0,3.0,1.0,11.0,13.0,11.0,8.0,12.0,9.0,8.0,9.0,8.0,12.0,10.0,8.0,12.0,12.0,8.0,10.0,14.0,11.0,14.0,12.0,12.0,14.0,12.0,8.0,10.0,8.0,15.0,14.0,15.0,12.0,12.0,8.0,7.0,5.0,14.0,20.0,14.0,10.0,12.0,5.0,10.0,11.0,8.0,15.0,10.0,10.0,12.0,9.0,10.0,12.0,5.0,22.0,20.0,0.0,9.0,1.0,179.0,70.0,2.0,2.0,3.0,1.0,2.0,1.0,3.0,2.0,1.0,3.0,1.0,7.0,15.0,13.0,7.0,11.0,5.0,10.0,8.0,14.0,13.0,10.0,9.0,16.0,12.0,17.0,15.0,15.0,9.0,13.0,9.0,10.0,15.0,13.0,8.0,12.0,10.0,12.0,17.0,16.0,14.0,14.0,11.0,20.0,17.0,16.0,10.0,15.0,12.0,15.0,10.0,16.0,4.0,11.0,14.0,16.0,9.0,14.0,12.0,9.0,10.0,10.0,18.0,0.0,0.0,0.0,0.0,165.0,63.0,2.0,3.0,2.0,3.0,3.0,3.0,1.0,3.0,1.0,2.0,2.0,11.0,11.0,12.0,8.0,13.0,11.0,5.0,10.0,3.0,5.0,12.0,13.0,8.0,13.0,13.0,9.0,9.0,13.0,9.0,13.0,12.0,12.0,16.0,8.0,10.0,8.0,11.0,11.0,12.0,13.0,11.0,6.0,10.0,12.0,12.0,20.0,8.0,6.0,13.0,8.0,12.0,4.0,8.0,16.0,18.0,5.0,13.0,14.0,11.0,13.0,8.0,25.0,0.0,0.0,0.0,0.0,177.0,66.0,2.0,3.0,1.0,3.0,2.0,3.0,4.0,1.0,4.0,3.0,1.0,11.0,11.0,11.0,7.0,13.0,11.0,8.0,10.0,7.0,4.0,12.0,11.0,6.0,12.0,8.0,12.0,11.0,12.0,12.0,12.0,9.0,13.0,11.0,7.0,11.0,9.0,14.0,13.0,11.0,13.0,12.0,9.0,20.0,14.0,10.0,8.0,16.0,9.0,13.0,8.0,2.0,6.0,10.0,9.0,11.0,15.0,12.0,14.0,14.0,14.0,6.0,25.0,0.0,0.0,0.0,0.0,174.0,73.0,1.0,1.0,3.0,2.0,1.0,1.0,1.0,2.0,3.0,3.0,3.0,11.0,12.0,12.0,6.0,13.0,11.0,7.0,11.0,10.0,9.0,13.0,9.0,10.0,14.0,11.0,13.0,13.0,12.0,11.0,15.0,11.0,14.0,13.0,7.0,11.0,12.0,15.0,16.0,12.0,14.0,12.0,8.0,20.0,14.0,13.0,7.0,12.0,11.0,12.0,11.0,13.0,9.0,12.0,8.0,13.0,13.0,12.0,15.0,15.0,15.0,6.0,19.0,0.0,0.0,0.0,0.0,175.0,60.0,4.0,2.0,2.0,1.0,1.0,2.0,3.0,2.0,3.0,3.0,1.0,10.0,11.0,15.0,12.0,14.0,6.0,4.0,13.0,10.0,10.0,12.0,9.0,11.0,14.0,8.0,10.0,10.0,14.0,11.0,12.0,15.0,4.0,11.0,7.0,8.0,10.0,11.0,12.0,12.0,12.0,11.0,8.0,5.0,9.0,10.0,20.0,9.0,8.0,10.0,10.0,7.0,10.0,10.0,14.0,12.0,10.0,11.0,14.0,10.0,11.0,2.0,21.0,0.0,0.0,0.0,0.0,176.0,71.0,3.0,1.0,2.0,1.0,3.0,2.0,1.0,2.0,3.0,1.0,3.0,11.0,11.0,15.0,11.0,13.0,9.0,4.0,7.0,5.0,5.0,12.0,8.0,5.0,14.0,10.0,9.0,10.0,12.0,13.0,10.0,10.0,12.0,15.0,5.0,15.0,6.0,10.0,10.0,16.0,16.0,11.0,9.0,8.0,12.0,15.0,20.0,13.0,7.0,11.0,7.0,8.0,4.0,7.0,10.0,12.0,10.0,11.0,12.0,12.0,12.0,5.0,19.0,0.0,0.0,0.0,0.0,185.0,79.0,2.0,3.0,3.0,1.0,2.0,1.0,2.0,3.0,3.0,3.0,2.0,11.0,11.0,11.0,12.0,11.0,10.0,12.0,12.0,5.0,6.0,11.0,12.0,6.0,12.0,15.0,12.0,13.0,11.0,10.0,12.0,11.0,10.0,13.0,12.0,12.0,8.0,10.0,12.0,10.0,13.0,12.0,12.0,20.0,10.0,9.0,10.0,10.0,7.0,10.0,12.0,10.0,5.0,9.0,11.0,12.0,13.0,10.0,13.0,14.0,18.0,3.0
1,2,31.0,22.0,0.0,17.0,0.0,185.0,82.0,12.0,12.0,13.0,6.0,14.0,11.0,15.0,18.0,14.0,10.0,13.0,7.0,3.0,8.0,5.0,9.0,10.0,8.0,12.0,2.0,2.0,9.0,6.0,3.0,10.0,6.0,12.0,15.0,16.0,12.0,8.0,12.0,14.0,8.0,15.0,3.0,13.0,13.0,8.0,13.0,17.0,14.0,13.0,7.0,12.0,11.0,20.0,15.0,14.0,13.0,6.0,16.0,3.0,1.0,8.0,16.0,12.0,13.0,16.0,16.0,16.0,7.0,19.0,0.0,0.0,7.0,2.0,188.0,85.0,1.0,3.0,2.0,1.0,2.0,3.0,3.0,2.0,2.0,3.0,1.0,10.0,6.0,9.0,8.0,10.0,12.0,15.0,8.0,7.0,14.0,11.0,10.0,13.0,10.0,14.0,11.0,13.0,9.0,11.0,10.0,10.0,9.0,1.0,8.0,12.0,13.0,13.0,14.0,13.0,10.0,13.0,15.0,9.0,12.0,13.0,20.0,14.0,14.0,9.0,11.0,4.0,9.0,11.0,14.0,13.0,12.0,12.0,12.0,1.0,13.0,2.0,16.0,0.0,0.0,0.0,0.0,192.0,0.0,2.0,3.0,1.0,2.0,3.0,1.0,1.0,1.0,2.0,3.0,3.0,6.0,8.0,8.0,6.0,10.0,6.0,12.0,6.0,7.0,12.0,10.0,7.0,12.0,10.0,13.0,12.0,14.0,11.0,10.0,8.0,10.0,10.0,8.0,6.0,8.0,9.0,10.0,13.0,13.0,11.0,12.0,13.0,6.0,14.0,12.0,20.0,10.0,10.0,10.0,7.0,8.0,8.0,10.0,9.0,13.0,10.0,11.0,11.0,10.0,15.0,9.0,24.0,0.0,0.0,0.0,0.0,177.0,65.0,1.0,2.0,1.0,2.0,1.0,2.0,1.0,1.0,1.0,2.0,3.0,8.0,11.0,13.0,10.0,13.0,8.0,10.0,11.0,7.0,5.0,12.0,13.0,6.0,13.0,8.0,11.0,9.0,10.0,9.0,9.0,11.0,13.0,12.0,5.0,12.0,8.0,7.0,9.0,16.0,15.0,12.0,8.0,10.0,15.0,15.0,20.0,14.0,12.0,11.0,8.0,13.0,7.0,12.0,20.0,14.0,13.0,12.0,9.0,12.0,11.0,10.0,26.0,27.0,0.0,0.0,0.0,183.0,70.0,1.0,3.0,1.0,3.0,4.0,1.0,3.0,3.0,2.0,1.0,3.0,9.0,14.0,12.0,8.0,10.0,8.0,12.0,13.0,14.0,9.0,12.0,7.0,13.0,11.0,14.0,9.0,15.0,10.0,12.0,9.0,10.0,16.0,10.0,9.0,12.0,8.0,12.0,17.0,14.0,11.0,13.0,12.0,10.0,16.0,16.0,20.0,16.0,13.0,13.0,10.0,14.0,6.0,15.0,10.0,15.0,14.0,10.0,16.0,13.0,13.0,4.0,28.0,41.0,2.0,0.0,0.0,187.0,80.0,3.0,2.0,3.0,2.0,1.0,1.0,2.0,3.0,1.0,4.0,2.0,7.0,10.0,11.0,7.0,12.0,7.0,10.0,12.0,13.0,15.0,13.0,8.0,18.0,12.0,18.0,13.0,17.0,12.0,14.0,10.0,12.0,17.0,7.0,13.0,9.0,14.0,17.0,18.0,14.0,13.0,16.0,14.0,20.0,18.0,13.0,12.0,18.0,14.0,15.0,16.0,15.0,6.0,15.0,14.0,13.0,10.0,14.0,12.0,8.0,7.0,8.0,21.0,0.0,0.0,11.0,2.0,180.0,72.0,2.0,3.0,3.0,3.0,3.0,2.0,2.0,1.0,3.0,2.0,3.0,12.0,13.0,14.0,9.0,14.0,13.0,8.0,12.0,5.0,8.0,14.0,10.0,9.0,14.0,12.0,12.0,9.0,13.0,12.0,15.0,13.0,14.0,15.0,8.0,13.0,10.0,16.0,14.0,15.0,14.0,12.0,9.0,8.0,15.0,14.0,20.0,13.0,12.0,12.0,8.0,11.0,10.0,11.0,10.0,14.0,16.0,14.0,15.0,15.0,15.0,6.0,29.0,26.0,6.0,12.0,4.0,175.0,77.0,1.0,2.0,1.0,3.0,3.0,2.0,1.0,2.0,1.0,2.0,2.0,16.0,14.0,16.0,15.0,15.0,18.0,6.0,15.0,6.0,6.0,18.0,11.0,5.0,17.0,9.0,12.0,10.0,16.0,12.0,16.0,14.0,14.0,16.0,6.0,16.0,6.0,10.0,10.0,13.0,15.0,14.0,8.0,15.0,15.0,14.0,20.0,13.0,12.0,11.0,9.0,16.0,7.0,8.0,8.0,11.0,8.0,13.0,12.0,13.0,11.0,10.0,21.0,0.0,0.0,0.0,0.0,187.0,84.0,4.0,2.0,1.0,2.0,3.0,1.0,2.0,3.0,1.0,1.0,2.0,11.0,13.0,15.0,12.0,14.0,11.0,13.0,14.0,4.0,5.0,12.0,14.0,5.0,16.0,12.0,12.0,14.0,12.0,10.0,10.0,9.0,14.0,17.0,10.0,12.0,7.0,10.0,14.0,14.0,16.0,14.0,15.0,9.0,13.0,14.0,20.0,14.0,14.0,14.0,8.0,15.0,5.0,14.0,11.0,16.0,13.0,14.0,13.0,15.0,15.0,6.0,25.0,33.0,13.0,16.0,6.0,189.0,88.0,2.0,4.0,1.0,2.0,3.0,1.0,2.0,3.0,2.0,1.0,2.0,12.0,13.0,15.0,15.0,15.0,17.0,16.0,16.0,8.0,5.0,14.0,19.0,7.0,16.0,13.0,14.0,12.0,16.0,9.0,14.0,12.0,7.0,15.0,8.0,12.0,5.0,2.0,4.0,13.0,15.0,14.0,14.0,12.0,12.0,15.0,20.0,13.0,15.0,7.0,16.0,13.0,14.0,11.0,8.0,13.0,4.0,11.0,8.0,3.0,4.0,16.0,26.0,0.0,0.0,4.0,0.0,180.0,73.0,2.0,3.0,1.0,4.0,2.0,3.0,3.0,1.0,1.0,4.0,1.0,11.0,13.0,13.0,14.0,14.0,11.0,15.0,12.0,3.0,7.0,14.0,14.0,8.0,13.0,12.0,14.0,17.0,13.0,15.0,14.0,14.0,16.0,12.0,15.0,16.0,12.0,18.0,16.0,13.0,14.0,13.0,12.0,8.0,14.0,13.0,20.0,15.0,12.0,15.0,8.0,14.0,7.0,15.0,19.0,14.0,17.0,14.0,18.0,16.0,16.0,5.0,23.0,0.0,0.0,0.0,0.0,188.0,85.0,14.0,12.0,12.0,7.0,13.0,10.0,11.0,14.0,7.0,13.0,12.0,2.0,3.0,1.0,3.0,8.0,6.0,2.0,1.0,2.0,2.0,8.0,3.0,1.0,8.0,7.0,10.0,12.0,9.0,11.0,8.0,11.0,14.0,2.0,9.0,1.0,12.0,11.0,8.0,7.0,12.0,14.0,14.0,6.0,14.0,10.0,20.0,12.0,14.0,13.0,7.0,10.0,7.0,1.0,14.0,14.0,9.0,13.0,13.0,10.0,12.0,6.0,22.0,0.0,0.0,3.0,1.0,180.0,80.0,1.0,1.0,2.0,3.0,1.0,2.0,3.0,3.0,3.0,3.0,1.0,7.0,9.0,10.0,6.0,10.0,8.0,12.0,8.0,10.0,11.0,10.0,9.0,14.0,12.0,13.0,11.0,11.0,11.0,10.0,8.0,10.0,3.0,9.0,9.0,9.0,10.0,12.0,11.0,14.0,15.0,10.0,10.0,8.0,12.0,12.0,20.0,11.0,9.0,13.0,12.0,10.0,10.0,16.0,14.0,15.0,10.0,12.0,12.0,11.0,11.0,5.0,28.0,0.0,0.0,0.0,0.0,190.0,85.0,3.0,2.0,3.0,3.0,2.0,2.0,2.0,4.0,3.0,1.0,2.0,5.0,9.0,8.0,9.0,8.0,7.0,14.0,10.0,9.0,15.0,9.0,6.0,14.0,9.0,16.0,13.0,16.0,10.0,13.0,10.0,12.0,15.0,6.0,13.0,7.0,13.0,14.0,16.0,12.0,11.0,17.0,13.0,20.0,15.0,13.0,8.0,15.0,15.0,12.0,14.0,14.0,9.0,8.0,14.0,13.0,14.0,11.0,12.0,13.0,16.0,14.0,24.0,0.0,0.0,0.0,0.0,185.0,77.0,1.0,1.0,3.0,2.0,1.0,1.0,3.0,1.0,3.0,3.0,1.0,7.0,10.0,12.0,11.0,12.0,12.0,14.0,13.0,7.0,13.0,12.0,8.0,14.0,12.0,10.0,13.0,11.0,13.0,13.0,12.0,13.0,16.0,10.0,8.0,12.0,13.0,13.0,13.0,14.0,14.0,12.0,14.0,12.0,14.0,13.0,20.0,11.0,12.0,12.0,12.0,10.0,11.0,7.0,17.0,11.0,10.0,10.0,10.0,7.0,8.0,5.0,28.0,0.0,0.0,0.0,0.0,174.0,67.0,3.0,4.0,1.0,1.0,1.0,3.0,1.0,3.0,2.0,1.0,2.0,11.0,8.0,11.0,9.0,13.0,6.0,7.0,12.0,8.0,10.0,10.0,3.0,6.0,12.0,10.0,13.0,7.0,12.0,8.0,10.0,9.0,12.0,13.0,5.0,12.0,9.0,12.0,11.0,14.0,14.0,11.0,7.0,10.0,15.0,12.0,20.0,11.0,6.0,9.0,6.0,10.0,10.0,9.0,11.0,14.0,9.0,11.0,12.0,8.0,8.0,8.0,24.0,0.0,0.0,0.0,0.0,175.0,72.0,3.0,2.0,4.0,3.0,2.0,4.0,1.0,1.0,1.0,2.0,2.0,8.0,12.0,12.0,6.0,11.0,7.0,10.0,9.0,12.0,11.0,12.0,8.0,12.0,11.0,11.0,12.0,13.0,10.0,10.0,9.0,9.0,3.0,9.0,9.0,11.0,12.0,11.0,11.0,14.0,13.0,11.0,8.0,20.0,12.0,13.0,6.0,12.0,11.0,10.0,10.0,10.0,9.0,10.0,10.0,13.0,10.0,11.0,10.0,13.0,18.0,1.0,19.0,0.0,0.0,0.0,0.0,174.0,61.0,1.0,3.0,2.0,3.0,2.0,1.0,2.0,2.0,3.0,1.0,1.0,5.0,9.0,10.0,6.0,12.0,6.0,8.0,8.0,5.0,9.0,10.0,7.0,9.0,13.0,11.0,12.0,12.0,11.0,9.0,11.0,11.0,8.0,9.0,10.0,8.0,10.0,12.0,16.0,13.0,13.0,10.0,8.0,20.0,15.0,11.0,8.0,13.0,9.0,15.0,11.0,10.0,6.0,13.0,10.0,9.0,14.0,11.0,12.0,14.0,14.0,8.0,22.0,0.0,0.0,0.0,0.0,187.0,84.0,2.0,2.0,1.0,2.0,3.0,2.0,2.0,3.0,3.0,2.0,2.0,4.0,7.0,10.0,6.0,9.0,10.0,13.0,12.0,5.0,11.0,11.0,7.0,10.0,12.0,12.0,11.0,13.0,10.0,9.0,11.0,9.0,15.0,8.0,7.0,9.0,11.0,11.0,14.0,13.0,10.0,15.0,14.0,8.0,15.0,11.0,20.0,14.0,15.0,11.0,12.0,7.0,9.0,8.0,7.0,13.0,15.0,13.0,11.0,14.0,14.0,7.0,21.0,0.0,0.0,0.0,0.0,172.0,66.0,2.0,3.0,2.0,2.0,1.0,1.0,1.0,3.0,2.0,1.0,1.0,10.0,10.0,13.0,9.0,14.0,9.0,8.0,10.0,7.0,13.0,13.0,9.0,12.0,13.0,10.0,12.0,13.0,13.0,12.0,14.0,13.0,13.0,11.0,9.0,14.0,13.0,14.0,14.0,14.0,13.0,12.0,8.0,8.0,12.0,12.0,20.0,13.0,12.0,14.0,10.0,11.0,8.0,12.0,15.0,10.0,15.0,8.0,11.0,14.0,14.0,6.0,24.0,24.0,4.0,0.0,0.0,172.0,74.0,2.0,4.0,3.0,2.0,2.0,1.0,2.0,2.0,3.0,2.0,4.0,8.0,9.0,14.0,13.0,14.0,9.0,11.0,10.0,7.0,5.0,12.0,12.0,3.0,13.0,10.0,12.0,12.0,13.0,12.0,11.0,10.0,14.0,13.0,7.0,14.0,9.0,9.0,13.0,16.0,15.0,13.0,6.0,8.0,13.0,16.0,20.0,14.0,12.0,11.0,11.0,13.0,9.0,8.0,9.0,13.0,9.0,11.0,12.0,13.0,10.0,9.0,24.0,2.0,0.0,0.0,0.0,195.0,84.0,1.0,4.0,1.0,2.0,3.0,1.0,2.0,1.0,2.0,1.0,1.0,6.0,6.0,9.0,11.0,10.0,8.0,14.0,11.0,5.0,8.0,10.0,11.0,2.0,11.0,11.0,12.0,14.0,11.0,14.0,8.0,12.0,13.0,8.0,6.0,11.0,7.0,13.0,14.0,13.0,12.0,18.0,18.0,8.0,13.0,14.0,20.0,14.0,17.0,12.0,11.0,10.0,7.0,5.0,8.0,12.0,9.0,12.0,13.0,12.0,14.0,2.0
0,0,22.0,0.0,0.0,0.0,0.0,191.0,86.0,14.0,11.0,10.0,12.0,13.0,9.0,14.0,13.0,10.0,13.0,12.0,4.0,2.0,2.0,1.0,5.0,6.0,10.0,3.0,3.0,3.0,7.0,5.0,3.0,6.0,12.0,10.0,12.0,13.0,10.0,6.0,12.0,11.0,11.0,11.0,5.0,9.0,8.0,6.0,10.0,12.0,16.0,15.0,6.0,14.0,9.0,20.0,11.0,15.0,11.0,11.0,13.0,7.0,1.0,18.0,10.0,11.0,13.0,14.0,11.0,20.0,4.0,29.0,0.0,0.0,0.0,0.0,183.0,74.0,3.0,3.0,3.0,3.0,3.0,2.0,2.0,2.0,1.0,3.0,1.0,5.0,12.0,7.0,6.0,10.0,7.0,14.0,12.0,5.0,14.0,12.0,6.0,13.0,11.0,14.0,13.0,17.0,13.0,16.0,12.0,12.0,13.0,9.0,8.0,9.0,14.0,14.0,15.0,13.0,12.0,15.0,12.0,6.0,17.0,11.0,20.0,17.0,13.0,14.0,14.0,15.0,5.0,13.0,9.0,14.0,19.0,15.0,14.0,11.0,11.0,6.0,32.0,0.0,0.0,0.0,0.0,183.0,79.0,1.0,1.0,1.0,3.0,1.0,3.0,1.0,1.0,2.0,1.0,1.0,5.0,10.0,6.0,6.0,9.0,6.0,15.0,7.0,11.0,14.0,10.0,7.0,13.0,10.0,13.0,15.0,15.0,15.0,14.0,9.0,13.0,16.0,6.0,14.0,8.0,12.0,13.0,16.0,11.0,12.0,16.0,11.0,8.0,16.0,12.0,20.0,15.0,14.0,14.0,11.0,12.0,5.0,15.0,18.0,15.0,14.0,13.0,17.0,14.0,14.0,5.0,22.0,0.0,0.0,0.0,0.0,178.0,73.0,3.0,2.0,2.0,1.0,2.0,4.0,3.0,1.0,3.0,1.0,2.0,6.0,12.0,12.0,6.0,11.0,7.0,8.0,8.0,11.0,12.0,10.0,8.0,13.0,11.0,12.0,12.0,13.0,11.0,10.0,11.0,11.0,13.0,6.0,7.0,12.0,9.0,13.0,14.0,16.0,14.0,13.0,9.0,6.0,14.0,15.0,20.0,15.0,14.0,12.0,12.0,13.0,6.0,14.0,12.0,15.0,13.0,13.0,14.0,14.0,14.0,6.0,21.0,0.0,0.0,0.0,0.0,172.0,68.0,3.0,3.0,1.0,2.0,1.0,2.0,3.0,2.0,2.0,3.0,2.0,12.0,13.0,12.0,8.0,12.0,12.0,5.0,8.0,12.0,11.0,13.0,8.0,13.0,12.0,14.0,13.0,14.0,13.0,13.0,10.0,11.0,15.0,9.0,13.0,13.0,12.0,13.0,14.0,12.0,12.0,12.0,6.0,20.0,13.0,13.0,13.0,13.0,11.0,12.0,10.0,10.0,11.0,9.0,20.0,13.0,15.0,12.0,16.0,13.0,13.0,8.0,21.0,4.0,1.0,0.0,0.0,176.0,60.0,1.0,1.0,3.0,2.0,3.0,2.0,1.0,3.0,3.0,4.0,2.0,9.0,10.0,13.0,9.0,13.0,8.0,7.0,12.0,7.0,11.0,13.0,7.0,12.0,11.0,9.0,14.0,12.0,9.0,11.0,12.0,11.0,10.0,9.0,5.0,10.0,12.0,12.0,15.0,15.0,14.0,13.0,7.0,12.0,10.0,12.0,20.0,14.0,4.0,9.0,9.0,9.0,7.0,5.0,15.0,16.0,12.0,10.0,9.0,16.0,8.0,3.0,18.0,0.0,0.0,0.0,0.0,178.0,70.0,1.0,2.0,3.0,2.0,4.0,2.0,3.0,1.0,1.0,2.0,3.0,11.0,7.0,10.0,10.0,14.0,12.0,9.0,10.0,6.0,7.0,15.0,5.0,10.0,12.0,9.0,10.0,9.0,8.0,10.0,9.0,12.0,7.0,4.0,3.0,12.0,9.0,10.0,14.0,15.0,12.0,10.0,8.0,6.0,5.0,11.0,20.0,10.0,9.0,12.0,8.0,2.0,10.0,10.0,11.0,10.0,12.0,12.0,11.0,12.0,19.0,6.0,32.0,0.0,0.0,13.0,0.0,175.0,65.0,2.0,1.0,1.0,2.0,3.0,3.0,1.0,2.0,3.0,2.0,3.0,15.0,13.0,11.0,6.0,14.0,13.0,10.0,12.0,8.0,8.0,16.0,8.0,12.0,13.0,11.0,14.0,15.0,14.0,15.0,14.0,14.0,14.0,6.0,13.0,9.0,15.0,18.0,13.0,12.0,13.0,13.0,8.0,8.0,13.0,10.0,20.0,13.0,13.0,12.0,11.0,15.0,12.0,10.0,17.0,14.0,15.0,14.0,16.0,14.0,14.0,6.0,18.0,0.0,0.0,0.0,0.0,179.0,67.0,3.0,3.0,2.0,4.0,2.0,4.0,3.0,1.0,3.0,4.0,1.0,5.0,7.0,12.0,9.0,12.0,12.0,10.0,12.0,6.0,4.0,12.0,12.0,3.0,14.0,11.0,12.0,11.0,11.0,8.0,13.0,12.0,12.0,12.0,6.0,12.0,5.0,10.0,12.0,15.0,11.0,12.0,10.0,20.0,13.0,14.0,8.0,14.0,8.0,9.0,6.0,14.0,5.0,10.0,16.0,13.0,12.0,12.0,13.0,9.0,15.0,2.0,28.0,0.0,0.0,2.0,2.0,182.0,79.0,1.0,1.0,2.0,2.0,3.0,1.0,2.0,3.0,1.0,2.0,2.0,8.0,11.0,14.0,12.0,14.0,11.0,12.0,13.0,6.0,4.0,11.0,13.0,5.0,14.0,11.0,12.0,13.0,10.0,12.0,11.0,11.0,15.0,13.0,7.0,14.0,7.0,12.0,14.0,15.0,14.0,14.0,12.0,8.0,15.0,14.0,20.0,15.0,14.0,12.0,11.0,15.0,8.0,8.0,16.0,15.0,12.0,11.0,14.0,13.0,12.0,8.0,18.0,0.0,0.0,0.0,0.0,188.0,80.0,1.0,3.0,1.0,3.0,2.0,3.0,3.0,1.0,2.0,2.0,4.0,6.0,8.0,12.0,11.0,12.0,7.0,13.0,10.0,4.0,4.0,8.0,10.0,5.0,12.0,11.0,11.0,13.0,10.0,11.0,11.0,12.0,11.0,13.0,7.0,13.0,8.0,13.0,13.0,11.0,12.0,12.0,12.0,10.0,12.0,11.0,20.0,10.0,12.0,12.0,8.0,11.0,7.0,13.0,8.0,13.0,13.0,11.0,12.0,12.0,13.0,7.0,22.0,0.0,0.0,0.0,0.0,186.0,79.0,14.0,13.0,11.0,7.0,12.0,10.0,13.0,14.0,8.0,6.0,8.0,2.0,1.0,3.0,6.0,8.0,5.0,3.0,11.0,3.0,2.0,8.0,8.0,1.0,8.0,8.0,12.0,14.0,12.0,11.0,7.0,11.0,12.0,6.0,9.0,3.0,12.0,12.0,5.0,8.0,12.0,15.0,15.0,20.0,15.0,7.0,5.0,9.0,15.0,14.0,8.0,5.0,5.0,1.0,10.0,12.0,13.0,12.0,8.0,15.0,15.0,5.0,17.0,0.0,0.0,0.0,0.0,191.0,79.0,1.0,1.0,2.0,3.0,2.0,1.0,1.0,3.0,3.0,3.0,2.0,2.0,1.0,1.0,1.0,4.0,1.0,10.0,5.0,2.0,14.0,6.0,4.0,12.0,1.0,6.0,7.0,5.0,4.0,6.0,1.0,14.0,1.0,1.0,11.0,4.0,14.0,6.0,7.0,6.0,12.0,7.0,11.0,5.0,8.0,8.0,20.0,7.0,11.0,8.0,6.0,7.0,8.0,8.0,14.0,11.0,11.0,14.0,10.0,9.0,12.0,5.0,17.0,0.0,0.0,0.0,0.0,173.0,0.0,2.0,1.0,3.0,1.0,2.0,3.0,1.0,3.0,2.0,1.0,2.0,3.0,5.0,7.0,6.0,8.0,2.0,8.0,1.0,8.0,10.0,7.0,4.0,15.0,10.0,9.0,7.0,10.0,7.0,6.0,5.0,8.0,9.0,5.0,12.0,8.0,6.0,9.0,9.0,15.0,15.0,9.0,7.0,20.0,14.0,15.0,5.0,7.0,8.0,9.0,9.0,9.0,9.0,9.0,18.0,8.0,10.0,11.0,11.0,8.0,12.0,4.0,27.0,10.0,0.0,0.0,0.0,181.0,69.0,1.0,1.0,3.0,3.0,3.0,3.0,2.0,3.0,3.0,3.0,1.0,5.0,13.0,10.0,7.0,13.0,9.0,10.0,10.0,12.0,12.0,11.0,7.0,12.0,11.0,11.0,13.0,12.0,11.0,13.0,9.0,9.0,12.0,8.0,7.0,12.0,11.0,11.0,13.0,15.0,13.0,13.0,10.0,20.0,12.0,15.0,8.0,15.0,12.0,13.0,11.0,14.0,13.0,12.0,10.0,14.0,12.0,10.0,11.0,15.0,15.0,7.0,23.0,0.0,0.0,0.0,0.0,182.0,80.0,2.0,3.0,2.0,2.0,2.0,3.0,4.0,4.0,1.0,2.0,1.0,5.0,7.0,12.0,5.0,13.0,6.0,12.0,6.0,6.0,13.0,11.0,6.0,14.0,11.0,13.0,12.0,13.0,14.0,13.0,9.0,10.0,13.0,7.0,10.0,8.0,10.0,13.0,12.0,14.0,12.0,13.0,10.0,5.0,12.0,13.0,20.0,15.0,14.0,14.0,6.0,10.0,9.0,7.0,9.0,12.0,17.0,13.0,14.0,14.0,14.0,5.0,21.0,0.0,0.0,1.0,0.0,177.0,68.0,4.0,1.0,2.0,1.0,1.0,1.0,1.0,1.0,2.0,1.0,2.0,5.0,12.0,9.0,7.0,12.0,8.0,13.0,10.0,16.0,13.0,12.0,8.0,14.0,12.0,12.0,13.0,12.0,12.0,12.0,10.0,13.0,15.0,11.0,13.0,11.0,13.0,13.0,14.0,13.0,14.0,13.0,11.0,10.0,14.0,12.0,20.0,12.0,14.0,12.0,11.0,12.0,8.0,14.0,13.0,10.0,14.0,12.0,14.0,12.0,11.0,5.0,24.0,10.0,0.0,0.0,0.0,180.0,73.0,3.0,2.0,3.0,1.0,1.0,1.0,1.0,3.0,3.0,3.0,2.0,5.0,10.0,8.0,5.0,8.0,6.0,13.0,8.0,6.0,14.0,12.0,6.0,13.0,10.0,12.0,13.0,13.0,11.0,12.0,9.0,12.0,14.0,1.0,7.0,7.0,12.0,12.0,13.0,15.0,11.0,13.0,10.0,5.0,15.0,14.0,20.0,12.0,14.0,12.0,12.0,11.0,8.0,11.0,8.0,11.0,9.0,15.0,12.0,11.0,19.0,6.0,18.0,0.0,0.0,0.0,0.0,177.0,66.0,2.0,2.0,1.0,2.0,1.0,3.0,3.0,2.0,3.0,2.0,3.0,8.0,6.0,8.0,7.0,12.0,6.0,5.0,9.0,5.0,1.0,10.0,4.0,4.0,12.0,5.0,4.0,6.0,6.0,3.0,13.0,7.0,8.0,12.0,6.0,10.0,6.0,8.0,12.0,15.0,10.0,7.0,7.0,20.0,14.0,11.0,5.0,13.0,5.0,8.0,8.0,7.0,8.0,8.0,13.0,10.0,11.0,11.0,11.0,9.0,18.0,3.0,27.0,1.0,0.0,0.0,0.0,179.0,70.0,3.0,2.0,1.0,3.0,3.0,2.0,1.0,3.0,2.0,1.0,1.0,14.0,15.0,15.0,11.0,15.0,14.0,8.0,12.0,5.0,8.0,13.0,12.0,9.0,18.0,11.0,11.0,11.0,9.0,10.0,16.0,10.0,17.0,15.0,8.0,12.0,8.0,12.0,11.0,14.0,13.0,12.0,10.0,12.0,13.0,14.0,20.0,16.0,12.0,10.0,9.0,10.0,7.0,8.0,13.0,15.0,13.0,10.0,11.0,12.0,10.0,8.0,21.0,0.0,0.0,4.0,1.0,184.0,79.0,1.0,2.0,3.0,1.0,2.0,1.0,3.0,2.0,2.0,1.0,3.0,3.0,6.0,10.0,12.0,12.0,7.0,15.0,8.0,4.0,5.0,13.0,10.0,8.0,12.0,18.0,12.0,19.0,13.0,10.0,13.0,12.0,14.0,13.0,10.0,12.0,9.0,16.0,15.0,12.0,14.0,14.0,14.0,12.0,13.0,10.0,20.0,14.0,14.0,11.0,14.0,14.0,11.0,5.0,10.0,13.0,14.0,15.0,10.0,8.0,4.0,15.0,27.0,0.0,0.0,0.0,0.0,191.0,83.0,1.0,1.0,3.0,2.0,1.0,1.0,1.0,1.0,2.0,3.0,1.0,5.0,9.0,11.0,12.0,11.0,7.0,13.0,9.0,5.0,4.0,9.0,3.0,3.0,10.0,10.0,12.0,14.0,10.0,10.0,7.0,11.0,12.0,10.0,6.0,13.0,5.0,13.0,14.0,12.0,11.0,14.0,16.0,5.0,12.0,11.0,20.0,13.0,15.0,12.0,12.0,8.0,7.0,10.0,13.0,11.0,13.0,12.0,12.0,13.0,12.0,8.0
0,3,24.0,0.0,0.0,0.0,0.0,197.0,86.0,15.0,9.0,12.0,14.0,13.0,12.0,10.0,13.0,11.0,7.0,8.0,2.0,3.0,3.0,3.0,8.0,7.0,1.0,3.0,1.0,2.0,12.0,2.0,2.0,8.0,10.0,12.0,10.0,14.0,12.0,10.0,10.0,10.0,3.0,8.0,1.0,11.0,10.0,6.0,12.0,13.0,10.0,16.0,5.0,13.0,11.0,20.0,9.0,10.0,10.0,10.0,10.0,7.0,10.0,9.0,11.0,11.0,9.0,12.0,13.0,10.0,8.0,28.0,0.0,0.0,0.0,0.0,190.0,83.0,1.0,1.0,3.0,2.0,1.0,1.0,3.0,3.0,1.0,2.0,1.0,2.0,9.0,5.0,6.0,10.0,5.0,13.0,7.0,4.0,12.0,9.0,7.0,10.0,11.0,13.0,14.0,15.0,13.0,11.0,8.0,11.0,13.0,8.0,12.0,7.0,12.0,12.0,12.0,11.0,11.0,15.0,15.0,20.0,15.0,11.0,5.0,13.0,16.0,15.0,13.0,11.0,7.0,5.0,12.0,12.0,14.0,12.0,15.0,13.0,12.0,6.0,21.0,0.0,0.0,0.0,0.0,193.0,79.0,3.0,3.0,4.0,4.0,2.0,3.0,1.0,1.0,3.0,2.0,3.0,8.0,8.0,8.0,8.0,12.0,11.0,14.0,11.0,12.0,15.0,14.0,6.0,13.0,10.0,12.0,11.0,12.0,12.0,14.0,11.0,10.0,15.0,12.0,12.0,12.0,13.0,14.0,12.0,12.0,12.0,14.0,16.0,9.0,8.0,12.0,20.0,12.0,14.0,13.0,9.0,11.0,16.0,12.0,12.0,14.0,11.0,14.0,12.0,11.0,10.0,5.0,22.0,20.0,0.0,9.0,1.0,179.0,70.0,2.0,2.0,3.0,1.0,2.0,1.0,3.0,2.0,1.0,3.0,1.0,7.0,15.0,13.0,7.0,11.0,5.0,10.0,8.0,14.0,13.0,10.0,9.0,16.0,12.0,17.0,15.0,15.0,9.0,13.0,9.0,10.0,15.0,13.0,8.0,12.0,10.0,12.0,17.0,16.0,14.0,14.0,11.0,20.0,17.0,16.0,10.0,15.0,12.0,15.0,10.0,16.0,4.0,11.0,14.0,16.0,9.0,14.0,12.0,9.0,10.0,10.0,21.0,0.0,0.0,9.0,0.0,178.0,77.0,4.0,3.0,1.0,1.0,1.0,2.0,2.0,3.0,3.0,3.0,1.0,11.0,13.0,11.0,8.0,12.0,9.0,8.0,9.0,8.0,12.0,10.0,8.0,12.0,12.0,8.0,10.0,14.0,11.0,14.0,12.0,12.0,14.0,12.0,8.0,10.0,8.0,15.0,14.0,15.0,12.0,12.0,8.0,7.0,5.0,14.0,20.0,14.0,10.0,12.0,5.0,10.0,11.0,8.0,15.0,10.0,10.0,12.0,9.0,10.0,12.0,5.0,32.0,55.0,0.0,0.0,0.0,180.0,74.0,1.0,3.0,3.0,2.0,1.0,2.0,2.0,1.0,3.0,3.0,1.0,6.0,8.0,8.0,6.0,11.0,10.0,12.0,10.0,6.0,13.0,11.0,7.0,15.0,11.0,14.0,14.0,17.0,12.0,14.0,10.0,13.0,16.0,8.0,12.0,8.0,14.0,16.0,18.0,12.0,13.0,13.0,10.0,8.0,16.0,14.0,20.0,18.0,13.0,16.0,15.0,14.0,5.0,10.0,9.0,15.0,13.0,15.0,14.0,11.0,10.0,7.0,25.0,0.0,0.0,0.0,0.0,177.0,66.0,2.0,3.0,1.0,3.0,2.0,3.0,4.0,1.0,4.0,3.0,1.0,11.0,11.0,11.0,7.0,13.0,11.0,8.0,10.0,7.0,4.0,12.0,11.0,6.0,12.0,8.0,12.0,11.0,12.0,12.0,12.0,9.0,13.0,11.0,7.0,11.0,9.0,14.0,13.0,11.0,13.0,12.0,9.0,20.0,14.0,10.0,8.0,16.0,9.0,13.0,8.0,2.0,6.0,10.0,9.0,11.0,15.0,12.0,14.0,14.0,14.0,6.0,25.0,0.0,0.0,0.0,0.0,174.0,73.0,1.0,1.0,3.0,2.0,1.0,1.0,1.0,2.0,3.0,3.0,3.0,11.0,12.0,12.0,6.0,13.0,11.0,7.0,11.0,10.0,9.0,13.0,9.0,10.0,14.0,11.0,13.0,13.0,12.0,11.0,15.0,11.0,14.0,13.0,7.0,11.0,12.0,15.0,16.0,12.0,14.0,12.0,8.0,20.0,14.0,13.0,7.0,12.0,11.0,12.0,11.0,13.0,9.0,12.0,8.0,13.0,13.0,12.0,15.0,15.0,15.0,6.0,19.0,0.0,0.0,0.0,0.0,175.0,60.0,4.0,2.0,2.0,1.0,1.0,2.0,3.0,2.0,3.0,3.0,1.0,10.0,11.0,15.0,12.0,14.0,6.0,4.0,13.0,10.0,10.0,12.0,9.0,11.0,14.0,8.0,10.0,10.0,14.0,11.0,12.0,15.0,4.0,11.0,7.0,8.0,10.0,11.0,12.0,12.0,12.0,11.0,8.0,5.0,9.0,10.0,20.0,9.0,8.0,10.0,10.0,7.0,10.0,10.0,14.0,12.0,10.0,11.0,14.0,10.0,11.0,2.0,21.0,0.0,0.0,0.0,0.0,176.0,71.0,3.0,1.0,2.0,1.0,3.0,2.0,1.0,2.0,3.0,1.0,3.0,11.0,11.0,15.0,11.0,13.0,9.0,4.0,7.0,5.0,5.0,12.0,8.0,5.0,14.0,10.0,9.0,10.0,12.0,13.0,10.0,10.0,12.0,15.0,5.0,15.0,6.0,10.0,10.0,16.0,16.0,11.0,9.0,8.0,12.0,15.0,20.0,13.0,7.0,11.0,7.0,8.0,4.0,7.0,10.0,12.0,10.0,11.0,12.0,12.0,12.0,5.0,19.0,0.0,0.0,0.0,0.0,185.0,79.0,2.0,3.0,3.0,1.0,2.0,1.0,2.0,3.0,3.0,3.0,2.0,11.0,11.0,11.0,12.0,11.0,10.0,12.0,12.0,5.0,6.0,11.0,12.0,6.0,12.0,15.0,12.0,13.0,11.0,10.0,12.0,11.0,10.0,13.0,12.0,12.0,8.0,10.0,12.0,10.0,13.0,12.0,12.0,20.0,10.0,9.0,10.0,10.0,7.0,10.0,12.0,10.0,5.0,9.0,11.0,12.0,13.0,10.0,13.0,14.0,18.0,3.0,19.0,0.0,0.0,0.0,0.0,190.0,78.0,13.0,12.0,11.0,14.0,13.0,6.0,11.0,13.0,13.0,12.0,7.0,3.0,3.0,1.0,3.0,8.0,8.0,3.0,1.0,2.0,3.0,7.0,3.0,1.0,7.0,8.0,13.0,13.0,12.0,13.0,7.0,11.0,11.0,3.0,14.0,2.0,11.0,11.0,10.0,12.0,13.0,11.0,15.0,20.0,10.0,13.0,5.0,13.0,13.0,9.0,10.0,6.0,10.0,10.0,10.0,12.0,11.0,14.0,14.0,12.0,13.0,3.0,21.0,0.0,0.0,0.0,0.0,185.0,79.0,3.0,4.0,3.0,1.0,3.0,1.0,2.0,1.0,1.0,1.0,1.0,7.0,9.0,7.0,8.0,12.0,7.0,13.0,8.0,8.0,13.0,12.0,8.0,13.0,10.0,14.0,11.0,13.0,10.0,12.0,11.0,10.0,14.0,10.0,7.0,8.0,13.0,11.0,10.0,12.0,11.0,13.0,13.0,6.0,13.0,11.0,20.0,13.0,15.0,12.0,12.0,10.0,5.0,14.0,17.0,12.0,13.0,10.0,12.0,12.0,12.0,4.0,17.0,0.0,0.0,0.0,0.0,177.0,69.0,2.0,3.0,2.0,2.0,1.0,1.0,3.0,2.0,1.0,3.0,4.0,6.0,11.0,10.0,6.0,11.0,6.0,7.0,8.0,8.0,8.0,9.0,7.0,10.0,11.0,12.0,10.0,12.0,9.0,10.0,11.0,8.0,11.0,9.0,6.0,9.0,8.0,10.0,12.0,13.0,12.0,10.0,7.0,8.0,9.0,12.0,20.0,10.0,7.0,9.0,9.0,7.0,8.0,12.0,8.0,11.0,13.0,11.0,10.0,10.0,11.0,6.0,17.0,0.0,0.0,0.0,0.0,170.0,74.0,3.0,3.0,2.0,1.0,3.0,3.0,2.0,3.0,1.0,3.0,4.0,8.0,13.0,11.0,10.0,9.0,10.0,6.0,7.0,6.0,10.0,9.0,4.0,11.0,12.0,9.0,10.0,10.0,10.0,12.0,12.0,8.0,10.0,8.0,2.0,10.0,11.0,11.0,11.0,13.0,16.0,11.0,7.0,20.0,15.0,15.0,6.0,12.0,13.0,12.0,3.0,6.0,10.0,14.0,12.0,16.0,11.0,11.0,12.0,12.0,17.0,8.0,19.0,0.0,0.0,0.0,0.0,179.0,70.0,2.0,1.0,2.0,4.0,3.0,1.0,3.0,3.0,4.0,2.0,3.0,8.0,10.0,8.0,7.0,12.0,6.0,11.0,6.0,5.0,12.0,10.0,8.0,13.0,10.0,12.0,12.0,12.0,11.0,11.0,7.0,12.0,10.0,7.0,9.0,10.0,10.0,10.0,12.0,12.0,12.0,13.0,10.0,20.0,10.0,13.0,10.0,12.0,14.0,14.0,10.0,3.0,7.0,10.0,13.0,10.0,9.0,10.0,8.0,9.0,15.0,7.0,24.0,0.0,0.0,6.0,1.0,172.0,70.0,3.0,1.0,1.0,3.0,1.0,2.0,3.0,1.0,1.0,3.0,3.0,11.0,12.0,11.0,8.0,12.0,10.0,6.0,14.0,7.0,11.0,15.0,8.0,12.0,13.0,14.0,14.0,18.0,13.0,12.0,13.0,13.0,15.0,12.0,12.0,12.0,11.0,18.0,18.0,13.0,14.0,13.0,7.0,10.0,16.0,12.0,20.0,14.0,12.0,14.0,14.0,15.0,4.0,8.0,7.0,14.0,14.0,13.0,14.0,12.0,10.0,6.0,24.0,0.0,0.0,0.0,0.0,172.0,69.0,3.0,4.0,1.0,4.0,1.0,2.0,1.0,2.0,2.0,3.0,3.0,10.0,12.0,13.0,7.0,13.0,13.0,7.0,11.0,6.0,2.0,12.0,10.0,4.0,15.0,12.0,11.0,12.0,9.0,10.0,13.0,11.0,3.0,15.0,6.0,13.0,5.0,10.0,13.0,14.0,15.0,11.0,7.0,5.0,14.0,14.0,20.0,13.0,10.0,13.0,12.0,13.0,8.0,10.0,9.0,11.0,10.0,11.0,9.0,11.0,10.0,3.0,20.0,0.0,0.0,0.0,0.0,180.0,73.0,4.0,1.0,1.0,1.0,2.0,1.0,3.0,1.0,1.0,1.0,3.0,9.0,11.0,12.0,10.0,12.0,7.0,11.0,10.0,8.0,6.0,10.0,11.0,5.0,10.0,9.0,8.0,9.0,10.0,8.0,10.0,11.0,9.0,7.0,1.0,10.0,7.0,7.0,10.0,13.0,9.0,13.0,10.0,5.0,6.0,13.0,20.0,9.0,11.0,9.0,9.0,9.0,9.0,9.0,13.0,8.0,12.0,12.0,12.0,11.0,13.0,1.0,21.0,0.0,0.0,0.0,0.0,179.0,75.0,3.0,3.0,2.0,2.0,1.0,3.0,3.0,3.0,1.0,1.0,1.0,5.0,9.0,13.0,11.0,11.0,8.0,10.0,11.0,5.0,2.0,9.0,12.0,2.0,12.0,7.0,11.0,12.0,10.0,9.0,10.0,10.0,13.0,12.0,5.0,13.0,7.0,7.0,11.0,14.0,13.0,13.0,9.0,6.0,12.0,15.0,20.0,13.0,14.0,11.0,10.0,10.0,5.0,10.0,16.0,11.0,10.0,12.0,9.0,13.0,13.0,9.0,23.0,0.0,0.0,0.0,0.0,181.0,73.0,2.0,1.0,2.0,1.0,3.0,3.0,2.0,2.0,4.0,2.0,1.0,5.0,12.0,14.0,13.0,13.0,7.0,12.0,8.0,4.0,5.0,9.0,12.0,5.0,13.0,11.0,11.0,12.0,13.0,11.0,8.0,12.0,14.0,11.0,6.0,13.0,7.0,12.0,13.0,12.0,14.0,13.0,10.0,8.0,14.0,11.0,20.0,13.0,12.0,13.0,5.0,10.0,7.0,14.0,12.0,11.0,14.0,10.0,11.0,10.0,15.0,4.0,21.0,0.0,0.0,0.0,0.0,180.0,71.0,1.0,2.0,1.0,3.0,3.0,3.0,2.0,2.0,2.0,2.0,3.0,10.0,10.0,11.0,10.0,12.0,10.0,8.0,10.0,8.0,8.0,12.0,5.0,6.0,12.0,4.0,11.0,8.0,10.0,9.0,11.0,10.0,10.0,13.0,8.0,12.0,7.0,11.0,12.0,13.0,12.0,10.0,10.0,5.0,12.0,12.0,20.0,11.0,10.0,10.0,10.0,5.0,10.0,12.0,7.0,10.0,14.0,12.0,9.0,10.0,16.0,7.0
3,2,22.0,0.0,0.0,0.0,0.0,186.0,79.0,14.0,13.0,11.0,7.0,12.0,10.0,13.0,14.0,8.0,6.0,8.0,2.0,1.0,3.0,6.0,8.0,5.0,3.0,11.0,3.0,2.0,8.0,8.0,1.0,8.0,8.0,12.0,14.0,12.0,11.0,7.0,11.0,12.0,6.0,9.0,3.0,12.0,12.0,5.0,8.0,12.0,15.0,15.0,20.0,15.0,7.0,5.0,9.0,15.0,14.0,8.0,5.0,5.0,1.0,10.0,12.0,13.0,12.0,8.0,15.0,15.0,5.0,21.0,0.0,0.0,0.0,0.0,182.0,74.0,2.0,2.0,2.0,2.0,2.0,1.0,1.0,1.0,3.0,2.0,2.0,9.0,11.0,12.0,7.0,9.0,8.0,12.0,7.0,11.0,12.0,7.0,8.0,13.0,11.0,12.0,12.0,14.0,12.0,13.0,7.0,12.0,11.0,1.0,9.0,11.0,9.0,10.0,12.0,14.0,10.0,13.0,11.0,9.0,8.0,12.0,20.0,13.0,11.0,10.0,13.0,8.0,10.0,10.0,15.0,11.0,13.0,10.0,10.0,8.0,13.0,7.0,27.0,10.0,0.0,0.0,0.0,181.0,69.0,1.0,1.0,3.0,3.0,3.0,3.0,2.0,3.0,3.0,3.0,1.0,5.0,13.0,10.0,7.0,13.0,9.0,10.0,10.0,12.0,12.0,11.0,7.0,12.0,11.0,11.0,13.0,12.0,11.0,13.0,9.0,9.0,12.0,8.0,7.0,12.0,11.0,11.0,13.0,15.0,13.0,13.0,10.0,20.0,12.0,15.0,8.0,15.0,12.0,13.0,11.0,14.0,13.0,12.0,10.0,14.0,12.0,10.0,11.0,15.0,15.0,7.0,21.0,0.0,0.0,1.0,0.0,177.0,68.0,4.0,1.0,2.0,1.0,1.0,1.0,1.0,1.0,2.0,1.0,2.0,5.0,12.0,9.0,7.0,12.0,8.0,13.0,10.0,16.0,13.0,12.0,8.0,14.0,12.0,12.0,13.0,12.0,12.0,12.0,10.0,13.0,15.0,11.0,13.0,11.0,13.0,13.0,14.0,13.0,14.0,13.0,11.0,10.0,14.0,12.0,20.0,12.0,14.0,12.0,11.0,12.0,8.0,14.0,13.0,10.0,14.0,12.0,14.0,12.0,11.0,5.0,23.0,0.0,0.0,0.0,0.0,182.0,80.0,2.0,3.0,2.0,2.0,2.0,3.0,4.0,4.0,1.0,2.0,1.0,5.0,7.0,12.0,5.0,13.0,6.0,12.0,6.0,6.0,13.0,11.0,6.0,14.0,11.0,13.0,12.0,13.0,14.0,13.0,9.0,10.0,13.0,7.0,10.0,8.0,10.0,13.0,12.0,14.0,12.0,13.0,10.0,5.0,12.0,13.0,20.0,15.0,14.0,14.0,6.0,10.0,9.0,7.0,9.0,12.0,17.0,13.0,14.0,14.0,14.0,5.0,18.0,0.0,0.0,0.0,0.0,177.0,66.0,2.0,2.0,1.0,2.0,1.0,3.0,3.0,2.0,3.0,2.0,3.0,8.0,6.0,8.0,7.0,12.0,6.0,5.0,9.0,5.0,1.0,10.0,4.0,4.0,12.0,5.0,4.0,6.0,6.0,3.0,13.0,7.0,8.0,12.0,6.0,10.0,6.0,8.0,12.0,15.0,10.0,7.0,7.0,20.0,14.0,11.0,5.0,13.0,5.0,8.0,8.0,7.0,8.0,8.0,13.0,10.0,11.0,11.0,11.0,9.0,18.0,3.0,21.0,0.0,0.0,0.0,0.0,180.0,68.0,4.0,1.0,1.0,1.0,1.0,3.0,1.0,2.0,2.0,2.0,3.0,10.0,10.0,13.0,9.0,13.0,9.0,8.0,8.0,6.0,11.0,13.0,10.0,10.0,12.0,8.0,8.0,8.0,11.0,10.0,13.0,10.0,20.0,13.0,6.0,9.0,9.0,7.0,10.0,14.0,14.0,13.0,10.0,10.0,10.0,14.0,20.0,12.0,11.0,10.0,10.0,7.0,6.0,13.0,17.0,12.0,10.0,12.0,12.0,8.0,10.0,2.0,27.0,1.0,0.0,0.0,0.0,179.0,70.0,3.0,2.0,1.0,3.0,3.0,2.0,1.0,3.0,2.0,1.0,1.0,14.0,15.0,15.0,11.0,15.0,14.0,8.0,12.0,5.0,8.0,13.0,12.0,9.0,18.0,11.0,11.0,11.0,9.0,10.0,16.0,10.0,17.0,15.0,8.0,12.0,8.0,12.0,11.0,14.0,13.0,12.0,10.0,12.0,13.0,14.0,20.0,16.0,12.0,10.0,9.0,10.0,7.0,8.0,13.0,15.0,13.0,10.0,11.0,12.0,10.0,8.0,27.0,0.0,0.0,0.0,0.0,191.0,83.0,1.0,1.0,3.0,2.0,1.0,1.0,1.0,1.0,2.0,3.0,1.0,5.0,9.0,11.0,12.0,11.0,7.0,13.0,9.0,5.0,4.0,9.0,3.0,3.0,10.0,10.0,12.0,14.0,10.0,10.0,7.0,11.0,12.0,10.0,6.0,13.0,5.0,13.0,14.0,12.0,11.0,14.0,16.0,5.0,12.0,11.0,20.0,13.0,15.0,12.0,12.0,8.0,7.0,10.0,13.0,11.0,13.0,12.0,12.0,13.0,12.0,8.0,17.0,0.0,0.0,0.0,0.0,187.0,77.0,3.0,4.0,1.0,2.0,2.0,3.0,1.0,1.0,2.0,1.0,2.0,5.0,1.0,13.0,13.0,9.0,5.0,13.0,2.0,1.0,1.0,6.0,9.0,1.0,10.0,8.0,7.0,3.0,10.0,2.0,3.0,10.0,7.0,10.0,2.0,13.0,3.0,5.0,6.0,13.0,8.0,6.0,11.0,5.0,8.0,10.0,20.0,5.0,10.0,8.0,8.0,7.0,5.0,7.0,9.0,11.0,11.0,10.0,11.0,8.0,16.0,3.0,23.0,15.0,5.0,0.0,0.0,186.0,81.0,3.0,1.0,1.0,4.0,1.0,1.0,2.0,2.0,3.0,3.0,4.0,5.0,10.0,13.0,14.0,10.0,5.0,11.0,13.0,5.0,4.0,9.0,10.0,4.0,10.0,13.0,11.0,14.0,12.0,9.0,8.0,8.0,15.0,13.0,7.0,8.0,7.0,10.0,10.0,15.0,12.0,15.0,12.0,7.0,10.0,18.0,20.0,17.0,15.0,8.0,8.0,11.0,12.0,12.0,12.0,15.0,13.0,12.0,15.0,13.0,13.0,6.0,24.0,0.0,0.0,0.0,0.0,197.0,86.0,15.0,9.0,12.0,14.0,13.0,12.0,10.0,13.0,11.0,7.0,8.0,2.0,3.0,3.0,3.0,8.0,7.0,1.0,3.0,1.0,2.0,12.0,2.0,2.0,8.0,10.0,12.0,10.0,14.0,12.0,10.0,10.0,10.0,3.0,8.0,1.0,11.0,10.0,6.0,12.0,13.0,10.0,16.0,5.0,13.0,11.0,20.0,9.0,10.0,10.0,10.0,10.0,7.0,10.0,9.0,11.0,11.0,9.0,12.0,13.0,10.0,8.0,28.0,0.0,0.0,0.0,0.0,190.0,83.0,1.0,1.0,3.0,2.0,1.0,1.0,3.0,3.0,1.0,2.0,1.0,2.0,9.0,5.0,6.0,10.0,5.0,13.0,7.0,4.0,12.0,9.0,7.0,10.0,11.0,13.0,14.0,15.0,13.0,11.0,8.0,11.0,13.0,8.0,12.0,7.0,12.0,12.0,12.0,11.0,11.0,15.0,15.0,20.0,15.0,11.0,5.0,13.0,16.0,15.0,13.0,11.0,7.0,5.0,12.0,12.0,14.0,12.0,15.0,13.0,12.0,6.0,21.0,0.0,0.0,0.0,0.0,193.0,79.0,3.0,3.0,4.0,4.0,2.0,3.0,1.0,1.0,3.0,2.0,3.0,8.0,8.0,8.0,8.0,12.0,11.0,14.0,11.0,12.0,15.0,14.0,6.0,13.0,10.0,12.0,11.0,12.0,12.0,14.0,11.0,10.0,15.0,12.0,12.0,12.0,13.0,14.0,12.0,12.0,12.0,14.0,16.0,9.0,8.0,12.0,20.0,12.0,14.0,13.0,9.0,11.0,16.0,12.0,12.0,14.0,11.0,14.0,12.0,11.0,10.0,5.0,21.0,0.0,0.0,9.0,0.0,178.0,77.0,4.0,3.0,1.0,1.0,1.0,2.0,2.0,3.0,3.0,3.0,1.0,11.0,13.0,11.0,8.0,12.0,9.0,8.0,9.0,8.0,12.0,10.0,8.0,12.0,12.0,8.0,10.0,14.0,11.0,14.0,12.0,12.0,14.0,12.0,8.0,10.0,8.0,15.0,14.0,15.0,12.0,12.0,8.0,7.0,5.0,14.0,20.0,14.0,10.0,12.0,5.0,10.0,11.0,8.0,15.0,10.0,10.0,12.0,9.0,10.0,12.0,5.0,22.0,0.0,0.0,0.0,0.0,168.0,67.0,1.0,1.0,3.0,3.0,3.0,3.0,3.0,2.0,3.0,3.0,3.0,9.0,10.0,12.0,10.0,12.0,10.0,5.0,12.0,6.0,10.0,12.0,8.0,9.0,13.0,11.0,11.0,13.0,11.0,10.0,12.0,12.0,11.0,12.0,5.0,11.0,8.0,10.0,13.0,14.0,14.0,10.0,6.0,20.0,12.0,13.0,6.0,11.0,8.0,12.0,10.0,4.0,5.0,10.0,16.0,11.0,11.0,8.0,12.0,10.0,14.0,6.0,32.0,55.0,0.0,0.0,0.0,180.0,74.0,1.0,3.0,3.0,2.0,1.0,2.0,2.0,1.0,3.0,3.0,1.0,6.0,8.0,8.0,6.0,11.0,10.0,12.0,10.0,6.0,13.0,11.0,7.0,15.0,11.0,14.0,14.0,17.0,12.0,14.0,10.0,13.0,16.0,8.0,12.0,8.0,14.0,16.0,18.0,12.0,13.0,13.0,10.0,8.0,16.0,14.0,20.0,18.0,13.0,16.0,15.0,14.0,5.0,10.0,9.0,15.0,13.0,15.0,14.0,11.0,10.0,7.0,25.0,0.0,0.0,0.0,0.0,177.0,66.0,2.0,3.0,1.0,3.0,2.0,3.0,4.0,1.0,4.0,3.0,1.0,11.0,11.0,11.0,7.0,13.0,11.0,8.0,10.0,7.0,4.0,12.0,11.0,6.0,12.0,8.0,12.0,11.0,12.0,12.0,12.0,9.0,13.0,11.0,7.0,11.0,9.0,14.0,13.0,11.0,13.0,12.0,9.0,20.0,14.0,10.0,8.0,16.0,9.0,13.0,8.0,2.0,6.0,10.0,9.0,11.0,15.0,12.0,14.0,14.0,14.0,6.0,21.0,2.0,1.0,0.0,0.0,173.0,68.0,4.0,1.0,1.0,3.0,1.0,3.0,1.0,1.0,1.0,1.0,1.0,8.0,12.0,11.0,11.0,12.0,8.0,5.0,6.0,4.0,5.0,12.0,9.0,7.0,12.0,13.0,10.0,10.0,9.0,13.0,13.0,11.0,10.0,13.0,6.0,12.0,8.0,10.0,13.0,14.0,14.0,14.0,7.0,13.0,12.0,13.0,20.0,11.0,7.0,13.0,6.0,12.0,6.0,9.0,11.0,12.0,9.0,7.0,10.0,11.0,13.0,7.0,19.0,0.0,0.0,0.0,0.0,175.0,60.0,4.0,2.0,2.0,1.0,1.0,2.0,3.0,2.0,3.0,3.0,1.0,10.0,11.0,15.0,12.0,14.0,6.0,4.0,13.0,10.0,10.0,12.0,9.0,11.0,14.0,8.0,10.0,10.0,14.0,11.0,12.0,15.0,4.0,11.0,7.0,8.0,10.0,11.0,12.0,12.0,12.0,11.0,8.0,5.0,9.0,10.0,20.0,9.0,8.0,10.0,10.0,7.0,10.0,10.0,14.0,12.0,10.0,11.0,14.0,10.0,11.0,2.0,19.0,0.0,0.0,0.0,0.0,185.0,79.0,2.0,3.0,3.0,1.0,2.0,1.0,2.0,3.0,3.0,3.0,2.0,11.0,11.0,11.0,12.0,11.0,10.0,12.0,12.0,5.0,6.0,11.0,12.0,6.0,12.0,15.0,12.0,13.0,11.0,10.0,12.0,11.0,10.0,13.0,12.0,12.0,8.0,10.0,12.0,10.0,13.0,12.0,12.0,20.0,10.0,9.0,10.0,10.0,7.0,10.0,12.0,10.0,5.0,9.0,11.0,12.0,13.0,10.0,13.0,14.0,18.0,3.0,28.0,0.0,0.0,0.0,0.0,185.0,80.0,3.0,4.0,2.0,1.0,3.0,3.0,4.0,1.0,3.0,2.0,2.0,10.0,12.0,13.0,12.0,14.0,11.0,13.0,10.0,4.0,6.0,13.0,10.0,4.0,13.0,15.0,12.0,16.0,10.0,10.0,12.0,12.0,14.0,12.0,5.0,13.0,8.0,11.0,14.0,13.0,13.0,14.0,12.0,8.0,13.0,14.0,20.0,11.0,13.0,13.0,11.0,13.0,7.0,10.0,12.0,14.0,12.0,12.0,11.0,13.0,13.0,7.0
0,3,31.0,22.0,0.0,17.0,0.0,185.0,82.0,12.0,12.0,13.0,6.0,14.0,11.0,15.0,18.0,14.0,10.0,13.0,7.0,3.0,8.0,5.0,9.0,10.0,8.0,12.0,2.0,2.0,9.0,6.0,3.0,10.0,6.0,12.0,15.0,16.0,12.0,8.0,12.0,14.0,8.0,15.0,3.0,13.0,13.0,8.0,13.0,17.0,14.0,13.0,7.0,12.0,11.0,20.0,15.0,14.0,13.0,6.0,16.0,3.0,1.0,8.0,16.0,12.0,13.0,16.0,16.0,16.0,7.0,16.0,0.0,0.0,0.0,0.0,192.0,0.0,2.0,3.0,1.0,2.0,3.0,1.0,1.0,1.0,2.0,3.0,3.0,6.0,8.0,8.0,6.0,10.0,6.0,12.0,6.0,7.0,12.0,10.0,7.0,12.0,10.0,13.0,12.0,14.0,11.0,10.0,8.0,10.0,10.0,8.0,6.0,8.0,9.0,10.0,13.0,13.0,11.0,12.0,13.0,6.0,14.0,12.0,20.0,10.0,10.0,10.0,7.0,8.0,8.0,10.0,9.0,13.0,10.0,11.0,11.0,10.0,15.0,9.0,19.0,0.0,0.0,7.0,2.0,188.0,85.0,1.0,3.0,2.0,1.0,2.0,3.0,3.0,2.0,2.0,3.0,1.0,10.0,6.0,9.0,8.0,10.0,12.0,15.0,8.0,7.0,14.0,11.0,10.0,13.0,10.0,14.0,11.0,13.0,9.0,11.0,10.0,10.0,9.0,1.0,8.0,12.0,13.0,13.0,14.0,13.0,10.0,13.0,15.0,9.0,12.0,13.0,20.0,14.0,14.0,9.0,11.0,4.0,9.0,11.0,14.0,13.0,12.0,12.0,12.0,1.0,13.0,2.0,26.0,27.0,0.0,0.0,0.0,183.0,70.0,1.0,3.0,1.0,3.0,4.0,1.0,3.0,3.0,2.0,1.0,3.0,9.0,14.0,12.0,8.0,10.0,8.0,12.0,13.0,14.0,9.0,12.0,7.0,13.0,11.0,14.0,9.0,15.0,10.0,12.0,9.0,10.0,16.0,10.0,9.0,12.0,8.0,12.0,17.0,14.0,11.0,13.0,12.0,10.0,16.0,16.0,20.0,16.0,13.0,13.0,10.0,14.0,6.0,15.0,10.0,15.0,14.0,10.0,16.0,13.0,13.0,4.0,22.0,0.0,0.0,3.0,0.0,176.0,70.0,1.0,1.0,1.0,3.0,2.0,1.0,2.0,3.0,1.0,3.0,3.0,10.0,15.0,14.0,6.0,13.0,10.0,13.0,10.0,9.0,9.0,13.0,8.0,11.0,14.0,10.0,11.0,12.0,10.0,13.0,11.0,13.0,14.0,13.0,7.0,13.0,9.0,11.0,13.0,17.0,13.0,12.0,10.0,20.0,14.0,16.0,5.0,15.0,11.0,13.0,10.0,14.0,8.0,10.0,11.0,13.0,16.0,11.0,15.0,14.0,13.0,7.0,28.0,41.0,2.0,0.0,0.0,187.0,80.0,3.0,2.0,3.0,2.0,1.0,1.0,2.0,3.0,1.0,4.0,2.0,7.0,10.0,11.0,7.0,12.0,7.0,10.0,12.0,13.0,15.0,13.0,8.0,18.0,12.0,18.0,13.0,17.0,12.0,14.0,10.0,12.0,17.0,7.0,13.0,9.0,14.0,17.0,18.0,14.0,13.0,16.0,14.0,20.0,18.0,13.0,12.0,18.0,14.0,15.0,16.0,15.0,6.0,15.0,14.0,13.0,10.0,14.0,12.0,8.0,7.0,8.0,26.0,28.0,3.0,12.0,1.0,186.0,78.0,1.0,3.0,1.0,3.0,2.0,1.0,3.0,2.0,1.0,1.0,3.0,10.0,12.0,10.0,11.0,13.0,10.0,10.0,13.0,5.0,10.0,17.0,13.0,15.0,13.0,17.0,16.0,15.0,18.0,16.0,15.0,16.0,19.0,8.0,16.0,14.0,15.0,17.0,16.0,12.0,13.0,15.0,11.0,20.0,7.0,14.0,9.0,14.0,16.0,15.0,12.0,15.0,16.0,10.0,16.0,16.0,14.0,17.0,17.0,13.0,15.0,8.0,18.0,0.0,0.0,0.0,0.0,167.0,60.0,2.0,1.0,2.0,2.0,2.0,1.0,2.0,1.0,1.0,1.0,1.0,10.0,11.0,12.0,8.0,13.0,10.0,3.0,10.0,5.0,6.0,13.0,12.0,8.0,15.0,8.0,11.0,8.0,12.0,11.0,13.0,12.0,13.0,12.0,6.0,11.0,11.0,12.0,13.0,15.0,14.0,8.0,5.0,8.0,15.0,12.0,20.0,12.0,7.0,8.0,8.0,14.0,7.0,8.0,18.0,11.0,12.0,11.0,12.0,15.0,15.0,7.0,21.0,0.0,0.0,0.0,0.0,187.0,84.0,4.0,2.0,1.0,2.0,3.0,1.0,2.0,3.0,1.0,1.0,2.0,11.0,13.0,15.0,12.0,14.0,11.0,13.0,14.0,4.0,5.0,12.0,14.0,5.0,16.0,12.0,12.0,14.0,12.0,10.0,10.0,9.0,14.0,17.0,10.0,12.0,7.0,10.0,14.0,14.0,16.0,14.0,15.0,9.0,13.0,14.0,20.0,14.0,14.0,14.0,8.0,15.0,5.0,14.0,11.0,16.0,13.0,14.0,13.0,15.0,15.0,6.0,20.0,0.0,0.0,0.0,0.0,178.0,81.0,2.0,1.0,3.0,3.0,2.0,2.0,3.0,3.0,2.0,3.0,3.0,11.0,12.0,15.0,12.0,14.0,8.0,7.0,14.0,5.0,3.0,10.0,10.0,3.0,14.0,16.0,12.0,10.0,12.0,8.0,11.0,8.0,11.0,15.0,8.0,13.0,5.0,7.0,6.0,14.0,14.0,12.0,8.0,8.0,8.0,14.0,20.0,9.0,10.0,11.0,14.0,10.0,6.0,9.0,6.0,14.0,4.0,11.0,4.0,7.0,4.0,18.0,25.0,33.0,13.0,16.0,6.0,189.0,88.0,2.0,4.0,1.0,2.0,3.0,1.0,2.0,3.0,2.0,1.0,2.0,12.0,13.0,15.0,15.0,15.0,17.0,16.0,16.0,8.0,5.0,14.0,19.0,7.0,16.0,13.0,14.0,12.0,16.0,9.0,14.0,12.0,7.0,15.0,8.0,12.0,5.0,2.0,4.0,13.0,15.0,14.0,14.0,12.0,12.0,15.0,20.0,13.0,15.0,7.0,16.0,13.0,14.0,11.0,8.0,13.0,4.0,11.0,8.0,3.0,4.0,16.0,25.0,4.0,0.0,11.0,0.0,184.0,81.0,14.0,14.0,13.0,9.0,15.0,12.0,16.0,16.0,13.0,7.0,11.0,8.0,1.0,2.0,1.0,11.0,12.0,6.0,1.0,3.0,3.0,11.0,5.0,3.0,11.0,8.0,15.0,15.0,13.0,14.0,10.0,11.0,14.0,8.0,13.0,5.0,13.0,10.0,10.0,14.0,16.0,14.0,13.0,20.0,14.0,12.0,5.0,14.0,14.0,15.0,9.0,16.0,6.0,1.0,17.0,11.0,15.0,13.0,14.0,12.0,12.0,4.0,32.0,0.0,0.0,0.0,0.0,172.0,71.0,2.0,1.0,3.0,1.0,2.0,3.0,2.0,3.0,2.0,2.0,2.0,8.0,9.0,7.0,6.0,10.0,6.0,10.0,9.0,10.0,14.0,11.0,6.0,14.0,11.0,10.0,16.0,15.0,12.0,12.0,7.0,12.0,15.0,9.0,13.0,8.0,14.0,15.0,15.0,14.0,14.0,14.0,10.0,20.0,14.0,14.0,8.0,15.0,13.0,13.0,11.0,13.0,7.0,13.0,17.0,14.0,17.0,8.0,13.0,15.0,15.0,6.0,27.0,0.0,0.0,0.0,0.0,184.0,81.0,1.0,1.0,1.0,3.0,3.0,2.0,2.0,2.0,1.0,2.0,3.0,8.0,6.0,8.0,12.0,10.0,8.0,12.0,9.0,1.0,3.0,8.0,14.0,4.0,9.0,4.0,11.0,12.0,11.0,8.0,8.0,11.0,10.0,9.0,8.0,11.0,9.0,8.0,11.0,10.0,8.0,13.0,13.0,9.0,13.0,9.0,20.0,12.0,13.0,13.0,9.0,2.0,9.0,9.0,15.0,10.0,12.0,10.0,11.0,6.0,4.0,6.0,21.0,0.0,0.0,0.0,0.0,178.0,65.0,2.0,3.0,3.0,3.0,3.0,1.0,1.0,1.0,1.0,3.0,1.0,9.0,13.0,11.0,6.0,12.0,7.0,9.0,8.0,8.0,13.0,12.0,7.0,13.0,12.0,8.0,12.0,13.0,12.0,12.0,13.0,13.0,14.0,9.0,8.0,12.0,12.0,13.0,13.0,12.0,14.0,13.0,11.0,8.0,15.0,12.0,20.0,13.0,12.0,14.0,8.0,11.0,7.0,10.0,19.0,10.0,13.0,10.0,11.0,15.0,15.0,6.0,19.0,0.0,0.0,3.0,1.0,181.0,69.0,3.0,2.0,3.0,3.0,2.0,1.0,1.0,1.0,3.0,3.0,4.0,10.0,10.0,12.0,12.0,12.0,7.0,8.0,11.0,5.0,7.0,10.0,10.0,7.0,11.0,8.0,10.0,10.0,12.0,8.0,11.0,8.0,14.0,13.0,6.0,14.0,8.0,13.0,13.0,16.0,14.0,13.0,9.0,20.0,15.0,16.0,10.0,15.0,13.0,12.0,8.0,11.0,7.0,12.0,11.0,11.0,15.0,10.0,12.0,14.0,14.0,1.0,21.0,0.0,0.0,0.0,0.0,179.0,68.0,2.0,3.0,2.0,1.0,2.0,1.0,2.0,3.0,2.0,1.0,1.0,6.0,13.0,12.0,6.0,13.0,6.0,8.0,7.0,12.0,10.0,12.0,8.0,12.0,13.0,10.0,11.0,11.0,12.0,10.0,11.0,11.0,12.0,11.0,7.0,13.0,10.0,12.0,14.0,15.0,13.0,12.0,10.0,20.0,14.0,14.0,8.0,14.0,10.0,13.0,8.0,13.0,8.0,12.0,13.0,14.0,10.0,12.0,10.0,10.0,12.0,10.0,19.0,0.0,0.0,0.0,0.0,175.0,67.0,3.0,2.0,1.0,3.0,3.0,1.0,1.0,1.0,2.0,1.0,3.0,7.0,8.0,12.0,8.0,10.0,6.0,12.0,9.0,8.0,10.0,10.0,8.0,12.0,11.0,14.0,10.0,12.0,9.0,10.0,11.0,10.0,12.0,12.0,10.0,12.0,12.0,13.0,14.0,13.0,11.0,14.0,8.0,6.0,14.0,12.0,20.0,14.0,12.0,12.0,8.0,11.0,6.0,12.0,17.0,13.0,10.0,11.0,12.0,11.0,17.0,5.0,18.0,0.0,0.0,0.0,0.0,170.0,67.0,3.0,1.0,3.0,3.0,3.0,4.0,1.0,2.0,1.0,2.0,2.0,11.0,11.0,12.0,13.0,12.0,11.0,6.0,10.0,8.0,7.0,12.0,10.0,7.0,13.0,9.0,11.0,8.0,10.0,10.0,12.0,12.0,15.0,12.0,12.0,11.0,12.0,11.0,12.0,12.0,12.0,10.0,6.0,5.0,14.0,12.0,20.0,10.0,9.0,10.0,8.0,2.0,6.0,12.0,11.0,11.0,12.0,13.0,14.0,11.0,13.0,4.0,18.0,0.0,0.0,0.0,0.0,184.0,71.0,2.0,3.0,2.0,3.0,1.0,2.0,1.0,3.0,2.0,1.0,3.0,8.0,10.0,14.0,10.0,12.0,8.0,5.0,10.0,3.0,5.0,12.0,7.0,6.0,13.0,8.0,8.0,8.0,11.0,8.0,11.0,14.0,12.0,10.0,11.0,10.0,9.0,9.0,13.0,14.0,13.0,5.0,10.0,10.0,13.0,14.0,20.0,12.0,8.0,10.0,8.0,10.0,4.0,10.0,11.0,12.0,11.0,12.0,13.0,11.0,13.0,6.0,22.0,5.0,1.0,1.0,0.0,173.0,72.0,1.0,3.0,1.0,3.0,3.0,3.0,3.0,3.0,3.0,2.0,2.0,14.0,13.0,16.0,14.0,16.0,14.0,5.0,11.0,5.0,5.0,15.0,11.0,5.0,16.0,8.0,13.0,9.0,14.0,13.0,15.0,13.0,15.0,16.0,5.0,13.0,5.0,9.0,10.0,15.0,16.0,14.0,5.0,20.0,14.0,15.0,5.0,12.0,14.0,13.0,11.0,13.0,8.0,14.0,10.0,15.0,14.0,10.0,13.0,10.0,10.0,13.0,22.0,24.0,3.0,7.0,0.0,177.0,78.0,2.0,1.0,2.0,3.0,2.0,2.0,4.0,3.0,3.0,2.0,1.0,10.0,13.0,16.0,14.0,16.0,16.0,8.0,16.0,4.0,4.0,15.0,12.0,4.0,16.0,12.0,11.0,12.0,13.0,10.0,11.0,8.0,13.0,17.0,5.0,14.0,5.0,10.0,12.0,15.0,14.0,13.0,9.0,10.0,17.0,16.0,20.0,15.0,14.0,12.0,11.0,15.0,4.0,12.0,19.0,16.0,14.0,14.0,11.0,13.0,10.0,12.0
2,2,22.0,0.0,0.0,0.0,0.0,191.0,86.0,14.0,11.0,10.0,12.0,13.0,9.0,14.0,13.0,10.0,13.0,12.0,4.0,2.0,2.0,1.0,5.0,6.0,10.0,3.0,3.0,3.0,7.0,5.0,3.0,6.0,12.0,10.0,12.0,13.0,10.0,6.0,12.0,11.0,11.0,11.0,5.0,9.0,8.0,6.0,10.0,12.0,16.0,15.0,6.0,14.0,9.0,20.0,11.0,15.0,11.0,11.0,13.0,7.0,1.0,18.0,10.0,11.0,13.0,14.0,11.0,20.0,4.0,19.0,1.0,0.0,0.0,0.0,182.0,67.0,1.0,3.0,2.0,1.0,2.0,3.0,1.0,1.0,2.0,1.0,1.0,7.0,7.0,8.0,4.0,10.0,7.0,9.0,9.0,7.0,14.0,9.0,7.0,13.0,9.0,9.0,10.0,8.0,9.0,8.0,9.0,14.0,2.0,7.0,12.0,7.0,8.0,8.0,12.0,12.0,10.0,9.0,11.0,5.0,13.0,8.0,20.0,11.0,8.0,9.0,5.0,4.0,9.0,9.0,10.0,12.0,13.0,9.0,10.0,13.0,12.0,3.0,32.0,0.0,0.0,0.0,0.0,183.0,79.0,1.0,1.0,1.0,3.0,1.0,3.0,1.0,1.0,2.0,1.0,1.0,5.0,10.0,6.0,6.0,9.0,6.0,15.0,7.0,11.0,14.0,10.0,7.0,13.0,10.0,13.0,15.0,15.0,15.0,14.0,9.0,13.0,16.0,6.0,14.0,8.0,12.0,13.0,16.0,11.0,12.0,16.0,11.0,8.0,16.0,12.0,20.0,15.0,14.0,14.0,11.0,12.0,5.0,15.0,18.0,15.0,14.0,13.0,17.0,14.0,14.0,5.0,21.0,0.0,0.0,0.0,0.0,172.0,68.0,3.0,3.0,1.0,2.0,1.0,2.0,3.0,2.0,2.0,3.0,2.0,12.0,13.0,12.0,8.0,12.0,12.0,5.0,8.0,12.0,11.0,13.0,8.0,13.0,12.0,14.0,13.0,14.0,13.0,13.0,10.0,11.0,15.0,9.0,13.0,13.0,12.0,13.0,14.0,12.0,12.0,12.0,6.0,20.0,13.0,13.0,13.0,13.0,11.0,12.0,10.0,10.0,11.0,9.0,20.0,13.0,15.0,12.0,16.0,13.0,13.0,8.0,22.0,0.0,0.0,0.0,0.0,178.0,73.0,3.0,2.0,2.0,1.0,2.0,4.0,3.0,1.0,3.0,1.0,2.0,6.0,12.0,12.0,6.0,11.0,7.0,8.0,8.0,11.0,12.0,10.0,8.0,13.0,11.0,12.0,12.0,13.0,11.0,10.0,11.0,11.0,13.0,6.0,7.0,12.0,9.0,13.0,14.0,16.0,14.0,13.0,9.0,6.0,14.0,15.0,20.0,15.0,14.0,12.0,12.0,13.0,6.0,14.0,12.0,15.0,13.0,13.0,14.0,14.0,14.0,6.0,21.0,4.0,1.0,0.0,0.0,176.0,60.0,1.0,1.0,3.0,2.0,3.0,2.0,1.0,3.0,3.0,4.0,2.0,9.0,10.0,13.0,9.0,13.0,8.0,7.0,12.0,7.0,11.0,13.0,7.0,12.0,11.0,9.0,14.0,12.0,9.0,11.0,12.0,11.0,10.0,9.0,5.0,10.0,12.0,12.0,15.0,15.0,14.0,13.0,7.0,12.0,10.0,12.0,20.0,14.0,4.0,9.0,9.0,9.0,7.0,5.0,15.0,16.0,12.0,10.0,9.0,16.0,8.0,3.0,32.0,0.0,0.0,13.0,0.0,175.0,65.0,2.0,1.0,1.0,2.0,3.0,3.0,1.0,2.0,3.0,2.0,3.0,15.0,13.0,11.0,6.0,14.0,13.0,10.0,12.0,8.0,8.0,16.0,8.0,12.0,13.0,11.0,14.0,15.0,14.0,15.0,14.0,14.0,14.0,6.0,13.0,9.0,15.0,18.0,13.0,12.0,13.0,13.0,8.0,8.0,13.0,10.0,20.0,13.0,13.0,12.0,11.0,15.0,12.0,10.0,17.0,14.0,15.0,14.0,16.0,14.0,14.0,6.0,18.0,0.0,0.0,0.0,0.0,178.0,70.0,1.0,2.0,3.0,2.0,4.0,2.0,3.0,1.0,1.0,2.0,3.0,11.0,7.0,10.0,10.0,14.0,12.0,9.0,10.0,6.0,7.0,15.0,5.0,10.0,12.0,9.0,10.0,9.0,8.0,10.0,9.0,12.0,7.0,4.0,3.0,12.0,9.0,10.0,14.0,15.0,12.0,10.0,8.0,6.0,5.0,11.0,20.0,10.0,9.0,12.0,8.0,2.0,10.0,10.0,11.0,10.0,12.0,12.0,11.0,12.0,19.0,6.0,18.0,0.0,0.0,0.0,0.0,179.0,67.0,3.0,3.0,2.0,4.0,2.0,4.0,3.0,1.0,3.0,4.0,1.0,5.0,7.0,12.0,9.0,12.0,12.0,10.0,12.0,6.0,4.0,12.0,12.0,3.0,14.0,11.0,12.0,11.0,11.0,8.0,13.0,12.0,12.0,12.0,6.0,12.0,5.0,10.0,12.0,15.0,11.0,12.0,10.0,20.0,13.0,14.0,8.0,14.0,8.0,9.0,6.0,14.0,5.0,10.0,16.0,13.0,12.0,12.0,13.0,9.0,15.0,2.0,18.0,0.0,0.0,0.0,0.0,188.0,80.0,1.0,3.0,1.0,3.0,2.0,3.0,3.0,1.0,2.0,2.0,4.0,6.0,8.0,12.0,11.0,12.0,7.0,13.0,10.0,4.0,4.0,8.0,10.0,5.0,12.0,11.0,11.0,13.0,10.0,11.0,11.0,12.0,11.0,13.0,7.0,13.0,8.0,13.0,13.0,11.0,12.0,12.0,12.0,10.0,12.0,11.0,20.0,10.0,12.0,12.0,8.0,11.0,7.0,13.0,8.0,13.0,13.0,11.0,12.0,12.0,13.0,7.0,32.0,0.0,0.0,0.0,0.0,187.0,76.0,1.0,3.0,1.0,2.0,3.0,2.0,3.0,3.0,2.0,1.0,2.0,5.0,8.0,11.0,6.0,12.0,6.0,9.0,8.0,8.0,11.0,12.0,8.0,13.0,14.0,8.0,14.0,12.0,11.0,10.0,10.0,10.0,12.0,14.0,5.0,11.0,8.0,13.0,15.0,11.0,11.0,13.0,13.0,7.0,10.0,13.0,20.0,9.0,11.0,13.0,4.0,12.0,6.0,15.0,17.0,9.0,11.0,11.0,14.0,17.0,16.0,2.0,19.0,0.0,0.0,0.0,0.0,190.0,78.0,13.0,12.0,11.0,14.0,13.0,6.0,11.0,13.0,13.0,12.0,7.0,3.0,3.0,1.0,3.0,8.0,8.0,3.0,1.0,2.0,3.0,7.0,3.0,1.0,7.0,8.0,13.0,13.0,12.0,13.0,7.0,11.0,11.0,3.0,14.0,2.0,11.0,11.0,10.0,12.0,13.0,11.0,15.0,20.0,10.0,13.0,5.0,13.0,13.0,9.0,10.0,6.0,10.0,10.0,10.0,12.0,11.0,14.0,14.0,12.0,13.0,3.0,21.0,0.0,0.0,0.0,0.0,185.0,79.0,3.0,4.0,3.0,1.0,3.0,1.0,2.0,1.0,1.0,1.0,1.0,7.0,9.0,7.0,8.0,12.0,7.0,13.0,8.0,8.0,13.0,12.0,8.0,13.0,10.0,14.0,11.0,13.0,10.0,12.0,11.0,10.0,14.0,10.0,7.0,8.0,13.0,11.0,10.0,12.0,11.0,13.0,13.0,6.0,13.0,11.0,20.0,13.0,15.0,12.0,12.0,10.0,5.0,14.0,17.0,12.0,13.0,10.0,12.0,12.0,12.0,4.0,17.0,0.0,0.0,0.0,0.0,177.0,69.0,2.0,3.0,2.0,2.0,1.0,1.0,3.0,2.0,1.0,3.0,4.0,6.0,11.0,10.0,6.0,11.0,6.0,7.0,8.0,8.0,8.0,9.0,7.0,10.0,11.0,12.0,10.0,12.0,9.0,10.0,11.0,8.0,11.0,9.0,6.0,9.0,8.0,10.0,12.0,13.0,12.0,10.0,7.0,8.0,9.0,12.0,20.0,10.0,7.0,9.0,9.0,7.0,8.0,12.0,8.0,11.0,13.0,11.0,10.0,10.0,11.0,6.0,19.0,0.0,0.0,0.0,0.0,179.0,70.0,2.0,1.0,2.0,4.0,3.0,1.0,3.0,3.0,4.0,2.0,3.0,8.0,10.0,8.0,7.0,12.0,6.0,11.0,6.0,5.0,12.0,10.0,8.0,13.0,10.0,12.0,12.0,12.0,11.0,11.0,7.0,12.0,10.0,7.0,9.0,10.0,10.0,10.0,12.0,12.0,12.0,13.0,10.0,20.0,10.0,13.0,10.0,12.0,14.0,14.0,10.0,3.0,7.0,10.0,13.0,10.0,9.0,10.0,8.0,9.0,15.0,7.0,17.0,0.0,0.0,0.0,0.0,170.0,74.0,3.0,3.0,2.0,1.0,3.0,3.0,2.0,3.0,1.0,3.0,4.0,8.0,13.0,11.0,10.0,9.0,10.0,6.0,7.0,6.0,10.0,9.0,4.0,11.0,12.0,9.0,10.0,10.0,10.0,12.0,12.0,8.0,10.0,8.0,2.0,10.0,11.0,11.0,11.0,13.0,16.0,11.0,7.0,20.0,15.0,15.0,6.0,12.0,13.0,12.0,3.0,6.0,10.0,14.0,12.0,16.0,11.0,11.0,12.0,12.0,17.0,8.0,20.0,0.0,0.0,0.0,0.0,178.0,72.0,3.0,2.0,3.0,3.0,4.0,2.0,2.0,1.0,2.0,1.0,3.0,9.0,11.0,11.0,6.0,11.0,6.0,8.0,10.0,11.0,11.0,12.0,7.0,12.0,8.0,12.0,11.0,12.0,12.0,11.0,13.0,11.0,10.0,4.0,12.0,8.0,12.0,13.0,13.0,13.0,12.0,13.0,9.0,20.0,14.0,12.0,7.0,11.0,13.0,10.0,4.0,10.0,6.0,10.0,15.0,11.0,13.0,11.0,10.0,14.0,16.0,5.0,20.0,0.0,0.0,0.0,0.0,180.0,73.0,4.0,1.0,1.0,1.0,2.0,1.0,3.0,1.0,1.0,1.0,3.0,9.0,11.0,12.0,10.0,12.0,7.0,11.0,10.0,8.0,6.0,10.0,11.0,5.0,10.0,9.0,8.0,9.0,10.0,8.0,10.0,11.0,9.0,7.0,1.0,10.0,7.0,7.0,10.0,13.0,9.0,13.0,10.0,5.0,6.0,13.0,20.0,9.0,11.0,9.0,9.0,9.0,9.0,9.0,13.0,8.0,12.0,12.0,12.0,11.0,13.0,1.0,24.0,0.0,0.0,6.0,1.0,172.0,70.0,3.0,1.0,1.0,3.0,1.0,2.0,3.0,1.0,1.0,3.0,3.0,11.0,12.0,11.0,8.0,12.0,10.0,6.0,14.0,7.0,11.0,15.0,8.0,12.0,13.0,14.0,14.0,18.0,13.0,12.0,13.0,13.0,15.0,12.0,12.0,12.0,11.0,18.0,18.0,13.0,14.0,13.0,7.0,10.0,16.0,12.0,20.0,14.0,12.0,14.0,14.0,15.0,4.0,8.0,7.0,14.0,14.0,13.0,14.0,12.0,10.0,6.0,21.0,0.0,0.0,0.0,0.0,180.0,71.0,1.0,2.0,1.0,3.0,3.0,3.0,2.0,2.0,2.0,2.0,3.0,10.0,10.0,11.0,10.0,12.0,10.0,8.0,10.0,8.0,8.0,12.0,5.0,6.0,12.0,4.0,11.0,8.0,10.0,9.0,11.0,10.0,10.0,13.0,8.0,12.0,7.0,11.0,12.0,13.0,12.0,10.0,10.0,5.0,12.0,12.0,20.0,11.0,10.0,10.0,10.0,5.0,10.0,12.0,7.0,10.0,14.0,12.0,9.0,10.0,16.0,7.0,23.0,0.0,0.0,0.0,0.0,181.0,73.0,2.0,1.0,2.0,1.0,3.0,3.0,2.0,2.0,4.0,2.0,1.0,5.0,12.0,14.0,13.0,13.0,7.0,12.0,8.0,4.0,5.0,9.0,12.0,5.0,13.0,11.0,11.0,12.0,13.0,11.0,8.0,12.0,14.0,11.0,6.0,13.0,7.0,12.0,13.0,12.0,14.0,13.0,10.0,8.0,14.0,11.0,20.0,13.0,12.0,13.0,5.0,10.0,7.0,14.0,12.0,11.0,14.0,10.0,11.0,10.0,15.0,4.0,21.0,0.0,0.0,0.0,0.0,179.0,75.0,3.0,3.0,2.0,2.0,1.0,3.0,3.0,3.0,1.0,1.0,1.0,5.0,9.0,13.0,11.0,11.0,8.0,10.0,11.0,5.0,2.0,9.0,12.0,2.0,12.0,7.0,11.0,12.0,10.0,9.0,10.0,10.0,13.0,12.0,5.0,13.0,7.0,7.0,11.0,14.0,13.0,13.0,9.0,6.0,12.0,15.0,20.0,13.0,14.0,11.0,10.0,10.0,5.0,10.0,16.0,11.0,10.0,12.0,9.0,13.0,13.0,9.0
4,0,25.0,4.0,0.0,11.0,0.0,184.0,81.0,14.0,14.0,13.0,9.0,15.0,12.0,16.0,16.0,13.0,7.0,11.0,8.0,1.0,2.0,1.0,11.0,12.0,6.0,1.0,3.0,3.0,11.0,5.0,3.0,11.0,8.0,15.0,15.0,13.0,14.0,10.0,11.0,14.0,8.0,13.0,5.0,13.0,10.0,10.0,14.0,16.0,14.0,13.0,20.0,14.0,12.0,5.0,14.0,14.0,15.0,9.0,16.0,6.0,1.0,17.0,11.0,15.0,13.0,14.0,12.0,12.0,4.0,32.0,0.0,0.0,0.0,0.0,172.0,71.0,2.0,1.0,3.0,1.0,2.0,3.0,2.0,3.0,2.0,2.0,2.0,8.0,9.0,7.0,6.0,10.0,6.0,10.0,9.0,10.0,14.0,11.0,6.0,14.0,11.0,10.0,16.0,15.0,12.0,12.0,7.0,12.0,15.0,9.0,13.0,8.0,14.0,15.0,15.0,14.0,14.0,14.0,10.0,20.0,14.0,14.0,8.0,15.0,13.0,13.0,11.0,13.0,7.0,13.0,17.0,14.0,17.0,8.0,13.0,15.0,15.0,6.0,27.0,0.0,0.0,0.0,0.0,184.0,81.0,1.0,1.0,1.0,3.0,3.0,2.0,2.0,2.0,1.0,2.0,3.0,8.0,6.0,8.0,12.0,10.0,8.0,12.0,9.0,1.0,3.0,8.0,14.0,4.0,9.0,4.0,11.0,12.0,11.0,8.0,8.0,11.0,10.0,9.0,8.0,11.0,9.0,8.0,11.0,10.0,8.0,13.0,13.0,9.0,13.0,9.0,20.0,12.0,13.0,13.0,9.0,2.0,9.0,9.0,15.0,10.0,12.0,10.0,11.0,6.0,4.0,6.0,21.0,0.0,0.0,0.0,0.0,178.0,65.0,2.0,3.0,3.0,3.0,3.0,1.0,1.0,1.0,1.0,3.0,1.0,9.0,13.0,11.0,6.0,12.0,7.0,9.0,8.0,8.0,13.0,12.0,7.0,13.0,12.0,8.0,12.0,13.0,12.0,12.0,13.0,13.0,14.0,9.0,8.0,12.0,12.0,13.0,13.0,12.0,14.0,13.0,11.0,8.0,15.0,12.0,20.0,13.0,12.0,14.0,8.0,11.0,7.0,10.0,19.0,10.0,13.0,10.0,11.0,15.0,15.0,6.0,19.0,0.0,0.0,3.0,1.0,181.0,69.0,3.0,2.0,3.0,3.0,2.0,1.0,1.0,1.0,3.0,3.0,4.0,10.0,10.0,12.0,12.0,12.0,7.0,8.0,11.0,5.0,7.0,10.0,10.0,7.0,11.0,8.0,10.0,10.0,12.0,8.0,11.0,8.0,14.0,13.0,6.0,14.0,8.0,13.0,13.0,16.0,14.0,13.0,9.0,20.0,15.0,16.0,10.0,15.0,13.0,12.0,8.0,11.0,7.0,12.0,11.0,11.0,15.0,10.0,12.0,14.0,14.0,1.0,21.0,0.0,0.0,0.0,0.0,179.0,68.0,2.0,3.0,2.0,1.0,2.0,1.0,2.0,3.0,2.0,1.0,1.0,6.0,13.0,12.0,6.0,13.0,6.0,8.0,7.0,12.0,10.0,12.0,8.0,12.0,13.0,10.0,11.0,11.0,12.0,10.0,11.0,11.0,12.0,11.0,7.0,13.0,10.0,12.0,14.0,15.0,13.0,12.0,10.0,20.0,14.0,14.0,8.0,14.0,10.0,13.0,8.0,13.0,8.0,12.0,13.0,14.0,10.0,12.0,10.0,10.0,12.0,10.0,18.0,0.0,0.0,0.0,0.0,170.0,67.0,3.0,1.0,3.0,3.0,3.0,4.0,1.0,2.0,1.0,2.0,2.0,11.0,11.0,12.0,13.0,12.0,11.0,6.0,10.0,8.0,7.0,12.0,10.0,7.0,13.0,9.0,11.0,8.0,10.0,10.0,12.0,12.0,15.0,12.0,12.0,11.0,12.0,11.0,12.0,12.0,12.0,10.0,6.0,5.0,14.0,12.0,20.0,10.0,9.0,10.0,8.0,2.0,6.0,12.0,11.0,11.0,12.0,13.0,14.0,11.0,13.0,4.0,19.0,0.0,0.0,0.0,0.0,175.0,67.0,3.0,2.0,1.0,3.0,3.0,1.0,1.0,1.0,2.0,1.0,3.0,7.0,8.0,12.0,8.0,10.0,6.0,12.0,9.0,8.0,10.0,10.0,8.0,12.0,11.0,14.0,10.0,12.0,9.0,10.0,11.0,10.0,12.0,12.0,10.0,12.0,12.0,13.0,14.0,13.0,11.0,14.0,8.0,6.0,14.0,12.0,20.0,14.0,12.0,12.0,8.0,11.0,6.0,12.0,17.0,13.0,10.0,11.0,12.0,11.0,17.0,5.0,22.0,24.0,3.0,7.0,0.0,177.0,78.0,2.0,1.0,2.0,3.0,2.0,2.0,4.0,3.0,3.0,2.0,1.0,10.0,13.0,16.0,14.0,16.0,16.0,8.0,16.0,4.0,4.0,15.0,12.0,4.0,16.0,12.0,11.0,12.0,13.0,10.0,11.0,8.0,13.0,17.0,5.0,14.0,5.0,10.0,12.0,15.0,14.0,13.0,9.0,10.0,17.0,16.0,20.0,15.0,14.0,12.0,11.0,15.0,4.0,12.0,19.0,16.0,14.0,14.0,11.0,13.0,10.0,12.0,19.0,0.0,0.0,0.0,0.0,183.0,74.0,3.0,3.0,1.0,2.0,3.0,2.0,1.0,1.0,3.0,1.0,2.0,8.0,9.0,14.0,14.0,12.0,8.0,13.0,12.0,7.0,3.0,9.0,15.0,3.0,14.0,10.0,14.0,8.0,14.0,11.0,10.0,13.0,15.0,14.0,6.0,13.0,7.0,8.0,10.0,16.0,14.0,14.0,11.0,12.0,14.0,15.0,20.0,13.0,15.0,13.0,5.0,13.0,7.0,5.0,10.0,15.0,8.0,13.0,13.0,11.0,12.0,11.0,18.0,0.0,0.0,0.0,0.0,184.0,71.0,2.0,3.0,2.0,3.0,1.0,2.0,1.0,3.0,2.0,1.0,3.0,8.0,10.0,14.0,10.0,12.0,8.0,5.0,10.0,3.0,5.0,12.0,7.0,6.0,13.0,8.0,8.0,8.0,11.0,8.0,11.0,14.0,12.0,10.0,11.0,10.0,9.0,9.0,13.0,14.0,13.0,5.0,10.0,10.0,13.0,14.0,20.0,12.0,8.0,10.0,8.0,10.0,4.0,10.0,11.0,12.0,11.0,12.0,13.0,11.0,13.0,6.0,22.0,0.0,0.0,0.0,0.0,186.0,79.0,14.0,13.0,11.0,7.0,12.0,10.0,13.0,14.0,8.0,6.0,8.0,2.0,1.0,3.0,6.0,8.0,5.0,3.0,11.0,3.0,2.0,8.0,8.0,1.0,8.0,8.0,12.0,14.0,12.0,11.0,7.0,11.0,12.0,6.0,9.0,3.0,12.0,12.0,5.0,8.0,12.0,15.0,15.0,20.0,15.0,7.0,5.0,9.0,15.0,14.0,8.0,5.0,5.0,1.0,10.0,12.0,13.0,12.0,8.0,15.0,15.0,5.0,21.0,0.0,0.0,0.0,0.0,182.0,74.0,2.0,2.0,2.0,2.0,2.0,1.0,1.0,1.0,3.0,2.0,2.0,9.0,11.0,12.0,7.0,9.0,8.0,12.0,7.0,11.0,12.0,7.0,8.0,13.0,11.0,12.0,12.0,14.0,12.0,13.0,7.0,12.0,11.0,1.0,9.0,11.0,9.0,10.0,12.0,14.0,10.0,13.0,11.0,9.0,8.0,12.0,20.0,13.0,11.0,10.0,13.0,8.0,10.0,10.0,15.0,11.0,13.0,10.0,10.0,8.0,13.0,7.0,17.0,0.0,0.0,0.0,0.0,191.0,79.0,1.0,1.0,2.0,3.0,2.0,1.0,1.0,3.0,3.0,3.0,2.0,2.0,1.0,1.0,1.0,4.0,1.0,10.0,5.0,2.0,14.0,6.0,4.0,12.0,1.0,6.0,7.0,5.0,4.0,6.0,1.0,14.0,1.0,1.0,11.0,4.0,14.0,6.0,7.0,6.0,12.0,7.0,11.0,5.0,8.0,8.0,20.0,7.0,11.0,8.0,6.0,7.0,8.0,8.0,14.0,11.0,11.0,14.0,10.0,9.0,12.0,5.0,27.0,10.0,0.0,0.0,0.0,181.0,69.0,1.0,1.0,3.0,3.0,3.0,3.0,2.0,3.0,3.0,3.0,1.0,5.0,13.0,10.0,7.0,13.0,9.0,10.0,10.0,12.0,12.0,11.0,7.0,12.0,11.0,11.0,13.0,12.0,11.0,13.0,9.0,9.0,12.0,8.0,7.0,12.0,11.0,11.0,13.0,15.0,13.0,13.0,10.0,20.0,12.0,15.0,8.0,15.0,12.0,13.0,11.0,14.0,13.0,12.0,10.0,14.0,12.0,10.0,11.0,15.0,15.0,7.0,23.0,0.0,0.0,0.0,0.0,182.0,80.0,2.0,3.0,2.0,2.0,2.0,3.0,4.0,4.0,1.0,2.0,1.0,5.0,7.0,12.0,5.0,13.0,6.0,12.0,6.0,6.0,13.0,11.0,6.0,14.0,11.0,13.0,12.0,13.0,14.0,13.0,9.0,10.0,13.0,7.0,10.0,8.0,10.0,13.0,12.0,14.0,12.0,13.0,10.0,5.0,12.0,13.0,20.0,15.0,14.0,14.0,6.0,10.0,9.0,7.0,9.0,12.0,17.0,13.0,14.0,14.0,14.0,5.0,21.0,0.0,0.0,1.0,0.0,177.0,68.0,4.0,1.0,2.0,1.0,1.0,1.0,1.0,1.0,2.0,1.0,2.0,5.0,12.0,9.0,7.0,12.0,8.0,13.0,10.0,16.0,13.0,12.0,8.0,14.0,12.0,12.0,13.0,12.0,12.0,12.0,10.0,13.0,15.0,11.0,13.0,11.0,13.0,13.0,14.0,13.0,14.0,13.0,11.0,10.0,14.0,12.0,20.0,12.0,14.0,12.0,11.0,12.0,8.0,14.0,13.0,10.0,14.0,12.0,14.0,12.0,11.0,5.0,18.0,0.0,0.0,0.0,0.0,177.0,66.0,2.0,2.0,1.0,2.0,1.0,3.0,3.0,2.0,3.0,2.0,3.0,8.0,6.0,8.0,7.0,12.0,6.0,5.0,9.0,5.0,1.0,10.0,4.0,4.0,12.0,5.0,4.0,6.0,6.0,3.0,13.0,7.0,8.0,12.0,6.0,10.0,6.0,8.0,12.0,15.0,10.0,7.0,7.0,20.0,14.0,11.0,5.0,13.0,5.0,8.0,8.0,7.0,8.0,8.0,13.0,10.0,11.0,11.0,11.0,9.0,18.0,3.0,21.0,0.0,0.0,0.0,0.0,180.0,68.0,4.0,1.0,1.0,1.0,1.0,3.0,1.0,2.0,2.0,2.0,3.0,10.0,10.0,13.0,9.0,13.0,9.0,8.0,8.0,6.0,11.0,13.0,10.0,10.0,12.0,8.0,8.0,8.0,11.0,10.0,13.0,10.0,20.0,13.0,6.0,9.0,9.0,7.0,10.0,14.0,14.0,13.0,10.0,10.0,10.0,14.0,20.0,12.0,11.0,10.0,10.0,7.0,6.0,13.0,17.0,12.0,10.0,12.0,12.0,8.0,10.0,2.0,27.0,1.0,0.0,0.0,0.0,179.0,70.0,3.0,2.0,1.0,3.0,3.0,2.0,1.0,3.0,2.0,1.0,1.0,14.0,15.0,15.0,11.0,15.0,14.0,8.0,12.0,5.0,8.0,13.0,12.0,9.0,18.0,11.0,11.0,11.0,9.0,10.0,16.0,10.0,17.0,15.0,8.0,12.0,8.0,12.0,11.0,14.0,13.0,12.0,10.0,12.0,13.0,14.0,20.0,16.0,12.0,10.0,9.0,10.0,7.0,8.0,13.0,15.0,13.0,10.0,11.0,12.0,10.0,8.0,21.0,0.0,0.0,4.0,1.0,184.0,79.0,1.0,2.0,3.0,1.0,2.0,1.0,3.0,2.0,2.0,1.0,3.0,3.0,6.0,10.0,12.0,12.0,7.0,15.0,8.0,4.0,5.0,13.0,10.0,8.0,12.0,18.0,12.0,19.0,13.0,10.0,13.0,12.0,14.0,13.0,10.0,12.0,9.0,16.0,15.0,12.0,14.0,14.0,14.0,12.0,13.0,10.0,20.0,14.0,14.0,11.0,14.0,14.0,11.0,5.0,10.0,13.0,14.0,15.0,10.0,8.0,4.0,15.0,23.0,15.0,5.0,0.0,0.0,186.0,81.0,3.0,1.0,1.0,4.0,1.0,1.0,2.0,2.0,3.0,3.0,4.0,5.0,10.0,13.0,14.0,10.0,5.0,11.0,13.0,5.0,4.0,9.0,10.0,4.0,10.0,13.0,11.0,14.0,12.0,9.0,8.0,8.0,15.0,13.0,7.0,8.0,7.0,10.0,10.0,15.0,12.0,15.0,12.0,7.0,10.0,18.0,20.0,17.0,15.0,8.0,8.0,11.0,12.0,12.0,12.0,15.0,13.0,12.0,15.0,13.0,13.0,6.0
0,1,22.0,0.0,0.0,0.0,0.0,186.0,79.0,14.0,13.0,11.0,7.0,12.0,10.0,13.0,14.0,8.0,6.0,8.0,2.0,1.0,3.0,6.0,8.0,5.0,3.0,11.0,3.0,2.0,8.0,8.0,1.0,8.0,8.0,12.0,14.0,12.0,11.0,7.0,11.0,12.0,6.0,9.0,3.0,12.0,12.0,5.0,8.0,12.0,15.0,15.0,20.0,15.0,7.0,5.0,9.0,15.0,14.0,8.0,5.0,5.0,1.0,10.0,12.0,13.0,12.0,8.0,15.0,15.0,5.0,21.0,0.0,0.0,0.0,0.0,182.0,74.0,2.0,2.0,2.0,2.0,2.0,1.0,1.0,1.0,3.0,2.0,2.0,9.0,11.0,12.0,7.0,9.0,8.0,12.0,7.0,11.0,12.0,7.0,8.0,13.0,11.0,12.0,12.0,14.0,12.0,13.0,7.0,12.0,11.0,1.0,9.0,11.0,9.0,10.0,12.0,14.0,10.0,13.0,11.0,9.0,8.0,12.0,20.0,13.0,11.0,10.0,13.0,8.0,10.0,10.0,15.0,11.0,13.0,10.0,10.0,8.0,13.0,7.0,27.0,10.0,0.0,0.0,0.0,181.0,69.0,1.0,1.0,3.0,3.0,3.0,3.0,2.0,3.0,3.0,3.0,1.0,5.0,13.0,10.0,7.0,13.0,9.0,10.0,10.0,12.0,12.0,11.0,7.0,12.0,11.0,11.0,13.0,12.0,11.0,13.0,9.0,9.0,12.0,8.0,7.0,12.0,11.0,11.0,13.0,15.0,13.0,13.0,10.0,20.0,12.0,15.0,8.0,15.0,12.0,13.0,11.0,14.0,13.0,12.0,10.0,14.0,12.0,10.0,11.0,15.0,15.0,7.0,21.0,0.0,0.0,1.0,0.0,177.0,68.0,4.0,1.0,2.0,1.0,1.0,1.0,1.0,1.0,2.0,1.0,2.0,5.0,12.0,9.0,7.0,12.0,8.0,13.0,10.0,16.0,13.0,12.0,8.0,14.0,12.0,12.0,13.0,12.0,12.0,12.0,10.0,13.0,15.0,11.0,13.0,11.0,13.0,13.0,14.0,13.0,14.0,13.0,11.0,10.0,14.0,12.0,20.0,12.0,14.0,12.0,11.0,12.0,8.0,14.0,13.0,10.0,14.0,12.0,14.0,12.0,11.0,5.0,23.0,0.0,0.0,0.0,0.0,182.0,80.0,2.0,3.0,2.0,2.0,2.0,3.0,4.0,4.0,1.0,2.0,1.0,5.0,7.0,12.0,5.0,13.0,6.0,12.0,6.0,6.0,13.0,11.0,6.0,14.0,11.0,13.0,12.0,13.0,14.0,13.0,9.0,10.0,13.0,7.0,10.0,8.0,10.0,13.0,12.0,14.0,12.0,13.0,10.0,5.0,12.0,13.0,20.0,15.0,14.0,14.0,6.0,10.0,9.0,7.0,9.0,12.0,17.0,13.0,14.0,14.0,14.0,5.0,18.0,0.0,0.0,0.0,0.0,177.0,66.0,2.0,2.0,1.0,2.0,1.0,3.0,3.0,2.0,3.0,2.0,3.0,8.0,6.0,8.0,7.0,12.0,6.0,5.0,9.0,5.0,1.0,10.0,4.0,4.0,12.0,5.0,4.0,6.0,6.0,3.0,13.0,7.0,8.0,12.0,6.0,10.0,6.0,8.0,12.0,15.0,10.0,7.0,7.0,20.0,14.0,11.0,5.0,13.0,5.0,8.0,8.0,7.0,8.0,8.0,13.0,10.0,11.0,11.0,11.0,9.0,18.0,3.0,27.0,1.0,0.0,0.0,0.0,179.0,70.0,3.0,2.0,1.0,3.0,3.0,2.0,1.0,3.0,2.0,1.0,1.0,14.0,15.0,15.0,11.0,15.0,14.0,8.0,12.0,5.0,8.0,13.0,12.0,9.0,18.0,11.0,11.0,11.0,9.0,10.0,16.0,10.0,17.0,15.0,8.0,12.0,8.0,12.0,11.0,14.0,13.0,12.0,10.0,12.0,13.0,14.0,20.0,16.0,12.0,10.0,9.0,10.0,7.0,8.0,13.0,15.0,13.0,10.0,11.0,12.0,10.0,8.0,17.0,0.0,0.0,0.0,0.0,187.0,77.0,3.0,4.0,1.0,2.0,2.0,3.0,1.0,1.0,2.0,1.0,2.0,5.0,1.0,13.0,13.0,9.0,5.0,13.0,2.0,1.0,1.0,6.0,9.0,1.0,10.0,8.0,7.0,3.0,10.0,2.0,3.0,10.0,7.0,10.0,2.0,13.0,3.0,5.0,6.0,13.0,8.0,6.0,11.0,5.0,8.0,10.0,20.0,5.0,10.0,8.0,8.0,7.0,5.0,7.0,9.0,11.0,11.0,10.0,11.0,8.0,16.0,3.0,27.0,0.0,0.0,0.0,0.0,191.0,83.0,1.0,1.0,3.0,2.0,1.0,1.0,1.0,1.0,2.0,3.0,1.0,5.0,9.0,11.0,12.0,11.0,7.0,13.0,9.0,5.0,4.0,9.0,3.0,3.0,10.0,10.0,12.0,14.0,10.0,10.0,7.0,11.0,12.0,10.0,6.0,13.0,5.0,13.0,14.0,12.0,11.0,14.0,16.0,5.0,12.0,11.0,20.0,13.0,15.0,12.0,12.0,8.0,7.0,10.0,13.0,11.0,13.0,12.0,12.0,13.0,12.0,8.0,23.0,15.0,5.0,0.0,0.0,186.0,81.0,3.0,1.0,1.0,4.0,1.0,1.0,2.0,2.0,3.0,3.0,4.0,5.0,10.0,13.0,14.0,10.0,5.0,11.0,13.0,5.0,4.0,9.0,10.0,4.0,10.0,13.0,11.0,14.0,12.0,9.0,8.0,8.0,15.0,13.0,7.0,8.0,7.0,10.0,10.0,15.0,12.0,15.0,12.0,7.0,10.0,18.0,20.0,17.0,15.0,8.0,8.0,11.0,12.0,12.0,12.0,15.0,13.0,12.0,15.0,13.0,13.0,6.0,21.0,0.0,0.0,4.0,1.0,184.0,79.0,1.0,2.0,3.0,1.0,2.0,1.0,3.0,2.0,2.0,1.0,3.0,3.0,6.0,10.0,12.0,12.0,7.0,15.0,8.0,4.0,5.0,13.0,10.0,8.0,12.0,18.0,12.0,19.0,13.0,10.0,13.0,12.0,14.0,13.0,10.0,12.0,9.0,16.0,15.0,12.0,14.0,14.0,14.0,12.0,13.0,10.0,20.0,14.0,14.0,11.0,14.0,14.0,11.0,5.0,10.0,13.0,14.0,15.0,10.0,8.0,4.0,15.0,17.0,0.0,0.0,0.0,0.0,181.0,72.0,9.0,8.0,7.0,5.0,8.0,11.0,10.0,14.0,5.0,9.0,10.0,3.0,1.0,2.0,2.0,4.0,5.0,1.0,1.0,1.0,1.0,3.0,3.0,3.0,3.0,1.0,9.0,11.0,5.0,10.0,8.0,15.0,18.0,1.0,4.0,2.0,10.0,9.0,8.0,15.0,15.0,9.0,12.0,5.0,9.0,12.0,20.0,5.0,8.0,9.0,3.0,9.0,9.0,6.0,10.0,13.0,14.0,9.0,10.0,13.0,17.0,8.0,34.0,0.0,0.0,0.0,0.0,191.0,81.0,14.0,10.0,8.0,3.0,9.0,14.0,13.0,10.0,9.0,3.0,12.0,4.0,3.0,3.0,1.0,1.0,6.0,1.0,1.0,2.0,1.0,2.0,3.0,3.0,3.0,8.0,6.0,10.0,8.0,9.0,5.0,10.0,2.0,1.0,10.0,2.0,10.0,8.0,7.0,10.0,8.0,8.0,16.0,9.0,14.0,9.0,20.0,3.0,9.0,9.0,9.0,1.0,9.0,9.0,20.0,9.0,13.0,12.0,10.0,10.0,12.0,7.0,17.0,0.0,0.0,0.0,0.0,178.0,70.0,2.0,2.0,2.0,2.0,3.0,2.0,3.0,2.0,4.0,2.0,3.0,7.0,7.0,1.0,3.0,10.0,5.0,14.0,5.0,3.0,9.0,12.0,2.0,13.0,8.0,9.0,13.0,10.0,7.0,10.0,3.0,12.0,2.0,2.0,14.0,4.0,14.0,8.0,9.0,12.0,11.0,9.0,11.0,8.0,5.0,13.0,20.0,12.0,13.0,10.0,10.0,14.0,7.0,10.0,19.0,11.0,9.0,14.0,11.0,13.0,10.0,5.0,20.0,0.0,0.0,6.0,0.0,188.0,79.0,2.0,3.0,2.0,1.0,1.0,3.0,2.0,1.0,2.0,2.0,1.0,4.0,4.0,11.0,6.0,11.0,8.0,13.0,8.0,9.0,13.0,12.0,9.0,13.0,11.0,14.0,13.0,15.0,14.0,13.0,8.0,12.0,14.0,9.0,11.0,10.0,12.0,12.0,13.0,11.0,11.0,11.0,13.0,8.0,12.0,13.0,20.0,13.0,12.0,13.0,14.0,13.0,10.0,11.0,11.0,13.0,12.0,14.0,14.0,15.0,10.0,7.0,20.0,0.0,0.0,0.0,0.0,168.0,67.0,3.0,3.0,3.0,1.0,1.0,3.0,1.0,2.0,1.0,2.0,3.0,7.0,10.0,9.0,8.0,11.0,6.0,9.0,8.0,13.0,12.0,10.0,7.0,14.0,9.0,16.0,12.0,15.0,9.0,16.0,7.0,11.0,17.0,9.0,10.0,11.0,12.0,14.0,15.0,13.0,10.0,12.0,6.0,6.0,16.0,11.0,20.0,14.0,9.0,17.0,12.0,15.0,5.0,18.0,7.0,12.0,16.0,13.0,18.0,14.0,15.0,5.0,23.0,0.0,0.0,0.0,0.0,174.0,64.0,4.0,3.0,1.0,1.0,3.0,3.0,2.0,3.0,3.0,2.0,3.0,8.0,12.0,10.0,8.0,11.0,7.0,10.0,9.0,12.0,14.0,9.0,10.0,13.0,12.0,12.0,12.0,12.0,11.0,12.0,10.0,12.0,13.0,8.0,9.0,12.0,11.0,13.0,14.0,15.0,14.0,11.0,10.0,10.0,14.0,14.0,20.0,15.0,10.0,14.0,12.0,12.0,8.0,13.0,10.0,12.0,15.0,12.0,13.0,10.0,17.0,6.0,28.0,0.0,0.0,0.0,0.0,172.0,68.0,4.0,4.0,2.0,1.0,3.0,2.0,2.0,1.0,3.0,3.0,1.0,6.0,5.0,10.0,7.0,14.0,8.0,8.0,8.0,5.0,9.0,11.0,6.0,6.0,12.0,10.0,11.0,8.0,10.0,8.0,12.0,14.0,9.0,11.0,6.0,12.0,9.0,9.0,13.0,11.0,12.0,9.0,6.0,10.0,13.0,11.0,20.0,10.0,6.0,10.0,4.0,6.0,10.0,10.0,12.0,12.0,13.0,10.0,11.0,7.0,13.0,1.0,26.0,0.0,0.0,0.0,0.0,184.0,76.0,3.0,1.0,3.0,1.0,3.0,2.0,3.0,2.0,1.0,1.0,3.0,10.0,11.0,13.0,9.0,13.0,12.0,13.0,10.0,6.0,11.0,13.0,9.0,14.0,12.0,12.0,13.0,12.0,12.0,11.0,13.0,12.0,13.0,13.0,10.0,12.0,13.0,12.0,16.0,15.0,13.0,15.0,13.0,20.0,15.0,14.0,5.0,16.0,15.0,13.0,12.0,14.0,5.0,12.0,18.0,14.0,10.0,7.0,11.0,11.0,13.0,10.0,34.0,103.0,7.0,16.0,1.0,182.0,72.0,2.0,1.0,1.0,1.0,3.0,1.0,4.0,3.0,3.0,2.0,1.0,11.0,13.0,12.0,8.0,15.0,13.0,9.0,13.0,6.0,8.0,15.0,12.0,8.0,15.0,11.0,14.0,13.0,15.0,15.0,14.0,16.0,17.0,15.0,14.0,11.0,13.0,17.0,13.0,8.0,11.0,10.0,11.0,16.0,13.0,8.0,20.0,12.0,10.0,15.0,11.0,12.0,12.0,15.0,14.0,12.0,15.0,15.0,18.0,14.0,14.0,7.0,20.0,7.0,1.0,0.0,0.0,182.0,75.0,2.0,1.0,3.0,2.0,2.0,1.0,3.0,1.0,3.0,2.0,1.0,11.0,11.0,13.0,12.0,13.0,11.0,12.0,10.0,5.0,4.0,12.0,8.0,5.0,13.0,11.0,12.0,11.0,11.0,8.0,10.0,10.0,3.0,10.0,1.0,13.0,8.0,12.0,12.0,15.0,14.0,13.0,11.0,6.0,14.0,13.0,20.0,12.0,13.0,12.0,9.0,11.0,9.0,11.0,9.0,9.0,9.0,12.0,11.0,9.0,17.0,7.0,30.0,5.0,0.0,22.0,9.0,181.0,84.0,2.0,3.0,3.0,1.0,2.0,3.0,3.0,1.0,3.0,1.0,3.0,7.0,10.0,12.0,13.0,11.0,7.0,13.0,10.0,12.0,6.0,11.0,13.0,6.0,13.0,17.0,13.0,16.0,11.0,13.0,11.0,11.0,17.0,14.0,8.0,14.0,9.0,13.0,17.0,15.0,12.0,15.0,11.0,8.0,14.0,15.0,20.0,14.0,14.0,13.0,9.0,13.0,7.0,10.0,7.0,16.0,13.0,14.0,13.0,15.0,15.0,10.0
2,3,19.0,0.0,0.0,0.0,0.0,190.0,78.0,13.0,12.0,11.0,14.0,13.0,6.0,11.0,13.0,13.0,12.0,7.0,3.0,3.0,1.0,3.0,8.0,8.0,3.0,1.0,2.0,3.0,7.0,3.0,1.0,7.0,8.0,13.0,13.0,12.0,13.0,7.0,11.0,11.0,3.0,14.0,2.0,11.0,11.0,10.0,12.0,13.0,11.0,15.0,20.0,10.0,13.0,5.0,13.0,13.0,9.0,10.0,6.0,10.0,10.0,10.0,12.0,11.0,14.0,14.0,12.0,13.0,3.0,21.0,0.0,0.0,0.0,0.0,185.0,79.0,3.0,4.0,3.0,1.0,3.0,1.0,2.0,1.0,1.0,1.0,1.0,7.0,9.0,7.0,8.0,12.0,7.0,13.0,8.0,8.0,13.0,12.0,8.0,13.0,10.0,14.0,11.0,13.0,10.0,12.0,11.0,10.0,14.0,10.0,7.0,8.0,13.0,11.0,10.0,12.0,11.0,13.0,13.0,6.0,13.0,11.0,20.0,13.0,15.0,12.0,12.0,10.0,5.0,14.0,17.0,12.0,13.0,10.0,12.0,12.0,12.0,4.0,17.0,0.0,0.0,0.0,0.0,170.0,74.0,3.0,3.0,2.0,1.0,3.0,3.0,2.0,3.0,1.0,3.0,4.0,8.0,13.0,11.0,10.0,9.0,10.0,6.0,7.0,6.0,10.0,9.0,4.0,11.0,12.0,9.0,10.0,10.0,10.0,12.0,12.0,8.0,10.0,8.0,2.0,10.0,11.0,11.0,11.0,13.0,16.0,11.0,7.0,20.0,15.0,15.0,6.0,12.0,13.0,12.0,3.0,6.0,10.0,14.0,12.0,16.0,11.0,11.0,12.0,12.0,17.0,8.0,22.0,0.0,0.0,0.0,0.0,182.0,71.0,3.0,2.0,1.0,1.0,3.0,1.0,3.0,2.0,3.0,2.0,1.0,8.0,9.0,11.0,7.0,11.0,7.0,12.0,12.0,12.0,10.0,12.0,5.0,11.0,8.0,13.0,11.0,13.0,8.0,11.0,8.0,11.0,15.0,11.0,7.0,6.0,11.0,13.0,13.0,13.0,12.0,13.0,10.0,5.0,15.0,13.0,20.0,14.0,12.0,10.0,6.0,10.0,5.0,10.0,9.0,11.0,11.0,14.0,10.0,11.0,11.0,1.0,19.0,0.0,0.0,0.0,0.0,179.0,70.0,2.0,1.0,2.0,4.0,3.0,1.0,3.0,3.0,4.0,2.0,3.0,8.0,10.0,8.0,7.0,12.0,6.0,11.0,6.0,5.0,12.0,10.0,8.0,13.0,10.0,12.0,12.0,12.0,11.0,11.0,7.0,12.0,10.0,7.0,9.0,10.0,10.0,10.0,12.0,12.0,12.0,13.0,10.0,20.0,10.0,13.0,10.0,12.0,14.0,14.0,10.0,3.0,7.0,10.0,13.0,10.0,9.0,10.0,8.0,9.0,15.0,7.0,24.0,0.0,0.0,6.0,1.0,172.0,70.0,3.0,1.0,1.0,3.0,1.0,2.0,3.0,1.0,1.0,3.0,3.0,11.0,12.0,11.0,8.0,12.0,10.0,6.0,14.0,7.0,11.0,15.0,8.0,12.0,13.0,14.0,14.0,18.0,13.0,12.0,13.0,13.0,15.0,12.0,12.0,12.0,11.0,18.0,18.0,13.0,14.0,13.0,7.0,10.0,16.0,12.0,20.0,14.0,12.0,14.0,14.0,15.0,4.0,8.0,7.0,14.0,14.0,13.0,14.0,12.0,10.0,6.0,20.0,0.0,0.0,0.0,0.0,180.0,73.0,4.0,1.0,1.0,1.0,2.0,1.0,3.0,1.0,1.0,1.0,3.0,9.0,11.0,12.0,10.0,12.0,7.0,11.0,10.0,8.0,6.0,10.0,11.0,5.0,10.0,9.0,8.0,9.0,10.0,8.0,10.0,11.0,9.0,7.0,1.0,10.0,7.0,7.0,10.0,13.0,9.0,13.0,10.0,5.0,6.0,13.0,20.0,9.0,11.0,9.0,9.0,9.0,9.0,9.0,13.0,8.0,12.0,12.0,12.0,11.0,13.0,1.0,24.0,0.0,0.0,0.0,0.0,172.0,69.0,3.0,4.0,1.0,4.0,1.0,2.0,1.0,2.0,2.0,3.0,3.0,10.0,12.0,13.0,7.0,13.0,13.0,7.0,11.0,6.0,2.0,12.0,10.0,4.0,15.0,12.0,11.0,12.0,9.0,10.0,13.0,11.0,3.0,15.0,6.0,13.0,5.0,10.0,13.0,14.0,15.0,11.0,7.0,5.0,14.0,14.0,20.0,13.0,10.0,13.0,12.0,13.0,8.0,10.0,9.0,11.0,10.0,11.0,9.0,11.0,10.0,3.0,21.0,0.0,0.0,0.0,0.0,179.0,75.0,3.0,3.0,2.0,2.0,1.0,3.0,3.0,3.0,1.0,1.0,1.0,5.0,9.0,13.0,11.0,11.0,8.0,10.0,11.0,5.0,2.0,9.0,12.0,2.0,12.0,7.0,11.0,12.0,10.0,9.0,10.0,10.0,13.0,12.0,5.0,13.0,7.0,7.0,11.0,14.0,13.0,13.0,9.0,6.0,12.0,15.0,20.0,13.0,14.0,11.0,10.0,10.0,5.0,10.0,16.0,11.0,10.0,12.0,9.0,13.0,13.0,9.0,21.0,0.0,0.0,0.0,0.0,180.0,71.0,1.0,2.0,1.0,3.0,3.0,3.0,2.0,2.0,2.0,2.0,3.0,10.0,10.0,11.0,10.0,12.0,10.0,8.0,10.0,8.0,8.0,12.0,5.0,6.0,12.0,4.0,11.0,8.0,10.0,9.0,11.0,10.0,10.0,13.0,8.0,12.0,7.0,11.0,12.0,13.0,12.0,10.0,10.0,5.0,12.0,12.0,20.0,11.0,10.0,10.0,10.0,5.0,10.0,12.0,7.0,10.0,14.0,12.0,9.0,10.0,16.0,7.0,23.0,0.0,0.0,0.0,0.0,181.0,73.0,2.0,1.0,2.0,1.0,3.0,3.0,2.0,2.0,4.0,2.0,1.0,5.0,12.0,14.0,13.0,13.0,7.0,12.0,8.0,4.0,5.0,9.0,12.0,5.0,13.0,11.0,11.0,12.0,13.0,11.0,8.0,12.0,14.0,11.0,6.0,13.0,7.0,12.0,13.0,12.0,14.0,13.0,10.0,8.0,14.0,11.0,20.0,13.0,12.0,13.0,5.0,10.0,7.0,14.0,12.0,11.0,14.0,10.0,11.0,10.0,15.0,4.0,25.0,0.0,0.0,3.0,0.0,187.0,83.0,15.0,9.0,12.0,8.0,13.0,11.0,12.0,14.0,7.0,12.0,8.0,4.0,2.0,3.0,2.0,9.0,9.0,6.0,2.0,2.0,1.0,9.0,2.0,1.0,9.0,8.0,13.0,15.0,12.0,10.0,7.0,9.0,15.0,5.0,9.0,3.0,12.0,13.0,8.0,12.0,12.0,15.0,14.0,20.0,13.0,9.0,5.0,14.0,14.0,12.0,8.0,10.0,7.0,1.0,14.0,11.0,16.0,11.0,14.0,14.0,14.0,6.0,32.0,0.0,0.0,0.0,0.0,172.0,71.0,2.0,1.0,3.0,1.0,2.0,3.0,2.0,3.0,2.0,2.0,2.0,8.0,9.0,7.0,6.0,10.0,6.0,10.0,9.0,10.0,14.0,11.0,6.0,14.0,11.0,10.0,16.0,15.0,12.0,12.0,7.0,12.0,15.0,9.0,13.0,8.0,14.0,15.0,15.0,14.0,14.0,14.0,10.0,20.0,14.0,14.0,8.0,15.0,13.0,13.0,11.0,13.0,7.0,13.0,17.0,14.0,17.0,8.0,13.0,15.0,15.0,6.0,27.0,0.0,0.0,0.0,0.0,184.0,81.0,1.0,1.0,1.0,3.0,3.0,2.0,2.0,2.0,1.0,2.0,3.0,8.0,6.0,8.0,12.0,10.0,8.0,12.0,9.0,1.0,3.0,8.0,14.0,4.0,9.0,4.0,11.0,12.0,11.0,8.0,8.0,11.0,10.0,9.0,8.0,11.0,9.0,8.0,11.0,10.0,8.0,13.0,13.0,9.0,13.0,9.0,20.0,12.0,13.0,13.0,9.0,2.0,9.0,9.0,15.0,10.0,12.0,10.0,11.0,6.0,4.0,6.0,19.0,0.0,0.0,3.0,1.0,181.0,69.0,3.0,2.0,3.0,3.0,2.0,1.0,1.0,1.0,3.0,3.0,4.0,10.0,10.0,12.0,12.0,12.0,7.0,8.0,11.0,5.0,7.0,10.0,10.0,7.0,11.0,8.0,10.0,10.0,12.0,8.0,11.0,8.0,14.0,13.0,6.0,14.0,8.0,13.0,13.0,16.0,14.0,13.0,9.0,20.0,15.0,16.0,10.0,15.0,13.0,12.0,8.0,11.0,7.0,12.0,11.0,11.0,15.0,10.0,12.0,14.0,14.0,1.0,21.0,0.0,0.0,0.0,0.0,178.0,65.0,2.0,3.0,3.0,3.0,3.0,1.0,1.0,1.0,1.0,3.0,1.0,9.0,13.0,11.0,6.0,12.0,7.0,9.0,8.0,8.0,13.0,12.0,7.0,13.0,12.0,8.0,12.0,13.0,12.0,12.0,13.0,13.0,14.0,9.0,8.0,12.0,12.0,13.0,13.0,12.0,14.0,13.0,11.0,8.0,15.0,12.0,20.0,13.0,12.0,14.0,8.0,11.0,7.0,10.0,19.0,10.0,13.0,10.0,11.0,15.0,15.0,6.0,21.0,0.0,0.0,0.0,0.0,179.0,68.0,2.0,3.0,2.0,1.0,2.0,1.0,2.0,3.0,2.0,1.0,1.0,6.0,13.0,12.0,6.0,13.0,6.0,8.0,7.0,12.0,10.0,12.0,8.0,12.0,13.0,10.0,11.0,11.0,12.0,10.0,11.0,11.0,12.0,11.0,7.0,13.0,10.0,12.0,14.0,15.0,13.0,12.0,10.0,20.0,14.0,14.0,8.0,14.0,10.0,13.0,8.0,13.0,8.0,12.0,13.0,14.0,10.0,12.0,10.0,10.0,12.0,10.0,18.0,0.0,0.0,0.0,0.0,170.0,67.0,3.0,1.0,3.0,3.0,3.0,4.0,1.0,2.0,1.0,2.0,2.0,11.0,11.0,12.0,13.0,12.0,11.0,6.0,10.0,8.0,7.0,12.0,10.0,7.0,13.0,9.0,11.0,8.0,10.0,10.0,12.0,12.0,15.0,12.0,12.0,11.0,12.0,11.0,12.0,12.0,12.0,10.0,6.0,5.0,14.0,12.0,20.0,10.0,9.0,10.0,8.0,2.0,6.0,12.0,11.0,11.0,12.0,13.0,14.0,11.0,13.0,4.0,19.0,0.0,0.0,0.0,0.0,175.0,67.0,3.0,2.0,1.0,3.0,3.0,1.0,1.0,1.0,2.0,1.0,3.0,7.0,8.0,12.0,8.0,10.0,6.0,12.0,9.0,8.0,10.0,10.0,8.0,12.0,11.0,14.0,10.0,12.0,9.0,10.0,11.0,10.0,12.0,12.0,10.0,12.0,12.0,13.0,14.0,13.0,11.0,14.0,8.0,6.0,14.0,12.0,20.0,14.0,12.0,12.0,8.0,11.0,6.0,12.0,17.0,13.0,10.0,11.0,12.0,11.0,17.0,5.0,19.0,0.0,0.0,0.0,0.0,183.0,74.0,3.0,3.0,1.0,2.0,3.0,2.0,1.0,1.0,3.0,1.0,2.0,8.0,9.0,14.0,14.0,12.0,8.0,13.0,12.0,7.0,3.0,9.0,15.0,3.0,14.0,10.0,14.0,8.0,14.0,11.0,10.0,13.0,15.0,14.0,6.0,13.0,7.0,8.0,10.0,16.0,14.0,14.0,11.0,12.0,14.0,15.0,20.0,13.0,15.0,13.0,5.0,13.0,7.0,5.0,10.0,15.0,8.0,13.0,13.0,11.0,12.0,11.0,18.0,0.0,0.0,0.0,0.0,184.0,71.0,2.0,3.0,2.0,3.0,1.0,2.0,1.0,3.0,2.0,1.0,3.0,8.0,10.0,14.0,10.0,12.0,8.0,5.0,10.0,3.0,5.0,12.0,7.0,6.0,13.0,8.0,8.0,8.0,11.0,8.0,11.0,14.0,12.0,10.0,11.0,10.0,9.0,9.0,13.0,14.0,13.0,5.0,10.0,10.0,13.0,14.0,20.0,12.0,8.0,10.0,8.0,10.0,4.0,10.0,11.0,12.0,11.0,12.0,13.0,11.0,13.0,6.0,22.0,24.0,3.0,7.0,0.0,177.0,78.0,2.0,1.0,2.0,3.0,2.0,2.0,4.0,3.0,3.0,2.0,1.0,10.0,13.0,16.0,14.0,16.0,16.0,8.0,16.0,4.0,4.0,15.0,12.0,4.0,16.0,12.0,11.0,12.0,13.0,10.0,11.0,8.0,13.0,17.0,5.0,14.0,5.0,10.0,12.0,15.0,14.0,13.0,9.0,10.0,17.0,16.0,20.0,15.0,14.0,12.0,11.0,15.0,4.0,12.0,19.0,16.0,14.0,14.0,11.0,13.0,10.0,12.0
3,1,24.0,0.0,0.0,0.0,0.0,197.0,86.0,15.0,9.0,12.0,14.0,13.0,12.0,10.0,13.0,11.0,7.0,8.0,2.0,3.0,3.0,3.0,8.0,7.0,1.0,3.0,1.0,2.0,12.0,2.0,2.0,8.0,10.0,12.0,10.0,14.0,12.0,10.0,10.0,10.0,3.0,8.0,1.0,11.0,10.0,6.0,12.0,13.0,10.0,16.0,5.0,13.0,11.0,20.0,9.0,10.0,10.0,10.0,10.0,7.0,10.0,9.0,11.0,11.0,9.0,12.0,13.0,10.0,8.0,18.0,0.0,0.0,0.0,0.0,190.0,86.0,3.0,3.0,2.0,1.0,1.0,2.0,3.0,2.0,3.0,1.0,2.0,3.0,3.0,2.0,2.0,8.0,1.0,12.0,1.0,1.0,13.0,8.0,5.0,11.0,5.0,10.0,7.0,10.0,5.0,9.0,7.0,13.0,6.0,1.0,8.0,5.0,13.0,7.0,8.0,13.0,13.0,8.0,12.0,5.0,13.0,13.0,20.0,7.0,9.0,10.0,9.0,10.0,10.0,10.0,7.0,10.0,9.0,12.0,12.0,11.0,18.0,8.0,28.0,0.0,0.0,0.0,0.0,190.0,83.0,1.0,1.0,3.0,2.0,1.0,1.0,3.0,3.0,1.0,2.0,1.0,2.0,9.0,5.0,6.0,10.0,5.0,13.0,7.0,4.0,12.0,9.0,7.0,10.0,11.0,13.0,14.0,15.0,13.0,11.0,8.0,11.0,13.0,8.0,12.0,7.0,12.0,12.0,12.0,11.0,11.0,15.0,15.0,20.0,15.0,11.0,5.0,13.0,16.0,15.0,13.0,11.0,7.0,5.0,12.0,12.0,14.0,12.0,15.0,13.0,12.0,6.0,22.0,0.0,0.0,0.0,0.0,168.0,67.0,1.0,1.0,3.0,3.0,3.0,3.0,3.0,2.0,3.0,3.0,3.0,9.0,10.0,12.0,10.0,12.0,10.0,5.0,12.0,6.0,10.0,12.0,8.0,9.0,13.0,11.0,11.0,13.0,11.0,10.0,12.0,12.0,11.0,12.0,5.0,11.0,8.0,10.0,13.0,14.0,14.0,10.0,6.0,20.0,12.0,13.0,6.0,11.0,8.0,12.0,10.0,4.0,5.0,10.0,16.0,11.0,11.0,8.0,12.0,10.0,14.0,6.0,22.0,20.0,0.0,9.0,1.0,179.0,70.0,2.0,2.0,3.0,1.0,2.0,1.0,3.0,2.0,1.0,3.0,1.0,7.0,15.0,13.0,7.0,11.0,5.0,10.0,8.0,14.0,13.0,10.0,9.0,16.0,12.0,17.0,15.0,15.0,9.0,13.0,9.0,10.0,15.0,13.0,8.0,12.0,10.0,12.0,17.0,16.0,14.0,14.0,11.0,20.0,17.0,16.0,10.0,15.0,12.0,15.0,10.0,16.0,4.0,11.0,14.0,16.0,9.0,14.0,12.0,9.0,10.0,10.0,32.0,55.0,0.0,0.0,0.0,180.0,74.0,1.0,3.0,3.0,2.0,1.0,2.0,2.0,1.0,3.0,3.0,1.0,6.0,8.0,8.0,6.0,11.0,10.0,12.0,10.0,6.0,13.0,11.0,7.0,15.0,11.0,14.0,14.0,17.0,12.0,14.0,10.0,13.0,16.0,8.0,12.0,8.0,14.0,16.0,18.0,12.0,13.0,13.0,10.0,8.0,16.0,14.0,20.0,18.0,13.0,16.0,15.0,14.0,5.0,10.0,9.0,15.0,13.0,15.0,14.0,11.0,10.0,7.0,25.0,0.0,0.0,0.0,0.0,174.0,73.0,1.0,1.0,3.0,2.0,1.0,1.0,1.0,2.0,3.0,3.0,3.0,11.0,12.0,12.0,6.0,13.0,11.0,7.0,11.0,10.0,9.0,13.0,9.0,10.0,14.0,11.0,13.0,13.0,12.0,11.0,15.0,11.0,14.0,13.0,7.0,11.0,12.0,15.0,16.0,12.0,14.0,12.0,8.0,20.0,14.0,13.0,7.0,12.0,11.0,12.0,11.0,13.0,9.0,12.0,8.0,13.0,13.0,12.0,15.0,15.0,15.0,6.0,25.0,0.0,0.0,0.0,0.0,177.0,66.0,2.0,3.0,1.0,3.0,2.0,3.0,4.0,1.0,4.0,3.0,1.0,11.0,11.0,11.0,7.0,13.0,11.0,8.0,10.0,7.0,4.0,12.0,11.0,6.0,12.0,8.0,12.0,11.0,12.0,12.0,12.0,9.0,13.0,11.0,7.0,11.0,9.0,14.0,13.0,11.0,13.0,12.0,9.0,20.0,14.0,10.0,8.0,16.0,9.0,13.0,8.0,2.0,6.0,10.0,9.0,11.0,15.0,12.0,14.0,14.0,14.0,6.0,19.0,0.0,0.0,0.0,0.0,175.0,60.0,4.0,2.0,2.0,1.0,1.0,2.0,3.0,2.0,3.0,3.0,1.0,10.0,11.0,15.0,12.0,14.0,6.0,4.0,13.0,10.0,10.0,12.0,9.0,11.0,14.0,8.0,10.0,10.0,14.0,11.0,12.0,15.0,4.0,11.0,7.0,8.0,10.0,11.0,12.0,12.0,12.0,11.0,8.0,5.0,9.0,10.0,20.0,9.0,8.0,10.0,10.0,7.0,10.0,10.0,14.0,12.0,10.0,11.0,14.0,10.0,11.0,2.0,21.0,2.0,1.0,0.0,0.0,173.0,68.0,4.0,1.0,1.0,3.0,1.0,3.0,1.0,1.0,1.0,1.0,1.0,8.0,12.0,11.0,11.0,12.0,8.0,5.0,6.0,4.0,5.0,12.0,9.0,7.0,12.0,13.0,10.0,10.0,9.0,13.0,13.0,11.0,10.0,13.0,6.0,12.0,8.0,10.0,13.0,14.0,14.0,14.0,7.0,13.0,12.0,13.0,20.0,11.0,7.0,13.0,6.0,12.0,6.0,9.0,11.0,12.0,9.0,7.0,10.0,11.0,13.0,7.0,19.0,0.0,0.0,0.0,0.0,185.0,79.0,2.0,3.0,3.0,1.0,2.0,1.0,2.0,3.0,3.0,3.0,2.0,11.0,11.0,11.0,12.0,11.0,10.0,12.0,12.0,5.0,6.0,11.0,12.0,6.0,12.0,15.0,12.0,13.0,11.0,10.0,12.0,11.0,10.0,13.0,12.0,12.0,8.0,10.0,12.0,10.0,13.0,12.0,12.0,20.0,10.0,9.0,10.0,10.0,7.0,10.0,12.0,10.0,5.0,9.0,11.0,12.0,13.0,10.0,13.0,14.0,18.0,3.0,38.0,161.0,0.0,11.0,0.0,192.0,91.0,14.0,20.0,20.0,16.0,14.0,12.0,17.0,19.0,18.0,16.0,13.0,1.0,1.0,1.0,1.0,9.0,1.0,1.0,1.0,1.0,1.0,8.0,4.0,1.0,8.0,5.0,17.0,17.0,17.0,16.0,7.0,17.0,18.0,12.0,20.0,1.0,20.0,6.0,10.0,8.0,14.0,14.0,14.0,7.0,12.0,8.0,20.0,10.0,15.0,19.0,5.0,17.0,12.0,1.0,12.0,16.0,20.0,18.0,16.0,15.0,14.0,4.0,29.0,0.0,0.0,0.0,0.0,170.0,65.0,2.0,1.0,3.0,3.0,1.0,3.0,2.0,1.0,2.0,3.0,2.0,5.0,11.0,4.0,6.0,7.0,4.0,7.0,5.0,6.0,6.0,6.0,2.0,6.0,7.0,9.0,10.0,13.0,8.0,12.0,8.0,13.0,15.0,2.0,7.0,5.0,9.0,8.0,8.0,12.0,12.0,14.0,4.0,9.0,12.0,11.0,20.0,12.0,5.0,9.0,9.0,9.0,9.0,9.0,10.0,12.0,12.0,12.0,12.0,7.0,5.0,8.0,19.0,0.0,0.0,0.0,0.0,185.0,73.0,1.0,1.0,4.0,3.0,3.0,4.0,3.0,2.0,2.0,1.0,1.0,6.0,9.0,10.0,6.0,12.0,5.0,14.0,7.0,10.0,12.0,13.0,7.0,15.0,13.0,11.0,14.0,13.0,15.0,8.0,12.0,10.0,10.0,9.0,11.0,7.0,11.0,14.0,9.0,13.0,12.0,14.0,14.0,12.0,16.0,17.0,20.0,13.0,11.0,11.0,9.0,14.0,5.0,17.0,10.0,17.0,5.0,12.0,9.0,14.0,12.0,15.0,23.0,2.0,0.0,5.0,3.0,182.0,73.0,3.0,1.0,1.0,1.0,2.0,1.0,2.0,1.0,3.0,4.0,2.0,12.0,14.0,14.0,10.0,13.0,12.0,16.0,11.0,13.0,12.0,13.0,13.0,14.0,14.0,12.0,11.0,14.0,13.0,11.0,13.0,11.0,15.0,15.0,9.0,15.0,10.0,14.0,15.0,16.0,15.0,13.0,13.0,20.0,14.0,15.0,6.0,15.0,12.0,13.0,9.0,13.0,14.0,15.0,17.0,15.0,13.0,12.0,12.0,15.0,13.0,9.0,24.0,9.0,0.0,7.0,1.0,190.0,82.0,2.0,2.0,3.0,3.0,1.0,2.0,2.0,1.0,1.0,3.0,1.0,8.0,14.0,13.0,11.0,12.0,10.0,12.0,11.0,9.0,11.0,13.0,8.0,13.0,13.0,10.0,14.0,14.0,13.0,13.0,14.0,14.0,16.0,11.0,6.0,12.0,12.0,16.0,16.0,12.0,11.0,11.0,14.0,8.0,14.0,14.0,20.0,15.0,13.0,14.0,9.0,13.0,8.0,14.0,13.0,14.0,12.0,14.0,16.0,12.0,15.0,2.0,22.0,0.0,0.0,0.0,0.0,180.0,75.0,2.0,3.0,2.0,2.0,1.0,2.0,1.0,3.0,1.0,1.0,1.0,15.0,14.0,14.0,11.0,16.0,15.0,6.0,15.0,5.0,8.0,17.0,14.0,13.0,15.0,14.0,15.0,16.0,16.0,9.0,16.0,12.0,14.0,16.0,10.0,13.0,10.0,14.0,14.0,12.0,13.0,12.0,8.0,10.0,14.0,12.0,20.0,12.0,12.0,14.0,8.0,11.0,10.0,5.0,15.0,13.0,11.0,13.0,14.0,15.0,9.0,5.0,23.0,15.0,1.0,7.0,0.0,165.0,60.0,2.0,3.0,2.0,1.0,1.0,1.0,3.0,3.0,2.0,1.0,3.0,14.0,14.0,16.0,8.0,16.0,13.0,6.0,10.0,6.0,11.0,18.0,15.0,12.0,18.0,16.0,15.0,15.0,17.0,13.0,17.0,15.0,14.0,18.0,12.0,10.0,12.0,15.0,16.0,14.0,16.0,16.0,6.0,12.0,13.0,14.0,20.0,15.0,11.0,16.0,14.0,15.0,10.0,12.0,14.0,15.0,16.0,14.0,14.0,13.0,10.0,6.0,22.0,24.0,2.0,1.0,1.0,187.0,75.0,1.0,2.0,1.0,1.0,2.0,1.0,2.0,1.0,2.0,3.0,3.0,13.0,13.0,16.0,13.0,17.0,10.0,9.0,17.0,8.0,6.0,14.0,10.0,8.0,16.0,10.0,12.0,9.0,12.0,10.0,15.0,11.0,10.0,15.0,7.0,13.0,8.0,12.0,11.0,15.0,14.0,10.0,16.0,18.0,12.0,13.0,20.0,14.0,11.0,8.0,5.0,15.0,12.0,13.0,11.0,17.0,8.0,10.0,16.0,12.0,14.0,13.0,28.0,66.0,15.0,13.0,3.0,180.0,70.0,2.0,2.0,1.0,2.0,1.0,1.0,3.0,2.0,3.0,3.0,1.0,14.0,15.0,16.0,13.0,17.0,15.0,6.0,15.0,4.0,5.0,16.0,14.0,8.0,17.0,13.0,16.0,11.0,15.0,13.0,16.0,14.0,13.0,17.0,10.0,14.0,9.0,13.0,13.0,16.0,18.0,12.0,10.0,20.0,14.0,15.0,8.0,16.0,9.0,13.0,14.0,12.0,10.0,15.0,14.0,15.0,10.0,16.0,14.0,6.0,12.0,10.0,17.0,0.0,0.0,0.0,0.0,178.0,68.0,2.0,1.0,2.0,1.0,3.0,3.0,3.0,1.0,3.0,3.0,2.0,10.0,11.0,15.0,12.0,13.0,10.0,8.0,9.0,2.0,3.0,12.0,12.0,3.0,16.0,11.0,9.0,11.0,12.0,9.0,12.0,10.0,17.0,17.0,9.0,13.0,5.0,9.0,13.0,15.0,14.0,11.0,9.0,8.0,14.0,14.0,20.0,12.0,9.0,14.0,7.0,15.0,7.0,13.0,13.0,19.0,12.0,16.0,15.0,14.0,14.0,7.0,29.0,76.0,27.0,13.0,9.0,188.0,72.0,2.0,3.0,1.0,2.0,3.0,3.0,1.0,3.0,3.0,3.0,3.0,5.0,10.0,13.0,16.0,13.0,11.0,17.0,13.0,5.0,10.0,13.0,14.0,10.0,13.0,15.0,16.0,18.0,14.0,15.0,10.0,13.0,14.0,13.0,10.0,18.0,12.0,14.0,19.0,15.0,14.0,16.0,14.0,10.0,18.0,16.0,20.0,18.0,14.0,14.0,8.0,15.0,5.0,16.0,10.0,16.0,12.0,14.0,16.0,14.0,10.0,10.0
3,0,33.0,0.0,0.0,3.0,0.0,188.0,84.0,14.0,13.0,13.0,9.0,13.0,13.0,15.0,15.0,11.0,11.0,9.0,7.0,3.0,3.0,1.0,7.0,10.0,2.0,1.0,1.0,2.0,6.0,4.0,1.0,7.0,8.0,13.0,14.0,14.0,14.0,8.0,11.0,15.0,6.0,13.0,3.0,13.0,12.0,8.0,12.0,14.0,15.0,14.0,8.0,13.0,11.0,20.0,13.0,15.0,16.0,8.0,13.0,6.0,1.0,11.0,14.0,13.0,11.0,16.0,14.0,11.0,6.0,26.0,0.0,0.0,10.0,1.0,196.0,91.0,3.0,1.0,2.0,2.0,2.0,3.0,2.0,4.0,2.0,2.0,1.0,3.0,5.0,8.0,6.0,9.0,5.0,14.0,7.0,8.0,13.0,10.0,5.0,12.0,10.0,10.0,13.0,14.0,12.0,12.0,7.0,10.0,13.0,6.0,9.0,6.0,12.0,14.0,10.0,9.0,8.0,13.0,18.0,8.0,17.0,11.0,20.0,12.0,16.0,13.0,12.0,10.0,7.0,4.0,18.0,10.0,12.0,9.0,13.0,7.0,10.0,7.0,29.0,2.0,0.0,0.0,0.0,185.0,75.0,2.0,3.0,3.0,3.0,2.0,3.0,2.0,1.0,3.0,1.0,2.0,4.0,10.0,8.0,6.0,10.0,6.0,14.0,7.0,7.0,14.0,11.0,6.0,14.0,9.0,13.0,13.0,14.0,11.0,12.0,12.0,12.0,14.0,8.0,11.0,12.0,13.0,13.0,13.0,15.0,12.0,15.0,12.0,8.0,15.0,13.0,20.0,14.0,15.0,14.0,7.0,14.0,8.0,6.0,14.0,13.0,15.0,14.0,14.0,14.0,14.0,6.0,26.0,0.0,0.0,0.0,0.0,175.0,69.0,3.0,3.0,2.0,2.0,3.0,1.0,3.0,1.0,3.0,2.0,2.0,6.0,12.0,10.0,5.0,11.0,6.0,10.0,10.0,10.0,13.0,12.0,9.0,13.0,12.0,12.0,13.0,14.0,12.0,13.0,12.0,11.0,15.0,11.0,13.0,12.0,13.0,14.0,14.0,15.0,13.0,12.0,7.0,9.0,13.0,13.0,20.0,14.0,11.0,14.0,12.0,12.0,11.0,15.0,14.0,9.0,17.0,10.0,8.0,11.0,20.0,7.0,27.0,0.0,0.0,0.0,0.0,175.0,64.0,1.0,1.0,1.0,2.0,1.0,4.0,2.0,1.0,1.0,3.0,3.0,7.0,13.0,9.0,6.0,12.0,6.0,12.0,10.0,10.0,14.0,13.0,6.0,13.0,12.0,14.0,13.0,13.0,12.0,12.0,10.0,12.0,14.0,7.0,9.0,11.0,12.0,13.0,15.0,14.0,13.0,15.0,11.0,10.0,12.0,12.0,20.0,14.0,12.0,12.0,12.0,13.0,10.0,10.0,10.0,12.0,14.0,13.0,14.0,15.0,15.0,6.0,21.0,0.0,0.0,0.0,0.0,183.0,73.0,1.0,4.0,3.0,3.0,3.0,1.0,4.0,1.0,2.0,3.0,2.0,11.0,10.0,12.0,11.0,13.0,9.0,12.0,10.0,5.0,8.0,12.0,9.0,8.0,13.0,13.0,12.0,12.0,10.0,12.0,14.0,12.0,12.0,14.0,8.0,12.0,8.0,12.0,12.0,14.0,14.0,14.0,11.0,8.0,13.0,13.0,20.0,12.0,12.0,12.0,5.0,10.0,7.0,12.0,15.0,11.0,11.0,10.0,11.0,12.0,11.0,4.0,29.0,0.0,0.0,0.0,0.0,183.0,78.0,1.0,3.0,3.0,3.0,3.0,1.0,2.0,3.0,3.0,1.0,1.0,13.0,8.0,9.0,6.0,12.0,14.0,13.0,10.0,12.0,11.0,12.0,8.0,13.0,12.0,12.0,15.0,13.0,13.0,13.0,11.0,13.0,15.0,6.0,12.0,7.0,13.0,16.0,18.0,12.0,11.0,14.0,12.0,20.0,14.0,11.0,8.0,16.0,14.0,14.0,12.0,14.0,6.0,12.0,10.0,12.0,13.0,11.0,15.0,15.0,15.0,5.0,29.0,0.0,0.0,0.0,0.0,180.0,71.0,1.0,3.0,1.0,1.0,1.0,4.0,4.0,1.0,1.0,2.0,3.0,10.0,11.0,12.0,9.0,13.0,11.0,8.0,14.0,6.0,8.0,11.0,10.0,8.0,12.0,10.0,11.0,12.0,12.0,9.0,12.0,11.0,14.0,12.0,7.0,12.0,10.0,12.0,14.0,15.0,14.0,12.0,10.0,20.0,16.0,13.0,12.0,15.0,10.0,13.0,10.0,15.0,7.0,8.0,16.0,12.0,12.0,13.0,14.0,15.0,15.0,6.0,18.0,0.0,0.0,0.0,0.0,188.0,0.0,2.0,2.0,1.0,1.0,1.0,2.0,1.0,4.0,2.0,2.0,1.0,8.0,11.0,14.0,11.0,13.0,10.0,11.0,10.0,2.0,6.0,12.0,11.0,8.0,13.0,8.0,11.0,9.0,13.0,9.0,13.0,11.0,14.0,15.0,8.0,12.0,7.0,11.0,13.0,14.0,12.0,12.0,13.0,12.0,11.0,14.0,20.0,11.0,11.0,12.0,8.0,11.0,8.0,14.0,12.0,11.0,10.0,12.0,13.0,12.0,14.0,7.0,23.0,0.0,0.0,0.0,0.0,175.0,70.0,2.0,1.0,2.0,2.0,1.0,2.0,2.0,3.0,4.0,1.0,2.0,10.0,11.0,12.0,9.0,13.0,8.0,6.0,13.0,2.0,5.0,13.0,10.0,6.0,13.0,7.0,13.0,9.0,13.0,11.0,13.0,12.0,13.0,12.0,10.0,12.0,10.0,13.0,12.0,11.0,12.0,13.0,8.0,8.0,14.0,12.0,20.0,14.0,12.0,13.0,9.0,11.0,10.0,11.0,19.0,12.0,14.0,11.0,13.0,10.0,16.0,7.0,23.0,1.0,0.0,0.0,0.0,185.0,70.0,4.0,3.0,1.0,2.0,1.0,3.0,2.0,3.0,1.0,2.0,3.0,5.0,8.0,12.0,13.0,13.0,7.0,14.0,11.0,5.0,5.0,8.0,13.0,5.0,13.0,6.0,13.0,10.0,12.0,12.0,11.0,11.0,13.0,12.0,7.0,13.0,9.0,8.0,10.0,16.0,12.0,14.0,12.0,8.0,14.0,15.0,20.0,13.0,13.0,12.0,7.0,15.0,7.0,7.0,13.0,13.0,12.0,10.0,12.0,15.0,15.0,7.0,26.0,2.0,0.0,1.0,0.0,188.0,84.0,12.0,13.0,15.0,9.0,15.0,13.0,13.0,15.0,10.0,11.0,14.0,9.0,2.0,1.0,2.0,12.0,11.0,3.0,2.0,3.0,3.0,11.0,3.0,1.0,10.0,14.0,13.0,14.0,10.0,13.0,11.0,11.0,14.0,3.0,11.0,5.0,12.0,15.0,13.0,10.0,12.0,13.0,14.0,5.0,14.0,9.0,20.0,12.0,14.0,12.0,10.0,15.0,3.0,11.0,12.0,11.0,16.0,13.0,15.0,16.0,16.0,4.0,29.0,0.0,0.0,0.0,0.0,183.0,74.0,3.0,3.0,3.0,3.0,3.0,2.0,2.0,2.0,1.0,3.0,1.0,5.0,12.0,7.0,6.0,10.0,7.0,14.0,12.0,5.0,14.0,12.0,6.0,13.0,11.0,14.0,13.0,17.0,13.0,16.0,12.0,12.0,13.0,9.0,8.0,9.0,14.0,14.0,15.0,13.0,12.0,15.0,12.0,6.0,17.0,11.0,20.0,17.0,13.0,14.0,14.0,15.0,5.0,13.0,9.0,14.0,19.0,15.0,14.0,11.0,11.0,6.0,19.0,1.0,0.0,0.0,0.0,182.0,67.0,1.0,3.0,2.0,1.0,2.0,3.0,1.0,1.0,2.0,1.0,1.0,7.0,7.0,8.0,4.0,10.0,7.0,9.0,9.0,7.0,14.0,9.0,7.0,13.0,9.0,9.0,10.0,8.0,9.0,8.0,9.0,14.0,2.0,7.0,12.0,7.0,8.0,8.0,12.0,12.0,10.0,9.0,11.0,5.0,13.0,8.0,20.0,11.0,8.0,9.0,5.0,4.0,9.0,9.0,10.0,12.0,13.0,9.0,10.0,13.0,12.0,3.0,22.0,0.0,0.0,0.0,0.0,178.0,73.0,3.0,2.0,2.0,1.0,2.0,4.0,3.0,1.0,3.0,1.0,2.0,6.0,12.0,12.0,6.0,11.0,7.0,8.0,8.0,11.0,12.0,10.0,8.0,13.0,11.0,12.0,12.0,13.0,11.0,10.0,11.0,11.0,13.0,6.0,7.0,12.0,9.0,13.0,14.0,16.0,14.0,13.0,9.0,6.0,14.0,15.0,20.0,15.0,14.0,12.0,12.0,13.0,6.0,14.0,12.0,15.0,13.0,13.0,14.0,14.0,14.0,6.0,21.0,0.0,0.0,0.0,0.0,172.0,68.0,3.0,3.0,1.0,2.0,1.0,2.0,3.0,2.0,2.0,3.0,2.0,12.0,13.0,12.0,8.0,12.0,12.0,5.0,8.0,12.0,11.0,13.0,8.0,13.0,12.0,14.0,13.0,14.0,13.0,13.0,10.0,11.0,15.0,9.0,13.0,13.0,12.0,13.0,14.0,12.0,12.0,12.0,6.0,20.0,13.0,13.0,13.0,13.0,11.0,12.0,10.0,10.0,11.0,9.0,20.0,13.0,15.0,12.0,16.0,13.0,13.0,8.0,32.0,0.0,0.0,13.0,0.0,175.0,65.0,2.0,1.0,1.0,2.0,3.0,3.0,1.0,2.0,3.0,2.0,3.0,15.0,13.0,11.0,6.0,14.0,13.0,10.0,12.0,8.0,8.0,16.0,8.0,12.0,13.0,11.0,14.0,15.0,14.0,15.0,14.0,14.0,14.0,6.0,13.0,9.0,15.0,18.0,13.0,12.0,13.0,13.0,8.0,8.0,13.0,10.0,20.0,13.0,13.0,12.0,11.0,15.0,12.0,10.0,17.0,14.0,15.0,14.0,16.0,14.0,14.0,6.0,27.0,0.0,0.0,0.0,0.0,188.0,77.0,1.0,4.0,1.0,1.0,3.0,1.0,2.0,1.0,2.0,2.0,2.0,4.0,7.0,8.0,7.0,13.0,6.0,15.0,9.0,6.0,13.0,12.0,6.0,12.0,11.0,14.0,14.0,15.0,10.0,12.0,11.0,13.0,16.0,7.0,12.0,9.0,12.0,15.0,16.0,14.0,10.0,14.0,15.0,9.0,13.0,12.0,20.0,14.0,16.0,12.0,14.0,13.0,6.0,12.0,4.0,13.0,18.0,13.0,14.0,14.0,13.0,7.0,25.0,5.0,0.0,5.0,0.0,186.0,72.0,1.0,2.0,1.0,2.0,2.0,3.0,3.0,3.0,3.0,3.0,2.0,13.0,12.0,14.0,9.0,16.0,15.0,11.0,12.0,5.0,8.0,16.0,11.0,10.0,15.0,8.0,13.0,11.0,14.0,13.0,15.0,14.0,15.0,14.0,11.0,13.0,10.0,12.0,12.0,13.0,14.0,14.0,10.0,10.0,13.0,11.0,20.0,11.0,11.0,13.0,9.0,15.0,13.0,7.0,15.0,17.0,14.0,13.0,15.0,15.0,15.0,7.0,20.0,0.0,0.0,2.0,0.0,180.0,75.0,3.0,1.0,2.0,2.0,3.0,2.0,1.0,1.0,3.0,3.0,1.0,8.0,13.0,14.0,9.0,13.0,8.0,10.0,9.0,6.0,5.0,12.0,6.0,5.0,14.0,8.0,13.0,12.0,13.0,12.0,12.0,12.0,7.0,13.0,8.0,14.0,7.0,12.0,13.0,15.0,13.0,14.0,10.0,8.0,14.0,15.0,20.0,13.0,12.0,13.0,11.0,9.0,7.0,13.0,9.0,11.0,11.0,11.0,12.0,11.0,10.0,1.0,25.0,0.0,0.0,0.0,0.0,176.0,74.0,2.0,2.0,1.0,3.0,2.0,2.0,2.0,4.0,3.0,3.0,3.0,12.0,12.0,14.0,12.0,14.0,13.0,7.0,12.0,6.0,3.0,12.0,12.0,3.0,15.0,9.0,10.0,8.0,12.0,11.0,12.0,10.0,10.0,14.0,5.0,13.0,4.0,6.0,8.0,17.0,15.0,12.0,8.0,20.0,12.0,14.0,8.0,13.0,12.0,11.0,9.0,14.0,10.0,8.0,8.0,14.0,12.0,7.0,10.0,11.0,11.0,9.0,30.0,5.0,0.0,22.0,9.0,181.0,84.0,2.0,3.0,3.0,1.0,2.0,3.0,3.0,1.0,3.0,1.0,3.0,7.0,10.0,12.0,13.0,11.0,7.0,13.0,10.0,12.0,6.0,11.0,13.0,6.0,13.0,17.0,13.0,16.0,11.0,13.0,11.0,11.0,17.0,14.0,8.0,14.0,9.0,13.0,17.0,15.0,12.0,15.0,11.0,8.0,14.0,15.0,20.0,14.0,14.0,13.0,9.0,13.0,7.0,10.0,7.0,16.0,13.0,14.0,13.0,15.0,15.0,10.0
2,0,36.0,0.0,0.0,0.0,0.0,185.0,78.0,11.0,14.0,12.0,7.0,13.0,12.0,14.0,15.0,13.0,14.0,10.0,4.0,1.0,3.0,1.0,8.0,8.0,11.0,8.0,3.0,3.0,7.0,2.0,1.0,8.0,11.0,13.0,15.0,11.0,12.0,7.0,13.0,9.0,5.0,14.0,3.0,13.0,15.0,8.0,11.0,14.0,13.0,12.0,5.0,15.0,11.0,20.0,12.0,14.0,13.0,11.0,13.0,8.0,1.0,19.0,14.0,16.0,10.0,17.0,9.0,9.0,11.0,21.0,0.0,0.0,0.0,0.0,182.0,74.0,2.0,2.0,2.0,2.0,2.0,1.0,1.0,1.0,3.0,2.0,2.0,9.0,11.0,12.0,7.0,9.0,8.0,12.0,7.0,11.0,12.0,7.0,8.0,13.0,11.0,12.0,12.0,14.0,12.0,13.0,7.0,12.0,11.0,1.0,9.0,11.0,9.0,10.0,12.0,14.0,10.0,13.0,11.0,9.0,8.0,12.0,20.0,13.0,11.0,10.0,13.0,8.0,10.0,10.0,15.0,11.0,13.0,10.0,10.0,8.0,13.0,7.0,28.0,8.0,0.0,1.0,0.0,182.0,79.0,1.0,1.0,3.0,2.0,4.0,1.0,3.0,3.0,1.0,1.0,3.0,5.0,9.0,9.0,9.0,11.0,6.0,13.0,8.0,12.0,14.0,9.0,8.0,14.0,11.0,14.0,14.0,15.0,10.0,13.0,7.0,12.0,16.0,8.0,8.0,9.0,14.0,13.0,14.0,15.0,12.0,13.0,11.0,5.0,13.0,14.0,20.0,15.0,14.0,12.0,14.0,13.0,7.0,15.0,11.0,13.0,10.0,13.0,10.0,11.0,12.0,5.0,21.0,0.0,0.0,1.0,0.0,177.0,68.0,4.0,1.0,2.0,1.0,1.0,1.0,1.0,1.0,2.0,1.0,2.0,5.0,12.0,9.0,7.0,12.0,8.0,13.0,10.0,16.0,13.0,12.0,8.0,14.0,12.0,12.0,13.0,12.0,12.0,12.0,10.0,13.0,15.0,11.0,13.0,11.0,13.0,13.0,14.0,13.0,14.0,13.0,11.0,10.0,14.0,12.0,20.0,12.0,14.0,12.0,11.0,12.0,8.0,14.0,13.0,10.0,14.0,12.0,14.0,12.0,11.0,5.0,24.0,10.0,0.0,0.0,0.0,180.0,73.0,3.0,2.0,3.0,1.0,1.0,1.0,1.0,3.0,3.0,3.0,2.0,5.0,10.0,8.0,5.0,8.0,6.0,13.0,8.0,6.0,14.0,12.0,6.0,13.0,10.0,12.0,13.0,13.0,11.0,12.0,9.0,12.0,14.0,1.0,7.0,7.0,12.0,12.0,13.0,15.0,11.0,13.0,10.0,5.0,15.0,14.0,20.0,12.0,14.0,12.0,12.0,11.0,8.0,11.0,8.0,11.0,9.0,15.0,12.0,11.0,19.0,6.0,23.0,14.0,1.0,0.0,0.0,180.0,75.0,1.0,3.0,2.0,4.0,1.0,3.0,2.0,2.0,4.0,1.0,2.0,5.0,12.0,12.0,6.0,11.0,7.0,13.0,12.0,6.0,12.0,12.0,6.0,12.0,11.0,13.0,13.0,15.0,11.0,11.0,12.0,9.0,16.0,7.0,12.0,8.0,12.0,14.0,16.0,14.0,13.0,15.0,10.0,8.0,15.0,13.0,20.0,15.0,14.0,14.0,13.0,12.0,7.0,11.0,12.0,13.0,14.0,14.0,14.0,13.0,13.0,6.0,24.0,0.0,0.0,0.0,0.0,188.0,75.0,1.0,3.0,2.0,2.0,1.0,1.0,2.0,1.0,3.0,3.0,1.0,15.0,11.0,11.0,12.0,13.0,15.0,11.0,12.0,9.0,6.0,15.0,13.0,6.0,11.0,11.0,12.0,12.0,14.0,14.0,14.0,14.0,14.0,12.0,12.0,11.0,8.0,13.0,13.0,11.0,12.0,9.0,15.0,20.0,12.0,10.0,8.0,13.0,9.0,12.0,7.0,14.0,11.0,11.0,14.0,14.0,12.0,11.0,10.0,11.0,10.0,6.0,19.0,0.0,0.0,0.0,0.0,184.0,72.0,2.0,2.0,3.0,2.0,1.0,2.0,1.0,3.0,2.0,1.0,2.0,11.0,9.0,9.0,10.0,15.0,11.0,11.0,16.0,8.0,14.0,11.0,9.0,16.0,10.0,11.0,13.0,6.0,12.0,11.0,10.0,12.0,12.0,7.0,4.0,12.0,13.0,12.0,15.0,14.0,9.0,13.0,12.0,7.0,13.0,11.0,20.0,10.0,12.0,10.0,11.0,8.0,8.0,11.0,12.0,14.0,8.0,13.0,12.0,5.0,9.0,3.0,18.0,2.0,0.0,0.0,0.0,179.0,71.0,2.0,1.0,2.0,1.0,2.0,2.0,4.0,4.0,1.0,2.0,2.0,4.0,6.0,1.0,4.0,11.0,6.0,13.0,6.0,4.0,10.0,7.0,1.0,13.0,7.0,9.0,8.0,8.0,6.0,7.0,5.0,13.0,9.0,9.0,6.0,2.0,11.0,7.0,11.0,11.0,11.0,7.0,8.0,5.0,9.0,10.0,20.0,13.0,6.0,8.0,9.0,9.0,9.0,9.0,14.0,12.0,10.0,12.0,12.0,12.0,14.0,3.0,26.0,0.0,0.0,0.0,0.0,193.0,81.0,1.0,3.0,3.0,3.0,3.0,1.0,2.0,2.0,2.0,3.0,3.0,4.0,9.0,14.0,10.0,13.0,12.0,14.0,14.0,5.0,5.0,10.0,12.0,3.0,14.0,8.0,13.0,12.0,9.0,10.0,11.0,11.0,12.0,16.0,5.0,14.0,6.0,9.0,12.0,14.0,13.0,14.0,16.0,14.0,13.0,13.0,20.0,13.0,14.0,10.0,8.0,14.0,9.0,8.0,16.0,16.0,11.0,13.0,11.0,13.0,13.0,10.0,21.0,0.0,0.0,4.0,1.0,184.0,79.0,1.0,2.0,3.0,1.0,2.0,1.0,3.0,2.0,2.0,1.0,3.0,3.0,6.0,10.0,12.0,12.0,7.0,15.0,8.0,4.0,5.0,13.0,10.0,8.0,12.0,18.0,12.0,19.0,13.0,10.0,13.0,12.0,14.0,13.0,10.0,12.0,9.0,16.0,15.0,12.0,14.0,14.0,14.0,12.0,13.0,10.0,20.0,14.0,14.0,11.0,14.0,14.0,11.0,5.0,10.0,13.0,14.0,15.0,10.0,8.0,4.0,15.0,27.0,0.0,0.0,0.0,0.0,185.0,81.0,13.0,11.0,11.0,9.0,11.0,11.0,12.0,13.0,11.0,14.0,8.0,4.0,1.0,1.0,2.0,9.0,8.0,7.0,2.0,2.0,1.0,8.0,5.0,1.0,8.0,10.0,12.0,15.0,12.0,12.0,8.0,11.0,14.0,6.0,11.0,2.0,11.0,12.0,6.0,12.0,13.0,14.0,13.0,5.0,14.0,10.0,20.0,12.0,13.0,12.0,10.0,13.0,10.0,1.0,10.0,14.0,14.0,12.0,13.0,14.0,11.0,7.0,23.0,2.0,0.0,0.0,0.0,188.0,85.0,1.0,3.0,2.0,2.0,1.0,3.0,3.0,2.0,3.0,2.0,1.0,7.0,8.0,7.0,5.0,12.0,5.0,14.0,9.0,7.0,13.0,11.0,6.0,13.0,12.0,14.0,13.0,13.0,11.0,12.0,6.0,12.0,5.0,1.0,6.0,8.0,12.0,14.0,13.0,12.0,11.0,14.0,15.0,6.0,13.0,11.0,20.0,14.0,15.0,13.0,9.0,7.0,10.0,10.0,12.0,12.0,13.0,10.0,9.0,8.0,8.0,2.0,27.0,0.0,0.0,0.0,0.0,169.0,60.0,3.0,2.0,1.0,3.0,3.0,2.0,1.0,3.0,3.0,2.0,2.0,11.0,11.0,13.0,9.0,13.0,12.0,8.0,10.0,4.0,5.0,14.0,8.0,5.0,13.0,12.0,9.0,9.0,10.0,10.0,10.0,9.0,16.0,13.0,4.0,14.0,8.0,11.0,8.0,16.0,16.0,9.0,9.0,5.0,13.0,15.0,20.0,11.0,11.0,10.0,8.0,7.0,5.0,11.0,14.0,10.0,12.0,11.0,12.0,10.0,13.0,8.0,16.0,0.0,0.0,0.0,0.0,177.0,0.0,3.0,2.0,1.0,1.0,3.0,3.0,2.0,2.0,2.0,1.0,3.0,1.0,3.0,2.0,2.0,4.0,1.0,3.0,1.0,6.0,9.0,2.0,1.0,9.0,6.0,14.0,4.0,5.0,5.0,3.0,2.0,5.0,4.0,5.0,7.0,4.0,8.0,4.0,3.0,10.0,7.0,13.0,7.0,15.0,13.0,9.0,20.0,5.0,8.0,7.0,11.0,5.0,8.0,8.0,11.0,11.0,5.0,14.0,20.0,7.0,12.0,5.0,24.0,0.0,0.0,0.0,0.0,178.0,77.0,2.0,1.0,3.0,2.0,1.0,3.0,3.0,3.0,1.0,3.0,2.0,5.0,10.0,8.0,5.0,9.0,6.0,11.0,8.0,12.0,11.0,8.0,6.0,12.0,9.0,11.0,11.0,13.0,11.0,12.0,7.0,11.0,15.0,9.0,6.0,9.0,11.0,12.0,14.0,16.0,12.0,14.0,10.0,5.0,15.0,15.0,20.0,14.0,13.0,14.0,11.0,13.0,5.0,8.0,17.0,12.0,14.0,14.0,14.0,14.0,14.0,6.0,23.0,0.0,0.0,8.0,0.0,183.0,77.0,2.0,3.0,1.0,2.0,1.0,3.0,3.0,3.0,3.0,2.0,2.0,7.0,13.0,12.0,7.0,12.0,6.0,8.0,9.0,11.0,12.0,9.0,7.0,12.0,12.0,10.0,12.0,14.0,13.0,12.0,11.0,11.0,15.0,11.0,7.0,13.0,12.0,12.0,13.0,16.0,13.0,14.0,11.0,8.0,15.0,15.0,20.0,13.0,13.0,11.0,10.0,13.0,7.0,8.0,11.0,13.0,14.0,11.0,14.0,15.0,15.0,5.0,26.0,0.0,0.0,0.0,0.0,184.0,76.0,2.0,3.0,1.0,3.0,1.0,1.0,3.0,1.0,3.0,2.0,2.0,10.0,12.0,14.0,12.0,14.0,12.0,11.0,13.0,11.0,13.0,14.0,13.0,12.0,15.0,14.0,13.0,12.0,11.0,11.0,13.0,14.0,14.0,12.0,13.0,12.0,11.0,11.0,14.0,15.0,14.0,13.0,10.0,5.0,14.0,14.0,20.0,14.0,14.0,14.0,7.0,16.0,6.0,8.0,19.0,14.0,14.0,14.0,14.0,14.0,14.0,6.0,22.0,0.0,0.0,0.0,0.0,188.0,79.0,1.0,2.0,2.0,3.0,2.0,2.0,3.0,4.0,3.0,2.0,1.0,8.0,10.0,11.0,7.0,11.0,8.0,10.0,8.0,7.0,8.0,10.0,10.0,11.0,11.0,11.0,12.0,13.0,11.0,10.0,8.0,11.0,10.0,8.0,8.0,12.0,10.0,12.0,15.0,13.0,12.0,14.0,14.0,20.0,13.0,12.0,8.0,14.0,14.0,12.0,10.0,6.0,8.0,15.0,11.0,11.0,11.0,11.0,11.0,10.0,12.0,6.0,28.0,0.0,0.0,0.0,0.0,181.0,75.0,4.0,2.0,1.0,3.0,3.0,3.0,2.0,2.0,2.0,2.0,2.0,13.0,12.0,12.0,9.0,12.0,13.0,7.0,11.0,7.0,7.0,13.0,5.0,7.0,13.0,9.0,13.0,3.0,12.0,11.0,12.0,12.0,3.0,12.0,14.0,12.0,9.0,12.0,13.0,13.0,13.0,10.0,11.0,20.0,13.0,12.0,6.0,13.0,9.0,13.0,6.0,13.0,8.0,10.0,20.0,12.0,14.0,11.0,13.0,10.0,11.0,4.0,24.0,0.0,0.0,4.0,0.0,181.0,79.0,1.0,3.0,2.0,2.0,1.0,1.0,1.0,2.0,2.0,2.0,1.0,4.0,6.0,10.0,11.0,11.0,7.0,12.0,10.0,5.0,5.0,7.0,13.0,3.0,10.0,9.0,12.0,12.0,11.0,10.0,6.0,10.0,8.0,9.0,5.0,11.0,5.0,9.0,12.0,15.0,13.0,13.0,11.0,5.0,11.0,14.0,20.0,13.0,14.0,11.0,9.0,12.0,13.0,5.0,19.0,11.0,9.0,9.0,7.0,14.0,14.0,13.0,18.0,0.0,0.0,0.0,0.0,184.0,71.0,2.0,3.0,2.0,3.0,1.0,2.0,1.0,3.0,2.0,1.0,3.0,8.0,10.0,14.0,10.0,12.0,8.0,5.0,10.0,3.0,5.0,12.0,7.0,6.0,13.0,8.0,8.0,8.0,11.0,8.0,11.0,14.0,12.0,10.0,11.0,10.0,9.0,9.0,13.0,14.0,13.0,5.0,10.0,10.0,13.0,14.0,20.0,12.0,8.0,10.0,8.0,10.0,4.0,10.0,11.0,12.0,11.0,12.0,13.0,11.0,13.0,6.0
1,3,27.0,0.0,0.0,0.0,0.0,185.0,81.0,13.0,11.0,11.0,9.0,11.0,11.0,12.0,13.0,11.0,14.0,8.0,4.0,1.0,1.0,2.0,9.0,8.0,7.0,2.0,2.0,1.0,8.0,5.0,1.0,8.0,10.0,12.0,15.0,12.0,12.0,8.0,11.0,14.0,6.0,11.0,2.0,11.0,12.0,6.0,12.0,13.0,14.0,13.0,5.0,14.0,10.0,20.0,12.0,13.0,12.0,10.0,13.0,10.0,1.0,10.0,14.0,14.0,12.0,13.0,14.0,11.0,7.0,27.0,0.0,0.0,0.0,0.0,169.0,60.0,3.0,2.0,1.0,3.0,3.0,2.0,1.0,3.0,3.0,2.0,2.0,11.0,11.0,13.0,9.0,13.0,12.0,8.0,10.0,4.0,5.0,14.0,8.0,5.0,13.0,12.0,9.0,9.0,10.0,10.0,10.0,9.0,16.0,13.0,4.0,14.0,8.0,11.0,8.0,16.0,16.0,9.0,9.0,5.0,13.0,15.0,20.0,11.0,11.0,10.0,8.0,7.0,5.0,11.0,14.0,10.0,12.0,11.0,12.0,10.0,13.0,8.0,29.0,0.0,0.0,0.0,0.0,185.0,84.0,3.0,2.0,2.0,2.0,1.0,3.0,1.0,2.0,1.0,3.0,1.0,3.0,6.0,6.0,7.0,10.0,5.0,14.0,5.0,4.0,14.0,9.0,7.0,13.0,9.0,13.0,13.0,14.0,12.0,13.0,8.0,12.0,14.0,8.0,16.0,8.0,12.0,13.0,15.0,11.0,11.0,15.0,12.0,5.0,14.0,12.0,20.0,14.0,16.0,13.0,12.0,10.0,7.0,7.0,7.0,12.0,13.0,13.0,14.0,13.0,12.0,8.0,16.0,0.0,0.0,0.0,0.0,177.0,0.0,3.0,2.0,1.0,1.0,3.0,3.0,2.0,2.0,2.0,1.0,3.0,1.0,3.0,2.0,2.0,4.0,1.0,3.0,1.0,6.0,9.0,2.0,1.0,9.0,6.0,14.0,4.0,5.0,5.0,3.0,2.0,5.0,4.0,5.0,7.0,4.0,8.0,4.0,3.0,10.0,7.0,13.0,7.0,15.0,13.0,9.0,20.0,5.0,8.0,7.0,11.0,5.0,8.0,8.0,11.0,11.0,5.0,14.0,20.0,7.0,12.0,5.0,24.0,0.0,0.0,0.0,0.0,178.0,77.0,2.0,1.0,3.0,2.0,1.0,3.0,3.0,3.0,1.0,3.0,2.0,5.0,10.0,8.0,5.0,9.0,6.0,11.0,8.0,12.0,11.0,8.0,6.0,12.0,9.0,11.0,11.0,13.0,11.0,12.0,7.0,11.0,15.0,9.0,6.0,9.0,11.0,12.0,14.0,16.0,12.0,14.0,10.0,5.0,15.0,15.0,20.0,14.0,13.0,14.0,11.0,13.0,5.0,8.0,17.0,12.0,14.0,14.0,14.0,14.0,14.0,6.0,26.0,0.0,0.0,0.0,0.0,184.0,76.0,2.0,3.0,1.0,3.0,1.0,1.0,3.0,1.0,3.0,2.0,2.0,10.0,12.0,14.0,12.0,14.0,12.0,11.0,13.0,11.0,13.0,14.0,13.0,12.0,15.0,14.0,13.0,12.0,11.0,11.0,13.0,14.0,14.0,12.0,13.0,12.0,11.0,11.0,14.0,15.0,14.0,13.0,10.0,5.0,14.0,14.0,20.0,14.0,14.0,14.0,7.0,16.0,6.0,8.0,19.0,14.0,14.0,14.0,14.0,14.0,14.0,6.0,22.0,0.0,0.0,0.0,0.0,188.0,79.0,1.0,2.0,2.0,3.0,2.0,2.0,3.0,4.0,3.0,2.0,1.0,8.0,10.0,11.0,7.0,11.0,8.0,10.0,8.0,7.0,8.0,10.0,10.0,11.0,11.0,11.0,12.0,13.0,11.0,10.0,8.0,11.0,10.0,8.0,8.0,12.0,10.0,12.0,15.0,13.0,12.0,14.0,14.0,20.0,13.0,12.0,8.0,14.0,14.0,12.0,10.0,6.0,8.0,15.0,11.0,11.0,11.0,11.0,11.0,10.0,12.0,6.0,28.0,0.0,0.0,0.0,0.0,181.0,75.0,4.0,2.0,1.0,3.0,3.0,3.0,2.0,2.0,2.0,2.0,2.0,13.0,12.0,12.0,9.0,12.0,13.0,7.0,11.0,7.0,7.0,13.0,5.0,7.0,13.0,9.0,13.0,3.0,12.0,11.0,12.0,12.0,3.0,12.0,14.0,12.0,9.0,12.0,13.0,13.0,13.0,10.0,11.0,20.0,13.0,12.0,6.0,13.0,9.0,13.0,6.0,13.0,8.0,10.0,20.0,12.0,14.0,11.0,13.0,10.0,11.0,4.0,18.0,0.0,0.0,0.0,0.0,184.0,71.0,2.0,3.0,2.0,3.0,1.0,2.0,1.0,3.0,2.0,1.0,3.0,8.0,10.0,14.0,10.0,12.0,8.0,5.0,10.0,3.0,5.0,12.0,7.0,6.0,13.0,8.0,8.0,8.0,11.0,8.0,11.0,14.0,12.0,10.0,11.0,10.0,9.0,9.0,13.0,14.0,13.0,5.0,10.0,10.0,13.0,14.0,20.0,12.0,8.0,10.0,8.0,10.0,4.0,10.0,11.0,12.0,11.0,12.0,13.0,11.0,13.0,6.0,24.0,0.0,0.0,4.0,0.0,181.0,79.0,1.0,3.0,2.0,2.0,1.0,1.0,1.0,2.0,2.0,2.0,1.0,4.0,6.0,10.0,11.0,11.0,7.0,12.0,10.0,5.0,5.0,7.0,13.0,3.0,10.0,9.0,12.0,12.0,11.0,10.0,6.0,10.0,8.0,9.0,5.0,11.0,5.0,9.0,12.0,15.0,13.0,13.0,11.0,5.0,11.0,14.0,20.0,13.0,14.0,11.0,9.0,12.0,13.0,5.0,19.0,11.0,9.0,9.0,7.0,14.0,14.0,13.0,33.0,0.0,0.0,0.0,0.0,185.0,80.0,1.0,3.0,2.0,1.0,2.0,3.0,3.0,4.0,3.0,2.0,3.0,5.0,10.0,11.0,12.0,12.0,7.0,14.0,10.0,5.0,4.0,10.0,12.0,4.0,11.0,8.0,13.0,15.0,11.0,12.0,10.0,12.0,14.0,12.0,8.0,11.0,7.0,11.0,12.0,11.0,11.0,15.0,13.0,10.0,12.0,10.0,20.0,13.0,15.0,12.0,8.0,14.0,11.0,8.0,12.0,15.0,11.0,11.0,13.0,13.0,11.0,8.0,31.0,25.0,0.0,6.0,0.0,191.0,84.0,11.0,14.0,13.0,12.0,15.0,14.0,15.0,16.0,13.0,14.0,14.0,8.0,2.0,10.0,5.0,11.0,11.0,7.0,10.0,2.0,5.0,10.0,11.0,11.0,9.0,12.0,13.0,15.0,13.0,13.0,8.0,13.0,16.0,12.0,14.0,1.0,16.0,13.0,11.0,12.0,13.0,16.0,16.0,8.0,16.0,13.0,20.0,15.0,15.0,17.0,8.0,15.0,7.0,2.0,15.0,15.0,17.0,15.0,17.0,16.0,15.0,6.0,32.0,0.0,0.0,3.0,0.0,187.0,82.0,1.0,2.0,2.0,3.0,2.0,1.0,1.0,2.0,2.0,3.0,1.0,5.0,11.0,8.0,7.0,10.0,6.0,15.0,9.0,13.0,15.0,10.0,8.0,16.0,9.0,16.0,14.0,17.0,12.0,15.0,8.0,12.0,17.0,9.0,14.0,11.0,13.0,15.0,13.0,12.0,11.0,16.0,14.0,6.0,13.0,14.0,20.0,13.0,16.0,15.0,14.0,14.0,8.0,14.0,14.0,14.0,15.0,16.0,15.0,12.0,10.0,7.0,28.0,46.0,3.0,14.0,3.0,190.0,80.0,2.0,3.0,3.0,2.0,2.0,1.0,1.0,3.0,1.0,3.0,1.0,4.0,6.0,7.0,9.0,11.0,7.0,17.0,11.0,10.0,15.0,12.0,11.0,16.0,10.0,17.0,15.0,18.0,13.0,14.0,12.0,14.0,18.0,6.0,17.0,8.0,15.0,15.0,14.0,11.0,10.0,17.0,16.0,7.0,17.0,13.0,20.0,15.0,18.0,17.0,14.0,16.0,4.0,6.0,14.0,15.0,16.0,17.0,18.0,14.0,15.0,6.0,23.0,0.0,0.0,0.0,0.0,184.0,77.0,1.0,1.0,1.0,1.0,3.0,2.0,3.0,2.0,2.0,2.0,3.0,6.0,9.0,11.0,7.0,12.0,7.0,15.0,9.0,11.0,14.0,13.0,10.0,15.0,12.0,14.0,15.0,15.0,13.0,12.0,11.0,13.0,15.0,11.0,9.0,9.0,14.0,14.0,14.0,14.0,13.0,15.0,13.0,9.0,16.0,15.0,20.0,14.0,14.0,14.0,11.0,14.0,4.0,11.0,14.0,13.0,15.0,14.0,16.0,14.0,15.0,6.0,23.0,0.0,0.0,1.0,0.0,182.0,71.0,3.0,1.0,2.0,3.0,4.0,2.0,3.0,1.0,2.0,1.0,3.0,9.0,13.0,14.0,8.0,14.0,13.0,12.0,10.0,13.0,14.0,14.0,13.0,15.0,13.0,14.0,14.0,13.0,11.0,12.0,12.0,13.0,16.0,12.0,12.0,15.0,13.0,14.0,15.0,15.0,13.0,14.0,12.0,9.0,16.0,15.0,20.0,15.0,15.0,15.0,10.0,14.0,6.0,12.0,8.0,15.0,14.0,16.0,15.0,15.0,16.0,6.0,29.0,90.0,4.0,16.0,2.0,170.0,61.0,2.0,3.0,3.0,1.0,3.0,1.0,2.0,2.0,2.0,2.0,1.0,15.0,14.0,15.0,9.0,17.0,16.0,7.0,12.0,4.0,11.0,18.0,15.0,12.0,17.0,15.0,15.0,16.0,13.0,16.0,17.0,14.0,16.0,15.0,14.0,12.0,14.0,18.0,16.0,13.0,14.0,12.0,8.0,10.0,14.0,11.0,20.0,14.0,10.0,14.0,9.0,17.0,10.0,14.0,13.0,17.0,15.0,16.0,17.0,15.0,16.0,7.0,31.0,0.0,0.0,6.0,0.0,174.0,80.0,1.0,1.0,1.0,1.0,1.0,5.0,1.0,1.0,1.0,1.0,1.0,14.0,12.0,11.0,7.0,12.0,13.0,9.0,7.0,10.0,11.0,11.0,10.0,10.0,12.0,11.0,11.0,11.0,10.0,6.0,10.0,9.0,12.0,12.0,12.0,10.0,12.0,12.0,14.0,12.0,15.0,10.0,9.0,20.0,12.0,12.0,7.0,12.0,9.0,9.0,10.0,12.0,7.0,9.0,11.0,14.0,9.0,7.0,14.0,8.0,9.0,9.0,20.0,0.0,0.0,7.0,1.0,170.0,58.0,1.0,2.0,2.0,2.0,2.0,2.0,2.0,4.0,1.0,3.0,2.0,16.0,14.0,16.0,13.0,16.0,17.0,5.0,14.0,2.0,6.0,15.0,13.0,4.0,17.0,9.0,12.0,14.0,12.0,12.0,14.0,13.0,15.0,16.0,7.0,13.0,9.0,13.0,15.0,15.0,16.0,11.0,7.0,20.0,14.0,15.0,8.0,14.0,8.0,15.0,5.0,15.0,7.0,16.0,15.0,15.0,15.0,14.0,16.0,18.0,16.0,3.0,20.0,0.0,0.0,10.0,1.0,174.0,68.0,1.0,3.0,3.0,3.0,2.0,3.0,3.0,2.0,1.0,2.0,2.0,11.0,12.0,15.0,11.0,14.0,12.0,6.0,12.0,2.0,4.0,14.0,11.0,4.0,15.0,9.0,11.0,10.0,12.0,11.0,14.0,12.0,14.0,14.0,7.0,13.0,7.0,11.0,13.0,14.0,15.0,13.0,7.0,20.0,12.0,14.0,10.0,13.0,9.0,12.0,7.0,12.0,10.0,12.0,15.0,16.0,12.0,14.0,13.0,15.0,15.0,5.0,21.0,3.0,0.0,0.0,0.0,181.0,77.0,2.0,2.0,2.0,1.0,1.0,1.0,3.0,2.0,4.0,3.0,3.0,6.0,13.0,16.0,12.0,15.0,7.0,6.0,10.0,5.0,5.0,13.0,10.0,6.0,16.0,13.0,13.0,13.0,9.0,10.0,11.0,13.0,15.0,17.0,10.0,14.0,5.0,12.0,11.0,16.0,15.0,13.0,10.0,15.0,16.0,15.0,20.0,13.0,14.0,14.0,10.0,13.0,8.0,16.0,17.0,17.0,11.0,14.0,10.0,9.0,11.0,9.0,26.0,40.0,16.0,6.0,2.0,183.0,79.0,1.0,2.0,1.0,2.0,2.0,1.0,2.0,1.0,3.0,2.0,2.0,9.0,14.0,16.0,14.0,17.0,13.0,10.0,13.0,4.0,5.0,15.0,14.0,7.0,17.0,12.0,13.0,10.0,14.0,12.0,14.0,15.0,14.0,17.0,13.0,12.0,7.0,11.0,11.0,14.0,15.0,14.0,11.0,11.0,8.0,15.0,20.0,12.0,12.0,13.0,12.0,15.0,16.0,13.0,13.0,15.0,13.0,13.0,15.0,16.0,18.0,7.0
1,0,30.0,42.0,0.0,13.0,0.0,195.0,88.0,16.0,13.0,14.0,6.0,14.0,13.0,13.0,15.0,12.0,10.0,14.0,1.0,8.0,5.0,2.0,8.0,2.0,8.0,2.0,5.0,3.0,9.0,5.0,3.0,8.0,10.0,12.0,10.0,14.0,10.0,10.0,14.0,13.0,3.0,14.0,3.0,12.0,14.0,12.0,8.0,13.0,18.0,18.0,17.0,14.0,11.0,20.0,14.0,17.0,14.0,4.0,14.0,4.0,1.0,12.0,13.0,14.0,9.0,15.0,13.0,13.0,5.0,24.0,0.0,0.0,0.0,0.0,185.0,77.0,1.0,1.0,3.0,2.0,1.0,1.0,3.0,1.0,3.0,3.0,1.0,7.0,10.0,12.0,11.0,12.0,12.0,14.0,13.0,7.0,13.0,12.0,8.0,14.0,12.0,10.0,13.0,11.0,13.0,13.0,12.0,13.0,16.0,10.0,8.0,12.0,13.0,13.0,13.0,14.0,14.0,12.0,14.0,12.0,14.0,13.0,20.0,11.0,12.0,12.0,12.0,10.0,11.0,7.0,17.0,11.0,10.0,10.0,10.0,7.0,8.0,5.0,28.0,0.0,0.0,0.0,0.0,174.0,67.0,3.0,4.0,1.0,1.0,1.0,3.0,1.0,3.0,2.0,1.0,2.0,11.0,8.0,11.0,9.0,13.0,6.0,7.0,12.0,8.0,10.0,10.0,3.0,6.0,12.0,10.0,13.0,7.0,12.0,8.0,10.0,9.0,12.0,13.0,5.0,12.0,9.0,12.0,11.0,14.0,14.0,11.0,7.0,10.0,15.0,12.0,20.0,11.0,6.0,9.0,6.0,10.0,10.0,9.0,11.0,14.0,9.0,11.0,12.0,8.0,8.0,8.0,19.0,0.0,0.0,0.0,0.0,189.0,78.0,2.0,2.0,2.0,1.0,1.0,1.0,3.0,1.0,2.0,1.0,2.0,7.0,8.0,9.0,7.0,9.0,6.0,12.0,8.0,8.0,12.0,12.0,6.0,13.0,11.0,15.0,13.0,14.0,11.0,10.0,8.0,12.0,14.0,6.0,9.0,11.0,11.0,13.0,14.0,13.0,12.0,12.0,13.0,6.0,14.0,13.0,20.0,12.0,13.0,13.0,6.0,12.0,5.0,13.0,16.0,13.0,13.0,13.0,15.0,14.0,12.0,5.0,21.0,0.0,0.0,0.0,0.0,177.0,0.0,1.0,1.0,1.0,2.0,3.0,3.0,2.0,3.0,2.0,2.0,3.0,6.0,4.0,13.0,13.0,13.0,6.0,13.0,7.0,3.0,5.0,7.0,6.0,1.0,11.0,9.0,7.0,8.0,7.0,7.0,7.0,8.0,7.0,11.0,8.0,13.0,7.0,6.0,7.0,12.0,13.0,7.0,6.0,8.0,8.0,13.0,20.0,5.0,5.0,9.0,5.0,9.0,9.0,9.0,10.0,10.0,12.0,12.0,11.0,10.0,9.0,6.0,21.0,0.0,0.0,0.0,0.0,178.0,65.0,2.0,3.0,3.0,3.0,3.0,1.0,1.0,1.0,1.0,3.0,1.0,9.0,13.0,11.0,6.0,12.0,7.0,9.0,8.0,8.0,13.0,12.0,7.0,13.0,12.0,8.0,12.0,13.0,12.0,12.0,13.0,13.0,14.0,9.0,8.0,12.0,12.0,13.0,13.0,12.0,14.0,13.0,11.0,8.0,15.0,12.0,20.0,13.0,12.0,14.0,8.0,11.0,7.0,10.0,19.0,10.0,13.0,10.0,11.0,15.0,15.0,6.0,26.0,25.0,1.0,7.0,0.0,189.0,78.0,1.0,1.0,1.0,1.0,1.0,1.0,1.0,1.0,1.0,1.0,1.0,8.0,9.0,10.0,6.0,12.0,8.0,13.0,14.0,7.0,11.0,14.0,11.0,13.0,13.0,13.0,13.0,16.0,13.0,13.0,12.0,13.0,14.0,10.0,10.0,12.0,13.0,15.0,15.0,12.0,11.0,9.0,15.0,10.0,14.0,13.0,20.0,14.0,14.0,12.0,13.0,11.0,14.0,12.0,14.0,11.0,14.0,12.0,16.0,15.0,13.0,5.0,21.0,0.0,0.0,0.0,0.0,172.0,66.0,2.0,3.0,2.0,2.0,1.0,1.0,1.0,3.0,2.0,1.0,1.0,10.0,10.0,13.0,9.0,14.0,9.0,8.0,10.0,7.0,13.0,13.0,9.0,12.0,13.0,10.0,12.0,13.0,13.0,12.0,14.0,13.0,13.0,11.0,9.0,14.0,13.0,14.0,14.0,14.0,13.0,12.0,8.0,8.0,12.0,12.0,20.0,13.0,12.0,14.0,10.0,11.0,8.0,12.0,15.0,10.0,15.0,8.0,11.0,14.0,14.0,6.0,22.0,0.0,0.0,0.0,0.0,177.0,72.0,2.0,1.0,2.0,4.0,2.0,2.0,1.0,3.0,4.0,2.0,3.0,10.0,12.0,13.0,11.0,12.0,10.0,12.0,12.0,4.0,10.0,13.0,11.0,11.0,13.0,11.0,12.0,11.0,13.0,9.0,13.0,12.0,3.0,12.0,8.0,14.0,12.0,12.0,13.0,16.0,13.0,12.0,9.0,8.0,15.0,14.0,20.0,14.0,13.0,10.0,4.0,11.0,11.0,12.0,19.0,9.0,12.0,13.0,12.0,11.0,14.0,7.0,24.0,4.0,1.0,0.0,0.0,188.0,79.0,2.0,3.0,2.0,1.0,2.0,1.0,1.0,2.0,1.0,2.0,2.0,10.0,11.0,13.0,12.0,11.0,9.0,13.0,9.0,5.0,8.0,11.0,11.0,7.0,13.0,10.0,12.0,11.0,11.0,12.0,13.0,11.0,14.0,12.0,9.0,12.0,12.0,14.0,14.0,12.0,13.0,15.0,14.0,8.0,13.0,12.0,20.0,13.0,14.0,11.0,9.0,10.0,5.0,10.0,14.0,12.0,13.0,10.0,14.0,13.0,12.0,10.0,25.0,0.0,0.0,0.0,0.0,187.0,83.0,2.0,1.0,3.0,3.0,1.0,3.0,3.0,3.0,1.0,1.0,3.0,4.0,8.0,10.0,14.0,12.0,8.0,14.0,9.0,5.0,7.0,11.0,13.0,5.0,12.0,11.0,13.0,13.0,13.0,11.0,10.0,12.0,16.0,9.0,8.0,13.0,11.0,13.0,16.0,14.0,13.0,15.0,13.0,20.0,14.0,12.0,8.0,14.0,16.0,13.0,11.0,13.0,7.0,5.0,13.0,14.0,13.0,14.0,14.0,13.0,13.0,6.0,24.0,0.0,0.0,0.0,0.0,186.0,80.0,9.0,10.0,13.0,6.0,12.0,11.0,13.0,14.0,11.0,12.0,7.0,5.0,2.0,2.0,3.0,9.0,10.0,2.0,2.0,2.0,1.0,8.0,2.0,1.0,9.0,8.0,11.0,13.0,9.0,10.0,7.0,9.0,14.0,6.0,9.0,1.0,11.0,12.0,6.0,10.0,13.0,14.0,13.0,20.0,14.0,7.0,5.0,12.0,14.0,10.0,8.0,14.0,7.0,1.0,15.0,13.0,15.0,11.0,14.0,13.0,12.0,8.0,32.0,67.0,9.0,7.0,0.0,191.0,85.0,1.0,1.0,1.0,3.0,2.0,2.0,4.0,3.0,3.0,2.0,3.0,7.0,7.0,6.0,9.0,12.0,3.0,16.0,7.0,3.0,15.0,11.0,7.0,13.0,12.0,14.0,11.0,14.0,10.0,11.0,10.0,14.0,11.0,8.0,13.0,13.0,13.0,13.0,15.0,9.0,7.0,14.0,16.0,8.0,7.0,10.0,20.0,12.0,15.0,13.0,14.0,5.0,6.0,11.0,8.0,11.0,9.0,12.0,11.0,6.0,9.0,11.0,23.0,0.0,0.0,0.0,0.0,188.0,75.0,2.0,2.0,2.0,2.0,3.0,4.0,2.0,2.0,2.0,3.0,3.0,4.0,10.0,7.0,5.0,10.0,7.0,13.0,10.0,5.0,13.0,11.0,6.0,13.0,12.0,13.0,13.0,14.0,11.0,11.0,8.0,11.0,12.0,5.0,6.0,10.0,12.0,13.0,14.0,13.0,11.0,15.0,14.0,5.0,14.0,12.0,20.0,14.0,14.0,12.0,13.0,11.0,7.0,12.0,9.0,12.0,11.0,7.0,12.0,10.0,10.0,8.0,24.0,0.0,0.0,0.0,0.0,183.0,78.0,2.0,3.0,1.0,3.0,2.0,1.0,1.0,1.0,1.0,3.0,3.0,5.0,10.0,9.0,5.0,12.0,11.0,12.0,11.0,8.0,13.0,13.0,11.0,14.0,10.0,15.0,14.0,14.0,13.0,15.0,10.0,14.0,14.0,6.0,6.0,9.0,14.0,13.0,14.0,12.0,12.0,14.0,11.0,5.0,15.0,11.0,20.0,14.0,14.0,14.0,13.0,12.0,7.0,10.0,12.0,13.0,16.0,13.0,15.0,15.0,15.0,5.0,22.0,0.0,0.0,0.0,0.0,170.0,64.0,3.0,3.0,1.0,1.0,4.0,3.0,1.0,3.0,2.0,3.0,3.0,7.0,11.0,11.0,7.0,11.0,6.0,6.0,9.0,9.0,10.0,11.0,7.0,10.0,10.0,9.0,12.0,10.0,12.0,11.0,9.0,11.0,13.0,11.0,8.0,12.0,10.0,12.0,14.0,15.0,13.0,12.0,7.0,20.0,12.0,13.0,6.0,13.0,7.0,13.0,7.0,9.0,8.0,12.0,11.0,12.0,14.0,11.0,13.0,15.0,12.0,6.0,29.0,0.0,0.0,0.0,0.0,188.0,74.0,1.0,2.0,3.0,3.0,2.0,3.0,1.0,3.0,2.0,1.0,1.0,4.0,8.0,10.0,6.0,13.0,7.0,14.0,9.0,6.0,13.0,12.0,8.0,13.0,13.0,12.0,14.0,13.0,14.0,11.0,13.0,12.0,14.0,6.0,13.0,8.0,14.0,15.0,15.0,9.0,12.0,14.0,14.0,10.0,13.0,10.0,20.0,16.0,12.0,13.0,12.0,15.0,9.0,11.0,11.0,14.0,14.0,12.0,15.0,13.0,13.0,6.0,21.0,0.0,0.0,3.0,0.0,174.0,70.0,3.0,1.0,3.0,3.0,2.0,2.0,1.0,3.0,3.0,2.0,1.0,10.0,11.0,12.0,10.0,13.0,8.0,7.0,11.0,6.0,10.0,14.0,11.0,8.0,13.0,7.0,11.0,11.0,12.0,12.0,14.0,11.0,8.0,11.0,10.0,12.0,8.0,13.0,14.0,13.0,14.0,13.0,9.0,20.0,11.0,12.0,8.0,13.0,11.0,13.0,7.0,10.0,5.0,12.0,13.0,11.0,12.0,9.0,11.0,12.0,10.0,5.0,39.0,0.0,0.0,0.0,0.0,178.0,75.0,4.0,3.0,1.0,2.0,2.0,2.0,3.0,3.0,2.0,2.0,1.0,12.0,12.0,13.0,12.0,15.0,12.0,12.0,11.0,6.0,6.0,15.0,15.0,8.0,16.0,7.0,12.0,12.0,13.0,14.0,14.0,12.0,14.0,11.0,12.0,9.0,12.0,12.0,14.0,11.0,12.0,14.0,8.0,10.0,15.0,10.0,20.0,10.0,12.0,15.0,7.0,16.0,6.0,10.0,14.0,14.0,14.0,14.0,14.0,14.0,14.0,6.0,24.0,0.0,0.0,0.0,0.0,169.0,65.0,3.0,3.0,2.0,1.0,2.0,4.0,1.0,3.0,4.0,3.0,2.0,11.0,12.0,12.0,7.0,12.0,9.0,5.0,10.0,7.0,3.0,11.0,12.0,5.0,13.0,7.0,10.0,9.0,12.0,9.0,12.0,10.0,4.0,11.0,6.0,12.0,6.0,12.0,14.0,16.0,14.0,11.0,6.0,20.0,14.0,15.0,5.0,14.0,7.0,12.0,7.0,14.0,6.0,8.0,16.0,13.0,16.0,12.0,12.0,10.0,15.0,6.0,19.0,0.0,0.0,0.0,0.0,168.0,64.0,3.0,2.0,4.0,1.0,2.0,2.0,1.0,1.0,1.0,1.0,3.0,9.0,11.0,13.0,10.0,11.0,8.0,4.0,10.0,3.0,4.0,11.0,10.0,4.0,12.0,8.0,11.0,11.0,9.0,8.0,10.0,10.0,12.0,11.0,6.0,9.0,9.0,10.0,9.0,14.0,11.0,10.0,7.0,11.0,12.0,14.0,20.0,11.0,10.0,11.0,12.0,9.0,8.0,11.0,10.0,11.0,9.0,11.0,8.0,7.0,8.0,10.0,23.0,0.0,0.0,7.0,3.0,181.0,71.0,2.0,2.0,2.0,2.0,2.0,2.0,4.0,2.0,3.0,3.0,2.0,7.0,12.0,12.0,14.0,13.0,7.0,11.0,11.0,7.0,6.0,11.0,15.0,7.0,12.0,12.0,13.0,16.0,12.0,12.0,10.0,11.0,6.0,12.0,7.0,14.0,9.0,12.0,16.0,13.0,14.0,13.0,9.0,8.0,14.0,12.0,20.0,12.0,12.0,12.0,10.0,12.0,8.0,10.0,19.0,10.0,10.0,10.0,11.0,11.0,12.0,6.0
1,0,25.0,4.0,0.0,11.0,0.0,184.0,81.0,14.0,14.0,13.0,9.0,15.0,12.0,16.0,16.0,13.0,7.0,11.0,8.0,1.0,2.0,1.0,11.0,12.0,6.0,1.0,3.0,3.0,11.0,5.0,3.0,11.0,8.0,15.0,15.0,13.0,14.0,10.0,11.0,14.0,8.0,13.0,5.0,13.0,10.0,10.0,14.0,16.0,14.0,13.0,20.0,14.0,12.0,5.0,14.0,14.0,15.0,9.0,16.0,6.0,1.0,17.0,11.0,15.0,13.0,14.0,12.0,12.0,4.0,32.0,0.0,0.0,0.0,0.0,172.0,71.0,2.0,1.0,3.0,1.0,2.0,3.0,2.0,3.0,2.0,2.0,2.0,8.0,9.0,7.0,6.0,10.0,6.0,10.0,9.0,10.0,14.0,11.0,6.0,14.0,11.0,10.0,16.0,15.0,12.0,12.0,7.0,12.0,15.0,9.0,13.0,8.0,14.0,15.0,15.0,14.0,14.0,14.0,10.0,20.0,14.0,14.0,8.0,15.0,13.0,13.0,11.0,13.0,7.0,13.0,17.0,14.0,17.0,8.0,13.0,15.0,15.0,6.0,27.0,0.0,0.0,0.0,0.0,184.0,81.0,1.0,1.0,1.0,3.0,3.0,2.0,2.0,2.0,1.0,2.0,3.0,8.0,6.0,8.0,12.0,10.0,8.0,12.0,9.0,1.0,3.0,8.0,14.0,4.0,9.0,4.0,11.0,12.0,11.0,8.0,8.0,11.0,10.0,9.0,8.0,11.0,9.0,8.0,11.0,10.0,8.0,13.0,13.0,9.0,13.0,9.0,20.0,12.0,13.0,13.0,9.0,2.0,9.0,9.0,15.0,10.0,12.0,10.0,11.0,6.0,4.0,6.0,37.0,0.0,0.0,0.0,0.0,185.0,83.0,1.0,1.0,2.0,1.0,3.0,2.0,3.0,1.0,1.0,3.0,1.0,6.0,8.0,9.0,12.0,10.0,8.0,13.0,9.0,4.0,5.0,10.0,14.0,4.0,11.0,11.0,10.0,11.0,13.0,12.0,12.0,13.0,15.0,14.0,12.0,11.0,7.0,12.0,8.0,7.0,7.0,12.0,12.0,11.0,11.0,7.0,20.0,8.0,14.0,12.0,8.0,13.0,9.0,12.0,12.0,12.0,19.0,14.0,15.0,14.0,8.0,8.0,21.0,0.0,0.0,0.0,0.0,179.0,68.0,2.0,3.0,2.0,1.0,2.0,1.0,2.0,3.0,2.0,1.0,1.0,6.0,13.0,12.0,6.0,13.0,6.0,8.0,7.0,12.0,10.0,12.0,8.0,12.0,13.0,10.0,11.0,11.0,12.0,10.0,11.0,11.0,12.0,11.0,7.0,13.0,10.0,12.0,14.0,15.0,13.0,12.0,10.0,20.0,14.0,14.0,8.0,14.0,10.0,13.0,8.0,13.0,8.0,12.0,13.0,14.0,10.0,12.0,10.0,10.0,12.0,10.0,19.0,0.0,0.0,0.0,0.0,185.0,82.0,4.0,2.0,3.0,1.0,3.0,2.0,1.0,2.0,1.0,2.0,3.0,7.0,7.0,10.0,6.0,13.0,7.0,14.0,7.0,6.0,12.0,13.0,7.0,13.0,13.0,13.0,13.0,13.0,11.0,12.0,11.0,12.0,14.0,9.0,14.0,11.0,11.0,15.0,15.0,12.0,12.0,14.0,13.0,5.0,14.0,12.0,20.0,14.0,13.0,10.0,11.0,11.0,6.0,10.0,10.0,12.0,12.0,14.0,14.0,11.0,16.0,6.0,24.0,0.0,0.0,6.0,1.0,172.0,70.0,3.0,1.0,1.0,3.0,1.0,2.0,3.0,1.0,1.0,3.0,3.0,11.0,12.0,11.0,8.0,12.0,10.0,6.0,14.0,7.0,11.0,15.0,8.0,12.0,13.0,14.0,14.0,18.0,13.0,12.0,13.0,13.0,15.0,12.0,12.0,12.0,11.0,18.0,18.0,13.0,14.0,13.0,7.0,10.0,16.0,12.0,20.0,14.0,12.0,14.0,14.0,15.0,4.0,8.0,7.0,14.0,14.0,13.0,14.0,12.0,10.0,6.0,19.0,0.0,0.0,0.0,0.0,175.0,67.0,3.0,2.0,1.0,3.0,3.0,1.0,1.0,1.0,2.0,1.0,3.0,7.0,8.0,12.0,8.0,10.0,6.0,12.0,9.0,8.0,10.0,10.0,8.0,12.0,11.0,14.0,10.0,12.0,9.0,10.0,11.0,10.0,12.0,12.0,10.0,12.0,12.0,13.0,14.0,13.0,11.0,14.0,8.0,6.0,14.0,12.0,20.0,14.0,12.0,12.0,8.0,11.0,6.0,12.0,17.0,13.0,10.0,11.0,12.0,11.0,17.0,5.0,17.0,0.0,0.0,0.0,0.0,175.0,0.0,1.0,1.0,2.0,2.0,3.0,3.0,2.0,3.0,4.0,1.0,1.0,8.0,8.0,11.0,11.0,10.0,8.0,15.0,9.0,5.0,8.0,9.0,5.0,3.0,11.0,8.0,11.0,9.0,8.0,7.0,11.0,10.0,13.0,9.0,11.0,11.0,5.0,8.0,9.0,15.0,11.0,9.0,5.0,8.0,12.0,12.0,20.0,9.0,7.0,8.0,6.0,5.0,9.0,8.0,14.0,10.0,10.0,11.0,11.0,9.0,15.0,8.0,20.0,29.0,2.0,0.0,0.0,181.0,75.0,1.0,1.0,2.0,2.0,2.0,3.0,2.0,1.0,1.0,3.0,2.0,5.0,9.0,15.0,10.0,11.0,9.0,10.0,8.0,7.0,3.0,10.0,10.0,5.0,15.0,7.0,10.0,9.0,12.0,10.0,8.0,11.0,14.0,12.0,5.0,13.0,5.0,11.0,12.0,16.0,12.0,9.0,12.0,20.0,14.0,16.0,7.0,12.0,10.0,9.0,10.0,10.0,11.0,6.0,10.0,15.0,9.0,13.0,11.0,14.0,18.0,7.0,22.0,0.0,0.0,0.0,0.0,186.0,0.0,1.0,2.0,3.0,3.0,1.0,3.0,1.0,2.0,1.0,2.0,1.0,4.0,1.0,12.0,12.0,12.0,1.0,7.0,5.0,1.0,3.0,5.0,1.0,1.0,8.0,8.0,6.0,6.0,4.0,5.0,4.0,11.0,6.0,9.0,12.0,12.0,5.0,4.0,5.0,12.0,12.0,5.0,11.0,12.0,10.0,12.0,20.0,6.0,8.0,8.0,8.0,8.0,7.0,8.0,13.0,11.0,12.0,13.0,12.0,5.0,14.0,5.0,36.0,0.0,0.0,0.0,0.0,185.0,78.0,11.0,14.0,12.0,7.0,13.0,12.0,14.0,15.0,13.0,14.0,10.0,4.0,1.0,3.0,1.0,8.0,8.0,11.0,8.0,3.0,3.0,7.0,2.0,1.0,8.0,11.0,13.0,15.0,11.0,12.0,7.0,13.0,9.0,5.0,14.0,3.0,13.0,15.0,8.0,11.0,14.0,13.0,12.0,5.0,15.0,11.0,20.0,12.0,14.0,13.0,11.0,13.0,8.0,1.0,19.0,14.0,16.0,10.0,17.0,9.0,9.0,11.0,21.0,0.0,0.0,0.0,0.0,182.0,74.0,2.0,2.0,2.0,2.0,2.0,1.0,1.0,1.0,3.0,2.0,2.0,9.0,11.0,12.0,7.0,9.0,8.0,12.0,7.0,11.0,12.0,7.0,8.0,13.0,11.0,12.0,12.0,14.0,12.0,13.0,7.0,12.0,11.0,1.0,9.0,11.0,9.0,10.0,12.0,14.0,10.0,13.0,11.0,9.0,8.0,12.0,20.0,13.0,11.0,10.0,13.0,8.0,10.0,10.0,15.0,11.0,13.0,10.0,10.0,8.0,13.0,7.0,28.0,8.0,0.0,1.0,0.0,182.0,79.0,1.0,1.0,3.0,2.0,4.0,1.0,3.0,3.0,1.0,1.0,3.0,5.0,9.0,9.0,9.0,11.0,6.0,13.0,8.0,12.0,14.0,9.0,8.0,14.0,11.0,14.0,14.0,15.0,10.0,13.0,7.0,12.0,16.0,8.0,8.0,9.0,14.0,13.0,14.0,15.0,12.0,13.0,11.0,5.0,13.0,14.0,20.0,15.0,14.0,12.0,14.0,13.0,7.0,15.0,11.0,13.0,10.0,13.0,10.0,11.0,12.0,5.0,21.0,0.0,0.0,1.0,0.0,177.0,68.0,4.0,1.0,2.0,1.0,1.0,1.0,1.0,1.0,2.0,1.0,2.0,5.0,12.0,9.0,7.0,12.0,8.0,13.0,10.0,16.0,13.0,12.0,8.0,14.0,12.0,12.0,13.0,12.0,12.0,12.0,10.0,13.0,15.0,11.0,13.0,11.0,13.0,13.0,14.0,13.0,14.0,13.0,11.0,10.0,14.0,12.0,20.0,12.0,14.0,12.0,11.0,12.0,8.0,14.0,13.0,10.0,14.0,12.0,14.0,12.0,11.0,5.0,24.0,0.0,0.0,0.0,0.0,188.0,75.0,1.0,3.0,2.0,2.0,1.0,1.0,2.0,1.0,3.0,3.0,1.0,15.0,11.0,11.0,12.0,13.0,15.0,11.0,12.0,9.0,6.0,15.0,13.0,6.0,11.0,11.0,12.0,12.0,14.0,14.0,14.0,14.0,14.0,12.0,12.0,11.0,8.0,13.0,13.0,11.0,12.0,9.0,15.0,20.0,12.0,10.0,8.0,13.0,9.0,12.0,7.0,14.0,11.0,11.0,14.0,14.0,12.0,11.0,10.0,11.0,10.0,6.0,23.0,14.0,1.0,0.0,0.0,180.0,75.0,1.0,3.0,2.0,4.0,1.0,3.0,2.0,2.0,4.0,1.0,2.0,5.0,12.0,12.0,6.0,11.0,7.0,13.0,12.0,6.0,12.0,12.0,6.0,12.0,11.0,13.0,13.0,15.0,11.0,11.0,12.0,9.0,16.0,7.0,12.0,8.0,12.0,14.0,16.0,14.0,13.0,15.0,10.0,8.0,15.0,13.0,20.0,15.0,14.0,14.0,13.0,12.0,7.0,11.0,12.0,13.0,14.0,14.0,14.0,13.0,13.0,6.0,19.0,0.0,0.0,0.0,0.0,184.0,72.0,2.0,2.0,3.0,2.0,1.0,2.0,1.0,3.0,2.0,1.0,2.0,11.0,9.0,9.0,10.0,15.0,11.0,11.0,16.0,8.0,14.0,11.0,9.0,16.0,10.0,11.0,13.0,6.0,12.0,11.0,10.0,12.0,12.0,7.0,4.0,12.0,13.0,12.0,15.0,14.0,9.0,13.0,12.0,7.0,13.0,11.0,20.0,10.0,12.0,10.0,11.0,8.0,8.0,11.0,12.0,14.0,8.0,13.0,12.0,5.0,9.0,3.0,33.0,0.0,0.0,0.0,0.0,187.0,76.0,2.0,2.0,3.0,1.0,1.0,3.0,2.0,1.0,2.0,3.0,2.0,15.0,14.0,14.0,10.0,15.0,13.0,10.0,12.0,7.0,4.0,15.0,13.0,7.0,15.0,6.0,12.0,9.0,14.0,11.0,15.0,12.0,12.0,14.0,12.0,13.0,7.0,13.0,12.0,11.0,12.0,14.0,12.0,14.0,15.0,12.0,20.0,11.0,12.0,12.0,6.0,14.0,6.0,11.0,14.0,13.0,12.0,12.0,15.0,15.0,13.0,9.0,30.0,0.0,0.0,0.0,0.0,178.0,73.0,3.0,4.0,1.0,1.0,2.0,4.0,3.0,2.0,2.0,2.0,3.0,13.0,14.0,12.0,7.0,13.0,12.0,7.0,13.0,5.0,10.0,13.0,9.0,10.0,13.0,11.0,11.0,12.0,12.0,13.0,11.0,14.0,14.0,11.0,7.0,11.0,10.0,13.0,15.0,13.0,15.0,15.0,8.0,20.0,14.0,14.0,8.0,14.0,11.0,13.0,11.0,14.0,8.0,10.0,19.0,12.0,12.0,9.0,12.0,12.0,10.0,10.0,26.0,0.0,0.0,0.0,0.0,193.0,81.0,1.0,3.0,3.0,3.0,3.0,1.0,2.0,2.0,2.0,3.0,3.0,4.0,9.0,14.0,10.0,13.0,12.0,14.0,14.0,5.0,5.0,10.0,12.0,3.0,14.0,8.0,13.0,12.0,9.0,10.0,11.0,11.0,12.0,16.0,5.0,14.0,6.0,9.0,12.0,14.0,13.0,14.0,16.0,14.0,13.0,13.0,20.0,13.0,14.0,10.0,8.0,14.0,9.0,8.0,16.0,16.0,11.0,13.0,11.0,13.0,13.0,10.0,21.0,0.0,0.0,4.0,1.0,184.0,79.0,1.0,2.0,3.0,1.0,2.0,1.0,3.0,2.0,2.0,1.0,3.0,3.0,6.0,10.0,12.0,12.0,7.0,15.0,8.0,4.0,5.0,13.0,10.0,8.0,12.0,18.0,12.0,19.0,13.0,10.0,13.0,12.0,14.0,13.0,10.0,12.0,9.0,16.0,15.0,12.0,14.0,14.0,14.0,12.0,13.0,10.0,20.0,14.0,14.0,11.0,14.0,14.0,11.0,5.0,10.0,13.0,14.0,15.0,10.0,8.0,4.0,15.0
2,1,31.0,25.0,0.0,6.0,0.0,191.0,84.0,11.0,14.0,13.0,12.0,15.0,14.0,15.0,16.0,13.0,14.0,14.0,8.0,2.0,10.0,5.0,11.0,11.0,7.0,10.0,2.0,5.0,10.0,11.0,11.0,9.0,12.0,13.0,15.0,13.0,13.0,8.0,13.0,16.0,12.0,14.0,1.0,16.0,13.0,11.0,12.0,13.0,16.0,16.0,8.0,16.0,13.0,20.0,15.0,15.0,17.0,8.0,15.0,7.0,2.0,15.0,15.0,17.0,15.0,17.0,16.0,15.0,6.0,28.0,46.0,3.0,14.0,3.0,190.0,80.0,2.0,3.0,3.0,2.0,2.0,1.0,1.0,3.0,1.0,3.0,1.0,4.0,6.0,7.0,9.0,11.0,7.0,17.0,11.0,10.0,15.0,12.0,11.0,16.0,10.0,17.0,15.0,18.0,13.0,14.0,12.0,14.0,18.0,6.0,17.0,8.0,15.0,15.0,14.0,11.0,10.0,17.0,16.0,7.0,17.0,13.0,20.0,15.0,18.0,17.0,14.0,16.0,4.0,6.0,14.0,15.0,16.0,17.0,18.0,14.0,15.0,6.0,23.0,0.0,0.0,0.0,0.0,184.0,77.0,1.0,1.0,1.0,1.0,3.0,2.0,3.0,2.0,2.0,2.0,3.0,6.0,9.0,11.0,7.0,12.0,7.0,15.0,9.0,11.0,14.0,13.0,10.0,15.0,12.0,14.0,15.0,15.0,13.0,12.0,11.0,13.0,15.0,11.0,9.0,9.0,14.0,14.0,14.0,14.0,13.0,15.0,13.0,9.0,16.0,15.0,20.0,14.0,14.0,14.0,11.0,14.0,4.0,11.0,14.0,13.0,15.0,14.0,16.0,14.0,15.0,6.0,32.0,0.0,0.0,0.0,0.0,185.0,79.0,2.0,1.0,1.0,1.0,1.0,1.0,3.0,3.0,3.0,3.0,3.0,7.0,8.0,7.0,8.0,12.0,5.0,16.0,8.0,10.0,12.0,12.0,8.0,12.0,8.0,12.0,12.0,14.0,11.0,12.0,11.0,12.0,10.0,7.0,12.0,7.0,15.0,13.0,17.0,9.0,10.0,10.0,14.0,20.0,14.0,10.0,5.0,13.0,12.0,12.0,11.0,10.0,7.0,9.0,7.0,10.0,9.0,11.0,10.0,10.0,15.0,8.0,23.0,0.0,0.0,1.0,0.0,182.0,71.0,3.0,1.0,2.0,3.0,4.0,2.0,3.0,1.0,2.0,1.0,3.0,9.0,13.0,14.0,8.0,14.0,13.0,12.0,10.0,13.0,14.0,14.0,13.0,15.0,13.0,14.0,14.0,13.0,11.0,12.0,12.0,13.0,16.0,12.0,12.0,15.0,13.0,14.0,15.0,15.0,13.0,14.0,12.0,9.0,16.0,15.0,20.0,15.0,15.0,15.0,10.0,14.0,6.0,12.0,8.0,15.0,14.0,16.0,15.0,15.0,16.0,6.0,19.0,0.0,0.0,12.0,4.0,177.0,75.0,2.0,1.0,1.0,1.0,2.0,2.0,3.0,1.0,1.0,3.0,3.0,11.0,12.0,13.0,8.0,15.0,11.0,5.0,12.0,8.0,5.0,15.0,16.0,8.0,16.0,10.0,12.0,14.0,13.0,13.0,13.0,11.0,10.0,15.0,9.0,12.0,5.0,10.0,7.0,13.0,15.0,7.0,9.0,14.0,13.0,13.0,20.0,11.0,6.0,12.0,11.0,13.0,5.0,11.0,12.0,15.0,16.0,14.0,12.0,15.0,15.0,5.0,29.0,90.0,4.0,16.0,2.0,170.0,61.0,2.0,3.0,3.0,1.0,3.0,1.0,2.0,2.0,2.0,2.0,1.0,15.0,14.0,15.0,9.0,17.0,16.0,7.0,12.0,4.0,11.0,18.0,15.0,12.0,17.0,15.0,15.0,16.0,13.0,16.0,17.0,14.0,16.0,15.0,14.0,12.0,14.0,18.0,16.0,13.0,14.0,12.0,8.0,10.0,14.0,11.0,20.0,14.0,10.0,14.0,9.0,17.0,10.0,14.0,13.0,17.0,15.0,16.0,17.0,15.0,16.0,7.0,31.0,0.0,0.0,6.0,0.0,174.0,80.0,1.0,1.0,1.0,1.0,1.0,5.0,1.0,1.0,1.0,1.0,1.0,14.0,12.0,11.0,7.0,12.0,13.0,9.0,7.0,10.0,11.0,11.0,10.0,10.0,12.0,11.0,11.0,11.0,10.0,6.0,10.0,9.0,12.0,12.0,12.0,10.0,12.0,12.0,14.0,12.0,15.0,10.0,9.0,20.0,12.0,12.0,7.0,12.0,9.0,9.0,10.0,12.0,7.0,9.0,11.0,14.0,9.0,7.0,14.0,8.0,9.0,9.0,20.0,0.0,0.0,10.0,1.0,174.0,68.0,1.0,3.0,3.0,3.0,2.0,3.0,3.0,2.0,1.0,2.0,2.0,11.0,12.0,15.0,11.0,14.0,12.0,6.0,12.0,2.0,4.0,14.0,11.0,4.0,15.0,9.0,11.0,10.0,12.0,11.0,14.0,12.0,14.0,14.0,7.0,13.0,7.0,11.0,13.0,14.0,15.0,13.0,7.0,20.0,12.0,14.0,10.0,13.0,9.0,12.0,7.0,12.0,10.0,12.0,15.0,16.0,12.0,14.0,13.0,15.0,15.0,5.0,30.0,62.0,25.0,13.0,8.0,177.0,72.0,1.0,3.0,3.0,1.0,3.0,2.0,1.0,3.0,1.0,4.0,1.0,8.0,11.0,12.0,17.0,14.0,12.0,18.0,14.0,3.0,4.0,13.0,18.0,5.0,16.0,14.0,15.0,16.0,17.0,13.0,14.0,16.0,16.0,16.0,16.0,16.0,6.0,13.0,13.0,13.0,14.0,13.0,11.0,14.0,13.0,12.0,20.0,12.0,12.0,15.0,8.0,19.0,10.0,6.0,13.0,18.0,14.0,19.0,15.0,16.0,17.0,10.0,21.0,3.0,0.0,0.0,0.0,181.0,77.0,2.0,2.0,2.0,1.0,1.0,1.0,3.0,2.0,4.0,3.0,3.0,6.0,13.0,16.0,12.0,15.0,7.0,6.0,10.0,5.0,5.0,13.0,10.0,6.0,16.0,13.0,13.0,13.0,9.0,10.0,11.0,13.0,15.0,17.0,10.0,14.0,5.0,12.0,11.0,16.0,15.0,13.0,10.0,15.0,16.0,15.0,20.0,13.0,14.0,14.0,10.0,13.0,8.0,16.0,17.0,17.0,11.0,14.0,10.0,9.0,11.0,9.0,30.0,42.0,0.0,13.0,0.0,195.0,88.0,16.0,13.0,14.0,6.0,14.0,13.0,13.0,15.0,12.0,10.0,14.0,1.0,8.0,5.0,2.0,8.0,2.0,8.0,2.0,5.0,3.0,9.0,5.0,3.0,8.0,10.0,12.0,10.0,14.0,10.0,10.0,14.0,13.0,3.0,14.0,3.0,12.0,14.0,12.0,8.0,13.0,18.0,18.0,17.0,14.0,11.0,20.0,14.0,17.0,14.0,4.0,14.0,4.0,1.0,12.0,13.0,14.0,9.0,15.0,13.0,13.0,5.0,28.0,0.0,0.0,0.0,0.0,190.0,85.0,3.0,2.0,3.0,3.0,2.0,2.0,2.0,4.0,3.0,1.0,2.0,5.0,9.0,8.0,9.0,8.0,7.0,14.0,10.0,9.0,15.0,9.0,6.0,14.0,9.0,16.0,13.0,16.0,10.0,13.0,10.0,12.0,15.0,6.0,13.0,7.0,13.0,14.0,16.0,12.0,11.0,17.0,13.0,20.0,15.0,13.0,8.0,15.0,15.0,12.0,14.0,14.0,9.0,8.0,14.0,13.0,14.0,11.0,12.0,13.0,16.0,14.0,28.0,0.0,0.0,0.0,0.0,174.0,67.0,3.0,4.0,1.0,1.0,1.0,3.0,1.0,3.0,2.0,1.0,2.0,11.0,8.0,11.0,9.0,13.0,6.0,7.0,12.0,8.0,10.0,10.0,3.0,6.0,12.0,10.0,13.0,7.0,12.0,8.0,10.0,9.0,12.0,13.0,5.0,12.0,9.0,12.0,11.0,14.0,14.0,11.0,7.0,10.0,15.0,12.0,20.0,11.0,6.0,9.0,6.0,10.0,10.0,9.0,11.0,14.0,9.0,11.0,12.0,8.0,8.0,8.0,23.0,0.0,0.0,0.0,0.0,184.0,71.0,1.0,2.0,1.0,2.0,2.0,2.0,2.0,4.0,2.0,1.0,3.0,4.0,10.0,10.0,6.0,11.0,6.0,14.0,8.0,7.0,14.0,11.0,6.0,13.0,11.0,12.0,12.0,13.0,12.0,11.0,12.0,12.0,14.0,6.0,8.0,10.0,13.0,13.0,14.0,15.0,13.0,14.0,13.0,8.0,12.0,14.0,20.0,13.0,14.0,13.0,12.0,14.0,15.0,8.0,11.0,13.0,13.0,10.0,8.0,9.0,16.0,7.0,21.0,0.0,0.0,0.0,0.0,177.0,0.0,1.0,1.0,1.0,2.0,3.0,3.0,2.0,3.0,2.0,2.0,3.0,6.0,4.0,13.0,13.0,13.0,6.0,13.0,7.0,3.0,5.0,7.0,6.0,1.0,11.0,9.0,7.0,8.0,7.0,7.0,7.0,8.0,7.0,11.0,8.0,13.0,7.0,6.0,7.0,12.0,13.0,7.0,6.0,8.0,8.0,13.0,20.0,5.0,5.0,9.0,5.0,9.0,9.0,9.0,10.0,10.0,12.0,12.0,11.0,10.0,9.0,6.0,21.0,0.0,0.0,0.0,0.0,178.0,65.0,2.0,3.0,3.0,3.0,3.0,1.0,1.0,1.0,1.0,3.0,1.0,9.0,13.0,11.0,6.0,12.0,7.0,9.0,8.0,8.0,13.0,12.0,7.0,13.0,12.0,8.0,12.0,13.0,12.0,12.0,13.0,13.0,14.0,9.0,8.0,12.0,12.0,13.0,13.0,12.0,14.0,13.0,11.0,8.0,15.0,12.0,20.0,13.0,12.0,14.0,8.0,11.0,7.0,10.0,19.0,10.0,13.0,10.0,11.0,15.0,15.0,6.0,26.0,25.0,1.0,7.0,0.0,189.0,78.0,1.0,1.0,1.0,1.0,1.0,1.0,1.0,1.0,1.0,1.0,1.0,8.0,9.0,10.0,6.0,12.0,8.0,13.0,14.0,7.0,11.0,14.0,11.0,13.0,13.0,13.0,13.0,16.0,13.0,13.0,12.0,13.0,14.0,10.0,10.0,12.0,13.0,15.0,15.0,12.0,11.0,9.0,15.0,10.0,14.0,13.0,20.0,14.0,14.0,12.0,13.0,11.0,14.0,12.0,14.0,11.0,14.0,12.0,16.0,15.0,13.0,5.0,22.0,0.0,0.0,0.0,0.0,187.0,84.0,2.0,2.0,1.0,2.0,3.0,2.0,2.0,3.0,3.0,2.0,2.0,4.0,7.0,10.0,6.0,9.0,10.0,13.0,12.0,5.0,11.0,11.0,7.0,10.0,12.0,12.0,11.0,13.0,10.0,9.0,11.0,9.0,15.0,8.0,7.0,9.0,11.0,11.0,14.0,13.0,10.0,15.0,14.0,8.0,15.0,11.0,20.0,14.0,15.0,11.0,12.0,7.0,9.0,8.0,7.0,13.0,15.0,13.0,11.0,14.0,14.0,7.0,21.0,0.0,0.0,0.0,0.0,172.0,66.0,2.0,3.0,2.0,2.0,1.0,1.0,1.0,3.0,2.0,1.0,1.0,10.0,10.0,13.0,9.0,14.0,9.0,8.0,10.0,7.0,13.0,13.0,9.0,12.0,13.0,10.0,12.0,13.0,13.0,12.0,14.0,13.0,13.0,11.0,9.0,14.0,13.0,14.0,14.0,14.0,13.0,12.0,8.0,8.0,12.0,12.0,20.0,13.0,12.0,14.0,10.0,11.0,8.0,12.0,15.0,10.0,15.0,8.0,11.0,14.0,14.0,6.0,22.0,0.0,0.0,0.0,0.0,177.0,72.0,2.0,1.0,2.0,4.0,2.0,2.0,1.0,3.0,4.0,2.0,3.0,10.0,12.0,13.0,11.0,12.0,10.0,12.0,12.0,4.0,10.0,13.0,11.0,11.0,13.0,11.0,12.0,11.0,13.0,9.0,13.0,12.0,3.0,12.0,8.0,14.0,12.0,12.0,13.0,16.0,13.0,12.0,9.0,8.0,15.0,14.0,20.0,14.0,13.0,10.0,4.0,11.0,11.0,12.0,19.0,9.0,12.0,13.0,12.0,11.0,14.0,7.0,25.0,0.0,0.0,0.0,0.0,187.0,83.0,2.0,1.0,3.0,3.0,1.0,3.0,3.0,3.0,1.0,1.0,3.0,4.0,8.0,10.0,14.0,12.0,8.0,14.0,9.0,5.0,7.0,11.0,13.0,5.0,12.0,11.0,13.0,13.0,13.0,11.0,10.0,12.0,16.0,9.0,8.0,13.0,11.0,13.0,16.0,14.0,13.0,15.0,13.0,20.0,14.0,12.0,8.0,14.0,16.0,13.0,11.0,13.0,7.0,5.0,13.0,14.0,13.0,14.0,14.0,13.0,13.0,6.0
1,1,33.0,0.0,0.0,3.0,0.0,188.0,84.0,14.0,13.0,13.0,9.0,13.0,13.0,15.0,15.0,11.0,11.0,9.0,7.0,3.0,3.0,1.0,7.0,10.0,2.0,1.0,1.0,2.0,6.0,4.0,1.0,7.0,8.0,13.0,14.0,14.0,14.0,8.0,11.0,15.0,6.0,13.0,3.0,13.0,12.0,8.0,12.0,14.0,15.0,14.0,8.0,13.0,11.0,20.0,13.0,15.0,16.0,8.0,13.0,6.0,1.0,11.0,14.0,13.0,11.0,16.0,14.0,11.0,6.0,29.0,2.0,0.0,0.0,0.0,185.0,75.0,2.0,3.0,3.0,3.0,2.0,3.0,2.0,1.0,3.0,1.0,2.0,4.0,10.0,8.0,6.0,10.0,6.0,14.0,7.0,7.0,14.0,11.0,6.0,14.0,9.0,13.0,13.0,14.0,11.0,12.0,12.0,12.0,14.0,8.0,11.0,12.0,13.0,13.0,13.0,15.0,12.0,15.0,12.0,8.0,15.0,13.0,20.0,14.0,15.0,14.0,7.0,14.0,8.0,6.0,14.0,13.0,15.0,14.0,14.0,14.0,14.0,6.0,28.0,0.0,0.0,0.0,0.0,193.0,84.0,1.0,1.0,2.0,2.0,2.0,3.0,2.0,3.0,2.0,1.0,3.0,4.0,8.0,8.0,9.0,10.0,6.0,14.0,7.0,8.0,14.0,12.0,6.0,14.0,11.0,12.0,13.0,14.0,11.0,14.0,12.0,12.0,14.0,6.0,11.0,8.0,14.0,13.0,13.0,11.0,11.0,16.0,16.0,20.0,12.0,12.0,8.0,14.0,16.0,14.0,12.0,13.0,6.0,10.0,7.0,12.0,15.0,12.0,16.0,15.0,13.0,6.0,26.0,0.0,0.0,0.0,0.0,182.0,68.0,1.0,4.0,3.0,2.0,3.0,1.0,2.0,1.0,2.0,4.0,1.0,7.0,12.0,9.0,5.0,10.0,6.0,12.0,7.0,15.0,12.0,9.0,6.0,12.0,10.0,12.0,13.0,14.0,11.0,10.0,9.0,9.0,13.0,7.0,6.0,10.0,10.0,14.0,15.0,16.0,13.0,13.0,11.0,5.0,15.0,15.0,20.0,14.0,10.0,12.0,12.0,13.0,7.0,12.0,12.0,14.0,14.0,15.0,13.0,14.0,14.0,7.0,26.0,0.0,0.0,0.0,0.0,175.0,69.0,3.0,3.0,2.0,2.0,3.0,1.0,3.0,1.0,3.0,2.0,2.0,6.0,12.0,10.0,5.0,11.0,6.0,10.0,10.0,10.0,13.0,12.0,9.0,13.0,12.0,12.0,13.0,14.0,12.0,13.0,12.0,11.0,15.0,11.0,13.0,12.0,13.0,14.0,14.0,15.0,13.0,12.0,7.0,9.0,13.0,13.0,20.0,14.0,11.0,14.0,12.0,12.0,11.0,15.0,14.0,9.0,17.0,10.0,8.0,11.0,20.0,7.0,27.0,32.0,6.0,0.0,0.0,188.0,78.0,3.0,2.0,3.0,2.0,1.0,3.0,3.0,3.0,2.0,2.0,2.0,4.0,8.0,11.0,12.0,12.0,6.0,16.0,13.0,8.0,13.0,14.0,7.0,12.0,12.0,12.0,10.0,14.0,13.0,12.0,11.0,12.0,15.0,9.0,11.0,12.0,6.0,13.0,12.0,14.0,13.0,15.0,15.0,5.0,13.0,12.0,20.0,16.0,15.0,14.0,12.0,15.0,11.0,10.0,9.0,15.0,12.0,12.0,13.0,13.0,13.0,7.0,21.0,0.0,0.0,0.0,0.0,183.0,73.0,1.0,4.0,3.0,3.0,3.0,1.0,4.0,1.0,2.0,3.0,2.0,11.0,10.0,12.0,11.0,13.0,9.0,12.0,10.0,5.0,8.0,12.0,9.0,8.0,13.0,13.0,12.0,12.0,10.0,12.0,14.0,12.0,12.0,14.0,8.0,12.0,8.0,12.0,12.0,14.0,14.0,14.0,11.0,8.0,13.0,13.0,20.0,12.0,12.0,12.0,5.0,10.0,7.0,12.0,15.0,11.0,11.0,10.0,11.0,12.0,11.0,4.0,29.0,0.0,0.0,0.0,0.0,183.0,78.0,1.0,3.0,3.0,3.0,3.0,1.0,2.0,3.0,3.0,1.0,1.0,13.0,8.0,9.0,6.0,12.0,14.0,13.0,10.0,12.0,11.0,12.0,8.0,13.0,12.0,12.0,15.0,13.0,13.0,13.0,11.0,13.0,15.0,6.0,12.0,7.0,13.0,16.0,18.0,12.0,11.0,14.0,12.0,20.0,14.0,11.0,8.0,16.0,14.0,14.0,12.0,14.0,6.0,12.0,10.0,12.0,13.0,11.0,15.0,15.0,15.0,5.0,23.0,0.0,0.0,0.0,0.0,175.0,70.0,2.0,1.0,2.0,2.0,1.0,2.0,2.0,3.0,4.0,1.0,2.0,10.0,11.0,12.0,9.0,13.0,8.0,6.0,13.0,2.0,5.0,13.0,10.0,6.0,13.0,7.0,13.0,9.0,13.0,11.0,13.0,12.0,13.0,12.0,10.0,12.0,10.0,13.0,12.0,11.0,12.0,13.0,8.0,8.0,14.0,12.0,20.0,14.0,12.0,13.0,9.0,11.0,10.0,11.0,19.0,12.0,14.0,11.0,13.0,10.0,16.0,7.0,18.0,0.0,0.0,0.0,0.0,188.0,0.0,2.0,2.0,1.0,1.0,1.0,2.0,1.0,4.0,2.0,2.0,1.0,8.0,11.0,14.0,11.0,13.0,10.0,11.0,10.0,2.0,6.0,12.0,11.0,8.0,13.0,8.0,11.0,9.0,13.0,9.0,13.0,11.0,14.0,15.0,8.0,12.0,7.0,11.0,13.0,14.0,12.0,12.0,13.0,12.0,11.0,14.0,20.0,11.0,11.0,12.0,8.0,11.0,8.0,14.0,12.0,11.0,10.0,12.0,13.0,12.0,14.0,7.0,23.0,1.0,0.0,0.0,0.0,185.0,70.0,4.0,3.0,1.0,2.0,1.0,3.0,2.0,3.0,1.0,2.0,3.0,5.0,8.0,12.0,13.0,13.0,7.0,14.0,11.0,5.0,5.0,8.0,13.0,5.0,13.0,6.0,13.0,10.0,12.0,12.0,11.0,11.0,13.0,12.0,7.0,13.0,9.0,8.0,10.0,16.0,12.0,14.0,12.0,8.0,14.0,15.0,20.0,13.0,13.0,12.0,7.0,15.0,7.0,7.0,13.0,13.0,12.0,10.0,12.0,15.0,15.0,7.0,27.0,0.0,0.0,0.0,0.0,185.0,81.0,13.0,11.0,11.0,9.0,11.0,11.0,12.0,13.0,11.0,14.0,8.0,4.0,1.0,1.0,2.0,9.0,8.0,7.0,2.0,2.0,1.0,8.0,5.0,1.0,8.0,10.0,12.0,15.0,12.0,12.0,8.0,11.0,14.0,6.0,11.0,2.0,11.0,12.0,6.0,12.0,13.0,14.0,13.0,5.0,14.0,10.0,20.0,12.0,13.0,12.0,10.0,13.0,10.0,1.0,10.0,14.0,14.0,12.0,13.0,14.0,11.0,7.0,29.0,0.0,0.0,0.0,0.0,185.0,84.0,3.0,2.0,2.0,2.0,1.0,3.0,1.0,2.0,1.0,3.0,1.0,3.0,6.0,6.0,7.0,10.0,5.0,14.0,5.0,4.0,14.0,9.0,7.0,13.0,9.0,13.0,13.0,14.0,12.0,13.0,8.0,12.0,14.0,8.0,16.0,8.0,12.0,13.0,15.0,11.0,11.0,15.0,12.0,5.0,14.0,12.0,20.0,14.0,16.0,13.0,12.0,10.0,7.0,7.0,7.0,12.0,13.0,13.0,14.0,13.0,12.0,8.0,27.0,0.0,0.0,0.0,0.0,169.0,60.0,3.0,2.0,1.0,3.0,3.0,2.0,1.0,3.0,3.0,2.0,2.0,11.0,11.0,13.0,9.0,13.0,12.0,8.0,10.0,4.0,5.0,14.0,8.0,5.0,13.0,12.0,9.0,9.0,10.0,10.0,10.0,9.0,16.0,13.0,4.0,14.0,8.0,11.0,8.0,16.0,16.0,9.0,9.0,5.0,13.0,15.0,20.0,11.0,11.0,10.0,8.0,7.0,5.0,11.0,14.0,10.0,12.0,11.0,12.0,10.0,13.0,8.0,16.0,0.0,0.0,0.0,0.0,177.0,0.0,3.0,2.0,1.0,1.0,3.0,3.0,2.0,2.0,2.0,1.0,3.0,1.0,3.0,2.0,2.0,4.0,1.0,3.0,1.0,6.0,9.0,2.0,1.0,9.0,6.0,14.0,4.0,5.0,5.0,3.0,2.0,5.0,4.0,5.0,7.0,4.0,8.0,4.0,3.0,10.0,7.0,13.0,7.0,15.0,13.0,9.0,20.0,5.0,8.0,7.0,11.0,5.0,8.0,8.0,11.0,11.0,5.0,14.0,20.0,7.0,12.0,5.0,30.0,0.0,0.0,0.0,0.0,178.0,79.0,1.0,2.0,2.0,3.0,2.0,2.0,1.0,2.0,1.0,2.0,1.0,11.0,13.0,9.0,6.0,11.0,11.0,12.0,11.0,10.0,12.0,12.0,7.0,13.0,11.0,15.0,13.0,15.0,11.0,12.0,10.0,12.0,13.0,12.0,15.0,10.0,12.0,16.0,15.0,14.0,12.0,13.0,9.0,5.0,13.0,12.0,20.0,15.0,14.0,14.0,14.0,13.0,9.0,14.0,18.0,12.0,15.0,14.0,14.0,14.0,14.0,6.0,22.0,0.0,0.0,0.0,0.0,188.0,79.0,1.0,2.0,2.0,3.0,2.0,2.0,3.0,4.0,3.0,2.0,1.0,8.0,10.0,11.0,7.0,11.0,8.0,10.0,8.0,7.0,8.0,10.0,10.0,11.0,11.0,11.0,12.0,13.0,11.0,10.0,8.0,11.0,10.0,8.0,8.0,12.0,10.0,12.0,15.0,13.0,12.0,14.0,14.0,20.0,13.0,12.0,8.0,14.0,14.0,12.0,10.0,6.0,8.0,15.0,11.0,11.0,11.0,11.0,11.0,10.0,12.0,6.0,26.0,0.0,0.0,0.0,0.0,184.0,76.0,2.0,3.0,1.0,3.0,1.0,1.0,3.0,1.0,3.0,2.0,2.0,10.0,12.0,14.0,12.0,14.0,12.0,11.0,13.0,11.0,13.0,14.0,13.0,12.0,15.0,14.0,13.0,12.0,11.0,11.0,13.0,14.0,14.0,12.0,13.0,12.0,11.0,11.0,14.0,15.0,14.0,13.0,10.0,5.0,14.0,14.0,20.0,14.0,14.0,14.0,7.0,16.0,6.0,8.0,19.0,14.0,14.0,14.0,14.0,14.0,14.0,6.0,28.0,0.0,0.0,0.0,0.0,181.0,75.0,4.0,2.0,1.0,3.0,3.0,3.0,2.0,2.0,2.0,2.0,2.0,13.0,12.0,12.0,9.0,12.0,13.0,7.0,11.0,7.0,7.0,13.0,5.0,7.0,13.0,9.0,13.0,3.0,12.0,11.0,12.0,12.0,3.0,12.0,14.0,12.0,9.0,12.0,13.0,13.0,13.0,10.0,11.0,20.0,13.0,12.0,6.0,13.0,9.0,13.0,6.0,13.0,8.0,10.0,20.0,12.0,14.0,11.0,13.0,10.0,11.0,4.0,29.0,0.0,0.0,0.0,0.0,180.0,74.0,2.0,1.0,3.0,3.0,2.0,4.0,1.0,3.0,3.0,2.0,2.0,9.0,13.0,13.0,10.0,14.0,10.0,12.0,12.0,6.0,8.0,12.0,8.0,8.0,14.0,10.0,13.0,14.0,13.0,12.0,13.0,11.0,13.0,11.0,7.0,10.0,10.0,14.0,14.0,14.0,13.0,13.0,12.0,10.0,14.0,13.0,20.0,14.0,11.0,14.0,10.0,15.0,8.0,10.0,8.0,12.0,14.0,16.0,14.0,15.0,15.0,6.0,18.0,0.0,0.0,0.0,0.0,184.0,71.0,2.0,3.0,2.0,3.0,1.0,2.0,1.0,3.0,2.0,1.0,3.0,8.0,10.0,14.0,10.0,12.0,8.0,5.0,10.0,3.0,5.0,12.0,7.0,6.0,13.0,8.0,8.0,8.0,11.0,8.0,11.0,14.0,12.0,10.0,11.0,10.0,9.0,9.0,13.0,14.0,13.0,5.0,10.0,10.0,13.0,14.0,20.0,12.0,8.0,10.0,8.0,10.0,4.0,10.0,11.0,12.0,11.0,12.0,13.0,11.0,13.0,6.0,24.0,0.0,0.0,4.0,0.0,181.0,79.0,1.0,3.0,2.0,2.0,1.0,1.0,1.0,2.0,2.0,2.0,1.0,4.0,6.0,10.0,11.0,11.0,7.0,12.0,10.0,5.0,5.0,7.0,13.0,3.0,10.0,9.0,12.0,12.0,11.0,10.0,6.0,10.0,8.0,9.0,5.0,11.0,5.0,9.0,12.0,15.0,13.0,13.0,11.0,5.0,11.0,14.0,20.0,13.0,14.0,11.0,9.0,12.0,13.0,5.0,19.0,11.0,9.0,9.0,7.0,14.0,14.0,13.0
0,5,33.0,70.0,0.0,0.0,0.0,185.0,81.0,12.0,9.0,11.0,10.0,11.0,11.0,12.0,15.0,10.0,15.0,8.0,6.0,2.0,8.0,1.0,12.0,8.0,10.0,1.0,2.0,1.0,2.0,1.0,3.0,11.0,10.0,9.0,13.0,11.0,15.0,9.0,11.0,15.0,2.0,10.0,1.0,12.0,17.0,9.0,7.0,14.0,13.0,14.0,10.0,7.0,9.0,20.0,11.0,10.0,14.0,11.0,13.0,6.0,11.0,18.0,18.0,10.0,10.0,17.0,14.0,12.0,2.0,26.0,1.0,0.0,0.0,0.0,185.0,80.0,3.0,1.0,3.0,3.0,3.0,3.0,2.0,3.0,4.0,2.0,1.0,5.0,9.0,11.0,8.0,11.0,6.0,12.0,8.0,10.0,15.0,11.0,12.0,14.0,12.0,16.0,12.0,17.0,14.0,9.0,9.0,10.0,15.0,13.0,9.0,7.0,10.0,8.0,12.0,15.0,13.0,17.0,14.0,8.0,13.0,18.0,20.0,13.0,14.0,11.0,12.0,11.0,4.0,10.0,12.0,12.0,13.0,10.0,10.0,8.0,7.0,14.0,24.0,0.0,0.0,0.0,0.0,175.0,68.0,4.0,3.0,3.0,4.0,1.0,3.0,2.0,2.0,3.0,3.0,1.0,8.0,12.0,11.0,7.0,11.0,8.0,9.0,12.0,13.0,11.0,11.0,7.0,12.0,13.0,12.0,11.0,14.0,12.0,11.0,10.0,12.0,14.0,6.0,8.0,13.0,12.0,14.0,14.0,13.0,13.0,10.0,6.0,12.0,14.0,13.0,20.0,14.0,9.0,13.0,6.0,12.0,5.0,15.0,15.0,10.0,10.0,13.0,14.0,15.0,13.0,4.0,29.0,0.0,0.0,0.0,0.0,170.0,66.0,1.0,1.0,1.0,1.0,4.0,3.0,1.0,2.0,3.0,1.0,1.0,11.0,13.0,12.0,7.0,12.0,10.0,7.0,12.0,9.0,13.0,12.0,8.0,12.0,13.0,14.0,11.0,15.0,12.0,14.0,10.0,12.0,14.0,12.0,10.0,13.0,8.0,13.0,15.0,14.0,13.0,10.0,7.0,20.0,15.0,13.0,10.0,15.0,7.0,14.0,14.0,14.0,6.0,16.0,9.0,13.0,14.0,14.0,16.0,11.0,9.0,9.0,20.0,0.0,0.0,0.0,0.0,190.0,80.0,2.0,2.0,1.0,4.0,2.0,2.0,3.0,4.0,2.0,2.0,1.0,12.0,12.0,10.0,9.0,11.0,7.0,12.0,8.0,12.0,10.0,10.0,9.0,12.0,11.0,13.0,11.0,13.0,11.0,12.0,8.0,11.0,11.0,7.0,8.0,10.0,10.0,13.0,12.0,13.0,12.0,12.0,15.0,20.0,13.0,14.0,6.0,13.0,14.0,12.0,6.0,10.0,5.0,13.0,16.0,13.0,9.0,12.0,10.0,10.0,11.0,4.0,24.0,0.0,0.0,0.0,0.0,174.0,68.0,3.0,1.0,3.0,1.0,1.0,2.0,1.0,3.0,1.0,1.0,1.0,13.0,12.0,12.0,10.0,13.0,13.0,8.0,13.0,10.0,6.0,14.0,12.0,7.0,13.0,9.0,13.0,11.0,13.0,11.0,13.0,13.0,12.0,11.0,7.0,12.0,9.0,12.0,12.0,14.0,13.0,12.0,8.0,8.0,14.0,12.0,20.0,13.0,10.0,13.0,10.0,13.0,7.0,12.0,14.0,14.0,15.0,9.0,11.0,13.0,12.0,8.0,27.0,27.0,1.0,2.0,1.0,183.0,72.0,2.0,2.0,2.0,1.0,2.0,1.0,3.0,1.0,2.0,2.0,4.0,5.0,8.0,10.0,6.0,11.0,10.0,14.0,11.0,5.0,14.0,12.0,10.0,15.0,11.0,14.0,13.0,16.0,11.0,11.0,9.0,10.0,12.0,8.0,12.0,8.0,13.0,14.0,14.0,14.0,12.0,16.0,11.0,8.0,12.0,13.0,20.0,15.0,15.0,10.0,14.0,11.0,7.0,11.0,13.0,13.0,9.0,9.0,11.0,10.0,10.0,8.0,31.0,0.0,0.0,0.0,0.0,180.0,74.0,3.0,2.0,3.0,1.0,2.0,3.0,2.0,1.0,4.0,3.0,3.0,12.0,12.0,10.0,9.0,13.0,14.0,11.0,13.0,6.0,10.0,14.0,15.0,13.0,13.0,15.0,14.0,17.0,12.0,14.0,13.0,13.0,15.0,7.0,13.0,10.0,13.0,18.0,15.0,9.0,11.0,14.0,10.0,10.0,13.0,12.0,20.0,15.0,14.0,14.0,13.0,15.0,8.0,7.0,19.0,13.0,13.0,13.0,13.0,13.0,12.0,9.0,27.0,0.0,0.0,11.0,1.0,174.0,72.0,2.0,3.0,4.0,1.0,1.0,4.0,3.0,3.0,3.0,3.0,1.0,10.0,13.0,14.0,8.0,14.0,7.0,6.0,11.0,5.0,6.0,13.0,10.0,5.0,14.0,7.0,12.0,10.0,10.0,12.0,9.0,12.0,12.0,12.0,4.0,14.0,6.0,9.0,13.0,16.0,14.0,10.0,6.0,9.0,13.0,16.0,20.0,12.0,9.0,14.0,6.0,11.0,7.0,10.0,10.0,13.0,12.0,11.0,14.0,14.0,16.0,8.0,26.0,0.0,0.0,15.0,6.0,182.0,80.0,1.0,4.0,1.0,3.0,1.0,3.0,3.0,1.0,2.0,1.0,3.0,5.0,9.0,11.0,12.0,10.0,9.0,13.0,10.0,5.0,4.0,9.0,13.0,6.0,12.0,9.0,12.0,12.0,12.0,12.0,11.0,12.0,12.0,13.0,8.0,13.0,10.0,12.0,12.0,16.0,15.0,12.0,12.0,7.0,14.0,16.0,20.0,12.0,15.0,12.0,6.0,12.0,7.0,10.0,11.0,11.0,13.0,8.0,12.0,14.0,14.0,7.0,28.0,0.0,0.0,2.0,2.0,182.0,79.0,1.0,1.0,2.0,2.0,3.0,1.0,2.0,3.0,1.0,2.0,2.0,8.0,11.0,14.0,12.0,14.0,11.0,12.0,13.0,6.0,4.0,11.0,13.0,5.0,14.0,11.0,12.0,13.0,10.0,12.0,11.0,11.0,15.0,13.0,7.0,14.0,7.0,12.0,14.0,15.0,14.0,14.0,12.0,8.0,15.0,14.0,20.0,15.0,14.0,12.0,11.0,15.0,8.0,8.0,16.0,15.0,12.0,11.0,14.0,13.0,12.0,8.0,25.0,4.0,0.0,11.0,0.0,184.0,81.0,14.0,14.0,13.0,9.0,15.0,12.0,16.0,16.0,13.0,7.0,11.0,8.0,1.0,2.0,1.0,11.0,12.0,6.0,1.0,3.0,3.0,11.0,5.0,3.0,11.0,8.0,15.0,15.0,13.0,14.0,10.0,11.0,14.0,8.0,13.0,5.0,13.0,10.0,10.0,14.0,16.0,14.0,13.0,20.0,14.0,12.0,5.0,14.0,14.0,15.0,9.0,16.0,6.0,1.0,17.0,11.0,15.0,13.0,14.0,12.0,12.0,4.0,32.0,0.0,0.0,0.0,0.0,172.0,71.0,2.0,1.0,3.0,1.0,2.0,3.0,2.0,3.0,2.0,2.0,2.0,8.0,9.0,7.0,6.0,10.0,6.0,10.0,9.0,10.0,14.0,11.0,6.0,14.0,11.0,10.0,16.0,15.0,12.0,12.0,7.0,12.0,15.0,9.0,13.0,8.0,14.0,15.0,15.0,14.0,14.0,14.0,10.0,20.0,14.0,14.0,8.0,15.0,13.0,13.0,11.0,13.0,7.0,13.0,17.0,14.0,17.0,8.0,13.0,15.0,15.0,6.0,27.0,0.0,0.0,0.0,0.0,184.0,81.0,1.0,1.0,1.0,3.0,3.0,2.0,2.0,2.0,1.0,2.0,3.0,8.0,6.0,8.0,12.0,10.0,8.0,12.0,9.0,1.0,3.0,8.0,14.0,4.0,9.0,4.0,11.0,12.0,11.0,8.0,8.0,11.0,10.0,9.0,8.0,11.0,9.0,8.0,11.0,10.0,8.0,13.0,13.0,9.0,13.0,9.0,20.0,12.0,13.0,13.0,9.0,2.0,9.0,9.0,15.0,10.0,12.0,10.0,11.0,6.0,4.0,6.0,21.0,0.0,0.0,0.0,0.0,179.0,68.0,2.0,3.0,2.0,1.0,2.0,1.0,2.0,3.0,2.0,1.0,1.0,6.0,13.0,12.0,6.0,13.0,6.0,8.0,7.0,12.0,10.0,12.0,8.0,12.0,13.0,10.0,11.0,11.0,12.0,10.0,11.0,11.0,12.0,11.0,7.0,13.0,10.0,12.0,14.0,15.0,13.0,12.0,10.0,20.0,14.0,14.0,8.0,14.0,10.0,13.0,8.0,13.0,8.0,12.0,13.0,14.0,10.0,12.0,10.0,10.0,12.0,10.0,37.0,0.0,0.0,0.0,0.0,185.0,83.0,1.0,1.0,2.0,1.0,3.0,2.0,3.0,1.0,1.0,3.0,1.0,6.0,8.0,9.0,12.0,10.0,8.0,13.0,9.0,4.0,5.0,10.0,14.0,4.0,11.0,11.0,10.0,11.0,13.0,12.0,12.0,13.0,15.0,14.0,12.0,11.0,7.0,12.0,8.0,7.0,7.0,12.0,12.0,11.0,11.0,7.0,20.0,8.0,14.0,12.0,8.0,13.0,9.0,12.0,12.0,12.0,19.0,14.0,15.0,14.0,8.0,8.0,19.0,0.0,0.0,0.0,0.0,185.0,82.0,4.0,2.0,3.0,1.0,3.0,2.0,1.0,2.0,1.0,2.0,3.0,7.0,7.0,10.0,6.0,13.0,7.0,14.0,7.0,6.0,12.0,13.0,7.0,13.0,13.0,13.0,13.0,13.0,11.0,12.0,11.0,12.0,14.0,9.0,14.0,11.0,11.0,15.0,15.0,12.0,12.0,14.0,13.0,5.0,14.0,12.0,20.0,14.0,13.0,10.0,11.0,11.0,6.0,10.0,10.0,12.0,12.0,14.0,14.0,11.0,16.0,6.0,19.0,0.0,0.0,0.0,0.0,175.0,67.0,3.0,2.0,1.0,3.0,3.0,1.0,1.0,1.0,2.0,1.0,3.0,7.0,8.0,12.0,8.0,10.0,6.0,12.0,9.0,8.0,10.0,10.0,8.0,12.0,11.0,14.0,10.0,12.0,9.0,10.0,11.0,10.0,12.0,12.0,10.0,12.0,12.0,13.0,14.0,13.0,11.0,14.0,8.0,6.0,14.0,12.0,20.0,14.0,12.0,12.0,8.0,11.0,6.0,12.0,17.0,13.0,10.0,11.0,12.0,11.0,17.0,5.0,18.0,0.0,0.0,0.0,0.0,170.0,67.0,3.0,1.0,3.0,3.0,3.0,4.0,1.0,2.0,1.0,2.0,2.0,11.0,11.0,12.0,13.0,12.0,11.0,6.0,10.0,8.0,7.0,12.0,10.0,7.0,13.0,9.0,11.0,8.0,10.0,10.0,12.0,12.0,15.0,12.0,12.0,11.0,12.0,11.0,12.0,12.0,12.0,10.0,6.0,5.0,14.0,12.0,20.0,10.0,9.0,10.0,8.0,2.0,6.0,12.0,11.0,11.0,12.0,13.0,14.0,11.0,13.0,4.0,24.0,0.0,0.0,6.0,1.0,172.0,70.0,3.0,1.0,1.0,3.0,1.0,2.0,3.0,1.0,1.0,3.0,3.0,11.0,12.0,11.0,8.0,12.0,10.0,6.0,14.0,7.0,11.0,15.0,8.0,12.0,13.0,14.0,14.0,18.0,13.0,12.0,13.0,13.0,15.0,12.0,12.0,12.0,11.0,18.0,18.0,13.0,14.0,13.0,7.0,10.0,16.0,12.0,20.0,14.0,12.0,14.0,14.0,15.0,4.0,8.0,7.0,14.0,14.0,13.0,14.0,12.0,10.0,6.0,20.0,29.0,2.0,0.0,0.0,181.0,75.0,1.0,1.0,2.0,2.0,2.0,3.0,2.0,1.0,1.0,3.0,2.0,5.0,9.0,15.0,10.0,11.0,9.0,10.0,8.0,7.0,3.0,10.0,10.0,5.0,15.0,7.0,10.0,9.0,12.0,10.0,8.0,11.0,14.0,12.0,5.0,13.0,5.0,11.0,12.0,16.0,12.0,9.0,12.0,20.0,14.0,16.0,7.0,12.0,10.0,9.0,10.0,10.0,11.0,6.0,10.0,15.0,9.0,13.0,11.0,14.0,18.0,7.0,22.0,24.0,3.0,7.0,0.0,177.0,78.0,2.0,1.0,2.0,3.0,2.0,2.0,4.0,3.0,3.0,2.0,1.0,10.0,13.0,16.0,14.0,16.0,16.0,8.0,16.0,4.0,4.0,15.0,12.0,4.0,16.0,12.0,11.0,12.0,13.0,10.0,11.0,8.0,13.0,17.0,5.0,14.0,5.0,10.0,12.0,15.0,14.0,13.0,9.0,10.0,17.0,16.0,20.0,15.0,14.0,12.0,11.0,15.0,4.0,12.0,19.0,16.0,14.0,14.0,11.0,13.0,10.0,12.0
1,1,30.0,42.0,0.0,13.0,0.0,195.0,88.0,16.0,13.0,14.0,6.0,14.0,13.0,13.0,15.0,12.0,10.0,14.0,1.0,8.0,5.0,2.0,8.0,2.0,8.0,2.0,5.0,3.0,9.0,5.0,3.0,8.0,10.0,12.0,10.0,14.0,10.0,10.0,14.0,13.0,3.0,14.0,3.0,12.0,14.0,12.0,8.0,13.0,18.0,18.0,17.0,14.0,11.0,20.0,14.0,17.0,14.0,4.0,14.0,4.0,1.0,12.0,13.0,14.0,9.0,15.0,13.0,13.0,5.0,24.0,0.0,0.0,0.0,0.0,185.0,77.0,1.0,1.0,3.0,2.0,1.0,1.0,3.0,1.0,3.0,3.0,1.0,7.0,10.0,12.0,11.0,12.0,12.0,14.0,13.0,7.0,13.0,12.0,8.0,14.0,12.0,10.0,13.0,11.0,13.0,13.0,12.0,13.0,16.0,10.0,8.0,12.0,13.0,13.0,13.0,14.0,14.0,12.0,14.0,12.0,14.0,13.0,20.0,11.0,12.0,12.0,12.0,10.0,11.0,7.0,17.0,11.0,10.0,10.0,10.0,7.0,8.0,5.0,28.0,0.0,0.0,0.0,0.0,190.0,85.0,3.0,2.0,3.0,3.0,2.0,2.0,2.0,4.0,3.0,1.0,2.0,5.0,9.0,8.0,9.0,8.0,7.0,14.0,10.0,9.0,15.0,9.0,6.0,14.0,9.0,16.0,13.0,16.0,10.0,13.0,10.0,12.0,15.0,6.0,13.0,7.0,13.0,14.0,16.0,12.0,11.0,17.0,13.0,20.0,15.0,13.0,8.0,15.0,15.0,12.0,14.0,14.0,9.0,8.0,14.0,13.0,14.0,11.0,12.0,13.0,16.0,14.0,23.0,0.0,0.0,0.0,0.0,184.0,71.0,1.0,2.0,1.0,2.0,2.0,2.0,2.0,4.0,2.0,1.0,3.0,4.0,10.0,10.0,6.0,11.0,6.0,14.0,8.0,7.0,14.0,11.0,6.0,13.0,11.0,12.0,12.0,13.0,12.0,11.0,12.0,12.0,14.0,6.0,8.0,10.0,13.0,13.0,14.0,15.0,13.0,14.0,13.0,8.0,12.0,14.0,20.0,13.0,14.0,13.0,12.0,14.0,15.0,8.0,11.0,13.0,13.0,10.0,8.0,9.0,16.0,7.0,19.0,0.0,0.0,0.0,0.0,189.0,78.0,2.0,2.0,2.0,1.0,1.0,1.0,3.0,1.0,2.0,1.0,2.0,7.0,8.0,9.0,7.0,9.0,6.0,12.0,8.0,8.0,12.0,12.0,6.0,13.0,11.0,15.0,13.0,14.0,11.0,10.0,8.0,12.0,14.0,6.0,9.0,11.0,11.0,13.0,14.0,13.0,12.0,12.0,13.0,6.0,14.0,13.0,20.0,12.0,13.0,13.0,6.0,12.0,5.0,13.0,16.0,13.0,13.0,13.0,15.0,14.0,12.0,5.0,21.0,0.0,0.0,0.0,0.0,177.0,0.0,1.0,1.0,1.0,2.0,3.0,3.0,2.0,3.0,2.0,2.0,3.0,6.0,4.0,13.0,13.0,13.0,6.0,13.0,7.0,3.0,5.0,7.0,6.0,1.0,11.0,9.0,7.0,8.0,7.0,7.0,7.0,8.0,7.0,11.0,8.0,13.0,7.0,6.0,7.0,12.0,13.0,7.0,6.0,8.0,8.0,13.0,20.0,5.0,5.0,9.0,5.0,9.0,9.0,9.0,10.0,10.0,12.0,12.0,11.0,10.0,9.0,6.0,22.0,0.0,0.0,0.0,0.0,187.0,84.0,2.0,2.0,1.0,2.0,3.0,2.0,2.0,3.0,3.0,2.0,2.0,4.0,7.0,10.0,6.0,9.0,10.0,13.0,12.0,5.0,11.0,11.0,7.0,10.0,12.0,12.0,11.0,13.0,10.0,9.0,11.0,9.0,15.0,8.0,7.0,9.0,11.0,11.0,14.0,13.0,10.0,15.0,14.0,8.0,15.0,11.0,20.0,14.0,15.0,11.0,12.0,7.0,9.0,8.0,7.0,13.0,15.0,13.0,11.0,14.0,14.0,7.0,22.0,0.0,0.0,0.0,0.0,177.0,72.0,2.0,1.0,2.0,4.0,2.0,2.0,1.0,3.0,4.0,2.0,3.0,10.0,12.0,13.0,11.0,12.0,10.0,12.0,12.0,4.0,10.0,13.0,11.0,11.0,13.0,11.0,12.0,11.0,13.0,9.0,13.0,12.0,3.0,12.0,8.0,14.0,12.0,12.0,13.0,16.0,13.0,12.0,9.0,8.0,15.0,14.0,20.0,14.0,13.0,10.0,4.0,11.0,11.0,12.0,19.0,9.0,12.0,13.0,12.0,11.0,14.0,7.0,24.0,0.0,0.0,0.0,0.0,172.0,72.0,1.0,1.0,3.0,2.0,2.0,1.0,1.0,1.0,1.0,3.0,1.0,10.0,11.0,12.0,10.0,11.0,8.0,8.0,10.0,7.0,7.0,11.0,11.0,6.0,12.0,8.0,11.0,11.0,10.0,10.0,11.0,12.0,15.0,12.0,5.0,10.0,11.0,13.0,15.0,15.0,13.0,10.0,9.0,8.0,14.0,13.0,20.0,14.0,11.0,11.0,8.0,13.0,7.0,12.0,18.0,13.0,10.0,10.0,11.0,11.0,11.0,6.0,29.0,30.0,6.0,0.0,0.0,178.0,76.0,2.0,3.0,3.0,4.0,3.0,2.0,2.0,2.0,2.0,1.0,1.0,6.0,11.0,16.0,10.0,12.0,5.0,8.0,8.0,5.0,4.0,13.0,7.0,3.0,12.0,7.0,8.0,12.0,11.0,10.0,8.0,9.0,13.0,15.0,4.0,13.0,7.0,12.0,10.0,16.0,15.0,14.0,8.0,11.0,13.0,16.0,20.0,10.0,13.0,10.0,11.0,10.0,7.0,5.0,9.0,16.0,9.0,10.0,11.0,11.0,14.0,3.0,25.0,0.0,0.0,0.0,0.0,187.0,83.0,2.0,1.0,3.0,3.0,1.0,3.0,3.0,3.0,1.0,1.0,3.0,4.0,8.0,10.0,14.0,12.0,8.0,14.0,9.0,5.0,7.0,11.0,13.0,5.0,12.0,11.0,13.0,13.0,13.0,11.0,10.0,12.0,16.0,9.0,8.0,13.0,11.0,13.0,16.0,14.0,13.0,15.0,13.0,20.0,14.0,12.0,8.0,14.0,16.0,13.0,11.0,13.0,7.0,5.0,13.0,14.0,13.0,14.0,14.0,13.0,13.0,6.0,23.0,3.0,0.0,12.0,0.0,187.0,98.0,12.0,14.0,15.0,6.0,14.0,12.0,14.0,15.0,11.0,10.0,14.0,2.0,1.0,1.0,1.0,7.0,2.0,2.0,2.0,5.0,6.0,9.0,9.0,8.0,6.0,10.0,11.0,14.0,11.0,11.0,6.0,12.0,15.0,15.0,16.0,4.0,12.0,12.0,2.0,12.0,12.0,12.0,13.0,5.0,13.0,12.0,20.0,9.0,14.0,14.0,10.0,11.0,10.0,1.0,10.0,13.0,13.0,17.0,8.0,11.0,8.0,10.0,19.0,0.0,0.0,0.0,0.0,182.0,77.0,1.0,1.0,2.0,2.0,3.0,2.0,2.0,1.0,2.0,2.0,2.0,2.0,7.0,6.0,4.0,10.0,5.0,12.0,6.0,5.0,9.0,9.0,8.0,11.0,11.0,8.0,9.0,10.0,11.0,11.0,8.0,15.0,12.0,5.0,12.0,6.0,9.0,10.0,12.0,9.0,10.0,13.0,11.0,10.0,15.0,11.0,20.0,12.0,11.0,10.0,8.0,6.0,10.0,10.0,18.0,14.0,10.0,9.0,14.0,15.0,15.0,8.0,19.0,0.0,0.0,0.0,0.0,182.0,89.0,1.0,2.0,2.0,1.0,1.0,1.0,2.0,1.0,3.0,3.0,3.0,5.0,8.0,6.0,5.0,11.0,5.0,14.0,6.0,6.0,12.0,11.0,8.0,13.0,10.0,13.0,12.0,15.0,12.0,13.0,9.0,12.0,12.0,8.0,8.0,7.0,12.0,13.0,14.0,12.0,11.0,15.0,12.0,10.0,15.0,13.0,20.0,14.0,16.0,13.0,4.0,10.0,6.0,11.0,9.0,13.0,10.0,13.0,13.0,14.0,14.0,6.0,29.0,0.0,0.0,4.0,0.0,184.0,72.0,3.0,2.0,4.0,2.0,3.0,1.0,1.0,3.0,1.0,1.0,1.0,8.0,13.0,10.0,6.0,11.0,7.0,12.0,8.0,10.0,12.0,11.0,9.0,13.0,11.0,9.0,14.0,14.0,11.0,14.0,10.0,12.0,16.0,9.0,14.0,12.0,13.0,15.0,16.0,15.0,12.0,14.0,12.0,8.0,13.0,14.0,20.0,16.0,12.0,13.0,9.0,16.0,8.0,15.0,13.0,13.0,17.0,14.0,16.0,16.0,16.0,5.0,24.0,9.0,0.0,0.0,0.0,176.0,71.0,3.0,1.0,1.0,2.0,3.0,1.0,1.0,1.0,3.0,1.0,4.0,5.0,12.0,10.0,6.0,11.0,5.0,6.0,9.0,11.0,8.0,9.0,6.0,11.0,12.0,12.0,11.0,11.0,9.0,10.0,8.0,10.0,14.0,9.0,8.0,12.0,10.0,12.0,13.0,16.0,13.0,12.0,8.0,10.0,16.0,14.0,20.0,15.0,10.0,13.0,12.0,10.0,5.0,15.0,9.0,13.0,13.0,10.0,12.0,14.0,14.0,7.0,21.0,0.0,0.0,1.0,0.0,186.0,75.0,3.0,4.0,2.0,2.0,2.0,2.0,1.0,2.0,2.0,1.0,3.0,10.0,11.0,10.0,8.0,13.0,11.0,10.0,11.0,8.0,12.0,11.0,7.0,14.0,12.0,11.0,12.0,14.0,11.0,10.0,10.0,11.0,14.0,12.0,11.0,14.0,11.0,12.0,12.0,13.0,11.0,12.0,14.0,20.0,11.0,14.0,5.0,13.0,12.0,12.0,11.0,11.0,10.0,11.0,11.0,14.0,11.0,12.0,9.0,8.0,7.0,2.0,20.0,0.0,0.0,0.0,0.0,183.0,70.0,1.0,1.0,2.0,2.0,3.0,1.0,1.0,2.0,2.0,2.0,3.0,6.0,10.0,12.0,7.0,11.0,8.0,9.0,10.0,6.0,3.0,11.0,8.0,2.0,14.0,8.0,10.0,7.0,10.0,10.0,14.0,10.0,11.0,12.0,6.0,11.0,7.0,8.0,11.0,14.0,13.0,12.0,12.0,20.0,13.0,12.0,8.0,10.0,7.0,10.0,8.0,10.0,7.0,14.0,14.0,12.0,13.0,11.0,11.0,10.0,17.0,6.0,22.0,5.0,0.0,9.0,2.0,181.0,73.0,3.0,1.0,2.0,1.0,3.0,2.0,2.0,3.0,3.0,1.0,1.0,12.0,13.0,12.0,7.0,14.0,12.0,9.0,11.0,6.0,7.0,14.0,10.0,8.0,15.0,13.0,11.0,12.0,13.0,12.0,15.0,12.0,12.0,11.0,10.0,11.0,11.0,14.0,13.0,11.0,13.0,14.0,10.0,10.0,16.0,12.0,20.0,14.0,12.0,12.0,11.0,14.0,9.0,8.0,12.0,13.0,16.0,12.0,14.0,13.0,14.0,5.0,31.0,1.0,0.0,0.0,0.0,178.0,74.0,1.0,3.0,2.0,2.0,2.0,1.0,2.0,2.0,3.0,1.0,3.0,12.0,13.0,13.0,7.0,15.0,13.0,10.0,12.0,7.0,6.0,14.0,11.0,8.0,15.0,14.0,14.0,13.0,13.0,12.0,13.0,13.0,15.0,14.0,10.0,12.0,10.0,10.0,12.0,12.0,13.0,14.0,10.0,10.0,15.0,12.0,20.0,14.0,12.0,11.0,14.0,14.0,6.0,14.0,12.0,14.0,10.0,12.0,13.0,10.0,6.0,14.0,25.0,19.0,6.0,0.0,0.0,182.0,78.0,1.0,4.0,3.0,1.0,2.0,1.0,2.0,2.0,4.0,1.0,4.0,16.0,13.0,12.0,11.0,12.0,13.0,8.0,12.0,5.0,5.0,13.0,13.0,5.0,15.0,11.0,12.0,12.0,13.0,12.0,15.0,12.0,15.0,14.0,6.0,15.0,9.0,11.0,14.0,15.0,14.0,14.0,10.0,11.0,11.0,14.0,20.0,12.0,13.0,10.0,11.0,15.0,5.0,12.0,10.0,15.0,16.0,11.0,13.0,16.0,16.0,7.0,22.0,0.0,0.0,0.0,0.0,178.0,71.0,3.0,1.0,1.0,1.0,4.0,1.0,1.0,1.0,4.0,1.0,3.0,10.0,11.0,12.0,7.0,13.0,11.0,7.0,11.0,5.0,8.0,14.0,8.0,8.0,14.0,9.0,13.0,12.0,13.0,11.0,13.0,12.0,16.0,8.0,11.0,10.0,11.0,15.0,14.0,10.0,14.0,12.0,9.0,8.0,14.0,8.0,20.0,14.0,11.0,14.0,9.0,10.0,7.0,12.0,20.0,12.0,15.0,12.0,11.0,14.0,14.0,6.0
2,0,25.0,4.0,0.0,11.0,0.0,184.0,81.0,14.0,14.0,13.0,9.0,15.0,12.0,16.0,16.0,13.0,7.0,11.0,8.0,1.0,2.0,1.0,11.0,12.0,6.0,1.0,3.0,3.0,11.0,5.0,3.0,11.0,8.0,15.0,15.0,13.0,14.0,10.0,11.0,14.0,8.0,13.0,5.0,13.0,10.0,10.0,14.0,16.0,14.0,13.0,20.0,14.0,12.0,5.0,14.0,14.0,15.0,9.0,16.0,6.0,1.0,17.0,11.0,15.0,13.0,14.0,12.0,12.0,4.0,32.0,0.0,0.0,0.0,0.0,172.0,71.0,2.0,1.0,3.0,1.0,2.0,3.0,2.0,3.0,2.0,2.0,2.0,8.0,9.0,7.0,6.0,10.0,6.0,10.0,9.0,10.0,14.0,11.0,6.0,14.0,11.0,10.0,16.0,15.0,12.0,12.0,7.0,12.0,15.0,9.0,13.0,8.0,14.0,15.0,15.0,14.0,14.0,14.0,10.0,20.0,14.0,14.0,8.0,15.0,13.0,13.0,11.0,13.0,7.0,13.0,17.0,14.0,17.0,8.0,13.0,15.0,15.0,6.0,27.0,0.0,0.0,0.0,0.0,184.0,81.0,1.0,1.0,1.0,3.0,3.0,2.0,2.0,2.0,1.0,2.0,3.0,8.0,6.0,8.0,12.0,10.0,8.0,12.0,9.0,1.0,3.0,8.0,14.0,4.0,9.0,4.0,11.0,12.0,11.0,8.0,8.0,11.0,10.0,9.0,8.0,11.0,9.0,8.0,11.0,10.0,8.0,13.0,13.0,9.0,13.0,9.0,20.0,12.0,13.0,13.0,9.0,2.0,9.0,9.0,15.0,10.0,12.0,10.0,11.0,6.0,4.0,6.0,37.0,0.0,0.0,0.0,0.0,185.0,83.0,1.0,1.0,2.0,1.0,3.0,2.0,3.0,1.0,1.0,3.0,1.0,6.0,8.0,9.0,12.0,10.0,8.0,13.0,9.0,4.0,5.0,10.0,14.0,4.0,11.0,11.0,10.0,11.0,13.0,12.0,12.0,13.0,15.0,14.0,12.0,11.0,7.0,12.0,8.0,7.0,7.0,12.0,12.0,11.0,11.0,7.0,20.0,8.0,14.0,12.0,8.0,13.0,9.0,12.0,12.0,12.0,19.0,14.0,15.0,14.0,8.0,8.0,21.0,0.0,0.0,0.0,0.0,179.0,68.0,2.0,3.0,2.0,1.0,2.0,1.0,2.0,3.0,2.0,1.0,1.0,6.0,13.0,12.0,6.0,13.0,6.0,8.0,7.0,12.0,10.0,12.0,8.0,12.0,13.0,10.0,11.0,11.0,12.0,10.0,11.0,11.0,12.0,11.0,7.0,13.0,10.0,12.0,14.0,15.0,13.0,12.0,10.0,20.0,14.0,14.0,8.0,14.0,10.0,13.0,8.0,13.0,8.0,12.0,13.0,14.0,10.0,12.0,10.0,10.0,12.0,10.0,19.0,0.0,0.0,0.0,0.0,185.0,82.0,4.0,2.0,3.0,1.0,3.0,2.0,1.0,2.0,1.0,2.0,3.0,7.0,7.0,10.0,6.0,13.0,7.0,14.0,7.0,6.0,12.0,13.0,7.0,13.0,13.0,13.0,13.0,13.0,11.0,12.0,11.0,12.0,14.0,9.0,14.0,11.0,11.0,15.0,15.0,12.0,12.0,14.0,13.0,5.0,14.0,12.0,20.0,14.0,13.0,10.0,11.0,11.0,6.0,10.0,10.0,12.0,12.0,14.0,14.0,11.0,16.0,6.0,19.0,0.0,0.0,0.0,0.0,175.0,67.0,3.0,2.0,1.0,3.0,3.0,1.0,1.0,1.0,2.0,1.0,3.0,7.0,8.0,12.0,8.0,10.0,6.0,12.0,9.0,8.0,10.0,10.0,8.0,12.0,11.0,14.0,10.0,12.0,9.0,10.0,11.0,10.0,12.0,12.0,10.0,12.0,12.0,13.0,14.0,13.0,11.0,14.0,8.0,6.0,14.0,12.0,20.0,14.0,12.0,12.0,8.0,11.0,6.0,12.0,17.0,13.0,10.0,11.0,12.0,11.0,17.0,5.0,18.0,0.0,0.0,0.0,0.0,170.0,67.0,3.0,1.0,3.0,3.0,3.0,4.0,1.0,2.0,1.0,2.0,2.0,11.0,11.0,12.0,13.0,12.0,11.0,6.0,10.0,8.0,7.0,12.0,10.0,7.0,13.0,9.0,11.0,8.0,10.0,10.0,12.0,12.0,15.0,12.0,12.0,11.0,12.0,11.0,12.0,12.0,12.0,10.0,6.0,5.0,14.0,12.0,20.0,10.0,9.0,10.0,8.0,2.0,6.0,12.0,11.0,11.0,12.0,13.0,14.0,11.0,13.0,4.0,22.0,24.0,3.0,7.0,0.0,177.0,78.0,2.0,1.0,2.0,3.0,2.0,2.0,4.0,3.0,3.0,2.0,1.0,10.0,13.0,16.0,14.0,16.0,16.0,8.0,16.0,4.0,4.0,15.0,12.0,4.0,16.0,12.0,11.0,12.0,13.0,10.0,11.0,8.0,13.0,17.0,5.0,14.0,5.0,10.0,12.0,15.0,14.0,13.0,9.0,10.0,17.0,16.0,20.0,15.0,14.0,12.0,11.0,15.0,4.0,12.0,19.0,16.0,14.0,14.0,11.0,13.0,10.0,12.0,20.0,29.0,2.0,0.0,0.0,181.0,75.0,1.0,1.0,2.0,2.0,2.0,3.0,2.0,1.0,1.0,3.0,2.0,5.0,9.0,15.0,10.0,11.0,9.0,10.0,8.0,7.0,3.0,10.0,10.0,5.0,15.0,7.0,10.0,9.0,12.0,10.0,8.0,11.0,14.0,12.0,5.0,13.0,5.0,11.0,12.0,16.0,12.0,9.0,12.0,20.0,14.0,16.0,7.0,12.0,10.0,9.0,10.0,10.0,11.0,6.0,10.0,15.0,9.0,13.0,11.0,14.0,18.0,7.0,22.0,5.0,1.0,1.0,0.0,173.0,72.0,1.0,3.0,1.0,3.0,3.0,3.0,3.0,3.0,3.0,2.0,2.0,14.0,13.0,16.0,14.0,16.0,14.0,5.0,11.0,5.0,5.0,15.0,11.0,5.0,16.0,8.0,13.0,9.0,14.0,13.0,15.0,13.0,15.0,16.0,5.0,13.0,5.0,9.0,10.0,15.0,16.0,14.0,5.0,20.0,14.0,15.0,5.0,12.0,14.0,13.0,11.0,13.0,8.0,14.0,10.0,15.0,14.0,10.0,13.0,10.0,10.0,13.0,30.0,42.0,0.0,13.0,0.0,195.0,88.0,16.0,13.0,14.0,6.0,14.0,13.0,13.0,15.0,12.0,10.0,14.0,1.0,8.0,5.0,2.0,8.0,2.0,8.0,2.0,5.0,3.0,9.0,5.0,3.0,8.0,10.0,12.0,10.0,14.0,10.0,10.0,14.0,13.0,3.0,14.0,3.0,12.0,14.0,12.0,8.0,13.0,18.0,18.0,17.0,14.0,11.0,20.0,14.0,17.0,14.0,4.0,14.0,4.0,1.0,12.0,13.0,14.0,9.0,15.0,13.0,13.0,5.0,28.0,0.0,0.0,0.0,0.0,190.0,85.0,3.0,2.0,3.0,3.0,2.0,2.0,2.0,4.0,3.0,1.0,2.0,5.0,9.0,8.0,9.0,8.0,7.0,14.0,10.0,9.0,15.0,9.0,6.0,14.0,9.0,16.0,13.0,16.0,10.0,13.0,10.0,12.0,15.0,6.0,13.0,7.0,13.0,14.0,16.0,12.0,11.0,17.0,13.0,20.0,15.0,13.0,8.0,15.0,15.0,12.0,14.0,14.0,9.0,8.0,14.0,13.0,14.0,11.0,12.0,13.0,16.0,14.0,23.0,0.0,0.0,0.0,0.0,184.0,71.0,1.0,2.0,1.0,2.0,2.0,2.0,2.0,4.0,2.0,1.0,3.0,4.0,10.0,10.0,6.0,11.0,6.0,14.0,8.0,7.0,14.0,11.0,6.0,13.0,11.0,12.0,12.0,13.0,12.0,11.0,12.0,12.0,14.0,6.0,8.0,10.0,13.0,13.0,14.0,15.0,13.0,14.0,13.0,8.0,12.0,14.0,20.0,13.0,14.0,13.0,12.0,14.0,15.0,8.0,11.0,13.0,13.0,10.0,8.0,9.0,16.0,7.0,21.0,0.0,0.0,0.0,0.0,177.0,0.0,1.0,1.0,1.0,2.0,3.0,3.0,2.0,3.0,2.0,2.0,3.0,6.0,4.0,13.0,13.0,13.0,6.0,13.0,7.0,3.0,5.0,7.0,6.0,1.0,11.0,9.0,7.0,8.0,7.0,7.0,7.0,8.0,7.0,11.0,8.0,13.0,7.0,6.0,7.0,12.0,13.0,7.0,6.0,8.0,8.0,13.0,20.0,5.0,5.0,9.0,5.0,9.0,9.0,9.0,10.0,10.0,12.0,12.0,11.0,10.0,9.0,6.0,21.0,0.0,0.0,0.0,0.0,178.0,65.0,2.0,3.0,3.0,3.0,3.0,1.0,1.0,1.0,1.0,3.0,1.0,9.0,13.0,11.0,6.0,12.0,7.0,9.0,8.0,8.0,13.0,12.0,7.0,13.0,12.0,8.0,12.0,13.0,12.0,12.0,13.0,13.0,14.0,9.0,8.0,12.0,12.0,13.0,13.0,12.0,14.0,13.0,11.0,8.0,15.0,12.0,20.0,13.0,12.0,14.0,8.0,11.0,7.0,10.0,19.0,10.0,13.0,10.0,11.0,15.0,15.0,6.0,22.0,0.0,0.0,0.0,0.0,187.0,84.0,2.0,2.0,1.0,2.0,3.0,2.0,2.0,3.0,3.0,2.0,2.0,4.0,7.0,10.0,6.0,9.0,10.0,13.0,12.0,5.0,11.0,11.0,7.0,10.0,12.0,12.0,11.0,13.0,10.0,9.0,11.0,9.0,15.0,8.0,7.0,9.0,11.0,11.0,14.0,13.0,10.0,15.0,14.0,8.0,15.0,11.0,20.0,14.0,15.0,11.0,12.0,7.0,9.0,8.0,7.0,13.0,15.0,13.0,11.0,14.0,14.0,7.0,21.0,0.0,0.0,0.0,0.0,172.0,66.0,2.0,3.0,2.0,2.0,1.0,1.0,1.0,3.0,2.0,1.0,1.0,10.0,10.0,13.0,9.0,14.0,9.0,8.0,10.0,7.0,13.0,13.0,9.0,12.0,13.0,10.0,12.0,13.0,13.0,12.0,14.0,13.0,13.0,11.0,9.0,14.0,13.0,14.0,14.0,14.0,13.0,12.0,8.0,8.0,12.0,12.0,20.0,13.0,12.0,14.0,10.0,11.0,8.0,12.0,15.0,10.0,15.0,8.0,11.0,14.0,14.0,6.0,19.0,0.0,0.0,0.0,0.0,174.0,61.0,1.0,3.0,2.0,3.0,2.0,1.0,2.0,2.0,3.0,1.0,1.0,5.0,9.0,10.0,6.0,12.0,6.0,8.0,8.0,5.0,9.0,10.0,7.0,9.0,13.0,11.0,12.0,12.0,11.0,9.0,11.0,11.0,8.0,9.0,10.0,8.0,10.0,12.0,16.0,13.0,13.0,10.0,8.0,20.0,15.0,11.0,8.0,13.0,9.0,15.0,11.0,10.0,6.0,13.0,10.0,9.0,14.0,11.0,12.0,14.0,14.0,8.0,24.0,0.0,0.0,0.0,0.0,172.0,72.0,1.0,1.0,3.0,2.0,2.0,1.0,1.0,1.0,1.0,3.0,1.0,10.0,11.0,12.0,10.0,11.0,8.0,8.0,10.0,7.0,7.0,11.0,11.0,6.0,12.0,8.0,11.0,11.0,10.0,10.0,11.0,12.0,15.0,12.0,5.0,10.0,11.0,13.0,15.0,15.0,13.0,10.0,9.0,8.0,14.0,13.0,20.0,14.0,11.0,11.0,8.0,13.0,7.0,12.0,18.0,13.0,10.0,10.0,11.0,11.0,11.0,6.0,22.0,0.0,0.0,0.0,0.0,177.0,72.0,2.0,1.0,2.0,4.0,2.0,2.0,1.0,3.0,4.0,2.0,3.0,10.0,12.0,13.0,11.0,12.0,10.0,12.0,12.0,4.0,10.0,13.0,11.0,11.0,13.0,11.0,12.0,11.0,13.0,9.0,13.0,12.0,3.0,12.0,8.0,14.0,12.0,12.0,13.0,16.0,13.0,12.0,9.0,8.0,15.0,14.0,20.0,14.0,13.0,10.0,4.0,11.0,11.0,12.0,19.0,9.0,12.0,13.0,12.0,11.0,14.0,7.0,29.0,30.0,6.0,0.0,0.0,178.0,76.0,2.0,3.0,3.0,4.0,3.0,2.0,2.0,2.0,2.0,1.0,1.0,6.0,11.0,16.0,10.0,12.0,5.0,8.0,8.0,5.0,4.0,13.0,7.0,3.0,12.0,7.0,8.0,12.0,11.0,10.0,8.0,9.0,13.0,15.0,4.0,13.0,7.0,12.0,10.0,16.0,15.0,14.0,8.0,11.0,13.0,16.0,20.0,10.0,13.0,10.0,11.0,10.0,7.0,5.0,9.0,16.0,9.0,10.0,11.0,11.0,14.0,3.0
3,1,24.0,0.0,0.0,0.0,0.0,186.0,80.0,9.0,10.0,13.0,6.0,12.0,11.0,13.0,14.0,11.0,12.0,7.0,5.0,2.0,2.0,3.0,9.0,10.0,2.0,2.0,2.0,1.0,8.0,2.0,1.0,9.0,8.0,11.0,13.0,9.0,10.0,7.0,9.0,14.0,6.0,9.0,1.0,11.0,12.0,6.0,10.0,13.0,14.0,13.0,20.0,14.0,7.0,5.0,12.0,14.0,10.0,8.0,14.0,7.0,1.0,15.0,13.0,15.0,11.0,14.0,13.0,12.0,8.0,23.0,0.0,0.0,0.0,0.0,188.0,75.0,2.0,2.0,2.0,2.0,3.0,4.0,2.0,2.0,2.0,3.0,3.0,4.0,10.0,7.0,5.0,10.0,7.0,13.0,10.0,5.0,13.0,11.0,6.0,13.0,12.0,13.0,13.0,14.0,11.0,11.0,8.0,11.0,12.0,5.0,6.0,10.0,12.0,13.0,14.0,13.0,11.0,15.0,14.0,5.0,14.0,12.0,20.0,14.0,14.0,12.0,13.0,11.0,7.0,12.0,9.0,12.0,11.0,7.0,12.0,10.0,10.0,8.0,24.0,0.0,0.0,0.0,0.0,185.0,70.0,3.0,2.0,3.0,2.0,2.0,1.0,2.0,1.0,1.0,2.0,3.0,5.0,6.0,9.0,7.0,11.0,8.0,15.0,12.0,7.0,14.0,13.0,7.0,11.0,11.0,11.0,14.0,14.0,13.0,9.0,9.0,12.0,4.0,8.0,5.0,10.0,12.0,15.0,12.0,11.0,11.0,14.0,13.0,6.0,15.0,11.0,20.0,13.0,14.0,13.0,9.0,11.0,7.0,10.0,15.0,11.0,13.0,11.0,10.0,9.0,14.0,4.0,26.0,0.0,0.0,0.0,0.0,167.0,67.0,3.0,1.0,3.0,1.0,2.0,2.0,3.0,1.0,3.0,1.0,3.0,7.0,11.0,11.0,5.0,12.0,6.0,6.0,7.0,10.0,12.0,12.0,6.0,12.0,13.0,11.0,11.0,10.0,13.0,12.0,9.0,12.0,13.0,7.0,5.0,8.0,11.0,13.0,13.0,15.0,14.0,10.0,6.0,7.0,15.0,15.0,20.0,14.0,8.0,14.0,8.0,13.0,7.0,10.0,14.0,13.0,13.0,14.0,14.0,16.0,16.0,6.0,24.0,0.0,0.0,0.0,0.0,175.0,72.0,3.0,2.0,4.0,3.0,2.0,4.0,1.0,1.0,1.0,2.0,2.0,8.0,12.0,12.0,6.0,11.0,7.0,10.0,9.0,12.0,11.0,12.0,8.0,12.0,11.0,11.0,12.0,13.0,10.0,10.0,9.0,9.0,3.0,9.0,9.0,11.0,12.0,11.0,11.0,14.0,13.0,11.0,8.0,20.0,12.0,13.0,6.0,12.0,11.0,10.0,10.0,10.0,9.0,10.0,10.0,13.0,10.0,11.0,10.0,13.0,18.0,1.0,21.0,0.0,0.0,3.0,0.0,174.0,70.0,3.0,1.0,3.0,3.0,2.0,2.0,1.0,3.0,3.0,2.0,1.0,10.0,11.0,12.0,10.0,13.0,8.0,7.0,11.0,6.0,10.0,14.0,11.0,8.0,13.0,7.0,11.0,11.0,12.0,12.0,14.0,11.0,8.0,11.0,10.0,12.0,8.0,13.0,14.0,13.0,14.0,13.0,9.0,20.0,11.0,12.0,8.0,13.0,11.0,13.0,7.0,10.0,5.0,12.0,13.0,11.0,12.0,9.0,11.0,12.0,10.0,5.0,26.0,0.0,0.0,0.0,0.0,178.0,74.0,2.0,3.0,1.0,3.0,3.0,3.0,2.0,2.0,3.0,1.0,3.0,14.0,12.0,12.0,10.0,13.0,14.0,9.0,12.0,5.0,6.0,12.0,8.0,8.0,13.0,11.0,11.0,12.0,10.0,11.0,12.0,13.0,15.0,12.0,8.0,11.0,12.0,12.0,15.0,14.0,15.0,15.0,10.0,5.0,13.0,13.0,20.0,14.0,13.0,13.0,13.0,14.0,8.0,6.0,14.0,13.0,12.0,11.0,13.0,12.0,16.0,7.0,39.0,0.0,0.0,0.0,0.0,178.0,75.0,4.0,3.0,1.0,2.0,2.0,2.0,3.0,3.0,2.0,2.0,1.0,12.0,12.0,13.0,12.0,15.0,12.0,12.0,11.0,6.0,6.0,15.0,15.0,8.0,16.0,7.0,12.0,12.0,13.0,14.0,14.0,12.0,14.0,11.0,12.0,9.0,12.0,12.0,14.0,11.0,12.0,14.0,8.0,10.0,15.0,10.0,20.0,10.0,12.0,15.0,7.0,16.0,6.0,10.0,14.0,14.0,14.0,14.0,14.0,14.0,14.0,6.0,24.0,0.0,0.0,0.0,0.0,169.0,65.0,3.0,3.0,2.0,1.0,2.0,4.0,1.0,3.0,4.0,3.0,2.0,11.0,12.0,12.0,7.0,12.0,9.0,5.0,10.0,7.0,3.0,11.0,12.0,5.0,13.0,7.0,10.0,9.0,12.0,9.0,12.0,10.0,4.0,11.0,6.0,12.0,6.0,12.0,14.0,16.0,14.0,11.0,6.0,20.0,14.0,15.0,5.0,14.0,7.0,12.0,7.0,14.0,6.0,8.0,16.0,13.0,16.0,12.0,12.0,10.0,15.0,6.0,19.0,0.0,0.0,0.0,0.0,168.0,64.0,3.0,2.0,4.0,1.0,2.0,2.0,1.0,1.0,1.0,1.0,3.0,9.0,11.0,13.0,10.0,11.0,8.0,4.0,10.0,3.0,4.0,11.0,10.0,4.0,12.0,8.0,11.0,11.0,9.0,8.0,10.0,10.0,12.0,11.0,6.0,9.0,9.0,10.0,9.0,14.0,11.0,10.0,7.0,11.0,12.0,14.0,20.0,11.0,10.0,11.0,12.0,9.0,8.0,11.0,10.0,11.0,9.0,11.0,8.0,7.0,8.0,10.0,23.0,0.0,0.0,7.0,3.0,181.0,71.0,2.0,2.0,2.0,2.0,2.0,2.0,4.0,2.0,3.0,3.0,2.0,7.0,12.0,12.0,14.0,13.0,7.0,11.0,11.0,7.0,6.0,11.0,15.0,7.0,12.0,12.0,13.0,16.0,12.0,12.0,10.0,11.0,6.0,12.0,7.0,14.0,9.0,12.0,16.0,13.0,14.0,13.0,9.0,8.0,14.0,12.0,20.0,12.0,12.0,12.0,10.0,12.0,8.0,10.0,19.0,10.0,10.0,10.0,11.0,11.0,12.0,6.0,36.0,0.0,0.0,0.0,0.0,185.0,78.0,11.0,14.0,12.0,7.0,13.0,12.0,14.0,15.0,13.0,14.0,10.0,4.0,1.0,3.0,1.0,8.0,8.0,11.0,8.0,3.0,3.0,7.0,2.0,1.0,8.0,11.0,13.0,15.0,11.0,12.0,7.0,13.0,9.0,5.0,14.0,3.0,13.0,15.0,8.0,11.0,14.0,13.0,12.0,5.0,15.0,11.0,20.0,12.0,14.0,13.0,11.0,13.0,8.0,1.0,19.0,14.0,16.0,10.0,17.0,9.0,9.0,11.0,28.0,8.0,0.0,1.0,0.0,182.0,79.0,1.0,1.0,3.0,2.0,4.0,1.0,3.0,3.0,1.0,1.0,3.0,5.0,9.0,9.0,9.0,11.0,6.0,13.0,8.0,12.0,14.0,9.0,8.0,14.0,11.0,14.0,14.0,15.0,10.0,13.0,7.0,12.0,16.0,8.0,8.0,9.0,14.0,13.0,14.0,15.0,12.0,13.0,11.0,5.0,13.0,14.0,20.0,15.0,14.0,12.0,14.0,13.0,7.0,15.0,11.0,13.0,10.0,13.0,10.0,11.0,12.0,5.0,28.0,0.0,0.0,0.0,0.0,183.0,81.0,1.0,2.0,4.0,1.0,1.0,3.0,2.0,3.0,3.0,3.0,1.0,5.0,5.0,6.0,10.0,12.0,6.0,14.0,8.0,6.0,15.0,11.0,6.0,13.0,12.0,13.0,14.0,16.0,14.0,14.0,10.0,12.0,14.0,5.0,14.0,8.0,14.0,15.0,15.0,9.0,12.0,15.0,13.0,7.0,11.0,12.0,20.0,15.0,15.0,14.0,14.0,14.0,9.0,8.0,14.0,14.0,11.0,13.0,15.0,13.0,15.0,6.0,21.0,0.0,0.0,0.0,0.0,182.0,74.0,2.0,2.0,2.0,2.0,2.0,1.0,1.0,1.0,3.0,2.0,2.0,9.0,11.0,12.0,7.0,9.0,8.0,12.0,7.0,11.0,12.0,7.0,8.0,13.0,11.0,12.0,12.0,14.0,12.0,13.0,7.0,12.0,11.0,1.0,9.0,11.0,9.0,10.0,12.0,14.0,10.0,13.0,11.0,9.0,8.0,12.0,20.0,13.0,11.0,10.0,13.0,8.0,10.0,10.0,15.0,11.0,13.0,10.0,10.0,8.0,13.0,7.0,21.0,0.0,0.0,1.0,0.0,177.0,68.0,4.0,1.0,2.0,1.0,1.0,1.0,1.0,1.0,2.0,1.0,2.0,5.0,12.0,9.0,7.0,12.0,8.0,13.0,10.0,16.0,13.0,12.0,8.0,14.0,12.0,12.0,13.0,12.0,12.0,12.0,10.0,13.0,15.0,11.0,13.0,11.0,13.0,13.0,14.0,13.0,14.0,13.0,11.0,10.0,14.0,12.0,20.0,12.0,14.0,12.0,11.0,12.0,8.0,14.0,13.0,10.0,14.0,12.0,14.0,12.0,11.0,5.0,24.0,10.0,0.0,0.0,0.0,180.0,73.0,3.0,2.0,3.0,1.0,1.0,1.0,1.0,3.0,3.0,3.0,2.0,5.0,10.0,8.0,5.0,8.0,6.0,13.0,8.0,6.0,14.0,12.0,6.0,13.0,10.0,12.0,13.0,13.0,11.0,12.0,9.0,12.0,14.0,1.0,7.0,7.0,12.0,12.0,13.0,15.0,11.0,13.0,10.0,5.0,15.0,14.0,20.0,12.0,14.0,12.0,12.0,11.0,8.0,11.0,8.0,11.0,9.0,15.0,12.0,11.0,19.0,6.0,19.0,0.0,0.0,0.0,0.0,184.0,72.0,2.0,2.0,3.0,2.0,1.0,2.0,1.0,3.0,2.0,1.0,2.0,11.0,9.0,9.0,10.0,15.0,11.0,11.0,16.0,8.0,14.0,11.0,9.0,16.0,10.0,11.0,13.0,6.0,12.0,11.0,10.0,12.0,12.0,7.0,4.0,12.0,13.0,12.0,15.0,14.0,9.0,13.0,12.0,7.0,13.0,11.0,20.0,10.0,12.0,10.0,11.0,8.0,8.0,11.0,12.0,14.0,8.0,13.0,12.0,5.0,9.0,3.0,33.0,0.0,0.0,0.0,0.0,187.0,76.0,2.0,2.0,3.0,1.0,1.0,3.0,2.0,1.0,2.0,3.0,2.0,15.0,14.0,14.0,10.0,15.0,13.0,10.0,12.0,7.0,4.0,15.0,13.0,7.0,15.0,6.0,12.0,9.0,14.0,11.0,15.0,12.0,12.0,14.0,12.0,13.0,7.0,13.0,12.0,11.0,12.0,14.0,12.0,14.0,15.0,12.0,20.0,11.0,12.0,12.0,6.0,14.0,6.0,11.0,14.0,13.0,12.0,12.0,15.0,15.0,13.0,9.0,25.0,0.0,0.0,0.0,0.0,182.0,72.0,1.0,3.0,2.0,3.0,1.0,1.0,2.0,2.0,2.0,1.0,2.0,5.0,8.0,12.0,13.0,13.0,6.0,9.0,10.0,6.0,5.0,8.0,11.0,5.0,13.0,8.0,11.0,12.0,11.0,12.0,6.0,12.0,10.0,12.0,5.0,13.0,6.0,9.0,11.0,15.0,13.0,13.0,11.0,10.0,13.0,14.0,20.0,13.0,12.0,13.0,8.0,5.0,8.0,11.0,12.0,13.0,13.0,12.0,11.0,10.0,11.0,1.0,30.0,0.0,0.0,0.0,0.0,178.0,73.0,3.0,4.0,1.0,1.0,2.0,4.0,3.0,2.0,2.0,2.0,3.0,13.0,14.0,12.0,7.0,13.0,12.0,7.0,13.0,5.0,10.0,13.0,9.0,10.0,13.0,11.0,11.0,12.0,12.0,13.0,11.0,14.0,14.0,11.0,7.0,11.0,10.0,13.0,15.0,13.0,15.0,15.0,8.0,20.0,14.0,14.0,8.0,14.0,11.0,13.0,11.0,14.0,8.0,10.0,19.0,12.0,12.0,9.0,12.0,12.0,10.0,10.0,27.0,0.0,0.0,0.0,0.0,190.0,87.0,1.0,3.0,2.0,3.0,1.0,3.0,1.0,1.0,2.0,3.0,2.0,5.0,7.0,9.0,14.0,14.0,10.0,14.0,13.0,5.0,6.0,12.0,12.0,8.0,14.0,14.0,13.0,16.0,14.0,11.0,10.0,13.0,15.0,10.0,11.0,14.0,9.0,15.0,14.0,10.0,11.0,16.0,15.0,9.0,12.0,12.0,20.0,14.0,16.0,13.0,13.0,12.0,7.0,5.0,10.0,12.0,14.0,12.0,14.0,14.0,19.0,12.0
3,0,25.0,0.0,0.0,3.0,0.0,187.0,83.0,15.0,9.0,12.0,8.0,13.0,11.0,12.0,14.0,7.0,12.0,8.0,4.0,2.0,3.0,2.0,9.0,9.0,6.0,2.0,2.0,1.0,9.0,2.0,1.0,9.0,8.0,13.0,15.0,12.0,10.0,7.0,9.0,15.0,5.0,9.0,3.0,12.0,13.0,8.0,12.0,12.0,15.0,14.0,20.0,13.0,9.0,5.0,14.0,14.0,12.0,8.0,10.0,7.0,1.0,14.0,11.0,16.0,11.0,14.0,14.0,14.0,6.0,27.0,0.0,0.0,0.0,0.0,184.0,81.0,1.0,1.0,1.0,3.0,3.0,2.0,2.0,2.0,1.0,2.0,3.0,8.0,6.0,8.0,12.0,10.0,8.0,12.0,9.0,1.0,3.0,8.0,14.0,4.0,9.0,4.0,11.0,12.0,11.0,8.0,8.0,11.0,10.0,9.0,8.0,11.0,9.0,8.0,11.0,10.0,8.0,13.0,13.0,9.0,13.0,9.0,20.0,12.0,13.0,13.0,9.0,2.0,9.0,9.0,15.0,10.0,12.0,10.0,11.0,6.0,4.0,6.0,32.0,0.0,0.0,0.0,0.0,172.0,71.0,2.0,1.0,3.0,1.0,2.0,3.0,2.0,3.0,2.0,2.0,2.0,8.0,9.0,7.0,6.0,10.0,6.0,10.0,9.0,10.0,14.0,11.0,6.0,14.0,11.0,10.0,16.0,15.0,12.0,12.0,7.0,12.0,15.0,9.0,13.0,8.0,14.0,15.0,15.0,14.0,14.0,14.0,10.0,20.0,14.0,14.0,8.0,15.0,13.0,13.0,11.0,13.0,7.0,13.0,17.0,14.0,17.0,8.0,13.0,15.0,15.0,6.0,37.0,0.0,0.0,0.0,0.0,185.0,83.0,1.0,1.0,2.0,1.0,3.0,2.0,3.0,1.0,1.0,3.0,1.0,6.0,8.0,9.0,12.0,10.0,8.0,13.0,9.0,4.0,5.0,10.0,14.0,4.0,11.0,11.0,10.0,11.0,13.0,12.0,12.0,13.0,15.0,14.0,12.0,11.0,7.0,12.0,8.0,7.0,7.0,12.0,12.0,11.0,11.0,7.0,20.0,8.0,14.0,12.0,8.0,13.0,9.0,12.0,12.0,12.0,19.0,14.0,15.0,14.0,8.0,8.0,21.0,0.0,0.0,0.0,0.0,179.0,68.0,2.0,3.0,2.0,1.0,2.0,1.0,2.0,3.0,2.0,1.0,1.0,6.0,13.0,12.0,6.0,13.0,6.0,8.0,7.0,12.0,10.0,12.0,8.0,12.0,13.0,10.0,11.0,11.0,12.0,10.0,11.0,11.0,12.0,11.0,7.0,13.0,10.0,12.0,14.0,15.0,13.0,12.0,10.0,20.0,14.0,14.0,8.0,14.0,10.0,13.0,8.0,13.0,8.0,12.0,13.0,14.0,10.0,12.0,10.0,10.0,12.0,10.0,19.0,0.0,0.0,0.0,0.0,185.0,82.0,4.0,2.0,3.0,1.0,3.0,2.0,1.0,2.0,1.0,2.0,3.0,7.0,7.0,10.0,6.0,13.0,7.0,14.0,7.0,6.0,12.0,13.0,7.0,13.0,13.0,13.0,13.0,13.0,11.0,12.0,11.0,12.0,14.0,9.0,14.0,11.0,11.0,15.0,15.0,12.0,12.0,14.0,13.0,5.0,14.0,12.0,20.0,14.0,13.0,10.0,11.0,11.0,6.0,10.0,10.0,12.0,12.0,14.0,14.0,11.0,16.0,6.0,18.0,0.0,0.0,0.0,0.0,170.0,67.0,3.0,1.0,3.0,3.0,3.0,4.0,1.0,2.0,1.0,2.0,2.0,11.0,11.0,12.0,13.0,12.0,11.0,6.0,10.0,8.0,7.0,12.0,10.0,7.0,13.0,9.0,11.0,8.0,10.0,10.0,12.0,12.0,15.0,12.0,12.0,11.0,12.0,11.0,12.0,12.0,12.0,10.0,6.0,5.0,14.0,12.0,20.0,10.0,9.0,10.0,8.0,2.0,6.0,12.0,11.0,11.0,12.0,13.0,14.0,11.0,13.0,4.0,19.0,0.0,0.0,0.0,0.0,175.0,67.0,3.0,2.0,1.0,3.0,3.0,1.0,1.0,1.0,2.0,1.0,3.0,7.0,8.0,12.0,8.0,10.0,6.0,12.0,9.0,8.0,10.0,10.0,8.0,12.0,11.0,14.0,10.0,12.0,9.0,10.0,11.0,10.0,12.0,12.0,10.0,12.0,12.0,13.0,14.0,13.0,11.0,14.0,8.0,6.0,14.0,12.0,20.0,14.0,12.0,12.0,8.0,11.0,6.0,12.0,17.0,13.0,10.0,11.0,12.0,11.0,17.0,5.0,22.0,24.0,3.0,7.0,0.0,177.0,78.0,2.0,1.0,2.0,3.0,2.0,2.0,4.0,3.0,3.0,2.0,1.0,10.0,13.0,16.0,14.0,16.0,16.0,8.0,16.0,4.0,4.0,15.0,12.0,4.0,16.0,12.0,11.0,12.0,13.0,10.0,11.0,8.0,13.0,17.0,5.0,14.0,5.0,10.0,12.0,15.0,14.0,13.0,9.0,10.0,17.0,16.0,20.0,15.0,14.0,12.0,11.0,15.0,4.0,12.0,19.0,16.0,14.0,14.0,11.0,13.0,10.0,12.0,22.0,5.0,1.0,1.0,0.0,173.0,72.0,1.0,3.0,1.0,3.0,3.0,3.0,3.0,3.0,3.0,2.0,2.0,14.0,13.0,16.0,14.0,16.0,14.0,5.0,11.0,5.0,5.0,15.0,11.0,5.0,16.0,8.0,13.0,9.0,14.0,13.0,15.0,13.0,15.0,16.0,5.0,13.0,5.0,9.0,10.0,15.0,16.0,14.0,5.0,20.0,14.0,15.0,5.0,12.0,14.0,13.0,11.0,13.0,8.0,14.0,10.0,15.0,14.0,10.0,13.0,10.0,10.0,13.0,20.0,29.0,2.0,0.0,0.0,181.0,75.0,1.0,1.0,2.0,2.0,2.0,3.0,2.0,1.0,1.0,3.0,2.0,5.0,9.0,15.0,10.0,11.0,9.0,10.0,8.0,7.0,3.0,10.0,10.0,5.0,15.0,7.0,10.0,9.0,12.0,10.0,8.0,11.0,14.0,12.0,5.0,13.0,5.0,11.0,12.0,16.0,12.0,9.0,12.0,20.0,14.0,16.0,7.0,12.0,10.0,9.0,10.0,10.0,11.0,6.0,10.0,15.0,9.0,13.0,11.0,14.0,18.0,7.0,24.0,0.0,0.0,0.0,0.0,186.0,80.0,9.0,10.0,13.0,6.0,12.0,11.0,13.0,14.0,11.0,12.0,7.0,5.0,2.0,2.0,3.0,9.0,10.0,2.0,2.0,2.0,1.0,8.0,2.0,1.0,9.0,8.0,11.0,13.0,9.0,10.0,7.0,9.0,14.0,6.0,9.0,1.0,11.0,12.0,6.0,10.0,13.0,14.0,13.0,20.0,14.0,7.0,5.0,12.0,14.0,10.0,8.0,14.0,7.0,1.0,15.0,13.0,15.0,11.0,14.0,13.0,12.0,8.0,23.0,0.0,0.0,0.0,0.0,188.0,75.0,2.0,2.0,2.0,2.0,3.0,4.0,2.0,2.0,2.0,3.0,3.0,4.0,10.0,7.0,5.0,10.0,7.0,13.0,10.0,5.0,13.0,11.0,6.0,13.0,12.0,13.0,13.0,14.0,11.0,11.0,8.0,11.0,12.0,5.0,6.0,10.0,12.0,13.0,14.0,13.0,11.0,15.0,14.0,5.0,14.0,12.0,20.0,14.0,14.0,12.0,13.0,11.0,7.0,12.0,9.0,12.0,11.0,7.0,12.0,10.0,10.0,8.0,24.0,0.0,0.0,0.0,0.0,185.0,70.0,3.0,2.0,3.0,2.0,2.0,1.0,2.0,1.0,1.0,2.0,3.0,5.0,6.0,9.0,7.0,11.0,8.0,15.0,12.0,7.0,14.0,13.0,7.0,11.0,11.0,11.0,14.0,14.0,13.0,9.0,9.0,12.0,4.0,8.0,5.0,10.0,12.0,15.0,12.0,11.0,11.0,14.0,13.0,6.0,15.0,11.0,20.0,13.0,14.0,13.0,9.0,11.0,7.0,10.0,15.0,11.0,13.0,11.0,10.0,9.0,14.0,4.0,26.0,0.0,0.0,0.0,0.0,167.0,67.0,3.0,1.0,3.0,1.0,2.0,2.0,3.0,1.0,3.0,1.0,3.0,7.0,11.0,11.0,5.0,12.0,6.0,6.0,7.0,10.0,12.0,12.0,6.0,12.0,13.0,11.0,11.0,10.0,13.0,12.0,9.0,12.0,13.0,7.0,5.0,8.0,11.0,13.0,13.0,15.0,14.0,10.0,6.0,7.0,15.0,15.0,20.0,14.0,8.0,14.0,8.0,13.0,7.0,10.0,14.0,13.0,13.0,14.0,14.0,16.0,16.0,6.0,24.0,0.0,0.0,0.0,0.0,175.0,72.0,3.0,2.0,4.0,3.0,2.0,4.0,1.0,1.0,1.0,2.0,2.0,8.0,12.0,12.0,6.0,11.0,7.0,10.0,9.0,12.0,11.0,12.0,8.0,12.0,11.0,11.0,12.0,13.0,10.0,10.0,9.0,9.0,3.0,9.0,9.0,11.0,12.0,11.0,11.0,14.0,13.0,11.0,8.0,20.0,12.0,13.0,6.0,12.0,11.0,10.0,10.0,10.0,9.0,10.0,10.0,13.0,10.0,11.0,10.0,13.0,18.0,1.0,29.0,0.0,0.0,0.0,0.0,188.0,74.0,1.0,2.0,3.0,3.0,2.0,3.0,1.0,3.0,2.0,1.0,1.0,4.0,8.0,10.0,6.0,13.0,7.0,14.0,9.0,6.0,13.0,12.0,8.0,13.0,13.0,12.0,14.0,13.0,14.0,11.0,13.0,12.0,14.0,6.0,13.0,8.0,14.0,15.0,15.0,9.0,12.0,14.0,14.0,10.0,13.0,10.0,20.0,16.0,12.0,13.0,12.0,15.0,9.0,11.0,11.0,14.0,14.0,12.0,15.0,13.0,13.0,6.0,21.0,0.0,0.0,3.0,0.0,174.0,70.0,3.0,1.0,3.0,3.0,2.0,2.0,1.0,3.0,3.0,2.0,1.0,10.0,11.0,12.0,10.0,13.0,8.0,7.0,11.0,6.0,10.0,14.0,11.0,8.0,13.0,7.0,11.0,11.0,12.0,12.0,14.0,11.0,8.0,11.0,10.0,12.0,8.0,13.0,14.0,13.0,14.0,13.0,9.0,20.0,11.0,12.0,8.0,13.0,11.0,13.0,7.0,10.0,5.0,12.0,13.0,11.0,12.0,9.0,11.0,12.0,10.0,5.0,26.0,0.0,0.0,0.0,0.0,178.0,74.0,2.0,3.0,1.0,3.0,3.0,3.0,2.0,2.0,3.0,1.0,3.0,14.0,12.0,12.0,10.0,13.0,14.0,9.0,12.0,5.0,6.0,12.0,8.0,8.0,13.0,11.0,11.0,12.0,10.0,11.0,12.0,13.0,15.0,12.0,8.0,11.0,12.0,12.0,15.0,14.0,15.0,15.0,10.0,5.0,13.0,13.0,20.0,14.0,13.0,13.0,13.0,14.0,8.0,6.0,14.0,13.0,12.0,11.0,13.0,12.0,16.0,7.0,24.0,0.0,0.0,0.0,0.0,169.0,65.0,3.0,3.0,2.0,1.0,2.0,4.0,1.0,3.0,4.0,3.0,2.0,11.0,12.0,12.0,7.0,12.0,9.0,5.0,10.0,7.0,3.0,11.0,12.0,5.0,13.0,7.0,10.0,9.0,12.0,9.0,12.0,10.0,4.0,11.0,6.0,12.0,6.0,12.0,14.0,16.0,14.0,11.0,6.0,20.0,14.0,15.0,5.0,14.0,7.0,12.0,7.0,14.0,6.0,8.0,16.0,13.0,16.0,12.0,12.0,10.0,15.0,6.0,19.0,0.0,0.0,0.0,0.0,168.0,64.0,3.0,2.0,4.0,1.0,2.0,2.0,1.0,1.0,1.0,1.0,3.0,9.0,11.0,13.0,10.0,11.0,8.0,4.0,10.0,3.0,4.0,11.0,10.0,4.0,12.0,8.0,11.0,11.0,9.0,8.0,10.0,10.0,12.0,11.0,6.0,9.0,9.0,10.0,9.0,14.0,11.0,10.0,7.0,11.0,12.0,14.0,20.0,11.0,10.0,11.0,12.0,9.0,8.0,11.0,10.0,11.0,9.0,11.0,8.0,7.0,8.0,10.0,23.0,0.0,0.0,7.0,3.0,181.0,71.0,2.0,2.0,2.0,2.0,2.0,2.0,4.0,2.0,3.0,3.0,2.0,7.0,12.0,12.0,14.0,13.0,7.0,11.0,11.0,7.0,6.0,11.0,15.0,7.0,12.0,12.0,13.0,16.0,12.0,12.0,10.0,11.0,6.0,12.0,7.0,14.0,9.0,12.0,16.0,13.0,14.0,13.0,9.0,8.0,14.0,12.0,20.0,12.0,12.0,12.0,10.0,12.0,8.0,10.0,19.0,10.0,10.0,10.0,11.0,11.0,12.0,6.0
1,2,33.0,70.0,0.0,0.0,0.0,185.0,81.0,12.0,9.0,11.0,10.0,11.0,11.0,12.0,15.0,10.0,15.0,8.0,6.0,2.0,8.0,1.0,12.0,8.0,10.0,1.0,2.0,1.0,2.0,1.0,3.0,11.0,10.0,9.0,13.0,11.0,15.0,9.0,11.0,15.0,2.0,10.0,1.0,12.0,17.0,9.0,7.0,14.0,13.0,14.0,10.0,7.0,9.0,20.0,11.0,10.0,14.0,11.0,13.0,6.0,11.0,18.0,18.0,10.0,10.0,17.0,14.0,12.0,2.0,27.0,0.0,0.0,0.0,0.0,181.0,79.0,3.0,1.0,3.0,1.0,3.0,1.0,1.0,2.0,3.0,3.0,3.0,5.0,12.0,10.0,5.0,10.0,6.0,11.0,7.0,8.0,12.0,9.0,7.0,12.0,11.0,13.0,13.0,14.0,13.0,12.0,9.0,9.0,13.0,9.0,7.0,8.0,13.0,13.0,13.0,15.0,12.0,13.0,10.0,5.0,13.0,13.0,20.0,15.0,14.0,15.0,13.0,7.0,6.0,10.0,8.0,13.0,13.0,13.0,14.0,14.0,14.0,5.0,19.0,0.0,0.0,0.0,0.0,190.0,75.0,2.0,1.0,1.0,3.0,4.0,3.0,3.0,1.0,2.0,1.0,2.0,4.0,6.0,6.0,6.0,9.0,5.0,11.0,9.0,6.0,11.0,7.0,4.0,11.0,8.0,13.0,11.0,11.0,7.0,7.0,12.0,7.0,18.0,4.0,10.0,5.0,9.0,9.0,11.0,14.0,15.0,13.0,13.0,12.0,15.0,13.0,20.0,11.0,10.0,10.0,13.0,9.0,10.0,10.0,19.0,10.0,13.0,10.0,11.0,7.0,17.0,6.0,29.0,0.0,0.0,0.0,0.0,170.0,66.0,1.0,1.0,1.0,1.0,4.0,3.0,1.0,2.0,3.0,1.0,1.0,11.0,13.0,12.0,7.0,12.0,10.0,7.0,12.0,9.0,13.0,12.0,8.0,12.0,13.0,14.0,11.0,15.0,12.0,14.0,10.0,12.0,14.0,12.0,10.0,13.0,8.0,13.0,15.0,14.0,13.0,10.0,7.0,20.0,15.0,13.0,10.0,15.0,7.0,14.0,14.0,14.0,6.0,16.0,9.0,13.0,14.0,14.0,16.0,11.0,9.0,9.0,20.0,0.0,0.0,0.0,0.0,190.0,80.0,2.0,2.0,1.0,4.0,2.0,2.0,3.0,4.0,2.0,2.0,1.0,12.0,12.0,10.0,9.0,11.0,7.0,12.0,8.0,12.0,10.0,10.0,9.0,12.0,11.0,13.0,11.0,13.0,11.0,12.0,8.0,11.0,11.0,7.0,8.0,10.0,10.0,13.0,12.0,13.0,12.0,12.0,15.0,20.0,13.0,14.0,6.0,13.0,14.0,12.0,6.0,10.0,5.0,13.0,16.0,13.0,9.0,12.0,10.0,10.0,11.0,4.0,24.0,0.0,0.0,0.0,0.0,174.0,68.0,3.0,1.0,3.0,1.0,1.0,2.0,1.0,3.0,1.0,1.0,1.0,13.0,12.0,12.0,10.0,13.0,13.0,8.0,13.0,10.0,6.0,14.0,12.0,7.0,13.0,9.0,13.0,11.0,13.0,11.0,13.0,13.0,12.0,11.0,7.0,12.0,9.0,12.0,12.0,14.0,13.0,12.0,8.0,8.0,14.0,12.0,20.0,13.0,10.0,13.0,10.0,13.0,7.0,12.0,14.0,14.0,15.0,9.0,11.0,13.0,12.0,8.0,27.0,27.0,1.0,2.0,1.0,183.0,72.0,2.0,2.0,2.0,1.0,2.0,1.0,3.0,1.0,2.0,2.0,4.0,5.0,8.0,10.0,6.0,11.0,10.0,14.0,11.0,5.0,14.0,12.0,10.0,15.0,11.0,14.0,13.0,16.0,11.0,11.0,9.0,10.0,12.0,8.0,12.0,8.0,13.0,14.0,14.0,14.0,12.0,16.0,11.0,8.0,12.0,13.0,20.0,15.0,15.0,10.0,14.0,11.0,7.0,11.0,13.0,13.0,9.0,9.0,11.0,10.0,10.0,8.0,31.0,0.0,0.0,0.0,0.0,180.0,74.0,3.0,2.0,3.0,1.0,2.0,3.0,2.0,1.0,4.0,3.0,3.0,12.0,12.0,10.0,9.0,13.0,14.0,11.0,13.0,6.0,10.0,14.0,15.0,13.0,13.0,15.0,14.0,17.0,12.0,14.0,13.0,13.0,15.0,7.0,13.0,10.0,13.0,18.0,15.0,9.0,11.0,14.0,10.0,10.0,13.0,12.0,20.0,15.0,14.0,14.0,13.0,15.0,8.0,7.0,19.0,13.0,13.0,13.0,13.0,13.0,12.0,9.0,27.0,0.0,0.0,11.0,1.0,174.0,72.0,2.0,3.0,4.0,1.0,1.0,4.0,3.0,3.0,3.0,3.0,1.0,10.0,13.0,14.0,8.0,14.0,7.0,6.0,11.0,5.0,6.0,13.0,10.0,5.0,14.0,7.0,12.0,10.0,10.0,12.0,9.0,12.0,12.0,12.0,4.0,14.0,6.0,9.0,13.0,16.0,14.0,10.0,6.0,9.0,13.0,16.0,20.0,12.0,9.0,14.0,6.0,11.0,7.0,10.0,10.0,13.0,12.0,11.0,14.0,14.0,16.0,8.0,26.0,0.0,0.0,15.0,6.0,182.0,80.0,1.0,4.0,1.0,3.0,1.0,3.0,3.0,1.0,2.0,1.0,3.0,5.0,9.0,11.0,12.0,10.0,9.0,13.0,10.0,5.0,4.0,9.0,13.0,6.0,12.0,9.0,12.0,12.0,12.0,12.0,11.0,12.0,12.0,13.0,8.0,13.0,10.0,12.0,12.0,16.0,15.0,12.0,12.0,7.0,14.0,16.0,20.0,12.0,15.0,12.0,6.0,12.0,7.0,10.0,11.0,11.0,13.0,8.0,12.0,14.0,14.0,7.0,28.0,0.0,0.0,2.0,2.0,182.0,79.0,1.0,1.0,2.0,2.0,3.0,1.0,2.0,3.0,1.0,2.0,2.0,8.0,11.0,14.0,12.0,14.0,11.0,12.0,13.0,6.0,4.0,11.0,13.0,5.0,14.0,11.0,12.0,13.0,10.0,12.0,11.0,11.0,15.0,13.0,7.0,14.0,7.0,12.0,14.0,15.0,14.0,14.0,12.0,8.0,15.0,14.0,20.0,15.0,14.0,12.0,11.0,15.0,8.0,8.0,16.0,15.0,12.0,11.0,14.0,13.0,12.0,8.0,33.0,0.0,0.0,3.0,0.0,188.0,84.0,14.0,13.0,13.0,9.0,13.0,13.0,15.0,15.0,11.0,11.0,9.0,7.0,3.0,3.0,1.0,7.0,10.0,2.0,1.0,1.0,2.0,6.0,4.0,1.0,7.0,8.0,13.0,14.0,14.0,14.0,8.0,11.0,15.0,6.0,13.0,3.0,13.0,12.0,8.0,12.0,14.0,15.0,14.0,8.0,13.0,11.0,20.0,13.0,15.0,16.0,8.0,13.0,6.0,1.0,11.0,14.0,13.0,11.0,16.0,14.0,11.0,6.0,29.0,2.0,0.0,0.0,0.0,185.0,75.0,2.0,3.0,3.0,3.0,2.0,3.0,2.0,1.0,3.0,1.0,2.0,4.0,10.0,8.0,6.0,10.0,6.0,14.0,7.0,7.0,14.0,11.0,6.0,14.0,9.0,13.0,13.0,14.0,11.0,12.0,12.0,12.0,14.0,8.0,11.0,12.0,13.0,13.0,13.0,15.0,12.0,15.0,12.0,8.0,15.0,13.0,20.0,14.0,15.0,14.0,7.0,14.0,8.0,6.0,14.0,13.0,15.0,14.0,14.0,14.0,14.0,6.0,26.0,0.0,0.0,10.0,1.0,196.0,91.0,3.0,1.0,2.0,2.0,2.0,3.0,2.0,4.0,2.0,2.0,1.0,3.0,5.0,8.0,6.0,9.0,5.0,14.0,7.0,8.0,13.0,10.0,5.0,12.0,10.0,10.0,13.0,14.0,12.0,12.0,7.0,10.0,13.0,6.0,9.0,6.0,12.0,14.0,10.0,9.0,8.0,13.0,18.0,8.0,17.0,11.0,20.0,12.0,16.0,13.0,12.0,10.0,7.0,4.0,18.0,10.0,12.0,9.0,13.0,7.0,10.0,7.0,26.0,0.0,0.0,0.0,0.0,175.0,69.0,3.0,3.0,2.0,2.0,3.0,1.0,3.0,1.0,3.0,2.0,2.0,6.0,12.0,10.0,5.0,11.0,6.0,10.0,10.0,10.0,13.0,12.0,9.0,13.0,12.0,12.0,13.0,14.0,12.0,13.0,12.0,11.0,15.0,11.0,13.0,12.0,13.0,14.0,14.0,15.0,13.0,12.0,7.0,9.0,13.0,13.0,20.0,14.0,11.0,14.0,12.0,12.0,11.0,15.0,14.0,9.0,17.0,10.0,8.0,11.0,20.0,7.0,26.0,0.0,0.0,0.0,0.0,182.0,68.0,1.0,4.0,3.0,2.0,3.0,1.0,2.0,1.0,2.0,4.0,1.0,7.0,12.0,9.0,5.0,10.0,6.0,12.0,7.0,15.0,12.0,9.0,6.0,12.0,10.0,12.0,13.0,14.0,11.0,10.0,9.0,9.0,13.0,7.0,6.0,10.0,10.0,14.0,15.0,16.0,13.0,13.0,11.0,5.0,15.0,15.0,20.0,14.0,10.0,12.0,12.0,13.0,7.0,12.0,12.0,14.0,14.0,15.0,13.0,14.0,14.0,7.0,27.0,32.0,6.0,0.0,0.0,188.0,78.0,3.0,2.0,3.0,2.0,1.0,3.0,3.0,3.0,2.0,2.0,2.0,4.0,8.0,11.0,12.0,12.0,6.0,16.0,13.0,8.0,13.0,14.0,7.0,12.0,12.0,12.0,10.0,14.0,13.0,12.0,11.0,12.0,15.0,9.0,11.0,12.0,6.0,13.0,12.0,14.0,13.0,15.0,15.0,5.0,13.0,12.0,20.0,16.0,15.0,14.0,12.0,15.0,11.0,10.0,9.0,15.0,12.0,12.0,13.0,13.0,13.0,7.0,21.0,0.0,0.0,0.0,0.0,183.0,73.0,1.0,4.0,3.0,3.0,3.0,1.0,4.0,1.0,2.0,3.0,2.0,11.0,10.0,12.0,11.0,13.0,9.0,12.0,10.0,5.0,8.0,12.0,9.0,8.0,13.0,13.0,12.0,12.0,10.0,12.0,14.0,12.0,12.0,14.0,8.0,12.0,8.0,12.0,12.0,14.0,14.0,14.0,11.0,8.0,13.0,13.0,20.0,12.0,12.0,12.0,5.0,10.0,7.0,12.0,15.0,11.0,11.0,10.0,11.0,12.0,11.0,4.0,29.0,0.0,0.0,0.0,0.0,183.0,78.0,1.0,3.0,3.0,3.0,3.0,1.0,2.0,3.0,3.0,1.0,1.0,13.0,8.0,9.0,6.0,12.0,14.0,13.0,10.0,12.0,11.0,12.0,8.0,13.0,12.0,12.0,15.0,13.0,13.0,13.0,11.0,13.0,15.0,6.0,12.0,7.0,13.0,16.0,18.0,12.0,11.0,14.0,12.0,20.0,14.0,11.0,8.0,16.0,14.0,14.0,12.0,14.0,6.0,12.0,10.0,12.0,13.0,11.0,15.0,15.0,15.0,5.0,29.0,0.0,0.0,0.0,0.0,180.0,71.0,1.0,3.0,1.0,1.0,1.0,4.0,4.0,1.0,1.0,2.0,3.0,10.0,11.0,12.0,9.0,13.0,11.0,8.0,14.0,6.0,8.0,11.0,10.0,8.0,12.0,10.0,11.0,12.0,12.0,9.0,12.0,11.0,14.0,12.0,7.0,12.0,10.0,12.0,14.0,15.0,14.0,12.0,10.0,20.0,16.0,13.0,12.0,15.0,10.0,13.0,10.0,15.0,7.0,8.0,16.0,12.0,12.0,13.0,14.0,15.0,15.0,6.0,23.0,0.0,0.0,0.0,0.0,175.0,70.0,2.0,1.0,2.0,2.0,1.0,2.0,2.0,3.0,4.0,1.0,2.0,10.0,11.0,12.0,9.0,13.0,8.0,6.0,13.0,2.0,5.0,13.0,10.0,6.0,13.0,7.0,13.0,9.0,13.0,11.0,13.0,12.0,13.0,12.0,10.0,12.0,10.0,13.0,12.0,11.0,12.0,13.0,8.0,8.0,14.0,12.0,20.0,14.0,12.0,13.0,9.0,11.0,10.0,11.0,19.0,12.0,14.0,11.0,13.0,10.0,16.0,7.0,23.0,1.0,0.0,0.0,0.0,185.0,70.0,4.0,3.0,1.0,2.0,1.0,3.0,2.0,3.0,1.0,2.0,3.0,5.0,8.0,12.0,13.0,13.0,7.0,14.0,11.0,5.0,5.0,8.0,13.0,5.0,13.0,6.0,13.0,10.0,12.0,12.0,11.0,11.0,13.0,12.0,7.0,13.0,9.0,8.0,10.0,16.0,12.0,14.0,12.0,8.0,14.0,15.0,20.0,13.0,13.0,12.0,7.0,15.0,7.0,7.0,13.0,13.0,12.0,10.0,12.0,15.0,15.0,7.0
0,2,30.0,42.0,0.0,13.0,0.0,195.0,88.0,16.0,13.0,14.0,6.0,14.0,13.0,13.0,15.0,12.0,10.0,14.0,1.0,8.0,5.0,2.0,8.0,2.0,8.0,2.0,5.0,3.0,9.0,5.0,3.0,8.0,10.0,12.0,10.0,14.0,10.0,10.0,14.0,13.0,3.0,14.0,3.0,12.0,14.0,12.0,8.0,13.0,18.0,18.0,17.0,14.0,11.0,20.0,14.0,17.0,14.0,4.0,14.0,4.0,1.0,12.0,13.0,14.0,9.0,15.0,13.0,13.0,5.0,19.0,0.0,0.0,0.0,0.0,189.0,78.0,2.0,2.0,2.0,1.0,1.0,1.0,3.0,1.0,2.0,1.0,2.0,7.0,8.0,9.0,7.0,9.0,6.0,12.0,8.0,8.0,12.0,12.0,6.0,13.0,11.0,15.0,13.0,14.0,11.0,10.0,8.0,12.0,14.0,6.0,9.0,11.0,11.0,13.0,14.0,13.0,12.0,12.0,13.0,6.0,14.0,13.0,20.0,12.0,13.0,13.0,6.0,12.0,5.0,13.0,16.0,13.0,13.0,13.0,15.0,14.0,12.0,5.0,28.0,0.0,0.0,0.0,0.0,190.0,85.0,3.0,2.0,3.0,3.0,2.0,2.0,2.0,4.0,3.0,1.0,2.0,5.0,9.0,8.0,9.0,8.0,7.0,14.0,10.0,9.0,15.0,9.0,6.0,14.0,9.0,16.0,13.0,16.0,10.0,13.0,10.0,12.0,15.0,6.0,13.0,7.0,13.0,14.0,16.0,12.0,11.0,17.0,13.0,20.0,15.0,13.0,8.0,15.0,15.0,12.0,14.0,14.0,9.0,8.0,14.0,13.0,14.0,11.0,12.0,13.0,16.0,14.0,23.0,0.0,0.0,0.0,0.0,184.0,71.0,1.0,2.0,1.0,2.0,2.0,2.0,2.0,4.0,2.0,1.0,3.0,4.0,10.0,10.0,6.0,11.0,6.0,14.0,8.0,7.0,14.0,11.0,6.0,13.0,11.0,12.0,12.0,13.0,12.0,11.0,12.0,12.0,14.0,6.0,8.0,10.0,13.0,13.0,14.0,15.0,13.0,14.0,13.0,8.0,12.0,14.0,20.0,13.0,14.0,13.0,12.0,14.0,15.0,8.0,11.0,13.0,13.0,10.0,8.0,9.0,16.0,7.0,21.0,0.0,0.0,0.0,0.0,177.0,0.0,1.0,1.0,1.0,2.0,3.0,3.0,2.0,3.0,2.0,2.0,3.0,6.0,4.0,13.0,13.0,13.0,6.0,13.0,7.0,3.0,5.0,7.0,6.0,1.0,11.0,9.0,7.0,8.0,7.0,7.0,7.0,8.0,7.0,11.0,8.0,13.0,7.0,6.0,7.0,12.0,13.0,7.0,6.0,8.0,8.0,13.0,20.0,5.0,5.0,9.0,5.0,9.0,9.0,9.0,10.0,10.0,12.0,12.0,11.0,10.0,9.0,6.0,21.0,0.0,0.0,0.0,0.0,178.0,65.0,2.0,3.0,3.0,3.0,3.0,1.0,1.0,1.0,1.0,3.0,1.0,9.0,13.0,11.0,6.0,12.0,7.0,9.0,8.0,8.0,13.0,12.0,7.0,13.0,12.0,8.0,12.0,13.0,12.0,12.0,13.0,13.0,14.0,9.0,8.0,12.0,12.0,13.0,13.0,12.0,14.0,13.0,11.0,8.0,15.0,12.0,20.0,13.0,12.0,14.0,8.0,11.0,7.0,10.0,19.0,10.0,13.0,10.0,11.0,15.0,15.0,6.0,22.0,0.0,0.0,0.0,0.0,187.0,84.0,2.0,2.0,1.0,2.0,3.0,2.0,2.0,3.0,3.0,2.0,2.0,4.0,7.0,10.0,6.0,9.0,10.0,13.0,12.0,5.0,11.0,11.0,7.0,10.0,12.0,12.0,11.0,13.0,10.0,9.0,11.0,9.0,15.0,8.0,7.0,9.0,11.0,11.0,14.0,13.0,10.0,15.0,14.0,8.0,15.0,11.0,20.0,14.0,15.0,11.0,12.0,7.0,9.0,8.0,7.0,13.0,15.0,13.0,11.0,14.0,14.0,7.0,21.0,0.0,0.0,0.0,0.0,172.0,66.0,2.0,3.0,2.0,2.0,1.0,1.0,1.0,3.0,2.0,1.0,1.0,10.0,10.0,13.0,9.0,14.0,9.0,8.0,10.0,7.0,13.0,13.0,9.0,12.0,13.0,10.0,12.0,13.0,13.0,12.0,14.0,13.0,13.0,11.0,9.0,14.0,13.0,14.0,14.0,14.0,13.0,12.0,8.0,8.0,12.0,12.0,20.0,13.0,12.0,14.0,10.0,11.0,8.0,12.0,15.0,10.0,15.0,8.0,11.0,14.0,14.0,6.0,22.0,0.0,0.0,0.0,0.0,177.0,72.0,2.0,1.0,2.0,4.0,2.0,2.0,1.0,3.0,4.0,2.0,3.0,10.0,12.0,13.0,11.0,12.0,10.0,12.0,12.0,4.0,10.0,13.0,11.0,11.0,13.0,11.0,12.0,11.0,13.0,9.0,13.0,12.0,3.0,12.0,8.0,14.0,12.0,12.0,13.0,16.0,13.0,12.0,9.0,8.0,15.0,14.0,20.0,14.0,13.0,10.0,4.0,11.0,11.0,12.0,19.0,9.0,12.0,13.0,12.0,11.0,14.0,7.0,29.0,30.0,6.0,0.0,0.0,178.0,76.0,2.0,3.0,3.0,4.0,3.0,2.0,2.0,2.0,2.0,1.0,1.0,6.0,11.0,16.0,10.0,12.0,5.0,8.0,8.0,5.0,4.0,13.0,7.0,3.0,12.0,7.0,8.0,12.0,11.0,10.0,8.0,9.0,13.0,15.0,4.0,13.0,7.0,12.0,10.0,16.0,15.0,14.0,8.0,11.0,13.0,16.0,20.0,10.0,13.0,10.0,11.0,10.0,7.0,5.0,9.0,16.0,9.0,10.0,11.0,11.0,14.0,3.0,25.0,0.0,0.0,0.0,0.0,187.0,83.0,2.0,1.0,3.0,3.0,1.0,3.0,3.0,3.0,1.0,1.0,3.0,4.0,8.0,10.0,14.0,12.0,8.0,14.0,9.0,5.0,7.0,11.0,13.0,5.0,12.0,11.0,13.0,13.0,13.0,11.0,10.0,12.0,16.0,9.0,8.0,13.0,11.0,13.0,16.0,14.0,13.0,15.0,13.0,20.0,14.0,12.0,8.0,14.0,16.0,13.0,11.0,13.0,7.0,5.0,13.0,14.0,13.0,14.0,14.0,13.0,13.0,6.0,25.0,0.0,0.0,0.0,0.0,187.0,83.0,11.0,14.0,12.0,8.0,13.0,11.0,14.0,15.0,13.0,13.0,9.0,8.0,1.0,1.0,1.0,11.0,11.0,1.0,2.0,2.0,1.0,10.0,3.0,2.0,11.0,8.0,12.0,14.0,12.0,12.0,10.0,12.0,14.0,6.0,14.0,2.0,12.0,12.0,8.0,13.0,15.0,14.0,13.0,20.0,15.0,11.0,5.0,14.0,13.0,13.0,8.0,8.0,10.0,1.0,9.0,13.0,14.0,12.0,15.0,15.0,15.0,5.0,17.0,0.0,0.0,0.0,0.0,178.0,72.0,2.0,2.0,1.0,2.0,1.0,1.0,3.0,3.0,2.0,2.0,3.0,7.0,9.0,7.0,3.0,9.0,4.0,7.0,5.0,8.0,7.0,10.0,6.0,13.0,10.0,4.0,7.0,9.0,7.0,9.0,9.0,10.0,9.0,9.0,5.0,8.0,8.0,9.0,9.0,15.0,11.0,9.0,9.0,20.0,10.0,12.0,8.0,7.0,10.0,9.0,4.0,9.0,9.0,9.0,12.0,12.0,12.0,11.0,11.0,10.0,20.0,4.0,31.0,0.0,0.0,7.0,2.0,185.0,80.0,3.0,3.0,1.0,1.0,4.0,1.0,4.0,3.0,3.0,3.0,1.0,5.0,10.0,9.0,6.0,11.0,7.0,15.0,8.0,8.0,14.0,12.0,6.0,13.0,11.0,12.0,14.0,16.0,12.0,13.0,8.0,11.0,17.0,5.0,14.0,6.0,15.0,14.0,14.0,12.0,11.0,15.0,14.0,10.0,16.0,11.0,20.0,14.0,15.0,14.0,12.0,15.0,8.0,13.0,8.0,15.0,17.0,14.0,16.0,15.0,15.0,7.0,26.0,0.0,0.0,0.0,0.0,183.0,79.0,1.0,1.0,3.0,4.0,3.0,2.0,2.0,1.0,2.0,1.0,1.0,9.0,8.0,12.0,11.0,10.0,11.0,10.0,9.0,7.0,6.0,8.0,9.0,5.0,12.0,10.0,9.0,8.0,11.0,11.0,9.0,8.0,11.0,14.0,6.0,12.0,8.0,10.0,11.0,11.0,12.0,11.0,10.0,10.0,10.0,12.0,20.0,11.0,11.0,9.0,9.0,9.0,6.0,13.0,17.0,11.0,10.0,11.0,12.0,10.0,10.0,4.0,25.0,13.0,1.0,0.0,0.0,176.0,69.0,3.0,3.0,3.0,1.0,1.0,3.0,1.0,3.0,3.0,2.0,3.0,9.0,12.0,12.0,6.0,11.0,11.0,9.0,7.0,8.0,10.0,11.0,3.0,11.0,11.0,6.0,10.0,8.0,8.0,8.0,7.0,11.0,5.0,8.0,4.0,13.0,11.0,12.0,15.0,15.0,14.0,15.0,8.0,20.0,15.0,15.0,10.0,13.0,8.0,9.0,5.0,2.0,11.0,12.0,14.0,13.0,8.0,13.0,13.0,11.0,16.0,4.0,19.0,0.0,0.0,0.0,0.0,181.0,68.0,2.0,3.0,1.0,1.0,2.0,3.0,2.0,3.0,2.0,1.0,2.0,8.0,11.0,12.0,9.0,11.0,11.0,8.0,11.0,6.0,9.0,12.0,7.0,12.0,12.0,12.0,10.0,7.0,10.0,10.0,12.0,8.0,3.0,13.0,7.0,11.0,12.0,13.0,13.0,12.0,13.0,14.0,10.0,12.0,15.0,14.0,20.0,14.0,11.0,10.0,12.0,8.0,11.0,14.0,18.0,13.0,9.0,12.0,12.0,12.0,19.0,1.0,21.0,0.0,0.0,0.0,0.0,185.0,69.0,2.0,3.0,2.0,1.0,3.0,3.0,3.0,3.0,3.0,2.0,2.0,5.0,9.0,12.0,9.0,16.0,10.0,11.0,15.0,5.0,13.0,13.0,8.0,14.0,13.0,11.0,16.0,13.0,13.0,14.0,12.0,11.0,15.0,10.0,7.0,8.0,13.0,14.0,13.0,13.0,13.0,14.0,12.0,6.0,13.0,12.0,20.0,13.0,11.0,12.0,10.0,12.0,7.0,13.0,10.0,14.0,14.0,11.0,14.0,14.0,14.0,6.0,27.0,0.0,0.0,0.0,0.0,186.0,77.0,2.0,4.0,2.0,2.0,1.0,1.0,1.0,3.0,2.0,2.0,1.0,10.0,11.0,12.0,10.0,13.0,11.0,12.0,14.0,8.0,10.0,14.0,6.0,12.0,13.0,13.0,12.0,13.0,12.0,12.0,12.0,12.0,14.0,9.0,10.0,12.0,11.0,14.0,15.0,12.0,13.0,14.0,12.0,20.0,12.0,11.0,9.0,16.0,13.0,13.0,13.0,13.0,15.0,12.0,14.0,13.0,14.0,13.0,15.0,15.0,15.0,5.0,23.0,15.0,5.0,0.0,0.0,186.0,81.0,3.0,1.0,1.0,4.0,1.0,1.0,2.0,2.0,3.0,3.0,4.0,5.0,10.0,13.0,14.0,10.0,5.0,11.0,13.0,5.0,4.0,9.0,10.0,4.0,10.0,13.0,11.0,14.0,12.0,9.0,8.0,8.0,15.0,13.0,7.0,8.0,7.0,10.0,10.0,15.0,12.0,15.0,12.0,7.0,10.0,18.0,20.0,17.0,15.0,8.0,8.0,11.0,12.0,12.0,12.0,15.0,13.0,12.0,15.0,13.0,13.0,6.0,23.0,3.0,2.0,15.0,5.0,173.0,70.0,4.0,2.0,3.0,3.0,2.0,1.0,1.0,3.0,2.0,1.0,1.0,7.0,12.0,15.0,12.0,12.0,10.0,6.0,15.0,7.0,5.0,13.0,9.0,7.0,13.0,6.0,9.0,7.0,10.0,9.0,15.0,9.0,14.0,15.0,7.0,13.0,12.0,12.0,11.0,17.0,15.0,15.0,9.0,20.0,14.0,15.0,15.0,13.0,7.0,8.0,8.0,11.0,9.0,9.0,12.0,17.0,9.0,9.0,12.0,10.0,10.0,7.0,27.0,17.0,2.0,0.0,0.0,180.0,78.0,2.0,3.0,2.0,1.0,1.0,2.0,1.0,1.0,2.0,3.0,2.0,7.0,10.0,13.0,12.0,13.0,11.0,12.0,12.0,7.0,5.0,12.0,9.0,4.0,12.0,12.0,13.0,14.0,10.0,11.0,11.0,10.0,12.0,14.0,5.0,13.0,7.0,10.0,14.0,16.0,15.0,14.0,11.0,20.0,12.0,15.0,8.0,14.0,14.0,11.0,12.0,15.0,9.0,10.0,6.0,14.0,12.0,11.0,13.0,13.0,13.0,10.0
2,1,23.0,3.0,0.0,12.0,0.0,187.0,98.0,12.0,14.0,15.0,6.0,14.0,12.0,14.0,15.0,11.0,10.0,14.0,2.0,1.0,1.0,1.0,7.0,2.0,2.0,2.0,5.0,6.0,9.0,9.0,8.0,6.0,10.0,11.0,14.0,11.0,11.0,6.0,12.0,15.0,15.0,16.0,4.0,12.0,12.0,2.0,12.0,12.0,12.0,13.0,5.0,13.0,12.0,20.0,9.0,14.0,14.0,10.0,11.0,10.0,1.0,10.0,13.0,13.0,17.0,8.0,11.0,8.0,10.0,19.0,0.0,0.0,0.0,0.0,182.0,77.0,1.0,1.0,2.0,2.0,3.0,2.0,2.0,1.0,2.0,2.0,2.0,2.0,7.0,6.0,4.0,10.0,5.0,12.0,6.0,5.0,9.0,9.0,8.0,11.0,11.0,8.0,9.0,10.0,11.0,11.0,8.0,15.0,12.0,5.0,12.0,6.0,9.0,10.0,12.0,9.0,10.0,13.0,11.0,10.0,15.0,11.0,20.0,12.0,11.0,10.0,8.0,6.0,10.0,10.0,18.0,14.0,10.0,9.0,14.0,15.0,15.0,8.0,19.0,0.0,0.0,0.0,0.0,182.0,89.0,1.0,2.0,2.0,1.0,1.0,1.0,2.0,1.0,3.0,3.0,3.0,5.0,8.0,6.0,5.0,11.0,5.0,14.0,6.0,6.0,12.0,11.0,8.0,13.0,10.0,13.0,12.0,15.0,12.0,13.0,9.0,12.0,12.0,8.0,8.0,7.0,12.0,13.0,14.0,12.0,11.0,15.0,12.0,10.0,15.0,13.0,20.0,14.0,16.0,13.0,4.0,10.0,6.0,11.0,9.0,13.0,10.0,13.0,13.0,14.0,14.0,6.0,29.0,0.0,0.0,4.0,0.0,184.0,72.0,3.0,2.0,4.0,2.0,3.0,1.0,1.0,3.0,1.0,1.0,1.0,8.0,13.0,10.0,6.0,11.0,7.0,12.0,8.0,10.0,12.0,11.0,9.0,13.0,11.0,9.0,14.0,14.0,11.0,14.0,10.0,12.0,16.0,9.0,14.0,12.0,13.0,15.0,16.0,15.0,12.0,14.0,12.0,8.0,13.0,14.0,20.0,16.0,12.0,13.0,9.0,16.0,8.0,15.0,13.0,13.0,17.0,14.0,16.0,16.0,16.0,5.0,24.0,9.0,0.0,0.0,0.0,176.0,71.0,3.0,1.0,1.0,2.0,3.0,1.0,1.0,1.0,3.0,1.0,4.0,5.0,12.0,10.0,6.0,11.0,5.0,6.0,9.0,11.0,8.0,9.0,6.0,11.0,12.0,12.0,11.0,11.0,9.0,10.0,8.0,10.0,14.0,9.0,8.0,12.0,10.0,12.0,13.0,16.0,13.0,12.0,8.0,10.0,16.0,14.0,20.0,15.0,10.0,13.0,12.0,10.0,5.0,15.0,9.0,13.0,13.0,10.0,12.0,14.0,14.0,7.0,21.0,0.0,0.0,1.0,0.0,186.0,75.0,3.0,4.0,2.0,2.0,2.0,2.0,1.0,2.0,2.0,1.0,3.0,10.0,11.0,10.0,8.0,13.0,11.0,10.0,11.0,8.0,12.0,11.0,7.0,14.0,12.0,11.0,12.0,14.0,11.0,10.0,10.0,11.0,14.0,12.0,11.0,14.0,11.0,12.0,12.0,13.0,11.0,12.0,14.0,20.0,11.0,14.0,5.0,13.0,12.0,12.0,11.0,11.0,10.0,11.0,11.0,14.0,11.0,12.0,9.0,8.0,7.0,2.0,25.0,0.0,0.0,7.0,0.0,180.0,76.0,2.0,1.0,3.0,3.0,3.0,3.0,4.0,2.0,1.0,1.0,3.0,10.0,12.0,11.0,8.0,14.0,9.0,12.0,13.0,8.0,10.0,14.0,8.0,12.0,14.0,13.0,13.0,15.0,13.0,14.0,13.0,13.0,15.0,10.0,7.0,11.0,12.0,15.0,16.0,14.0,15.0,14.0,10.0,8.0,14.0,13.0,20.0,15.0,13.0,14.0,13.0,14.0,9.0,16.0,12.0,13.0,15.0,13.0,14.0,12.0,11.0,8.0,22.0,5.0,0.0,9.0,2.0,181.0,73.0,3.0,1.0,2.0,1.0,3.0,2.0,2.0,3.0,3.0,1.0,1.0,12.0,13.0,12.0,7.0,14.0,12.0,9.0,11.0,6.0,7.0,14.0,10.0,8.0,15.0,13.0,11.0,12.0,13.0,12.0,15.0,12.0,12.0,11.0,10.0,11.0,11.0,14.0,13.0,11.0,13.0,14.0,10.0,10.0,16.0,12.0,20.0,14.0,12.0,12.0,11.0,14.0,9.0,8.0,12.0,13.0,16.0,12.0,14.0,13.0,14.0,5.0,22.0,0.0,0.0,0.0,0.0,178.0,71.0,3.0,1.0,1.0,1.0,4.0,1.0,1.0,1.0,4.0,1.0,3.0,10.0,11.0,12.0,7.0,13.0,11.0,7.0,11.0,5.0,8.0,14.0,8.0,8.0,14.0,9.0,13.0,12.0,13.0,11.0,13.0,12.0,16.0,8.0,11.0,10.0,11.0,15.0,14.0,10.0,14.0,12.0,9.0,8.0,14.0,8.0,20.0,14.0,11.0,14.0,9.0,10.0,7.0,12.0,20.0,12.0,15.0,12.0,11.0,14.0,14.0,6.0,22.0,0.0,0.0,0.0,0.0,176.0,61.0,1.0,4.0,1.0,1.0,3.0,1.0,3.0,1.0,3.0,3.0,3.0,11.0,11.0,13.0,12.0,13.0,11.0,6.0,11.0,6.0,8.0,13.0,10.0,10.0,14.0,10.0,12.0,13.0,10.0,10.0,13.0,12.0,11.0,12.0,11.0,12.0,12.0,13.0,12.0,13.0,14.0,12.0,8.0,8.0,12.0,13.0,20.0,13.0,8.0,12.0,12.0,11.0,11.0,11.0,17.0,12.0,13.0,12.0,14.0,15.0,15.0,6.0,18.0,0.0,0.0,4.0,0.0,188.0,81.0,3.0,3.0,1.0,3.0,1.0,4.0,1.0,2.0,1.0,3.0,4.0,6.0,8.0,13.0,10.0,10.0,10.0,8.0,12.0,6.0,6.0,10.0,14.0,6.0,9.0,10.0,7.0,14.0,9.0,9.0,11.0,11.0,10.0,8.0,11.0,8.0,4.0,11.0,13.0,12.0,13.0,14.0,13.0,8.0,14.0,14.0,20.0,12.0,13.0,10.0,10.0,7.0,6.0,10.0,17.0,10.0,9.0,9.0,13.0,10.0,11.0,6.0,27.0,0.0,0.0,0.0,0.0,185.0,81.0,13.0,11.0,11.0,9.0,11.0,11.0,12.0,13.0,11.0,14.0,8.0,4.0,1.0,1.0,2.0,9.0,8.0,7.0,2.0,2.0,1.0,8.0,5.0,1.0,8.0,10.0,12.0,15.0,12.0,12.0,8.0,11.0,14.0,6.0,11.0,2.0,11.0,12.0,6.0,12.0,13.0,14.0,13.0,5.0,14.0,10.0,20.0,12.0,13.0,12.0,10.0,13.0,10.0,1.0,10.0,14.0,14.0,12.0,13.0,14.0,11.0,7.0,29.0,0.0,0.0,0.0,0.0,185.0,84.0,3.0,2.0,2.0,2.0,1.0,3.0,1.0,2.0,1.0,3.0,1.0,3.0,6.0,6.0,7.0,10.0,5.0,14.0,5.0,4.0,14.0,9.0,7.0,13.0,9.0,13.0,13.0,14.0,12.0,13.0,8.0,12.0,14.0,8.0,16.0,8.0,12.0,13.0,15.0,11.0,11.0,15.0,12.0,5.0,14.0,12.0,20.0,14.0,16.0,13.0,12.0,10.0,7.0,7.0,7.0,12.0,13.0,13.0,14.0,13.0,12.0,8.0,27.0,0.0,0.0,0.0,0.0,169.0,60.0,3.0,2.0,1.0,3.0,3.0,2.0,1.0,3.0,3.0,2.0,2.0,11.0,11.0,13.0,9.0,13.0,12.0,8.0,10.0,4.0,5.0,14.0,8.0,5.0,13.0,12.0,9.0,9.0,10.0,10.0,10.0,9.0,16.0,13.0,4.0,14.0,8.0,11.0,8.0,16.0,16.0,9.0,9.0,5.0,13.0,15.0,20.0,11.0,11.0,10.0,8.0,7.0,5.0,11.0,14.0,10.0,12.0,11.0,12.0,10.0,13.0,8.0,16.0,0.0,0.0,0.0,0.0,177.0,0.0,3.0,2.0,1.0,1.0,3.0,3.0,2.0,2.0,2.0,1.0,3.0,1.0,3.0,2.0,2.0,4.0,1.0,3.0,1.0,6.0,9.0,2.0,1.0,9.0,6.0,14.0,4.0,5.0,5.0,3.0,2.0,5.0,4.0,5.0,7.0,4.0,8.0,4.0,3.0,10.0,7.0,13.0,7.0,15.0,13.0,9.0,20.0,5.0,8.0,7.0,11.0,5.0,8.0,8.0,11.0,11.0,5.0,14.0,20.0,7.0,12.0,5.0,23.0,0.0,0.0,8.0,0.0,183.0,77.0,2.0,3.0,1.0,2.0,1.0,3.0,3.0,3.0,3.0,2.0,2.0,7.0,13.0,12.0,7.0,12.0,6.0,8.0,9.0,11.0,12.0,9.0,7.0,12.0,12.0,10.0,12.0,14.0,13.0,12.0,11.0,11.0,15.0,11.0,7.0,13.0,12.0,12.0,13.0,16.0,13.0,14.0,11.0,8.0,15.0,15.0,20.0,13.0,13.0,11.0,10.0,13.0,7.0,8.0,11.0,13.0,14.0,11.0,14.0,15.0,15.0,5.0,30.0,0.0,0.0,0.0,0.0,178.0,79.0,1.0,2.0,2.0,3.0,2.0,2.0,1.0,2.0,1.0,2.0,1.0,11.0,13.0,9.0,6.0,11.0,11.0,12.0,11.0,10.0,12.0,12.0,7.0,13.0,11.0,15.0,13.0,15.0,11.0,12.0,10.0,12.0,13.0,12.0,15.0,10.0,12.0,16.0,15.0,14.0,12.0,13.0,9.0,5.0,13.0,12.0,20.0,15.0,14.0,14.0,14.0,13.0,9.0,14.0,18.0,12.0,15.0,14.0,14.0,14.0,14.0,6.0,26.0,0.0,0.0,0.0,0.0,184.0,76.0,2.0,3.0,1.0,3.0,1.0,1.0,3.0,1.0,3.0,2.0,2.0,10.0,12.0,14.0,12.0,14.0,12.0,11.0,13.0,11.0,13.0,14.0,13.0,12.0,15.0,14.0,13.0,12.0,11.0,11.0,13.0,14.0,14.0,12.0,13.0,12.0,11.0,11.0,14.0,15.0,14.0,13.0,10.0,5.0,14.0,14.0,20.0,14.0,14.0,14.0,7.0,16.0,6.0,8.0,19.0,14.0,14.0,14.0,14.0,14.0,14.0,6.0,22.0,0.0,0.0,0.0,0.0,188.0,79.0,1.0,2.0,2.0,3.0,2.0,2.0,3.0,4.0,3.0,2.0,1.0,8.0,10.0,11.0,7.0,11.0,8.0,10.0,8.0,7.0,8.0,10.0,10.0,11.0,11.0,11.0,12.0,13.0,11.0,10.0,8.0,11.0,10.0,8.0,8.0,12.0,10.0,12.0,15.0,13.0,12.0,14.0,14.0,20.0,13.0,12.0,8.0,14.0,14.0,12.0,10.0,6.0,8.0,15.0,11.0,11.0,11.0,11.0,11.0,10.0,12.0,6.0,28.0,0.0,0.0,0.0,0.0,181.0,75.0,4.0,2.0,1.0,3.0,3.0,3.0,2.0,2.0,2.0,2.0,2.0,13.0,12.0,12.0,9.0,12.0,13.0,7.0,11.0,7.0,7.0,13.0,5.0,7.0,13.0,9.0,13.0,3.0,12.0,11.0,12.0,12.0,3.0,12.0,14.0,12.0,9.0,12.0,13.0,13.0,13.0,10.0,11.0,20.0,13.0,12.0,6.0,13.0,9.0,13.0,6.0,13.0,8.0,10.0,20.0,12.0,14.0,11.0,13.0,10.0,11.0,4.0,24.0,0.0,0.0,0.0,0.0,179.0,85.0,2.0,4.0,2.0,3.0,1.0,1.0,1.0,1.0,1.0,1.0,2.0,4.0,8.0,12.0,14.0,11.0,8.0,13.0,11.0,7.0,8.0,9.0,12.0,6.0,12.0,12.0,12.0,13.0,13.0,14.0,9.0,14.0,16.0,11.0,8.0,13.0,5.0,11.0,12.0,11.0,13.0,16.0,10.0,9.0,2.0,12.0,20.0,14.0,16.0,14.0,12.0,13.0,7.0,5.0,19.0,13.0,13.0,8.0,12.0,12.0,12.0,10.0,24.0,0.0,0.0,4.0,0.0,181.0,79.0,1.0,3.0,2.0,2.0,1.0,1.0,1.0,2.0,2.0,2.0,1.0,4.0,6.0,10.0,11.0,11.0,7.0,12.0,10.0,5.0,5.0,7.0,13.0,3.0,10.0,9.0,12.0,12.0,11.0,10.0,6.0,10.0,8.0,9.0,5.0,11.0,5.0,9.0,12.0,15.0,13.0,13.0,11.0,5.0,11.0,14.0,20.0,13.0,14.0,11.0,9.0,12.0,13.0,5.0,19.0,11.0,9.0,9.0,7.0,14.0,14.0,13.0
0,2,33.0,0.0,0.0,3.0,0.0,188.0,84.0,14.0,13.0,13.0,9.0,13.0,13.0,15.0,15.0,11.0,11.0,9.0,7.0,3.0,3.0,1.0,7.0,10.0,2.0,1.0,1.0,2.0,6.0,4.0,1.0,7.0,8.0,13.0,14.0,14.0,14.0,8.0,11.0,15.0,6.0,13.0,3.0,13.0,12.0,8.0,12.0,14.0,15.0,14.0,8.0,13.0,11.0,20.0,13.0,15.0,16.0,8.0,13.0,6.0,1.0,11.0,14.0,13.0,11.0,16.0,14.0,11.0,6.0,26.0,0.0,0.0,10.0,1.0,196.0,91.0,3.0,1.0,2.0,2.0,2.0,3.0,2.0,4.0,2.0,2.0,1.0,3.0,5.0,8.0,6.0,9.0,5.0,14.0,7.0,8.0,13.0,10.0,5.0,12.0,10.0,10.0,13.0,14.0,12.0,12.0,7.0,10.0,13.0,6.0,9.0,6.0,12.0,14.0,10.0,9.0,8.0,13.0,18.0,8.0,17.0,11.0,20.0,12.0,16.0,13.0,12.0,10.0,7.0,4.0,18.0,10.0,12.0,9.0,13.0,7.0,10.0,7.0,29.0,2.0,0.0,0.0,0.0,185.0,75.0,2.0,3.0,3.0,3.0,2.0,3.0,2.0,1.0,3.0,1.0,2.0,4.0,10.0,8.0,6.0,10.0,6.0,14.0,7.0,7.0,14.0,11.0,6.0,14.0,9.0,13.0,13.0,14.0,11.0,12.0,12.0,12.0,14.0,8.0,11.0,12.0,13.0,13.0,13.0,15.0,12.0,15.0,12.0,8.0,15.0,13.0,20.0,14.0,15.0,14.0,7.0,14.0,8.0,6.0,14.0,13.0,15.0,14.0,14.0,14.0,14.0,6.0,26.0,0.0,0.0,0.0,0.0,175.0,69.0,3.0,3.0,2.0,2.0,3.0,1.0,3.0,1.0,3.0,2.0,2.0,6.0,12.0,10.0,5.0,11.0,6.0,10.0,10.0,10.0,13.0,12.0,9.0,13.0,12.0,12.0,13.0,14.0,12.0,13.0,12.0,11.0,15.0,11.0,13.0,12.0,13.0,14.0,14.0,15.0,13.0,12.0,7.0,9.0,13.0,13.0,20.0,14.0,11.0,14.0,12.0,12.0,11.0,15.0,14.0,9.0,17.0,10.0,8.0,11.0,20.0,7.0,26.0,0.0,0.0,0.0,0.0,182.0,68.0,1.0,4.0,3.0,2.0,3.0,1.0,2.0,1.0,2.0,4.0,1.0,7.0,12.0,9.0,5.0,10.0,6.0,12.0,7.0,15.0,12.0,9.0,6.0,12.0,10.0,12.0,13.0,14.0,11.0,10.0,9.0,9.0,13.0,7.0,6.0,10.0,10.0,14.0,15.0,16.0,13.0,13.0,11.0,5.0,15.0,15.0,20.0,14.0,10.0,12.0,12.0,13.0,7.0,12.0,12.0,14.0,14.0,15.0,13.0,14.0,14.0,7.0,29.0,0.0,0.0,0.0,0.0,183.0,78.0,1.0,3.0,3.0,3.0,3.0,1.0,2.0,3.0,3.0,1.0,1.0,13.0,8.0,9.0,6.0,12.0,14.0,13.0,10.0,12.0,11.0,12.0,8.0,13.0,12.0,12.0,15.0,13.0,13.0,13.0,11.0,13.0,15.0,6.0,12.0,7.0,13.0,16.0,18.0,12.0,11.0,14.0,12.0,20.0,14.0,11.0,8.0,16.0,14.0,14.0,12.0,14.0,6.0,12.0,10.0,12.0,13.0,11.0,15.0,15.0,15.0,5.0,27.0,32.0,6.0,0.0,0.0,188.0,78.0,3.0,2.0,3.0,2.0,1.0,3.0,3.0,3.0,2.0,2.0,2.0,4.0,8.0,11.0,12.0,12.0,6.0,16.0,13.0,8.0,13.0,14.0,7.0,12.0,12.0,12.0,10.0,14.0,13.0,12.0,11.0,12.0,15.0,9.0,11.0,12.0,6.0,13.0,12.0,14.0,13.0,15.0,15.0,5.0,13.0,12.0,20.0,16.0,15.0,14.0,12.0,15.0,11.0,10.0,9.0,15.0,12.0,12.0,13.0,13.0,13.0,7.0,21.0,0.0,0.0,0.0,0.0,183.0,73.0,1.0,4.0,3.0,3.0,3.0,1.0,4.0,1.0,2.0,3.0,2.0,11.0,10.0,12.0,11.0,13.0,9.0,12.0,10.0,5.0,8.0,12.0,9.0,8.0,13.0,13.0,12.0,12.0,10.0,12.0,14.0,12.0,12.0,14.0,8.0,12.0,8.0,12.0,12.0,14.0,14.0,14.0,11.0,8.0,13.0,13.0,20.0,12.0,12.0,12.0,5.0,10.0,7.0,12.0,15.0,11.0,11.0,10.0,11.0,12.0,11.0,4.0,29.0,0.0,0.0,0.0,0.0,180.0,71.0,1.0,3.0,1.0,1.0,1.0,4.0,4.0,1.0,1.0,2.0,3.0,10.0,11.0,12.0,9.0,13.0,11.0,8.0,14.0,6.0,8.0,11.0,10.0,8.0,12.0,10.0,11.0,12.0,12.0,9.0,12.0,11.0,14.0,12.0,7.0,12.0,10.0,12.0,14.0,15.0,14.0,12.0,10.0,20.0,16.0,13.0,12.0,15.0,10.0,13.0,10.0,15.0,7.0,8.0,16.0,12.0,12.0,13.0,14.0,15.0,15.0,6.0,23.0,0.0,0.0,0.0,0.0,175.0,70.0,2.0,1.0,2.0,2.0,1.0,2.0,2.0,3.0,4.0,1.0,2.0,10.0,11.0,12.0,9.0,13.0,8.0,6.0,13.0,2.0,5.0,13.0,10.0,6.0,13.0,7.0,13.0,9.0,13.0,11.0,13.0,12.0,13.0,12.0,10.0,12.0,10.0,13.0,12.0,11.0,12.0,13.0,8.0,8.0,14.0,12.0,20.0,14.0,12.0,13.0,9.0,11.0,10.0,11.0,19.0,12.0,14.0,11.0,13.0,10.0,16.0,7.0,23.0,1.0,0.0,0.0,0.0,185.0,70.0,4.0,3.0,1.0,2.0,1.0,3.0,2.0,3.0,1.0,2.0,3.0,5.0,8.0,12.0,13.0,13.0,7.0,14.0,11.0,5.0,5.0,8.0,13.0,5.0,13.0,6.0,13.0,10.0,12.0,12.0,11.0,11.0,13.0,12.0,7.0,13.0,9.0,8.0,10.0,16.0,12.0,14.0,12.0,8.0,14.0,15.0,20.0,13.0,13.0,12.0,7.0,15.0,7.0,7.0,13.0,13.0,12.0,10.0,12.0,15.0,15.0,7.0,30.0,42.0,0.0,13.0,0.0,195.0,88.0,16.0,13.0,14.0,6.0,14.0,13.0,13.0,15.0,12.0,10.0,14.0,1.0,8.0,5.0,2.0,8.0,2.0,8.0,2.0,5.0,3.0,9.0,5.0,3.0,8.0,10.0,12.0,10.0,14.0,10.0,10.0,14.0,13.0,3.0,14.0,3.0,12.0,14.0,12.0,8.0,13.0,18.0,18.0,17.0,14.0,11.0,20.0,14.0,17.0,14.0,4.0,14.0,4.0,1.0,12.0,13.0,14.0,9.0,15.0,13.0,13.0,5.0,28.0,0.0,0.0,0.0,0.0,190.0,85.0,3.0,2.0,3.0,3.0,2.0,2.0,2.0,4.0,3.0,1.0,2.0,5.0,9.0,8.0,9.0,8.0,7.0,14.0,10.0,9.0,15.0,9.0,6.0,14.0,9.0,16.0,13.0,16.0,10.0,13.0,10.0,12.0,15.0,6.0,13.0,7.0,13.0,14.0,16.0,12.0,11.0,17.0,13.0,20.0,15.0,13.0,8.0,15.0,15.0,12.0,14.0,14.0,9.0,8.0,14.0,13.0,14.0,11.0,12.0,13.0,16.0,14.0,23.0,0.0,0.0,0.0,0.0,184.0,71.0,1.0,2.0,1.0,2.0,2.0,2.0,2.0,4.0,2.0,1.0,3.0,4.0,10.0,10.0,6.0,11.0,6.0,14.0,8.0,7.0,14.0,11.0,6.0,13.0,11.0,12.0,12.0,13.0,12.0,11.0,12.0,12.0,14.0,6.0,8.0,10.0,13.0,13.0,14.0,15.0,13.0,14.0,13.0,8.0,12.0,14.0,20.0,13.0,14.0,13.0,12.0,14.0,15.0,8.0,11.0,13.0,13.0,10.0,8.0,9.0,16.0,7.0,21.0,0.0,0.0,0.0,0.0,178.0,65.0,2.0,3.0,3.0,3.0,3.0,1.0,1.0,1.0,1.0,3.0,1.0,9.0,13.0,11.0,6.0,12.0,7.0,9.0,8.0,8.0,13.0,12.0,7.0,13.0,12.0,8.0,12.0,13.0,12.0,12.0,13.0,13.0,14.0,9.0,8.0,12.0,12.0,13.0,13.0,12.0,14.0,13.0,11.0,8.0,15.0,12.0,20.0,13.0,12.0,14.0,8.0,11.0,7.0,10.0,19.0,10.0,13.0,10.0,11.0,15.0,15.0,6.0,21.0,0.0,0.0,0.0,0.0,177.0,0.0,1.0,1.0,1.0,2.0,3.0,3.0,2.0,3.0,2.0,2.0,3.0,6.0,4.0,13.0,13.0,13.0,6.0,13.0,7.0,3.0,5.0,7.0,6.0,1.0,11.0,9.0,7.0,8.0,7.0,7.0,7.0,8.0,7.0,11.0,8.0,13.0,7.0,6.0,7.0,12.0,13.0,7.0,6.0,8.0,8.0,13.0,20.0,5.0,5.0,9.0,5.0,9.0,9.0,9.0,10.0,10.0,12.0,12.0,11.0,10.0,9.0,6.0,26.0,25.0,1.0,7.0,0.0,189.0,78.0,1.0,1.0,1.0,1.0,1.0,1.0,1.0,1.0,1.0,1.0,1.0,8.0,9.0,10.0,6.0,12.0,8.0,13.0,14.0,7.0,11.0,14.0,11.0,13.0,13.0,13.0,13.0,16.0,13.0,13.0,12.0,13.0,14.0,10.0,10.0,12.0,13.0,15.0,15.0,12.0,11.0,9.0,15.0,10.0,14.0,13.0,20.0,14.0,14.0,12.0,13.0,11.0,14.0,12.0,14.0,11.0,14.0,12.0,16.0,15.0,13.0,5.0,19.0,0.0,0.0,0.0,0.0,174.0,61.0,1.0,3.0,2.0,3.0,2.0,1.0,2.0,2.0,3.0,1.0,1.0,5.0,9.0,10.0,6.0,12.0,6.0,8.0,8.0,5.0,9.0,10.0,7.0,9.0,13.0,11.0,12.0,12.0,11.0,9.0,11.0,11.0,8.0,9.0,10.0,8.0,10.0,12.0,16.0,13.0,13.0,10.0,8.0,20.0,15.0,11.0,8.0,13.0,9.0,15.0,11.0,10.0,6.0,13.0,10.0,9.0,14.0,11.0,12.0,14.0,14.0,8.0,21.0,0.0,0.0,0.0,0.0,172.0,66.0,2.0,3.0,2.0,2.0,1.0,1.0,1.0,3.0,2.0,1.0,1.0,10.0,10.0,13.0,9.0,14.0,9.0,8.0,10.0,7.0,13.0,13.0,9.0,12.0,13.0,10.0,12.0,13.0,13.0,12.0,14.0,13.0,13.0,11.0,9.0,14.0,13.0,14.0,14.0,14.0,13.0,12.0,8.0,8.0,12.0,12.0,20.0,13.0,12.0,14.0,10.0,11.0,8.0,12.0,15.0,10.0,15.0,8.0,11.0,14.0,14.0,6.0,22.0,0.0,0.0,0.0,0.0,187.0,84.0,2.0,2.0,1.0,2.0,3.0,2.0,2.0,3.0,3.0,2.0,2.0,4.0,7.0,10.0,6.0,9.0,10.0,13.0,12.0,5.0,11.0,11.0,7.0,10.0,12.0,12.0,11.0,13.0,10.0,9.0,11.0,9.0,15.0,8.0,7.0,9.0,11.0,11.0,14.0,13.0,10.0,15.0,14.0,8.0,15.0,11.0,20.0,14.0,15.0,11.0,12.0,7.0,9.0,8.0,7.0,13.0,15.0,13.0,11.0,14.0,14.0,7.0,24.0,2.0,0.0,0.0,0.0,195.0,84.0,1.0,4.0,1.0,2.0,3.0,1.0,2.0,1.0,2.0,1.0,1.0,6.0,6.0,9.0,11.0,10.0,8.0,14.0,11.0,5.0,8.0,10.0,11.0,2.0,11.0,11.0,12.0,14.0,11.0,14.0,8.0,12.0,13.0,8.0,6.0,11.0,7.0,13.0,14.0,13.0,12.0,18.0,18.0,8.0,13.0,14.0,20.0,14.0,17.0,12.0,11.0,10.0,7.0,5.0,8.0,12.0,9.0,12.0,13.0,12.0,14.0,2.0,25.0,0.0,0.0,0.0,0.0,187.0,83.0,2.0,1.0,3.0,3.0,1.0,3.0,3.0,3.0,1.0,1.0,3.0,4.0,8.0,10.0,14.0,12.0,8.0,14.0,9.0,5.0,7.0,11.0,13.0,5.0,12.0,11.0,13.0,13.0,13.0,11.0,10.0,12.0,16.0,9.0,8.0,13.0,11.0,13.0,16.0,14.0,13.0,15.0,13.0,20.0,14.0,12.0,8.0,14.0,16.0,13.0,11.0,13.0,7.0,5.0,13.0,14.0,13.0,14.0,14.0,13.0,13.0,6.0
3,2,27.0,0.0,0.0,0.0,0.0,185.0,81.0,13.0,11.0,11.0,9.0,11.0,11.0,12.0,13.0,11.0,14.0,8.0,4.0,1.0,1.0,2.0,9.0,8.0,7.0,2.0,2.0,1.0,8.0,5.0,1.0,8.0,10.0,12.0,15.0,12.0,12.0,8.0,11.0,14.0,6.0,11.0,2.0,11.0,12.0,6.0,12.0,13.0,14.0,13.0,5.0,14.0,10.0,20.0,12.0,13.0,12.0,10.0,13.0,10.0,1.0,10.0,14.0,14.0,12.0,13.0,14.0,11.0,7.0,33.0,24.0,1.0,3.0,0.0,193.0,90.0,1.0,2.0,2.0,2.0,3.0,2.0,3.0,1.0,3.0,2.0,3.0,3.0,6.0,8.0,8.0,11.0,10.0,17.0,8.0,5.0,13.0,10.0,7.0,14.0,11.0,14.0,14.0,16.0,11.0,10.0,9.0,10.0,14.0,7.0,13.0,7.0,13.0,14.0,11.0,9.0,10.0,15.0,15.0,7.0,13.0,10.0,20.0,10.0,13.0,10.0,13.0,15.0,9.0,8.0,12.0,15.0,13.0,11.0,15.0,12.0,13.0,7.0,16.0,0.0,0.0,0.0,0.0,177.0,0.0,3.0,2.0,1.0,1.0,3.0,3.0,2.0,2.0,2.0,1.0,3.0,1.0,3.0,2.0,2.0,4.0,1.0,3.0,1.0,6.0,9.0,2.0,1.0,9.0,6.0,14.0,4.0,5.0,5.0,3.0,2.0,5.0,4.0,5.0,7.0,4.0,8.0,4.0,3.0,10.0,7.0,13.0,7.0,15.0,13.0,9.0,20.0,5.0,8.0,7.0,11.0,5.0,8.0,8.0,11.0,11.0,5.0,14.0,20.0,7.0,12.0,5.0,24.0,0.0,0.0,0.0,0.0,178.0,77.0,2.0,1.0,3.0,2.0,1.0,3.0,3.0,3.0,1.0,3.0,2.0,5.0,10.0,8.0,5.0,9.0,6.0,11.0,8.0,12.0,11.0,8.0,6.0,12.0,9.0,11.0,11.0,13.0,11.0,12.0,7.0,11.0,15.0,9.0,6.0,9.0,11.0,12.0,14.0,16.0,12.0,14.0,10.0,5.0,15.0,15.0,20.0,14.0,13.0,14.0,11.0,13.0,5.0,8.0,17.0,12.0,14.0,14.0,14.0,14.0,14.0,6.0,23.0,0.0,0.0,8.0,0.0,183.0,77.0,2.0,3.0,1.0,2.0,1.0,3.0,3.0,3.0,3.0,2.0,2.0,7.0,13.0,12.0,7.0,12.0,6.0,8.0,9.0,11.0,12.0,9.0,7.0,12.0,12.0,10.0,12.0,14.0,13.0,12.0,11.0,11.0,15.0,11.0,7.0,13.0,12.0,12.0,13.0,16.0,13.0,14.0,11.0,8.0,15.0,15.0,20.0,13.0,13.0,11.0,10.0,13.0,7.0,8.0,11.0,13.0,14.0,11.0,14.0,15.0,15.0,5.0,29.0,0.0,0.0,0.0,0.0,181.0,69.0,1.0,3.0,1.0,4.0,1.0,2.0,2.0,3.0,4.0,3.0,2.0,4.0,6.0,7.0,8.0,12.0,8.0,12.0,12.0,7.0,11.0,12.0,13.0,13.0,11.0,15.0,13.0,14.0,13.0,14.0,8.0,12.0,15.0,7.0,10.0,7.0,13.0,15.0,17.0,12.0,12.0,14.0,10.0,8.0,13.0,11.0,20.0,14.0,11.0,14.0,15.0,14.0,9.0,8.0,9.0,13.0,14.0,12.0,13.0,10.0,10.0,6.0,26.0,0.0,0.0,0.0,0.0,184.0,76.0,2.0,3.0,1.0,3.0,1.0,1.0,3.0,1.0,3.0,2.0,2.0,10.0,12.0,14.0,12.0,14.0,12.0,11.0,13.0,11.0,13.0,14.0,13.0,12.0,15.0,14.0,13.0,12.0,11.0,11.0,13.0,14.0,14.0,12.0,13.0,12.0,11.0,11.0,14.0,15.0,14.0,13.0,10.0,5.0,14.0,14.0,20.0,14.0,14.0,14.0,7.0,16.0,6.0,8.0,19.0,14.0,14.0,14.0,14.0,14.0,14.0,6.0,22.0,0.0,0.0,0.0,0.0,188.0,79.0,1.0,2.0,2.0,3.0,2.0,2.0,3.0,4.0,3.0,2.0,1.0,8.0,10.0,11.0,7.0,11.0,8.0,10.0,8.0,7.0,8.0,10.0,10.0,11.0,11.0,11.0,12.0,13.0,11.0,10.0,8.0,11.0,10.0,8.0,8.0,12.0,10.0,12.0,15.0,13.0,12.0,14.0,14.0,20.0,13.0,12.0,8.0,14.0,14.0,12.0,10.0,6.0,8.0,15.0,11.0,11.0,11.0,11.0,11.0,10.0,12.0,6.0,29.0,0.0,0.0,0.0,0.0,180.0,74.0,2.0,1.0,3.0,3.0,2.0,4.0,1.0,3.0,3.0,2.0,2.0,9.0,13.0,13.0,10.0,14.0,10.0,12.0,12.0,6.0,8.0,12.0,8.0,8.0,14.0,10.0,13.0,14.0,13.0,12.0,13.0,11.0,13.0,11.0,7.0,10.0,10.0,14.0,14.0,14.0,13.0,13.0,12.0,10.0,14.0,13.0,20.0,14.0,11.0,14.0,10.0,15.0,8.0,10.0,8.0,12.0,14.0,16.0,14.0,15.0,15.0,6.0,28.0,0.0,0.0,0.0,0.0,181.0,75.0,4.0,2.0,1.0,3.0,3.0,3.0,2.0,2.0,2.0,2.0,2.0,13.0,12.0,12.0,9.0,12.0,13.0,7.0,11.0,7.0,7.0,13.0,5.0,7.0,13.0,9.0,13.0,3.0,12.0,11.0,12.0,12.0,3.0,12.0,14.0,12.0,9.0,12.0,13.0,13.0,13.0,10.0,11.0,20.0,13.0,12.0,6.0,13.0,9.0,13.0,6.0,13.0,8.0,10.0,20.0,12.0,14.0,11.0,13.0,10.0,11.0,4.0,24.0,0.0,0.0,4.0,0.0,181.0,79.0,1.0,3.0,2.0,2.0,1.0,1.0,1.0,2.0,2.0,2.0,1.0,4.0,6.0,10.0,11.0,11.0,7.0,12.0,10.0,5.0,5.0,7.0,13.0,3.0,10.0,9.0,12.0,12.0,11.0,10.0,6.0,10.0,8.0,9.0,5.0,11.0,5.0,9.0,12.0,15.0,13.0,13.0,11.0,5.0,11.0,14.0,20.0,13.0,14.0,11.0,9.0,12.0,13.0,5.0,19.0,11.0,9.0,9.0,7.0,14.0,14.0,13.0,25.0,0.0,0.0,3.0,0.0,187.0,83.0,15.0,9.0,12.0,8.0,13.0,11.0,12.0,14.0,7.0,12.0,8.0,4.0,2.0,3.0,2.0,9.0,9.0,6.0,2.0,2.0,1.0,9.0,2.0,1.0,9.0,8.0,13.0,15.0,12.0,10.0,7.0,9.0,15.0,5.0,9.0,3.0,12.0,13.0,8.0,12.0,12.0,15.0,14.0,20.0,13.0,9.0,5.0,14.0,14.0,12.0,8.0,10.0,7.0,1.0,14.0,11.0,16.0,11.0,14.0,14.0,14.0,6.0,32.0,0.0,0.0,0.0,0.0,172.0,71.0,2.0,1.0,3.0,1.0,2.0,3.0,2.0,3.0,2.0,2.0,2.0,8.0,9.0,7.0,6.0,10.0,6.0,10.0,9.0,10.0,14.0,11.0,6.0,14.0,11.0,10.0,16.0,15.0,12.0,12.0,7.0,12.0,15.0,9.0,13.0,8.0,14.0,15.0,15.0,14.0,14.0,14.0,10.0,20.0,14.0,14.0,8.0,15.0,13.0,13.0,11.0,13.0,7.0,13.0,17.0,14.0,17.0,8.0,13.0,15.0,15.0,6.0,19.0,0.0,0.0,0.0,0.0,193.0,89.0,3.0,2.0,2.0,3.0,1.0,3.0,1.0,4.0,2.0,2.0,3.0,8.0,10.0,5.0,4.0,10.0,10.0,14.0,12.0,6.0,12.0,10.0,4.0,12.0,9.0,11.0,11.0,14.0,11.0,12.0,8.0,14.0,13.0,8.0,8.0,11.0,11.0,13.0,13.0,10.0,9.0,14.0,16.0,6.0,14.0,10.0,20.0,12.0,14.0,11.0,7.0,6.0,6.0,8.0,16.0,10.0,10.0,12.0,13.0,16.0,16.0,5.0,37.0,0.0,0.0,0.0,0.0,185.0,83.0,1.0,1.0,2.0,1.0,3.0,2.0,3.0,1.0,1.0,3.0,1.0,6.0,8.0,9.0,12.0,10.0,8.0,13.0,9.0,4.0,5.0,10.0,14.0,4.0,11.0,11.0,10.0,11.0,13.0,12.0,12.0,13.0,15.0,14.0,12.0,11.0,7.0,12.0,8.0,7.0,7.0,12.0,12.0,11.0,11.0,7.0,20.0,8.0,14.0,12.0,8.0,13.0,9.0,12.0,12.0,12.0,19.0,14.0,15.0,14.0,8.0,8.0,21.0,0.0,0.0,0.0,0.0,179.0,68.0,2.0,3.0,2.0,1.0,2.0,1.0,2.0,3.0,2.0,1.0,1.0,6.0,13.0,12.0,6.0,13.0,6.0,8.0,7.0,12.0,10.0,12.0,8.0,12.0,13.0,10.0,11.0,11.0,12.0,10.0,11.0,11.0,12.0,11.0,7.0,13.0,10.0,12.0,14.0,15.0,13.0,12.0,10.0,20.0,14.0,14.0,8.0,14.0,10.0,13.0,8.0,13.0,8.0,12.0,13.0,14.0,10.0,12.0,10.0,10.0,12.0,10.0,19.0,0.0,0.0,0.0,0.0,185.0,82.0,4.0,2.0,3.0,1.0,3.0,2.0,1.0,2.0,1.0,2.0,3.0,7.0,7.0,10.0,6.0,13.0,7.0,14.0,7.0,6.0,12.0,13.0,7.0,13.0,13.0,13.0,13.0,13.0,11.0,12.0,11.0,12.0,14.0,9.0,14.0,11.0,11.0,15.0,15.0,12.0,12.0,14.0,13.0,5.0,14.0,12.0,20.0,14.0,13.0,10.0,11.0,11.0,6.0,10.0,10.0,12.0,12.0,14.0,14.0,11.0,16.0,6.0,19.0,0.0,0.0,0.0,0.0,175.0,67.0,3.0,2.0,1.0,3.0,3.0,1.0,1.0,1.0,2.0,1.0,3.0,7.0,8.0,12.0,8.0,10.0,6.0,12.0,9.0,8.0,10.0,10.0,8.0,12.0,11.0,14.0,10.0,12.0,9.0,10.0,11.0,10.0,12.0,12.0,10.0,12.0,12.0,13.0,14.0,13.0,11.0,14.0,8.0,6.0,14.0,12.0,20.0,14.0,12.0,12.0,8.0,11.0,6.0,12.0,17.0,13.0,10.0,11.0,12.0,11.0,17.0,5.0,18.0,0.0,0.0,0.0,0.0,170.0,67.0,3.0,1.0,3.0,3.0,3.0,4.0,1.0,2.0,1.0,2.0,2.0,11.0,11.0,12.0,13.0,12.0,11.0,6.0,10.0,8.0,7.0,12.0,10.0,7.0,13.0,9.0,11.0,8.0,10.0,10.0,12.0,12.0,15.0,12.0,12.0,11.0,12.0,11.0,12.0,12.0,12.0,10.0,6.0,5.0,14.0,12.0,20.0,10.0,9.0,10.0,8.0,2.0,6.0,12.0,11.0,11.0,12.0,13.0,14.0,11.0,13.0,4.0,22.0,24.0,3.0,7.0,0.0,177.0,78.0,2.0,1.0,2.0,3.0,2.0,2.0,4.0,3.0,3.0,2.0,1.0,10.0,13.0,16.0,14.0,16.0,16.0,8.0,16.0,4.0,4.0,15.0,12.0,4.0,16.0,12.0,11.0,12.0,13.0,10.0,11.0,8.0,13.0,17.0,5.0,14.0,5.0,10.0,12.0,15.0,14.0,13.0,9.0,10.0,17.0,16.0,20.0,15.0,14.0,12.0,11.0,15.0,4.0,12.0,19.0,16.0,14.0,14.0,11.0,13.0,10.0,12.0,20.0,29.0,2.0,0.0,0.0,181.0,75.0,1.0,1.0,2.0,2.0,2.0,3.0,2.0,1.0,1.0,3.0,2.0,5.0,9.0,15.0,10.0,11.0,9.0,10.0,8.0,7.0,3.0,10.0,10.0,5.0,15.0,7.0,10.0,9.0,12.0,10.0,8.0,11.0,14.0,12.0,5.0,13.0,5.0,11.0,12.0,16.0,12.0,9.0,12.0,20.0,14.0,16.0,7.0,12.0,10.0,9.0,10.0,10.0,11.0,6.0,10.0,15.0,9.0,13.0,11.0,14.0,18.0,7.0,22.0,5.0,1.0,1.0,0.0,173.0,72.0,1.0,3.0,1.0,3.0,3.0,3.0,3.0,3.0,3.0,2.0,2.0,14.0,13.0,16.0,14.0,16.0,14.0,5.0,11.0,5.0,5.0,15.0,11.0,5.0,16.0,8.0,13.0,9.0,14.0,13.0,15.0,13.0,15.0,16.0,5.0,13.0,5.0,9.0,10.0,15.0,16.0,14.0,5.0,20.0,14.0,15.0,5.0,12.0,14.0,13.0,11.0,13.0,8.0,14.0,10.0,15.0,14.0,10.0,13.0,10.0,10.0,13.0
1,0,30.0,42.0,0.0,13.0,0.0,195.0,88.0,16.0,13.0,14.0,6.0,14.0,13.0,13.0,15.0,12.0,10.0,14.0,1.0,8.0,5.0,2.0,8.0,2.0,8.0,2.0,5.0,3.0,9.0,5.0,3.0,8.0,10.0,12.0,10.0,14.0,10.0,10.0,14.0,13.0,3.0,14.0,3.0,12.0,14.0,12.0,8.0,13.0,18.0,18.0,17.0,14.0,11.0,20.0,14.0,17.0,14.0,4.0,14.0,4.0,1.0,12.0,13.0,14.0,9.0,15.0,13.0,13.0,5.0,23.0,0.0,0.0,0.0,0.0,184.0,71.0,1.0,2.0,1.0,2.0,2.0,2.0,2.0,4.0,2.0,1.0,3.0,4.0,10.0,10.0,6.0,11.0,6.0,14.0,8.0,7.0,14.0,11.0,6.0,13.0,11.0,12.0,12.0,13.0,12.0,11.0,12.0,12.0,14.0,6.0,8.0,10.0,13.0,13.0,14.0,15.0,13.0,14.0,13.0,8.0,12.0,14.0,20.0,13.0,14.0,13.0,12.0,14.0,15.0,8.0,11.0,13.0,13.0,10.0,8.0,9.0,16.0,7.0,28.0,0.0,0.0,0.0,0.0,190.0,85.0,3.0,2.0,3.0,3.0,2.0,2.0,2.0,4.0,3.0,1.0,2.0,5.0,9.0,8.0,9.0,8.0,7.0,14.0,10.0,9.0,15.0,9.0,6.0,14.0,9.0,16.0,13.0,16.0,10.0,13.0,10.0,12.0,15.0,6.0,13.0,7.0,13.0,14.0,16.0,12.0,11.0,17.0,13.0,20.0,15.0,13.0,8.0,15.0,15.0,12.0,14.0,14.0,9.0,8.0,14.0,13.0,14.0,11.0,12.0,13.0,16.0,14.0,21.0,0.0,0.0,0.0,0.0,177.0,0.0,1.0,1.0,1.0,2.0,3.0,3.0,2.0,3.0,2.0,2.0,3.0,6.0,4.0,13.0,13.0,13.0,6.0,13.0,7.0,3.0,5.0,7.0,6.0,1.0,11.0,9.0,7.0,8.0,7.0,7.0,7.0,8.0,7.0,11.0,8.0,13.0,7.0,6.0,7.0,12.0,13.0,7.0,6.0,8.0,8.0,13.0,20.0,5.0,5.0,9.0,5.0,9.0,9.0,9.0,10.0,10.0,12.0,12.0,11.0,10.0,9.0,6.0,21.0,0.0,0.0,0.0,0.0,178.0,65.0,2.0,3.0,3.0,3.0,3.0,1.0,1.0,1.0,1.0,3.0,1.0,9.0,13.0,11.0,6.0,12.0,7.0,9.0,8.0,8.0,13.0,12.0,7.0,13.0,12.0,8.0,12.0,13.0,12.0,12.0,13.0,13.0,14.0,9.0,8.0,12.0,12.0,13.0,13.0,12.0,14.0,13.0,11.0,8.0,15.0,12.0,20.0,13.0,12.0,14.0,8.0,11.0,7.0,10.0,19.0,10.0,13.0,10.0,11.0,15.0,15.0,6.0,26.0,25.0,1.0,7.0,0.0,189.0,78.0,1.0,1.0,1.0,1.0,1.0,1.0,1.0,1.0,1.0,1.0,1.0,8.0,9.0,10.0,6.0,12.0,8.0,13.0,14.0,7.0,11.0,14.0,11.0,13.0,13.0,13.0,13.0,16.0,13.0,13.0,12.0,13.0,14.0,10.0,10.0,12.0,13.0,15.0,15.0,12.0,11.0,9.0,15.0,10.0,14.0,13.0,20.0,14.0,14.0,12.0,13.0,11.0,14.0,12.0,14.0,11.0,14.0,12.0,16.0,15.0,13.0,5.0,21.0,0.0,0.0,0.0,0.0,172.0,66.0,2.0,3.0,2.0,2.0,1.0,1.0,1.0,3.0,2.0,1.0,1.0,10.0,10.0,13.0,9.0,14.0,9.0,8.0,10.0,7.0,13.0,13.0,9.0,12.0,13.0,10.0,12.0,13.0,13.0,12.0,14.0,13.0,13.0,11.0,9.0,14.0,13.0,14.0,14.0,14.0,13.0,12.0,8.0,8.0,12.0,12.0,20.0,13.0,12.0,14.0,10.0,11.0,8.0,12.0,15.0,10.0,15.0,8.0,11.0,14.0,14.0,6.0,19.0,0.0,0.0,0.0,0.0,174.0,61.0,1.0,3.0,2.0,3.0,2.0,1.0,2.0,2.0,3.0,1.0,1.0,5.0,9.0,10.0,6.0,12.0,6.0,8.0,8.0,5.0,9.0,10.0,7.0,9.0,13.0,11.0,12.0,12.0,11.0,9.0,11.0,11.0,8.0,9.0,10.0,8.0,10.0,12.0,16.0,13.0,13.0,10.0,8.0,20.0,15.0,11.0,8.0,13.0,9.0,15.0,11.0,10.0,6.0,13.0,10.0,9.0,14.0,11.0,12.0,14.0,14.0,8.0,22.0,0.0,0.0,0.0,0.0,187.0,84.0,2.0,2.0,1.0,2.0,3.0,2.0,2.0,3.0,3.0,2.0,2.0,4.0,7.0,10.0,6.0,9.0,10.0,13.0,12.0,5.0,11.0,11.0,7.0,10.0,12.0,12.0,11.0,13.0,10.0,9.0,11.0,9.0,15.0,8.0,7.0,9.0,11.0,11.0,14.0,13.0,10.0,15.0,14.0,8.0,15.0,11.0,20.0,14.0,15.0,11.0,12.0,7.0,9.0,8.0,7.0,13.0,15.0,13.0,11.0,14.0,14.0,7.0,24.0,2.0,0.0,0.0,0.0,195.0,84.0,1.0,4.0,1.0,2.0,3.0,1.0,2.0,1.0,2.0,1.0,1.0,6.0,6.0,9.0,11.0,10.0,8.0,14.0,11.0,5.0,8.0,10.0,11.0,2.0,11.0,11.0,12.0,14.0,11.0,14.0,8.0,12.0,13.0,8.0,6.0,11.0,7.0,13.0,14.0,13.0,12.0,18.0,18.0,8.0,13.0,14.0,20.0,14.0,17.0,12.0,11.0,10.0,7.0,5.0,8.0,12.0,9.0,12.0,13.0,12.0,14.0,2.0,25.0,0.0,0.0,0.0,0.0,187.0,83.0,2.0,1.0,3.0,3.0,1.0,3.0,3.0,3.0,1.0,1.0,3.0,4.0,8.0,10.0,14.0,12.0,8.0,14.0,9.0,5.0,7.0,11.0,13.0,5.0,12.0,11.0,13.0,13.0,13.0,11.0,10.0,12.0,16.0,9.0,8.0,13.0,11.0,13.0,16.0,14.0,13.0,15.0,13.0,20.0,14.0,12.0,8.0,14.0,16.0,13.0,11.0,13.0,7.0,5.0,13.0,14.0,13.0,14.0,14.0,13.0,13.0,6.0,19.0,0.0,0.0,0.0,0.0,193.0,84.0,14.0,11.0,10.0,9.0,12.0,13.0,13.0,13.0,9.0,8.0,13.0,4.0,2.0,1.0,3.0,7.0,7.0,2.0,3.0,1.0,1.0,8.0,1.0,3.0,7.0,8.0,11.0,12.0,10.0,12.0,8.0,10.0,10.0,6.0,7.0,1.0,12.0,11.0,10.0,9.0,13.0,12.0,13.0,5.0,15.0,8.0,20.0,12.0,14.0,12.0,10.0,4.0,3.0,10.0,18.0,13.0,13.0,9.0,13.0,11.0,19.0,4.0,33.0,24.0,1.0,3.0,0.0,193.0,90.0,1.0,2.0,2.0,2.0,3.0,2.0,3.0,1.0,3.0,2.0,3.0,3.0,6.0,8.0,8.0,11.0,10.0,17.0,8.0,5.0,13.0,10.0,7.0,14.0,11.0,14.0,14.0,16.0,11.0,10.0,9.0,10.0,14.0,7.0,13.0,7.0,13.0,14.0,11.0,9.0,10.0,15.0,15.0,7.0,13.0,10.0,20.0,10.0,13.0,10.0,13.0,15.0,9.0,8.0,12.0,15.0,13.0,11.0,15.0,12.0,13.0,7.0,29.0,0.0,0.0,0.0,0.0,185.0,84.0,3.0,2.0,2.0,2.0,1.0,3.0,1.0,2.0,1.0,3.0,1.0,3.0,6.0,6.0,7.0,10.0,5.0,14.0,5.0,4.0,14.0,9.0,7.0,13.0,9.0,13.0,13.0,14.0,12.0,13.0,8.0,12.0,14.0,8.0,16.0,8.0,12.0,13.0,15.0,11.0,11.0,15.0,12.0,5.0,14.0,12.0,20.0,14.0,16.0,13.0,12.0,10.0,7.0,7.0,7.0,12.0,13.0,13.0,14.0,13.0,12.0,8.0,16.0,0.0,0.0,0.0,0.0,177.0,0.0,3.0,2.0,1.0,1.0,3.0,3.0,2.0,2.0,2.0,1.0,3.0,1.0,3.0,2.0,2.0,4.0,1.0,3.0,1.0,6.0,9.0,2.0,1.0,9.0,6.0,14.0,4.0,5.0,5.0,3.0,2.0,5.0,4.0,5.0,7.0,4.0,8.0,4.0,3.0,10.0,7.0,13.0,7.0,15.0,13.0,9.0,20.0,5.0,8.0,7.0,11.0,5.0,8.0,8.0,11.0,11.0,5.0,14.0,20.0,7.0,12.0,5.0,23.0,0.0,0.0,8.0,0.0,183.0,77.0,2.0,3.0,1.0,2.0,1.0,3.0,3.0,3.0,3.0,2.0,2.0,7.0,13.0,12.0,7.0,12.0,6.0,8.0,9.0,11.0,12.0,9.0,7.0,12.0,12.0,10.0,12.0,14.0,13.0,12.0,11.0,11.0,15.0,11.0,7.0,13.0,12.0,12.0,13.0,16.0,13.0,14.0,11.0,8.0,15.0,15.0,20.0,13.0,13.0,11.0,10.0,13.0,7.0,8.0,11.0,13.0,14.0,11.0,14.0,15.0,15.0,5.0,24.0,0.0,0.0,0.0,0.0,178.0,77.0,2.0,1.0,3.0,2.0,1.0,3.0,3.0,3.0,1.0,3.0,2.0,5.0,10.0,8.0,5.0,9.0,6.0,11.0,8.0,12.0,11.0,8.0,6.0,12.0,9.0,11.0,11.0,13.0,11.0,12.0,7.0,11.0,15.0,9.0,6.0,9.0,11.0,12.0,14.0,16.0,12.0,14.0,10.0,5.0,15.0,15.0,20.0,14.0,13.0,14.0,11.0,13.0,5.0,8.0,17.0,12.0,14.0,14.0,14.0,14.0,14.0,6.0,30.0,0.0,0.0,0.0,0.0,178.0,79.0,1.0,2.0,2.0,3.0,2.0,2.0,1.0,2.0,1.0,2.0,1.0,11.0,13.0,9.0,6.0,11.0,11.0,12.0,11.0,10.0,12.0,12.0,7.0,13.0,11.0,15.0,13.0,15.0,11.0,12.0,10.0,12.0,13.0,12.0,15.0,10.0,12.0,16.0,15.0,14.0,12.0,13.0,9.0,5.0,13.0,12.0,20.0,15.0,14.0,14.0,14.0,13.0,9.0,14.0,18.0,12.0,15.0,14.0,14.0,14.0,14.0,6.0,29.0,0.0,0.0,0.0,0.0,181.0,69.0,1.0,3.0,1.0,4.0,1.0,2.0,2.0,3.0,4.0,3.0,2.0,4.0,6.0,7.0,8.0,12.0,8.0,12.0,12.0,7.0,11.0,12.0,13.0,13.0,11.0,15.0,13.0,14.0,13.0,14.0,8.0,12.0,15.0,7.0,10.0,7.0,13.0,15.0,17.0,12.0,12.0,14.0,10.0,8.0,13.0,11.0,20.0,14.0,11.0,14.0,15.0,14.0,9.0,8.0,9.0,13.0,14.0,12.0,13.0,10.0,10.0,6.0,28.0,0.0,0.0,0.0,0.0,181.0,75.0,4.0,2.0,1.0,3.0,3.0,3.0,2.0,2.0,2.0,2.0,2.0,13.0,12.0,12.0,9.0,12.0,13.0,7.0,11.0,7.0,7.0,13.0,5.0,7.0,13.0,9.0,13.0,3.0,12.0,11.0,12.0,12.0,3.0,12.0,14.0,12.0,9.0,12.0,13.0,13.0,13.0,10.0,11.0,20.0,13.0,12.0,6.0,13.0,9.0,13.0,6.0,13.0,8.0,10.0,20.0,12.0,14.0,11.0,13.0,10.0,11.0,4.0,29.0,0.0,0.0,0.0,0.0,180.0,74.0,2.0,1.0,3.0,3.0,2.0,4.0,1.0,3.0,3.0,2.0,2.0,9.0,13.0,13.0,10.0,14.0,10.0,12.0,12.0,6.0,8.0,12.0,8.0,8.0,14.0,10.0,13.0,14.0,13.0,12.0,13.0,11.0,13.0,11.0,7.0,10.0,10.0,14.0,14.0,14.0,13.0,13.0,12.0,10.0,14.0,13.0,20.0,14.0,11.0,14.0,10.0,15.0,8.0,10.0,8.0,12.0,14.0,16.0,14.0,15.0,15.0,6.0,24.0,0.0,0.0,4.0,0.0,181.0,79.0,1.0,3.0,2.0,2.0,1.0,1.0,1.0,2.0,2.0,2.0,1.0,4.0,6.0,10.0,11.0,11.0,7.0,12.0,10.0,5.0,5.0,7.0,13.0,3.0,10.0,9.0,12.0,12.0,11.0,10.0,6.0,10.0,8.0,9.0,5.0,11.0,5.0,9.0,12.0,15.0,13.0,13.0,11.0,5.0,11.0,14.0,20.0,13.0,14.0,11.0,9.0,12.0,13.0,5.0,19.0,11.0,9.0,9.0,7.0,14.0,14.0,13.0
1,0,21.0,0.0,0.0,1.0,0.0,188.0,74.0,14.0,15.0,14.0,7.0,15.0,13.0,12.0,15.0,13.0,7.0,16.0,6.0,3.0,2.0,3.0,8.0,11.0,2.0,2.0,3.0,2.0,4.0,6.0,1.0,9.0,11.0,14.0,13.0,15.0,15.0,11.0,14.0,19.0,1.0,11.0,1.0,16.0,14.0,12.0,11.0,14.0,14.0,16.0,9.0,13.0,10.0,20.0,13.0,12.0,16.0,9.0,13.0,6.0,12.0,13.0,13.0,11.0,12.0,12.0,10.0,19.0,7.0,16.0,0.0,0.0,0.0,0.0,186.0,0.0,2.0,2.0,1.0,1.0,3.0,1.0,2.0,3.0,3.0,3.0,3.0,3.0,3.0,4.0,4.0,5.0,2.0,7.0,2.0,4.0,6.0,7.0,3.0,12.0,7.0,12.0,7.0,15.0,6.0,8.0,4.0,6.0,6.0,7.0,10.0,4.0,9.0,18.0,14.0,9.0,6.0,12.0,13.0,7.0,14.0,10.0,20.0,10.0,7.0,7.0,9.0,7.0,11.0,6.0,5.0,9.0,14.0,13.0,13.0,10.0,7.0,5.0,24.0,0.0,0.0,0.0,0.0,186.0,77.0,3.0,3.0,2.0,3.0,2.0,4.0,2.0,3.0,3.0,1.0,2.0,9.0,10.0,6.0,7.0,12.0,10.0,15.0,9.0,9.0,10.0,11.0,5.0,13.0,10.0,8.0,14.0,13.0,10.0,12.0,10.0,12.0,11.0,5.0,12.0,7.0,12.0,14.0,14.0,10.0,11.0,11.0,13.0,9.0,6.0,12.0,20.0,14.0,13.0,11.0,5.0,7.0,11.0,11.0,7.0,11.0,12.0,10.0,10.0,10.0,16.0,8.0,30.0,0.0,0.0,0.0,0.0,179.0,74.0,2.0,3.0,2.0,2.0,2.0,1.0,1.0,3.0,2.0,1.0,2.0,9.0,12.0,11.0,8.0,11.0,8.0,7.0,10.0,11.0,12.0,13.0,7.0,13.0,11.0,13.0,12.0,14.0,12.0,13.0,11.0,12.0,12.0,8.0,13.0,14.0,14.0,15.0,16.0,13.0,13.0,13.0,8.0,12.0,13.0,12.0,20.0,14.0,11.0,15.0,9.0,6.0,7.0,17.0,19.0,11.0,11.0,12.0,12.0,10.0,18.0,2.0,16.0,0.0,0.0,0.0,0.0,151.0,0.0,4.0,1.0,2.0,2.0,1.0,3.0,2.0,2.0,1.0,3.0,2.0,9.0,6.0,5.0,4.0,4.0,11.0,3.0,3.0,1.0,2.0,5.0,3.0,2.0,5.0,17.0,3.0,9.0,4.0,4.0,6.0,9.0,6.0,8.0,13.0,4.0,1.0,9.0,12.0,14.0,11.0,3.0,2.0,9.0,15.0,13.0,20.0,8.0,3.0,5.0,14.0,9.0,9.0,4.0,10.0,15.0,6.0,11.0,8.0,7.0,9.0,6.0,29.0,0.0,0.0,0.0,0.0,177.0,75.0,1.0,1.0,2.0,3.0,2.0,2.0,2.0,1.0,3.0,2.0,3.0,10.0,11.0,12.0,9.0,10.0,14.0,10.0,15.0,12.0,11.0,10.0,9.0,13.0,10.0,12.0,11.0,14.0,9.0,14.0,9.0,12.0,10.0,9.0,7.0,12.0,13.0,15.0,14.0,13.0,13.0,10.0,9.0,15.0,12.0,12.0,20.0,14.0,10.0,14.0,7.0,4.0,8.0,17.0,12.0,11.0,8.0,8.0,10.0,11.0,10.0,7.0,20.0,0.0,0.0,2.0,0.0,180.0,75.0,2.0,3.0,1.0,1.0,3.0,3.0,1.0,1.0,2.0,2.0,1.0,10.0,10.0,9.0,7.0,13.0,12.0,9.0,9.0,11.0,13.0,13.0,3.0,14.0,12.0,11.0,14.0,13.0,13.0,13.0,12.0,13.0,11.0,8.0,13.0,11.0,15.0,14.0,13.0,13.0,13.0,13.0,8.0,20.0,7.0,14.0,7.0,14.0,11.0,13.0,9.0,11.0,11.0,11.0,18.0,12.0,12.0,9.0,11.0,12.0,12.0,4.0,32.0,0.0,0.0,0.0,0.0,178.0,70.0,1.0,3.0,1.0,2.0,2.0,3.0,1.0,1.0,1.0,3.0,3.0,13.0,11.0,12.0,10.0,14.0,12.0,6.0,11.0,8.0,6.0,15.0,11.0,5.0,15.0,7.0,13.0,8.0,12.0,11.0,16.0,14.0,14.0,16.0,11.0,15.0,6.0,13.0,9.0,10.0,12.0,11.0,10.0,10.0,15.0,10.0,20.0,10.0,9.0,9.0,8.0,13.0,7.0,13.0,11.0,13.0,12.0,12.0,14.0,12.0,13.0,6.0,16.0,0.0,0.0,0.0,0.0,176.0,0.0,3.0,3.0,3.0,4.0,2.0,3.0,4.0,3.0,2.0,1.0,2.0,2.0,2.0,1.0,1.0,4.0,2.0,5.0,3.0,4.0,4.0,4.0,2.0,8.0,3.0,6.0,5.0,6.0,2.0,4.0,3.0,11.0,12.0,7.0,8.0,3.0,7.0,7.0,12.0,9.0,8.0,4.0,6.0,20.0,10.0,7.0,9.0,7.0,6.0,8.0,7.0,9.0,9.0,6.0,9.0,6.0,12.0,14.0,7.0,13.0,12.0,3.0,29.0,0.0,0.0,2.0,0.0,172.0,70.0,1.0,3.0,2.0,2.0,3.0,1.0,2.0,1.0,1.0,3.0,3.0,14.0,13.0,16.0,11.0,14.0,11.0,5.0,11.0,6.0,4.0,12.0,12.0,8.0,14.0,9.0,13.0,10.0,12.0,10.0,13.0,12.0,14.0,16.0,10.0,15.0,4.0,11.0,11.0,15.0,15.0,14.0,7.0,9.0,11.0,13.0,20.0,11.0,10.0,12.0,7.0,12.0,13.0,13.0,20.0,11.0,11.0,12.0,13.0,12.0,14.0,6.0,27.0,55.0,15.0,0.0,0.0,187.0,81.0,3.0,2.0,1.0,1.0,2.0,1.0,3.0,3.0,1.0,1.0,2.0,7.0,12.0,12.0,15.0,12.0,9.0,14.0,15.0,7.0,7.0,12.0,14.0,8.0,14.0,14.0,14.0,14.0,15.0,13.0,13.0,13.0,15.0,14.0,9.0,11.0,8.0,11.0,10.0,14.0,14.0,12.0,14.0,20.0,12.0,14.0,10.0,16.0,14.0,12.0,8.0,11.0,11.0,8.0,15.0,17.0,10.0,10.0,15.0,15.0,12.0,5.0,29.0,0.0,0.0,0.0,0.0,190.0,80.0,14.0,13.0,13.0,6.0,15.0,14.0,12.0,15.0,13.0,17.0,15.0,7.0,1.0,3.0,2.0,8.0,9.0,8.0,2.0,3.0,3.0,8.0,2.0,3.0,10.0,6.0,13.0,13.0,7.0,15.0,10.0,13.0,15.0,3.0,9.0,2.0,16.0,11.0,11.0,9.0,13.0,14.0,15.0,8.0,13.0,11.0,20.0,14.0,13.0,10.0,4.0,12.0,6.0,12.0,12.0,15.0,13.0,11.0,14.0,15.0,11.0,8.0,27.0,3.0,0.0,0.0,0.0,191.0,83.0,3.0,1.0,3.0,1.0,3.0,2.0,1.0,3.0,3.0,2.0,3.0,6.0,11.0,12.0,8.0,12.0,5.0,15.0,11.0,11.0,14.0,13.0,14.0,15.0,13.0,12.0,13.0,12.0,16.0,13.0,7.0,13.0,12.0,9.0,11.0,9.0,14.0,13.0,14.0,11.0,9.0,16.0,17.0,7.0,14.0,11.0,20.0,14.0,15.0,10.0,11.0,11.0,14.0,12.0,16.0,14.0,13.0,11.0,16.0,11.0,13.0,4.0,21.0,0.0,0.0,0.0,0.0,189.0,0.0,1.0,1.0,3.0,3.0,2.0,1.0,2.0,2.0,3.0,2.0,2.0,3.0,1.0,4.0,1.0,7.0,1.0,7.0,3.0,1.0,13.0,7.0,2.0,13.0,6.0,7.0,5.0,9.0,7.0,6.0,1.0,13.0,9.0,1.0,10.0,3.0,12.0,6.0,7.0,9.0,9.0,7.0,13.0,10.0,9.0,12.0,20.0,4.0,10.0,9.0,9.0,9.0,6.0,9.0,8.0,11.0,10.0,10.0,11.0,9.0,14.0,8.0,21.0,0.0,0.0,0.0,0.0,183.0,70.0,3.0,1.0,3.0,1.0,3.0,1.0,1.0,3.0,3.0,1.0,1.0,8.0,11.0,12.0,7.0,12.0,8.0,11.0,8.0,8.0,13.0,9.0,5.0,13.0,10.0,12.0,12.0,10.0,12.0,12.0,9.0,12.0,19.0,4.0,8.0,13.0,12.0,13.0,13.0,13.0,12.0,10.0,13.0,12.0,14.0,14.0,20.0,14.0,12.0,12.0,11.0,11.0,10.0,14.0,13.0,11.0,13.0,13.0,10.0,9.0,11.0,1.0,28.0,0.0,0.0,26.0,0.0,173.0,74.0,1.0,1.0,1.0,1.0,3.0,2.0,2.0,2.0,1.0,1.0,2.0,18.0,14.0,13.0,7.0,12.0,14.0,7.0,13.0,14.0,11.0,13.0,3.0,13.0,13.0,16.0,11.0,18.0,8.0,11.0,11.0,10.0,12.0,15.0,11.0,15.0,10.0,16.0,17.0,14.0,14.0,15.0,9.0,8.0,15.0,11.0,20.0,16.0,10.0,11.0,14.0,10.0,4.0,15.0,12.0,11.0,7.0,6.0,11.0,7.0,14.0,5.0,32.0,44.0,0.0,0.0,0.0,176.0,60.0,1.0,3.0,2.0,1.0,1.0,3.0,2.0,2.0,1.0,3.0,2.0,7.0,9.0,10.0,7.0,13.0,13.0,12.0,14.0,12.0,13.0,11.0,11.0,15.0,11.0,15.0,14.0,17.0,10.0,13.0,10.0,14.0,15.0,8.0,12.0,12.0,14.0,17.0,17.0,13.0,13.0,13.0,10.0,20.0,17.0,13.0,10.0,16.0,12.0,14.0,14.0,15.0,7.0,14.0,17.0,14.0,8.0,15.0,15.0,9.0,8.0,10.0,22.0,0.0,0.0,0.0,0.0,186.0,0.0,3.0,1.0,3.0,1.0,2.0,2.0,2.0,1.0,1.0,1.0,1.0,8.0,3.0,8.0,6.0,11.0,3.0,12.0,6.0,5.0,11.0,11.0,4.0,11.0,6.0,10.0,8.0,11.0,7.0,9.0,9.0,13.0,9.0,7.0,11.0,10.0,13.0,10.0,12.0,12.0,10.0,11.0,13.0,20.0,10.0,11.0,8.0,12.0,12.0,10.0,10.0,6.0,5.0,10.0,18.0,11.0,9.0,13.0,9.0,4.0,5.0,1.0,29.0,0.0,0.0,6.0,1.0,183.0,81.0,1.0,2.0,3.0,2.0,2.0,2.0,4.0,4.0,1.0,4.0,2.0,18.0,18.0,16.0,11.0,16.0,17.0,7.0,15.0,7.0,5.0,16.0,13.0,6.0,18.0,9.0,12.0,9.0,15.0,11.0,17.0,14.0,10.0,17.0,13.0,15.0,7.0,10.0,9.0,13.0,14.0,10.0,11.0,10.0,9.0,12.0,20.0,11.0,9.0,10.0,12.0,15.0,13.0,11.0,14.0,13.0,6.0,11.0,12.0,12.0,13.0,14.0,22.0,0.0,0.0,0.0,0.0,189.0,0.0,3.0,1.0,1.0,3.0,2.0,3.0,3.0,2.0,3.0,2.0,1.0,7.0,11.0,13.0,9.0,11.0,7.0,4.0,9.0,4.0,7.0,10.0,8.0,4.0,11.0,10.0,6.0,9.0,5.0,7.0,10.0,11.0,10.0,10.0,10.0,9.0,7.0,8.0,12.0,13.0,11.0,5.0,12.0,10.0,7.0,11.0,20.0,13.0,9.0,10.0,7.0,9.0,10.0,10.0,11.0,10.0,10.0,13.0,10.0,3.0,8.0,4.0,24.0,0.0,0.0,13.0,2.0,174.0,70.0,1.0,1.0,3.0,3.0,1.0,2.0,2.0,3.0,3.0,1.0,3.0,14.0,15.0,16.0,11.0,16.0,16.0,8.0,12.0,5.0,8.0,16.0,12.0,6.0,17.0,10.0,11.0,10.0,12.0,11.0,15.0,12.0,9.0,16.0,8.0,14.0,5.0,11.0,10.0,15.0,16.0,9.0,7.0,20.0,12.0,14.0,8.0,13.0,9.0,12.0,9.0,15.0,10.0,14.0,17.0,12.0,10.0,12.0,13.0,14.0,10.0,10.0,25.0,0.0,0.0,1.0,0.0,182.0,71.0,1.0,2.0,3.0,1.0,4.0,3.0,3.0,3.0,2.0,3.0,3.0,9.0,13.0,14.0,14.0,12.0,10.0,13.0,12.0,8.0,7.0,12.0,11.0,7.0,14.0,9.0,13.0,13.0,12.0,13.0,13.0,11.0,11.0,12.0,8.0,14.0,7.0,12.0,12.0,13.0,14.0,12.0,12.0,12.0,12.0,15.0,20.0,14.0,12.0,11.0,7.0,12.0,14.0,8.0,19.0,14.0,11.0,12.0,13.0,12.0,12.0,12.0
0,0,32.0,0.0,0.0,1.0,0.0,187.0,79.0,14.0,14.0,14.0,15.0,15.0,13.0,16.0,15.0,15.0,16.0,15.0,7.0,12.0,12.0,3.0,12.0,11.0,8.0,15.0,3.0,2.0,12.0,2.0,2.0,11.0,10.0,12.0,14.0,14.0,12.0,12.0,11.0,14.0,12.0,17.0,7.0,13.0,11.0,11.0,14.0,12.0,10.0,13.0,20.0,13.0,12.0,10.0,11.0,10.0,13.0,10.0,17.0,11.0,11.0,18.0,13.0,15.0,13.0,10.0,11.0,7.0,13.0,26.0,0.0,0.0,0.0,0.0,187.0,76.0,2.0,3.0,2.0,2.0,3.0,1.0,3.0,4.0,2.0,3.0,1.0,5.0,3.0,4.0,6.0,8.0,7.0,12.0,4.0,1.0,10.0,9.0,5.0,13.0,4.0,6.0,14.0,9.0,8.0,11.0,6.0,10.0,2.0,5.0,7.0,5.0,12.0,8.0,9.0,14.0,11.0,9.0,14.0,20.0,9.0,10.0,10.0,14.0,13.0,10.0,10.0,10.0,4.0,10.0,17.0,9.0,8.0,11.0,11.0,6.0,10.0,3.0,16.0,0.0,0.0,0.0,0.0,189.0,0.0,3.0,3.0,3.0,1.0,1.0,3.0,1.0,3.0,1.0,1.0,2.0,5.0,7.0,5.0,4.0,6.0,6.0,1.0,1.0,4.0,2.0,5.0,3.0,5.0,10.0,10.0,4.0,5.0,6.0,3.0,7.0,7.0,5.0,11.0,3.0,4.0,3.0,7.0,7.0,11.0,7.0,4.0,12.0,20.0,9.0,9.0,9.0,9.0,6.0,5.0,11.0,4.0,10.0,12.0,10.0,11.0,12.0,12.0,9.0,7.0,7.0,10.0,29.0,0.0,0.0,0.0,0.0,168.0,67.0,2.0,2.0,1.0,2.0,3.0,2.0,3.0,3.0,2.0,3.0,2.0,7.0,11.0,10.0,9.0,12.0,4.0,11.0,12.0,10.0,12.0,13.0,12.0,12.0,12.0,12.0,12.0,17.0,16.0,11.0,9.0,10.0,12.0,13.0,16.0,9.0,11.0,15.0,16.0,11.0,12.0,15.0,5.0,10.0,12.0,11.0,20.0,15.0,14.0,10.0,11.0,16.0,13.0,20.0,14.0,10.0,14.0,13.0,18.0,17.0,20.0,1.0,26.0,0.0,0.0,0.0,0.0,180.0,75.0,1.0,2.0,1.0,1.0,4.0,1.0,3.0,2.0,1.0,3.0,1.0,12.0,14.0,14.0,12.0,13.0,10.0,9.0,12.0,7.0,12.0,14.0,12.0,12.0,14.0,9.0,12.0,10.0,13.0,12.0,14.0,11.0,11.0,12.0,13.0,13.0,13.0,14.0,14.0,12.0,12.0,10.0,8.0,20.0,13.0,14.0,11.0,13.0,12.0,8.0,4.0,12.0,11.0,12.0,8.0,12.0,10.0,8.0,7.0,10.0,11.0,12.0,18.0,0.0,0.0,0.0,0.0,180.0,0.0,3.0,2.0,1.0,3.0,2.0,2.0,3.0,2.0,4.0,2.0,1.0,8.0,7.0,6.0,9.0,7.0,6.0,8.0,12.0,4.0,12.0,11.0,1.0,11.0,11.0,9.0,9.0,8.0,10.0,9.0,11.0,15.0,9.0,6.0,1.0,8.0,10.0,9.0,8.0,11.0,12.0,5.0,7.0,8.0,10.0,10.0,20.0,6.0,11.0,9.0,9.0,4.0,6.0,9.0,8.0,12.0,12.0,12.0,11.0,4.0,10.0,3.0,28.0,0.0,0.0,0.0,0.0,175.0,66.0,1.0,3.0,4.0,3.0,2.0,3.0,2.0,2.0,3.0,3.0,4.0,12.0,12.0,11.0,10.0,13.0,12.0,7.0,12.0,7.0,12.0,14.0,13.0,12.0,14.0,11.0,12.0,13.0,11.0,13.0,14.0,13.0,12.0,14.0,11.0,11.0,13.0,15.0,14.0,11.0,12.0,12.0,8.0,20.0,11.0,11.0,10.0,12.0,11.0,12.0,7.0,12.0,10.0,5.0,10.0,9.0,14.0,11.0,10.0,12.0,18.0,2.0,27.0,0.0,0.0,0.0,0.0,171.0,63.0,2.0,1.0,1.0,3.0,1.0,2.0,4.0,2.0,2.0,2.0,3.0,8.0,4.0,6.0,6.0,13.0,8.0,8.0,6.0,1.0,14.0,13.0,5.0,8.0,14.0,6.0,10.0,9.0,8.0,9.0,14.0,12.0,10.0,10.0,11.0,12.0,11.0,9.0,13.0,14.0,14.0,9.0,5.0,5.0,10.0,14.0,20.0,9.0,6.0,10.0,7.0,10.0,10.0,10.0,13.0,13.0,9.0,9.0,12.0,11.0,14.0,2.0,25.0,0.0,0.0,0.0,0.0,181.0,77.0,3.0,1.0,1.0,2.0,1.0,2.0,1.0,3.0,3.0,3.0,2.0,9.0,10.0,11.0,12.0,11.0,14.0,13.0,10.0,6.0,9.0,11.0,15.0,9.0,11.0,15.0,11.0,15.0,12.0,12.0,12.0,12.0,9.0,12.0,12.0,13.0,10.0,14.0,15.0,12.0,12.0,11.0,12.0,12.0,15.0,12.0,20.0,14.0,16.0,12.0,9.0,17.0,12.0,11.0,16.0,10.0,11.0,11.0,13.0,13.0,17.0,6.0,28.0,0.0,0.0,0.0,0.0,177.0,72.0,3.0,4.0,3.0,1.0,3.0,1.0,1.0,1.0,3.0,2.0,2.0,13.0,14.0,15.0,12.0,11.0,13.0,14.0,12.0,8.0,11.0,13.0,13.0,12.0,15.0,14.0,13.0,14.0,11.0,13.0,12.0,11.0,10.0,17.0,13.0,17.0,13.0,14.0,14.0,12.0,13.0,11.0,10.0,11.0,13.0,12.0,20.0,13.0,13.0,12.0,10.0,7.0,7.0,15.0,17.0,13.0,9.0,9.0,11.0,9.0,17.0,6.0,20.0,5.0,0.0,5.0,0.0,181.0,74.0,3.0,1.0,2.0,1.0,1.0,3.0,3.0,2.0,3.0,1.0,1.0,7.0,9.0,15.0,15.0,17.0,7.0,12.0,11.0,5.0,5.0,9.0,7.0,6.0,16.0,13.0,12.0,14.0,12.0,10.0,13.0,10.0,12.0,11.0,9.0,13.0,12.0,11.0,10.0,14.0,15.0,13.0,9.0,12.0,12.0,12.0,20.0,13.0,12.0,9.0,9.0,8.0,13.0,9.0,11.0,13.0,12.0,11.0,12.0,6.0,17.0,4.0,29.0,66.0,0.0,0.0,0.0,184.0,78.0,10.0,15.0,15.0,4.0,12.0,13.0,17.0,19.0,10.0,16.0,15.0,10.0,1.0,3.0,3.0,8.0,12.0,9.0,1.0,1.0,1.0,9.0,3.0,2.0,6.0,11.0,15.0,15.0,13.0,18.0,8.0,15.0,16.0,8.0,12.0,3.0,13.0,15.0,15.0,12.0,18.0,14.0,12.0,9.0,17.0,14.0,20.0,14.0,13.0,16.0,4.0,17.0,9.0,12.0,14.0,15.0,16.0,15.0,20.0,16.0,19.0,3.0,27.0,0.0,0.0,0.0,0.0,183.0,0.0,2.0,4.0,1.0,2.0,2.0,2.0,1.0,2.0,3.0,1.0,3.0,2.0,4.0,5.0,4.0,12.0,6.0,6.0,4.0,3.0,11.0,13.0,1.0,11.0,7.0,9.0,8.0,5.0,8.0,7.0,8.0,13.0,9.0,4.0,13.0,6.0,8.0,7.0,12.0,13.0,13.0,7.0,8.0,8.0,11.0,13.0,20.0,7.0,7.0,9.0,9.0,2.0,15.0,9.0,8.0,13.0,9.0,10.0,11.0,12.0,20.0,2.0,23.0,28.0,2.0,15.0,3.0,191.0,83.0,1.0,2.0,2.0,1.0,3.0,1.0,3.0,1.0,1.0,1.0,4.0,5.0,9.0,11.0,6.0,13.0,8.0,15.0,9.0,10.0,17.0,14.0,10.0,17.0,14.0,11.0,15.0,13.0,14.0,18.0,11.0,14.0,12.0,11.0,9.0,8.0,17.0,14.0,14.0,15.0,13.0,11.0,17.0,8.0,16.0,16.0,20.0,14.0,14.0,17.0,6.0,15.0,14.0,14.0,12.0,16.0,13.0,17.0,14.0,17.0,16.0,8.0,27.0,0.0,0.0,0.0,0.0,185.0,0.0,4.0,1.0,3.0,3.0,1.0,1.0,3.0,3.0,1.0,1.0,1.0,7.0,5.0,6.0,8.0,13.0,7.0,2.0,10.0,3.0,11.0,7.0,7.0,10.0,9.0,9.0,9.0,9.0,9.0,9.0,7.0,13.0,10.0,10.0,9.0,7.0,8.0,8.0,12.0,13.0,13.0,8.0,9.0,10.0,12.0,12.0,20.0,13.0,9.0,10.0,10.0,1.0,10.0,10.0,20.0,11.0,10.0,10.0,10.0,2.0,17.0,6.0,27.0,0.0,0.0,0.0,0.0,184.0,81.0,1.0,1.0,1.0,3.0,3.0,2.0,2.0,2.0,1.0,2.0,3.0,8.0,6.0,8.0,12.0,10.0,8.0,12.0,9.0,1.0,3.0,8.0,14.0,4.0,9.0,4.0,11.0,12.0,11.0,8.0,8.0,11.0,10.0,9.0,8.0,11.0,9.0,8.0,11.0,10.0,8.0,13.0,13.0,9.0,13.0,9.0,20.0,12.0,13.0,13.0,9.0,2.0,9.0,9.0,15.0,10.0,12.0,10.0,11.0,6.0,4.0,6.0,26.0,71.0,11.0,10.0,2.0,182.0,78.0,1.0,2.0,3.0,3.0,2.0,3.0,2.0,4.0,3.0,2.0,2.0,18.0,18.0,14.0,13.0,18.0,14.0,7.0,17.0,8.0,8.0,20.0,13.0,9.0,16.0,10.0,17.0,10.0,18.0,14.0,18.0,19.0,9.0,11.0,12.0,14.0,12.0,18.0,13.0,12.0,9.0,12.0,10.0,15.0,12.0,13.0,20.0,16.0,14.0,13.0,10.0,14.0,7.0,13.0,8.0,14.0,8.0,14.0,17.0,18.0,17.0,7.0,24.0,14.0,1.0,18.0,9.0,175.0,74.0,3.0,1.0,1.0,1.0,2.0,2.0,3.0,3.0,2.0,3.0,1.0,15.0,15.0,18.0,13.0,18.0,14.0,9.0,15.0,8.0,5.0,17.0,15.0,8.0,18.0,10.0,15.0,8.0,15.0,13.0,18.0,15.0,16.0,18.0,13.0,13.0,8.0,10.0,10.0,14.0,14.0,17.0,8.0,14.0,10.0,12.0,20.0,13.0,10.0,12.0,10.0,15.0,3.0,15.0,15.0,16.0,8.0,17.0,12.0,13.0,11.0,9.0,30.0,93.0,11.0,15.0,2.0,173.0,65.0,3.0,2.0,2.0,3.0,3.0,3.0,4.0,1.0,1.0,1.0,1.0,16.0,16.0,17.0,9.0,19.0,13.0,8.0,12.0,7.0,8.0,19.0,14.0,11.0,18.0,12.0,17.0,13.0,15.0,16.0,18.0,18.0,16.0,13.0,13.0,12.0,12.0,16.0,17.0,14.0,17.0,13.0,7.0,13.0,13.0,13.0,20.0,17.0,8.0,15.0,12.0,14.0,11.0,16.0,10.0,15.0,13.0,17.0,16.0,16.0,17.0,5.0,26.0,61.0,22.0,13.0,3.0,186.0,82.0,2.0,2.0,2.0,1.0,3.0,2.0,1.0,1.0,2.0,1.0,3.0,14.0,16.0,16.0,17.0,15.0,17.0,19.0,19.0,15.0,6.0,14.0,13.0,9.0,16.0,10.0,14.0,11.0,13.0,11.0,13.0,13.0,16.0,17.0,9.0,18.0,7.0,10.0,10.0,15.0,14.0,14.0,15.0,20.0,13.0,19.0,11.0,18.0,17.0,13.0,10.0,13.0,15.0,16.0,8.0,14.0,11.0,14.0,14.0,17.0,14.0,12.0,23.0,0.0,0.0,5.0,2.0,178.0,73.0,3.0,1.0,2.0,1.0,1.0,3.0,2.0,2.0,1.0,1.0,3.0,13.0,9.0,15.0,14.0,16.0,12.0,8.0,12.0,5.0,4.0,13.0,13.0,5.0,17.0,13.0,13.0,11.0,12.0,8.0,12.0,9.0,14.0,16.0,8.0,16.0,7.0,10.0,9.0,15.0,16.0,14.0,9.0,10.0,9.0,15.0,20.0,12.0,11.0,7.0,10.0,11.0,12.0,14.0,6.0,9.0,13.0,10.0,8.0,4.0,6.0,10.0,31.0,133.0,61.0,10.0,3.0,186.0,84.0,2.0,1.0,3.0,1.0,3.0,2.0,2.0,3.0,1.0,3.0,2.0,12.0,14.0,15.0,19.0,16.0,14.0,18.0,19.0,6.0,2.0,14.0,19.0,8.0,15.0,6.0,17.0,16.0,13.0,16.0,13.0,17.0,20.0,18.0,15.0,18.0,5.0,6.0,7.0,13.0,12.0,13.0,16.0,15.0,19.0,17.0,20.0,17.0,16.0,17.0,12.0,14.0,7.0,10.0,18.0,20.0,13.0,19.0,20.0,7.0,7.0,12.0
0,0,24.0,0.0,0.0,0.0,0.0,189.0,80.0,13.0,11.0,13.0,6.0,15.0,14.0,18.0,18.0,13.0,8.0,13.0,8.0,1.0,3.0,1.0,11.0,13.0,6.0,1.0,2.0,2.0,14.0,2.0,3.0,14.0,13.0,16.0,15.0,7.0,13.0,10.0,14.0,15.0,3.0,13.0,2.0,13.0,14.0,13.0,12.0,14.0,7.0,14.0,6.0,17.0,11.0,20.0,13.0,12.0,15.0,12.0,13.0,3.0,13.0,15.0,15.0,18.0,10.0,20.0,15.0,10.0,5.0,25.0,2.0,0.0,4.0,0.0,181.0,77.0,4.0,1.0,3.0,3.0,3.0,2.0,2.0,3.0,2.0,3.0,2.0,5.0,6.0,9.0,8.0,12.0,14.0,14.0,16.0,5.0,15.0,15.0,3.0,16.0,14.0,17.0,17.0,16.0,14.0,12.0,13.0,13.0,16.0,13.0,15.0,7.0,16.0,15.0,15.0,14.0,12.0,13.0,12.0,20.0,12.0,13.0,11.0,13.0,15.0,14.0,14.0,13.0,6.0,5.0,14.0,14.0,16.0,13.0,13.0,14.0,11.0,10.0,23.0,27.0,0.0,21.0,1.0,189.0,68.0,1.0,1.0,3.0,2.0,3.0,2.0,4.0,2.0,3.0,1.0,2.0,6.0,7.0,8.0,6.0,14.0,7.0,13.0,8.0,10.0,16.0,12.0,11.0,16.0,12.0,10.0,13.0,13.0,12.0,13.0,11.0,11.0,14.0,7.0,11.0,10.0,15.0,14.0,13.0,12.0,13.0,11.0,16.0,11.0,14.0,14.0,20.0,12.0,10.0,12.0,8.0,10.0,3.0,14.0,13.0,14.0,14.0,9.0,17.0,15.0,16.0,6.0,30.0,0.0,0.0,0.0,0.0,182.0,82.0,2.0,4.0,2.0,2.0,3.0,1.0,3.0,1.0,3.0,1.0,2.0,12.0,12.0,12.0,4.0,11.0,11.0,8.0,11.0,12.0,12.0,12.0,9.0,14.0,12.0,12.0,13.0,14.0,12.0,13.0,12.0,13.0,13.0,10.0,10.0,12.0,13.0,14.0,14.0,14.0,13.0,12.0,10.0,20.0,10.0,13.0,8.0,13.0,14.0,13.0,4.0,12.0,8.0,7.0,12.0,12.0,12.0,12.0,14.0,17.0,16.0,7.0,22.0,0.0,0.0,0.0,0.0,182.0,72.0,3.0,3.0,1.0,3.0,2.0,2.0,1.0,1.0,3.0,2.0,3.0,4.0,12.0,9.0,8.0,12.0,7.0,15.0,12.0,12.0,12.0,12.0,6.0,14.0,13.0,13.0,12.0,16.0,13.0,14.0,14.0,14.0,8.0,4.0,12.0,9.0,13.0,17.0,14.0,12.0,10.0,12.0,13.0,10.0,13.0,14.0,20.0,9.0,12.0,12.0,11.0,9.0,7.0,12.0,12.0,11.0,11.0,12.0,11.0,12.0,14.0,2.0,26.0,0.0,0.0,16.0,0.0,179.0,76.0,2.0,2.0,1.0,2.0,1.0,2.0,1.0,3.0,2.0,2.0,2.0,11.0,10.0,10.0,7.0,15.0,11.0,8.0,11.0,6.0,14.0,17.0,9.0,14.0,14.0,15.0,15.0,14.0,12.0,16.0,15.0,14.0,9.0,7.0,12.0,9.0,17.0,19.0,17.0,11.0,12.0,13.0,10.0,8.0,14.0,12.0,20.0,18.0,14.0,14.0,13.0,12.0,7.0,9.0,13.0,12.0,14.0,9.0,17.0,15.0,15.0,4.0,23.0,0.0,0.0,1.0,0.0,182.0,68.0,1.0,2.0,3.0,3.0,3.0,3.0,2.0,1.0,4.0,3.0,3.0,15.0,14.0,12.0,9.0,16.0,14.0,4.0,15.0,2.0,7.0,16.0,12.0,8.0,16.0,8.0,13.0,13.0,14.0,13.0,18.0,14.0,13.0,12.0,11.0,13.0,9.0,14.0,13.0,11.0,11.0,10.0,11.0,16.0,12.0,11.0,20.0,10.0,10.0,10.0,5.0,12.0,8.0,5.0,12.0,14.0,14.0,12.0,13.0,15.0,15.0,8.0,32.0,0.0,0.0,5.0,0.0,186.0,76.0,1.0,2.0,3.0,1.0,1.0,2.0,2.0,2.0,1.0,2.0,1.0,13.0,15.0,18.0,10.0,16.0,13.0,13.0,8.0,2.0,8.0,15.0,20.0,11.0,19.0,6.0,16.0,14.0,15.0,14.0,16.0,15.0,14.0,17.0,15.0,13.0,12.0,16.0,13.0,10.0,14.0,10.0,14.0,9.0,12.0,12.0,20.0,11.0,11.0,14.0,4.0,14.0,4.0,14.0,14.0,11.0,20.0,13.0,16.0,14.0,14.0,5.0,21.0,0.0,0.0,7.0,2.0,173.0,70.0,4.0,1.0,3.0,3.0,1.0,1.0,2.0,2.0,2.0,1.0,2.0,12.0,10.0,17.0,10.0,14.0,9.0,5.0,11.0,6.0,2.0,11.0,12.0,6.0,16.0,8.0,10.0,6.0,12.0,10.0,11.0,10.0,12.0,18.0,4.0,13.0,7.0,7.0,11.0,19.0,15.0,10.0,6.0,10.0,9.0,18.0,20.0,12.0,7.0,12.0,6.0,13.0,8.0,14.0,16.0,17.0,7.0,12.0,14.0,14.0,14.0,5.0,27.0,43.0,14.0,8.0,0.0,177.0,75.0,3.0,3.0,3.0,1.0,1.0,3.0,3.0,4.0,4.0,1.0,2.0,13.0,14.0,17.0,15.0,16.0,13.0,8.0,13.0,1.0,4.0,15.0,13.0,5.0,17.0,10.0,14.0,12.0,13.0,10.0,15.0,11.0,12.0,17.0,10.0,16.0,8.0,8.0,7.0,17.0,17.0,12.0,7.0,20.0,7.0,16.0,8.0,12.0,7.0,11.0,6.0,14.0,9.0,13.0,9.0,10.0,7.0,13.0,9.0,14.0,13.0,7.0,31.0,0.0,0.0,0.0,0.0,188.0,82.0,2.0,2.0,2.0,3.0,3.0,1.0,4.0,1.0,1.0,2.0,1.0,8.0,8.0,8.0,6.0,10.0,8.0,12.0,8.0,8.0,10.0,9.0,8.0,9.0,10.0,10.0,9.0,9.0,8.0,7.0,6.0,7.0,7.0,8.0,9.0,8.0,10.0,9.0,8.0,12.0,11.0,13.0,14.0,20.0,15.0,12.0,5.0,12.0,14.0,10.0,9.0,10.0,8.0,11.0,9.0,11.0,11.0,11.0,13.0,11.0,12.0,4.0,32.0,0.0,0.0,1.0,0.0,187.0,79.0,14.0,14.0,14.0,15.0,15.0,13.0,16.0,15.0,15.0,16.0,15.0,7.0,12.0,12.0,3.0,12.0,11.0,8.0,15.0,3.0,2.0,12.0,2.0,2.0,11.0,10.0,12.0,14.0,14.0,12.0,12.0,11.0,14.0,12.0,17.0,7.0,13.0,11.0,11.0,14.0,12.0,10.0,13.0,20.0,13.0,12.0,10.0,11.0,10.0,13.0,10.0,17.0,11.0,11.0,18.0,13.0,15.0,13.0,10.0,11.0,7.0,13.0,26.0,0.0,0.0,0.0,0.0,187.0,76.0,2.0,3.0,2.0,2.0,3.0,1.0,3.0,4.0,2.0,3.0,1.0,5.0,3.0,4.0,6.0,8.0,7.0,12.0,4.0,1.0,10.0,9.0,5.0,13.0,4.0,6.0,14.0,9.0,8.0,11.0,6.0,10.0,2.0,5.0,7.0,5.0,12.0,8.0,9.0,14.0,11.0,9.0,14.0,20.0,9.0,10.0,10.0,14.0,13.0,10.0,10.0,10.0,4.0,10.0,17.0,9.0,8.0,11.0,11.0,6.0,10.0,3.0,16.0,0.0,0.0,0.0,0.0,189.0,0.0,3.0,3.0,3.0,1.0,1.0,3.0,1.0,3.0,1.0,1.0,2.0,5.0,7.0,5.0,4.0,6.0,6.0,1.0,1.0,4.0,2.0,5.0,3.0,5.0,10.0,10.0,4.0,5.0,6.0,3.0,7.0,7.0,5.0,11.0,3.0,4.0,3.0,7.0,7.0,11.0,7.0,4.0,12.0,20.0,9.0,9.0,9.0,9.0,6.0,5.0,11.0,4.0,10.0,12.0,10.0,11.0,12.0,12.0,9.0,7.0,7.0,10.0,29.0,0.0,0.0,0.0,0.0,168.0,67.0,2.0,2.0,1.0,2.0,3.0,2.0,3.0,3.0,2.0,3.0,2.0,7.0,11.0,10.0,9.0,12.0,4.0,11.0,12.0,10.0,12.0,13.0,12.0,12.0,12.0,12.0,12.0,17.0,16.0,11.0,9.0,10.0,12.0,13.0,16.0,9.0,11.0,15.0,16.0,11.0,12.0,15.0,5.0,10.0,12.0,11.0,20.0,15.0,14.0,10.0,11.0,16.0,13.0,20.0,14.0,10.0,14.0,13.0,18.0,17.0,20.0,1.0,26.0,0.0,0.0,0.0,0.0,180.0,75.0,1.0,2.0,1.0,1.0,4.0,1.0,3.0,2.0,1.0,3.0,1.0,12.0,14.0,14.0,12.0,13.0,10.0,9.0,12.0,7.0,12.0,14.0,12.0,12.0,14.0,9.0,12.0,10.0,13.0,12.0,14.0,11.0,11.0,12.0,13.0,13.0,13.0,14.0,14.0,12.0,12.0,10.0,8.0,20.0,13.0,14.0,11.0,13.0,12.0,8.0,4.0,12.0,11.0,12.0,8.0,12.0,10.0,8.0,7.0,10.0,11.0,12.0,18.0,0.0,0.0,0.0,0.0,180.0,0.0,3.0,2.0,1.0,3.0,2.0,2.0,3.0,2.0,4.0,2.0,1.0,8.0,7.0,6.0,9.0,7.0,6.0,8.0,12.0,4.0,12.0,11.0,1.0,11.0,11.0,9.0,9.0,8.0,10.0,9.0,11.0,15.0,9.0,6.0,1.0,8.0,10.0,9.0,8.0,11.0,12.0,5.0,7.0,8.0,10.0,10.0,20.0,6.0,11.0,9.0,9.0,4.0,6.0,9.0,8.0,12.0,12.0,12.0,11.0,4.0,10.0,3.0,28.0,0.0,0.0,0.0,0.0,175.0,66.0,1.0,3.0,4.0,3.0,2.0,3.0,2.0,2.0,3.0,3.0,4.0,12.0,12.0,11.0,10.0,13.0,12.0,7.0,12.0,7.0,12.0,14.0,13.0,12.0,14.0,11.0,12.0,13.0,11.0,13.0,14.0,13.0,12.0,14.0,11.0,11.0,13.0,15.0,14.0,11.0,12.0,12.0,8.0,20.0,11.0,11.0,10.0,12.0,11.0,12.0,7.0,12.0,10.0,5.0,10.0,9.0,14.0,11.0,10.0,12.0,18.0,2.0,27.0,0.0,0.0,0.0,0.0,171.0,63.0,2.0,1.0,1.0,3.0,1.0,2.0,4.0,2.0,2.0,2.0,3.0,8.0,4.0,6.0,6.0,13.0,8.0,8.0,6.0,1.0,14.0,13.0,5.0,8.0,14.0,6.0,10.0,9.0,8.0,9.0,14.0,12.0,10.0,10.0,11.0,12.0,11.0,9.0,13.0,14.0,14.0,9.0,5.0,5.0,10.0,14.0,20.0,9.0,6.0,10.0,7.0,10.0,10.0,10.0,13.0,13.0,9.0,9.0,12.0,11.0,14.0,2.0,28.0,0.0,0.0,0.0,0.0,177.0,72.0,3.0,4.0,3.0,1.0,3.0,1.0,1.0,1.0,3.0,2.0,2.0,13.0,14.0,15.0,12.0,11.0,13.0,14.0,12.0,8.0,11.0,13.0,13.0,12.0,15.0,14.0,13.0,14.0,11.0,13.0,12.0,11.0,10.0,17.0,13.0,17.0,13.0,14.0,14.0,12.0,13.0,11.0,10.0,11.0,13.0,12.0,20.0,13.0,13.0,12.0,10.0,7.0,7.0,15.0,17.0,13.0,9.0,9.0,11.0,9.0,17.0,6.0,25.0,0.0,0.0,0.0,0.0,181.0,77.0,3.0,1.0,1.0,2.0,1.0,2.0,1.0,3.0,3.0,3.0,2.0,9.0,10.0,11.0,12.0,11.0,14.0,13.0,10.0,6.0,9.0,11.0,15.0,9.0,11.0,15.0,11.0,15.0,12.0,12.0,12.0,12.0,9.0,12.0,12.0,13.0,10.0,14.0,15.0,12.0,12.0,11.0,12.0,12.0,15.0,12.0,20.0,14.0,16.0,12.0,9.0,17.0,12.0,11.0,16.0,10.0,11.0,11.0,13.0,13.0,17.0,6.0,20.0,5.0,0.0,5.0,0.0,181.0,74.0,3.0,1.0,2.0,1.0,1.0,3.0,3.0,2.0,3.0,1.0,1.0,7.0,9.0,15.0,15.0,17.0,7.0,12.0,11.0,5.0,5.0,9.0,7.0,6.0,16.0,13.0,12.0,14.0,12.0,10.0,13.0,10.0,12.0,11.0,9.0,13.0,12.0,11.0,10.0,14.0,15.0,13.0,9.0,12.0,12.0,12.0,20.0,13.0,12.0,9.0,9.0,8.0,13.0,9.0,11.0,13.0,12.0,11.0,12.0,6.0,17.0,4.0
3,0,18.0,0.0,0.0,0.0,0.0,180.0,0.0,3.0,2.0,1.0,3.0,2.0,2.0,3.0,2.0,4.0,2.0,1.0,8.0,7.0,6.0,9.0,7.0,6.0,8.0,12.0,4.0,12.0,11.0,1.0,11.0,11.0,9.0,9.0,8.0,10.0,9.0,11.0,15.0,9.0,6.0,1.0,8.0,10.0,9.0,8.0,11.0,12.0,5.0,7.0,8.0,10.0,10.0,20.0,6.0,11.0,9.0,9.0,4.0,6.0,9.0,8.0,12.0,12.0,12.0,11.0,4.0,10.0,3.0,30.0,0.0,0.0,6.0,0.0,183.0,81.0,1.0,3.0,1.0,1.0,1.0,2.0,1.0,2.0,2.0,2.0,1.0,5.0,7.0,7.0,5.0,9.0,7.0,15.0,6.0,9.0,17.0,11.0,8.0,16.0,8.0,17.0,15.0,18.0,12.0,13.0,9.0,15.0,15.0,6.0,16.0,6.0,17.0,16.0,16.0,12.0,11.0,9.0,13.0,8.0,16.0,14.0,20.0,13.0,16.0,14.0,17.0,15.0,6.0,12.0,14.0,15.0,13.0,14.0,13.0,7.0,9.0,11.0,26.0,0.0,0.0,14.0,0.0,186.0,72.0,1.0,2.0,1.0,2.0,1.0,1.0,2.0,1.0,3.0,1.0,1.0,7.0,11.0,9.0,8.0,14.0,8.0,12.0,11.0,10.0,13.0,17.0,11.0,16.0,14.0,13.0,16.0,13.0,15.0,15.0,13.0,14.0,12.0,9.0,12.0,7.0,16.0,14.0,13.0,11.0,10.0,8.0,13.0,20.0,11.0,13.0,7.0,14.0,17.0,14.0,8.0,11.0,8.0,13.0,8.0,13.0,14.0,12.0,13.0,12.0,12.0,4.0,17.0,0.0,0.0,0.0,0.0,173.0,0.0,1.0,4.0,2.0,1.0,1.0,4.0,1.0,4.0,2.0,1.0,3.0,4.0,2.0,13.0,13.0,13.0,6.0,13.0,7.0,1.0,4.0,7.0,3.0,1.0,13.0,9.0,10.0,7.0,6.0,3.0,2.0,13.0,3.0,13.0,11.0,11.0,2.0,6.0,7.0,13.0,13.0,7.0,7.0,4.0,9.0,13.0,20.0,7.0,8.0,9.0,9.0,9.0,9.0,9.0,8.0,14.0,9.0,12.0,12.0,6.0,19.0,2.0,25.0,0.0,0.0,12.0,0.0,174.0,75.0,1.0,2.0,1.0,3.0,2.0,2.0,3.0,1.0,3.0,3.0,1.0,4.0,13.0,10.0,6.0,12.0,7.0,9.0,6.0,14.0,13.0,12.0,9.0,15.0,12.0,16.0,14.0,16.0,14.0,16.0,10.0,13.0,15.0,7.0,12.0,13.0,15.0,15.0,16.0,15.0,13.0,13.0,9.0,12.0,13.0,14.0,20.0,15.0,14.0,15.0,9.0,13.0,7.0,8.0,19.0,13.0,15.0,11.0,11.0,8.0,6.0,3.0,27.0,14.0,0.0,14.0,0.0,178.0,70.0,1.0,1.0,3.0,3.0,3.0,2.0,1.0,1.0,1.0,3.0,2.0,13.0,13.0,12.0,9.0,14.0,16.0,11.0,11.0,14.0,11.0,13.0,9.0,13.0,14.0,14.0,13.0,12.0,11.0,13.0,11.0,11.0,13.0,11.0,8.0,11.0,10.0,12.0,13.0,14.0,12.0,12.0,11.0,9.0,12.0,13.0,20.0,13.0,11.0,15.0,10.0,14.0,7.0,19.0,17.0,16.0,13.0,17.0,15.0,13.0,10.0,7.0,29.0,4.0,3.0,0.0,0.0,185.0,81.0,1.0,4.0,2.0,3.0,3.0,1.0,2.0,1.0,2.0,3.0,3.0,10.0,14.0,15.0,13.0,15.0,16.0,13.0,14.0,8.0,9.0,15.0,14.0,10.0,15.0,16.0,15.0,16.0,14.0,17.0,14.0,14.0,14.0,14.0,11.0,14.0,11.0,16.0,15.0,10.0,13.0,10.0,14.0,20.0,11.0,14.0,10.0,14.0,14.0,8.0,14.0,11.0,13.0,15.0,12.0,15.0,10.0,9.0,14.0,13.0,8.0,8.0,30.0,9.0,1.0,0.0,0.0,177.0,74.0,3.0,2.0,2.0,1.0,3.0,1.0,3.0,3.0,3.0,4.0,3.0,11.0,16.0,14.0,11.0,15.0,6.0,8.0,10.0,5.0,8.0,13.0,8.0,12.0,13.0,15.0,15.0,15.0,14.0,15.0,13.0,16.0,16.0,12.0,7.0,13.0,13.0,16.0,17.0,13.0,14.0,12.0,9.0,14.0,14.0,13.0,20.0,15.0,12.0,16.0,13.0,13.0,12.0,12.0,9.0,13.0,15.0,13.0,15.0,15.0,10.0,8.0,30.0,39.0,2.0,0.0,0.0,171.0,58.0,2.0,1.0,3.0,1.0,3.0,3.0,1.0,2.0,3.0,3.0,1.0,15.0,16.0,15.0,12.0,14.0,11.0,8.0,11.0,8.0,7.0,13.0,14.0,8.0,14.0,12.0,13.0,11.0,8.0,12.0,13.0,11.0,11.0,13.0,9.0,16.0,9.0,13.0,13.0,17.0,17.0,17.0,6.0,12.0,13.0,15.0,20.0,12.0,8.0,11.0,13.0,13.0,7.0,7.0,10.0,10.0,9.0,14.0,10.0,13.0,7.0,12.0,29.0,13.0,5.0,0.0,0.0,175.0,73.0,1.0,3.0,3.0,3.0,3.0,1.0,1.0,2.0,1.0,3.0,3.0,15.0,12.0,15.0,14.0,15.0,12.0,9.0,13.0,6.0,4.0,13.0,15.0,10.0,16.0,9.0,13.0,12.0,14.0,13.0,13.0,14.0,10.0,16.0,14.0,15.0,10.0,12.0,10.0,15.0,15.0,14.0,9.0,15.0,12.0,13.0,20.0,14.0,13.0,12.0,14.0,14.0,7.0,12.0,12.0,14.0,12.0,10.0,10.0,7.0,10.0,12.0,28.0,0.0,0.0,0.0,0.0,176.0,67.0,2.0,1.0,1.0,3.0,3.0,2.0,3.0,4.0,2.0,1.0,4.0,13.0,11.0,15.0,15.0,16.0,15.0,14.0,14.0,7.0,6.0,14.0,16.0,7.0,14.0,12.0,15.0,15.0,14.0,14.0,14.0,14.0,15.0,15.0,10.0,16.0,7.0,11.0,16.0,15.0,14.0,13.0,11.0,20.0,15.0,15.0,10.0,14.0,9.0,12.0,6.0,16.0,5.0,14.0,10.0,14.0,16.0,13.0,11.0,8.0,6.0,15.0,29.0,0.0,0.0,0.0,0.0,189.0,79.0,14.0,15.0,14.0,5.0,14.0,14.0,11.0,13.0,10.0,7.0,12.0,6.0,2.0,3.0,2.0,8.0,11.0,7.0,2.0,3.0,1.0,8.0,2.0,1.0,7.0,10.0,12.0,14.0,11.0,11.0,6.0,14.0,13.0,3.0,12.0,3.0,11.0,12.0,5.0,8.0,11.0,12.0,13.0,5.0,8.0,7.0,20.0,8.0,13.0,11.0,9.0,8.0,7.0,11.0,13.0,14.0,15.0,14.0,12.0,12.0,8.0,3.0,33.0,1.0,0.0,15.0,1.0,183.0,77.0,2.0,3.0,3.0,1.0,3.0,3.0,3.0,3.0,3.0,2.0,1.0,8.0,10.0,10.0,7.0,14.0,10.0,15.0,7.0,10.0,14.0,15.0,10.0,14.0,14.0,12.0,14.0,11.0,11.0,14.0,12.0,13.0,9.0,11.0,12.0,9.0,15.0,11.0,12.0,11.0,11.0,12.0,12.0,12.0,9.0,12.0,20.0,12.0,12.0,14.0,7.0,13.0,14.0,9.0,12.0,15.0,8.0,7.0,10.0,13.0,14.0,8.0,22.0,1.0,0.0,7.0,0.0,186.0,75.0,1.0,4.0,3.0,2.0,1.0,2.0,3.0,4.0,3.0,4.0,3.0,8.0,10.0,9.0,6.0,14.0,6.0,14.0,6.0,13.0,15.0,13.0,9.0,16.0,14.0,15.0,14.0,18.0,11.0,15.0,9.0,15.0,8.0,6.0,11.0,7.0,16.0,15.0,16.0,12.0,10.0,8.0,13.0,10.0,12.0,12.0,20.0,14.0,13.0,11.0,12.0,10.0,9.0,15.0,9.0,12.0,12.0,9.0,12.0,13.0,17.0,5.0,26.0,0.0,0.0,0.0,0.0,177.0,73.0,1.0,3.0,1.0,3.0,3.0,2.0,3.0,3.0,4.0,1.0,4.0,8.0,10.0,7.0,2.0,12.0,3.0,6.0,3.0,3.0,8.0,8.0,5.0,12.0,8.0,7.0,10.0,7.0,8.0,9.0,8.0,7.0,1.0,7.0,11.0,7.0,8.0,7.0,8.0,14.0,14.0,7.0,8.0,8.0,11.0,14.0,20.0,10.0,6.0,8.0,8.0,3.0,8.0,17.0,13.0,13.0,10.0,11.0,8.0,12.0,13.0,7.0,28.0,0.0,0.0,0.0,0.0,182.0,0.0,3.0,2.0,2.0,2.0,2.0,3.0,1.0,2.0,1.0,1.0,1.0,6.0,5.0,10.0,4.0,13.0,4.0,6.0,9.0,1.0,6.0,12.0,5.0,4.0,13.0,9.0,7.0,4.0,10.0,7.0,11.0,9.0,5.0,13.0,4.0,9.0,6.0,7.0,12.0,13.0,11.0,7.0,5.0,7.0,11.0,10.0,20.0,13.0,9.0,9.0,9.0,9.0,8.0,9.0,7.0,12.0,9.0,14.0,12.0,11.0,15.0,4.0,27.0,0.0,0.0,1.0,0.0,180.0,73.0,4.0,1.0,1.0,3.0,2.0,1.0,3.0,3.0,3.0,2.0,2.0,9.0,9.0,11.0,8.0,12.0,10.0,10.0,11.0,6.0,12.0,13.0,11.0,12.0,12.0,9.0,13.0,14.0,14.0,15.0,13.0,14.0,11.0,10.0,13.0,12.0,14.0,15.0,15.0,13.0,12.0,10.0,10.0,12.0,10.0,11.0,20.0,13.0,12.0,13.0,8.0,11.0,13.0,12.0,12.0,10.0,11.0,13.0,13.0,12.0,9.0,13.0,35.0,0.0,0.0,0.0,0.0,177.0,70.0,1.0,4.0,4.0,3.0,1.0,2.0,3.0,2.0,3.0,3.0,1.0,15.0,14.0,12.0,12.0,17.0,17.0,10.0,14.0,7.0,3.0,18.0,16.0,4.0,17.0,10.0,13.0,8.0,14.0,13.0,18.0,17.0,12.0,17.0,15.0,11.0,8.0,12.0,9.0,9.0,8.0,10.0,7.0,16.0,11.0,9.0,20.0,12.0,9.0,13.0,6.0,12.0,12.0,11.0,12.0,15.0,9.0,12.0,13.0,11.0,12.0,10.0,25.0,0.0,0.0,6.0,1.0,190.0,78.0,3.0,3.0,3.0,3.0,1.0,2.0,3.0,3.0,3.0,2.0,3.0,10.0,10.0,13.0,11.0,12.0,13.0,11.0,16.0,8.0,4.0,12.0,13.0,8.0,14.0,10.0,8.0,8.0,7.0,7.0,8.0,9.0,14.0,17.0,5.0,13.0,7.0,9.0,13.0,17.0,13.0,12.0,15.0,12.0,17.0,16.0,20.0,16.0,17.0,10.0,7.0,9.0,7.0,12.0,6.0,17.0,10.0,12.0,10.0,12.0,12.0,10.0,29.0,0.0,0.0,13.0,1.0,176.0,76.0,1.0,2.0,1.0,1.0,3.0,2.0,4.0,4.0,2.0,1.0,2.0,14.0,15.0,12.0,9.0,13.0,15.0,7.0,13.0,9.0,11.0,13.0,12.0,13.0,13.0,14.0,11.0,15.0,10.0,11.0,10.0,8.0,14.0,14.0,10.0,12.0,9.0,7.0,15.0,14.0,15.0,12.0,8.0,14.0,14.0,13.0,20.0,14.0,10.0,15.0,10.0,11.0,11.0,12.0,9.0,9.0,11.0,10.0,11.0,14.0,8.0,15.0,33.0,37.0,19.0,0.0,0.0,188.0,83.0,2.0,2.0,1.0,1.0,4.0,2.0,1.0,1.0,2.0,3.0,2.0,7.0,7.0,12.0,13.0,11.0,10.0,17.0,13.0,12.0,7.0,9.0,13.0,7.0,12.0,14.0,8.0,15.0,11.0,12.0,9.0,12.0,9.0,13.0,9.0,13.0,6.0,11.0,13.0,12.0,12.0,10.0,16.0,20.0,16.0,13.0,10.0,15.0,17.0,11.0,11.0,13.0,5.0,6.0,14.0,13.0,12.0,8.0,6.0,12.0,14.0,15.0,25.0,0.0,0.0,0.0,0.0,175.0,74.0,3.0,3.0,3.0,3.0,3.0,3.0,3.0,1.0,3.0,2.0,3.0,7.0,7.0,4.0,7.0,14.0,7.0,7.0,10.0,4.0,9.0,14.0,4.0,14.0,10.0,9.0,9.0,8.0,6.0,9.0,11.0,14.0,3.0,1.0,10.0,5.0,14.0,8.0,11.0,14.0,10.0,8.0,6.0,4.0,10.0,11.0,20.0,10.0,7.0,9.0,5.0,8.0,3.0,9.0,14.0,12.0,13.0,10.0,12.0,11.0,18.0,1.0
0,6,21.0,0.0,0.0,1.0,0.0,188.0,74.0,14.0,15.0,14.0,7.0,15.0,13.0,12.0,15.0,13.0,7.0,16.0,6.0,3.0,2.0,3.0,8.0,11.0,2.0,2.0,3.0,2.0,4.0,6.0,1.0,9.0,11.0,14.0,13.0,15.0,15.0,11.0,14.0,19.0,1.0,11.0,1.0,16.0,14.0,12.0,11.0,14.0,14.0,16.0,9.0,13.0,10.0,20.0,13.0,12.0,16.0,9.0,13.0,6.0,12.0,13.0,13.0,11.0,12.0,12.0,10.0,19.0,7.0,32.0,1.0,0.0,5.0,0.0,189.0,93.0,1.0,1.0,3.0,4.0,2.0,2.0,3.0,2.0,3.0,3.0,3.0,3.0,8.0,8.0,7.0,9.0,8.0,16.0,8.0,7.0,14.0,10.0,9.0,14.0,9.0,15.0,14.0,16.0,12.0,10.0,10.0,12.0,14.0,9.0,9.0,7.0,13.0,14.0,15.0,9.0,8.0,10.0,14.0,8.0,16.0,11.0,20.0,14.0,19.0,12.0,14.0,12.0,8.0,6.0,13.0,16.0,14.0,11.0,15.0,14.0,12.0,10.0,16.0,0.0,0.0,0.0,0.0,186.0,0.0,2.0,2.0,1.0,1.0,3.0,1.0,2.0,3.0,3.0,3.0,3.0,3.0,3.0,4.0,4.0,5.0,2.0,7.0,2.0,4.0,6.0,7.0,3.0,12.0,7.0,12.0,7.0,15.0,6.0,8.0,4.0,6.0,6.0,7.0,10.0,4.0,9.0,18.0,14.0,9.0,6.0,12.0,13.0,7.0,14.0,10.0,20.0,10.0,7.0,7.0,9.0,7.0,11.0,6.0,5.0,9.0,14.0,13.0,13.0,10.0,7.0,5.0,30.0,0.0,0.0,0.0,0.0,179.0,74.0,2.0,3.0,2.0,2.0,2.0,1.0,1.0,3.0,2.0,1.0,2.0,9.0,12.0,11.0,8.0,11.0,8.0,7.0,10.0,11.0,12.0,13.0,7.0,13.0,11.0,13.0,12.0,14.0,12.0,13.0,11.0,12.0,12.0,8.0,13.0,14.0,14.0,15.0,16.0,13.0,13.0,13.0,8.0,12.0,13.0,12.0,20.0,14.0,11.0,15.0,9.0,6.0,7.0,17.0,19.0,11.0,11.0,12.0,12.0,10.0,18.0,2.0,16.0,0.0,0.0,0.0,0.0,151.0,0.0,4.0,1.0,2.0,2.0,1.0,3.0,2.0,2.0,1.0,3.0,2.0,9.0,6.0,5.0,4.0,4.0,11.0,3.0,3.0,1.0,2.0,5.0,3.0,2.0,5.0,17.0,3.0,9.0,4.0,4.0,6.0,9.0,6.0,8.0,13.0,4.0,1.0,9.0,12.0,14.0,11.0,3.0,2.0,9.0,15.0,13.0,20.0,8.0,3.0,5.0,14.0,9.0,9.0,4.0,10.0,15.0,6.0,11.0,8.0,7.0,9.0,6.0,20.0,0.0,0.0,2.0,0.0,180.0,75.0,2.0,3.0,1.0,1.0,3.0,3.0,1.0,1.0,2.0,2.0,1.0,10.0,10.0,9.0,7.0,13.0,12.0,9.0,9.0,11.0,13.0,13.0,3.0,14.0,12.0,11.0,14.0,13.0,13.0,13.0,12.0,13.0,11.0,8.0,13.0,11.0,15.0,14.0,13.0,13.0,13.0,13.0,8.0,20.0,7.0,14.0,7.0,14.0,11.0,13.0,9.0,11.0,11.0,11.0,18.0,12.0,12.0,9.0,11.0,12.0,12.0,4.0,29.0,0.0,0.0,0.0,0.0,177.0,75.0,1.0,1.0,2.0,3.0,2.0,2.0,2.0,1.0,3.0,2.0,3.0,10.0,11.0,12.0,9.0,10.0,14.0,10.0,15.0,12.0,11.0,10.0,9.0,13.0,10.0,12.0,11.0,14.0,9.0,14.0,9.0,12.0,10.0,9.0,7.0,12.0,13.0,15.0,14.0,13.0,13.0,10.0,9.0,15.0,12.0,12.0,20.0,14.0,10.0,14.0,7.0,4.0,8.0,17.0,12.0,11.0,8.0,8.0,10.0,11.0,10.0,7.0,16.0,0.0,0.0,0.0,0.0,176.0,0.0,3.0,3.0,3.0,4.0,2.0,3.0,4.0,3.0,2.0,1.0,2.0,2.0,2.0,1.0,1.0,4.0,2.0,5.0,3.0,4.0,4.0,4.0,2.0,8.0,3.0,6.0,5.0,6.0,2.0,4.0,3.0,11.0,12.0,7.0,8.0,3.0,7.0,7.0,12.0,9.0,8.0,4.0,6.0,20.0,10.0,7.0,9.0,7.0,6.0,8.0,7.0,9.0,9.0,6.0,9.0,6.0,12.0,14.0,7.0,13.0,12.0,3.0,32.0,0.0,0.0,0.0,0.0,178.0,70.0,1.0,3.0,1.0,2.0,2.0,3.0,1.0,1.0,1.0,3.0,3.0,13.0,11.0,12.0,10.0,14.0,12.0,6.0,11.0,8.0,6.0,15.0,11.0,5.0,15.0,7.0,13.0,8.0,12.0,11.0,16.0,14.0,14.0,16.0,11.0,15.0,6.0,13.0,9.0,10.0,12.0,11.0,10.0,10.0,15.0,10.0,20.0,10.0,9.0,9.0,8.0,13.0,7.0,13.0,11.0,13.0,12.0,12.0,14.0,12.0,13.0,6.0,27.0,55.0,15.0,0.0,0.0,187.0,81.0,3.0,2.0,1.0,1.0,2.0,1.0,3.0,3.0,1.0,1.0,2.0,7.0,12.0,12.0,15.0,12.0,9.0,14.0,15.0,7.0,7.0,12.0,14.0,8.0,14.0,14.0,14.0,14.0,15.0,13.0,13.0,13.0,15.0,14.0,9.0,11.0,8.0,11.0,10.0,14.0,14.0,12.0,14.0,20.0,12.0,14.0,10.0,16.0,14.0,12.0,8.0,11.0,11.0,8.0,15.0,17.0,10.0,10.0,15.0,15.0,12.0,5.0,24.0,0.0,0.0,0.0,0.0,183.0,77.0,3.0,2.0,2.0,2.0,1.0,2.0,3.0,3.0,1.0,3.0,2.0,8.0,11.0,14.0,15.0,16.0,9.0,13.0,13.0,7.0,4.0,14.0,15.0,6.0,13.0,13.0,14.0,13.0,13.0,13.0,13.0,13.0,16.0,12.0,12.0,16.0,8.0,14.0,16.0,13.0,12.0,12.0,13.0,20.0,12.0,13.0,12.0,14.0,12.0,14.0,4.0,17.0,7.0,8.0,19.0,13.0,14.0,12.0,15.0,15.0,16.0,5.0,29.0,66.0,0.0,0.0,0.0,184.0,78.0,10.0,15.0,15.0,4.0,12.0,13.0,17.0,19.0,10.0,16.0,15.0,10.0,1.0,3.0,3.0,8.0,12.0,9.0,1.0,1.0,1.0,9.0,3.0,2.0,6.0,11.0,15.0,15.0,13.0,18.0,8.0,15.0,16.0,8.0,12.0,3.0,13.0,15.0,15.0,12.0,18.0,14.0,12.0,9.0,17.0,14.0,20.0,14.0,13.0,16.0,4.0,17.0,9.0,12.0,14.0,15.0,16.0,15.0,20.0,16.0,19.0,3.0,27.0,0.0,0.0,0.0,0.0,183.0,0.0,2.0,4.0,1.0,2.0,2.0,2.0,1.0,2.0,3.0,1.0,3.0,2.0,4.0,5.0,4.0,12.0,6.0,6.0,4.0,3.0,11.0,13.0,1.0,11.0,7.0,9.0,8.0,5.0,8.0,7.0,8.0,13.0,9.0,4.0,13.0,6.0,8.0,7.0,12.0,13.0,13.0,7.0,8.0,8.0,11.0,13.0,20.0,7.0,7.0,9.0,9.0,2.0,15.0,9.0,8.0,13.0,9.0,10.0,11.0,12.0,20.0,2.0,18.0,0.0,0.0,0.0,0.0,173.0,0.0,3.0,1.0,2.0,3.0,1.0,3.0,3.0,2.0,1.0,1.0,1.0,5.0,5.0,12.0,10.0,14.0,7.0,7.0,10.0,2.0,6.0,12.0,5.0,8.0,14.0,11.0,6.0,8.0,10.0,7.0,13.0,11.0,7.0,13.0,6.0,7.0,5.0,8.0,11.0,13.0,14.0,7.0,8.0,5.0,13.0,14.0,20.0,9.0,5.0,9.0,6.0,9.0,5.0,9.0,13.0,11.0,8.0,12.0,13.0,1.0,5.0,3.0,27.0,0.0,0.0,0.0,0.0,184.0,81.0,1.0,1.0,1.0,3.0,3.0,2.0,2.0,2.0,1.0,2.0,3.0,8.0,6.0,8.0,12.0,10.0,8.0,12.0,9.0,1.0,3.0,8.0,14.0,4.0,9.0,4.0,11.0,12.0,11.0,8.0,8.0,11.0,10.0,9.0,8.0,11.0,9.0,8.0,11.0,10.0,8.0,13.0,13.0,9.0,13.0,9.0,20.0,12.0,13.0,13.0,9.0,2.0,9.0,9.0,15.0,10.0,12.0,10.0,11.0,6.0,4.0,6.0,24.0,5.0,0.0,10.0,1.0,173.0,73.0,2.0,1.0,3.0,2.0,1.0,2.0,2.0,3.0,3.0,1.0,1.0,11.0,14.0,12.0,8.0,13.0,8.0,10.0,9.0,13.0,14.0,13.0,9.0,15.0,12.0,17.0,14.0,18.0,13.0,16.0,12.0,13.0,16.0,12.0,13.0,17.0,13.0,17.0,19.0,16.0,14.0,17.0,8.0,10.0,16.0,14.0,20.0,18.0,12.0,16.0,12.0,11.0,5.0,13.0,15.0,15.0,17.0,14.0,19.0,8.0,9.0,5.0,24.0,11.0,0.0,15.0,3.0,184.0,83.0,1.0,3.0,3.0,2.0,4.0,1.0,3.0,3.0,3.0,3.0,1.0,10.0,11.0,12.0,9.0,14.0,10.0,13.0,12.0,10.0,13.0,14.0,11.0,15.0,13.0,18.0,14.0,16.0,15.0,16.0,12.0,15.0,13.0,12.0,10.0,12.0,16.0,17.0,19.0,12.0,12.0,15.0,13.0,13.0,15.0,14.0,20.0,19.0,17.0,16.0,9.0,11.0,5.0,12.0,13.0,12.0,10.0,14.0,12.0,10.0,13.0,14.0,30.0,93.0,11.0,15.0,2.0,173.0,65.0,3.0,2.0,2.0,3.0,3.0,3.0,4.0,1.0,1.0,1.0,1.0,16.0,16.0,17.0,9.0,19.0,13.0,8.0,12.0,7.0,8.0,19.0,14.0,11.0,18.0,12.0,17.0,13.0,15.0,16.0,18.0,18.0,16.0,13.0,13.0,12.0,12.0,16.0,17.0,14.0,17.0,13.0,7.0,13.0,13.0,13.0,20.0,17.0,8.0,15.0,12.0,14.0,11.0,16.0,10.0,15.0,13.0,17.0,16.0,16.0,17.0,5.0,26.0,61.0,22.0,13.0,3.0,186.0,82.0,2.0,2.0,2.0,1.0,3.0,2.0,1.0,1.0,2.0,1.0,3.0,14.0,16.0,16.0,17.0,15.0,17.0,19.0,19.0,15.0,6.0,14.0,13.0,9.0,16.0,10.0,14.0,11.0,13.0,11.0,13.0,13.0,16.0,17.0,9.0,18.0,7.0,10.0,10.0,15.0,14.0,14.0,15.0,20.0,13.0,19.0,11.0,18.0,17.0,13.0,10.0,13.0,15.0,16.0,8.0,14.0,11.0,14.0,14.0,17.0,14.0,12.0,24.0,14.0,1.0,18.0,9.0,175.0,74.0,3.0,1.0,1.0,1.0,2.0,2.0,3.0,3.0,2.0,3.0,1.0,15.0,15.0,18.0,13.0,18.0,14.0,9.0,15.0,8.0,5.0,17.0,15.0,8.0,18.0,10.0,15.0,8.0,15.0,13.0,18.0,15.0,16.0,18.0,13.0,13.0,8.0,10.0,10.0,14.0,14.0,17.0,8.0,14.0,10.0,12.0,20.0,13.0,10.0,12.0,10.0,15.0,3.0,15.0,15.0,16.0,8.0,17.0,12.0,13.0,11.0,9.0,28.0,81.0,27.0,5.0,0.0,184.0,84.0,1.0,3.0,2.0,3.0,3.0,3.0,1.0,1.0,2.0,3.0,3.0,10.0,11.0,17.0,16.0,19.0,12.0,13.0,13.0,7.0,7.0,15.0,14.0,9.0,18.0,8.0,14.0,7.0,18.0,12.0,18.0,17.0,8.0,17.0,10.0,17.0,8.0,15.0,11.0,14.0,14.0,16.0,11.0,17.0,11.0,14.0,20.0,13.0,14.0,9.0,4.0,11.0,8.0,8.0,8.0,11.0,12.0,15.0,9.0,17.0,18.0,20.0,31.0,133.0,61.0,10.0,3.0,186.0,84.0,2.0,1.0,3.0,1.0,3.0,2.0,2.0,3.0,1.0,3.0,2.0,12.0,14.0,15.0,19.0,16.0,14.0,18.0,19.0,6.0,2.0,14.0,19.0,8.0,15.0,6.0,17.0,16.0,13.0,16.0,13.0,17.0,20.0,18.0,15.0,18.0,5.0,6.0,7.0,13.0,12.0,13.0,16.0,15.0,19.0,17.0,20.0,17.0,16.0,17.0,12.0,14.0,7.0,10.0,18.0,20.0,13.0,19.0,20.0,7.0,7.0,12.0
1,0,29.0,66.0,0.0,0.0,0.0,184.0,78.0,10.0,15.0,15.0,4.0,12.0,13.0,17.0,19.0,10.0,16.0,15.0,10.0,1.0,3.0,3.0,8.0,12.0,9.0,1.0,1.0,1.0,9.0,3.0,2.0,6.0,11.0,15.0,15.0,13.0,18.0,8.0,15.0,16.0,8.0,12.0,3.0,13.0,15.0,15.0,12.0,18.0,14.0,12.0,9.0,17.0,14.0,20.0,14.0,13.0,16.0,4.0,17.0,9.0,12.0,14.0,15.0,16.0,15.0,20.0,16.0,19.0,3.0,18.0,0.0,0.0,0.0,0.0,173.0,0.0,3.0,1.0,2.0,3.0,1.0,3.0,3.0,2.0,1.0,1.0,1.0,5.0,5.0,12.0,10.0,14.0,7.0,7.0,10.0,2.0,6.0,12.0,5.0,8.0,14.0,11.0,6.0,8.0,10.0,7.0,13.0,11.0,7.0,13.0,6.0,7.0,5.0,8.0,11.0,13.0,14.0,7.0,8.0,5.0,13.0,14.0,20.0,9.0,5.0,9.0,6.0,9.0,5.0,9.0,13.0,11.0,8.0,12.0,13.0,1.0,5.0,3.0,23.0,28.0,2.0,15.0,3.0,191.0,83.0,1.0,2.0,2.0,1.0,3.0,1.0,3.0,1.0,1.0,1.0,4.0,5.0,9.0,11.0,6.0,13.0,8.0,15.0,9.0,10.0,17.0,14.0,10.0,17.0,14.0,11.0,15.0,13.0,14.0,18.0,11.0,14.0,12.0,11.0,9.0,8.0,17.0,14.0,14.0,15.0,13.0,11.0,17.0,8.0,16.0,16.0,20.0,14.0,14.0,17.0,6.0,15.0,14.0,14.0,12.0,16.0,13.0,17.0,14.0,17.0,16.0,8.0,27.0,0.0,0.0,0.0,0.0,184.0,81.0,1.0,1.0,1.0,3.0,3.0,2.0,2.0,2.0,1.0,2.0,3.0,8.0,6.0,8.0,12.0,10.0,8.0,12.0,9.0,1.0,3.0,8.0,14.0,4.0,9.0,4.0,11.0,12.0,11.0,8.0,8.0,11.0,10.0,9.0,8.0,11.0,9.0,8.0,11.0,10.0,8.0,13.0,13.0,9.0,13.0,9.0,20.0,12.0,13.0,13.0,9.0,2.0,9.0,9.0,15.0,10.0,12.0,10.0,11.0,6.0,4.0,6.0,24.0,5.0,0.0,10.0,1.0,173.0,73.0,2.0,1.0,3.0,2.0,1.0,2.0,2.0,3.0,3.0,1.0,1.0,11.0,14.0,12.0,8.0,13.0,8.0,10.0,9.0,13.0,14.0,13.0,9.0,15.0,12.0,17.0,14.0,18.0,13.0,16.0,12.0,13.0,16.0,12.0,13.0,17.0,13.0,17.0,19.0,16.0,14.0,17.0,8.0,10.0,16.0,14.0,20.0,18.0,12.0,16.0,12.0,11.0,5.0,13.0,15.0,15.0,17.0,14.0,19.0,8.0,9.0,5.0,26.0,71.0,11.0,10.0,2.0,182.0,78.0,1.0,2.0,3.0,3.0,2.0,3.0,2.0,4.0,3.0,2.0,2.0,18.0,18.0,14.0,13.0,18.0,14.0,7.0,17.0,8.0,8.0,20.0,13.0,9.0,16.0,10.0,17.0,10.0,18.0,14.0,18.0,19.0,9.0,11.0,12.0,14.0,12.0,18.0,13.0,12.0,9.0,12.0,10.0,15.0,12.0,13.0,20.0,16.0,14.0,13.0,10.0,14.0,7.0,13.0,8.0,14.0,8.0,14.0,17.0,18.0,17.0,7.0,24.0,14.0,1.0,18.0,9.0,175.0,74.0,3.0,1.0,1.0,1.0,2.0,2.0,3.0,3.0,2.0,3.0,1.0,15.0,15.0,18.0,13.0,18.0,14.0,9.0,15.0,8.0,5.0,17.0,15.0,8.0,18.0,10.0,15.0,8.0,15.0,13.0,18.0,15.0,16.0,18.0,13.0,13.0,8.0,10.0,10.0,14.0,14.0,17.0,8.0,14.0,10.0,12.0,20.0,13.0,10.0,12.0,10.0,15.0,3.0,15.0,15.0,16.0,8.0,17.0,12.0,13.0,11.0,9.0,30.0,93.0,11.0,15.0,2.0,173.0,65.0,3.0,2.0,2.0,3.0,3.0,3.0,4.0,1.0,1.0,1.0,1.0,16.0,16.0,17.0,9.0,19.0,13.0,8.0,12.0,7.0,8.0,19.0,14.0,11.0,18.0,12.0,17.0,13.0,15.0,16.0,18.0,18.0,16.0,13.0,13.0,12.0,12.0,16.0,17.0,14.0,17.0,13.0,7.0,13.0,13.0,13.0,20.0,17.0,8.0,15.0,12.0,14.0,11.0,16.0,10.0,15.0,13.0,17.0,16.0,16.0,17.0,5.0,25.0,2.0,0.0,0.0,0.0,173.0,70.0,1.0,1.0,3.0,1.0,2.0,4.0,1.0,2.0,3.0,2.0,4.0,14.0,14.0,14.0,11.0,14.0,11.0,10.0,11.0,8.0,8.0,13.0,12.0,12.0,14.0,15.0,13.0,13.0,11.0,13.0,12.0,13.0,14.0,14.0,11.0,15.0,10.0,13.0,16.0,16.0,15.0,15.0,7.0,12.0,14.0,14.0,20.0,15.0,9.0,14.0,8.0,12.0,6.0,15.0,16.0,10.0,14.0,13.0,15.0,14.0,16.0,4.0,28.0,81.0,27.0,5.0,0.0,184.0,84.0,1.0,3.0,2.0,3.0,3.0,3.0,1.0,1.0,2.0,3.0,3.0,10.0,11.0,17.0,16.0,19.0,12.0,13.0,13.0,7.0,7.0,15.0,14.0,9.0,18.0,8.0,14.0,7.0,18.0,12.0,18.0,17.0,8.0,17.0,10.0,17.0,8.0,15.0,11.0,14.0,14.0,16.0,11.0,17.0,11.0,14.0,20.0,13.0,14.0,9.0,4.0,11.0,8.0,8.0,8.0,11.0,12.0,15.0,9.0,17.0,18.0,20.0,31.0,133.0,61.0,10.0,3.0,186.0,84.0,2.0,1.0,3.0,1.0,3.0,2.0,2.0,3.0,1.0,3.0,2.0,12.0,14.0,15.0,19.0,16.0,14.0,18.0,19.0,6.0,2.0,14.0,19.0,8.0,15.0,6.0,17.0,16.0,13.0,16.0,13.0,17.0,20.0,18.0,15.0,18.0,5.0,6.0,7.0,13.0,12.0,13.0,16.0,15.0,19.0,17.0,20.0,17.0,16.0,17.0,12.0,14.0,7.0,10.0,18.0,20.0,13.0,19.0,20.0,7.0,7.0,12.0,29.0,0.0,0.0,0.0,0.0,184.0,86.0,13.0,13.0,12.0,6.0,14.0,12.0,14.0,17.0,11.0,9.0,13.0,7.0,1.0,2.0,2.0,8.0,9.0,6.0,1.0,2.0,2.0,10.0,3.0,2.0,9.0,10.0,12.0,13.0,11.0,13.0,6.0,13.0,8.0,6.0,11.0,2.0,15.0,11.0,13.0,10.0,14.0,13.0,11.0,11.0,13.0,12.0,20.0,14.0,15.0,16.0,7.0,12.0,7.0,12.0,9.0,10.0,13.0,11.0,8.0,12.0,11.0,3.0,21.0,1.0,0.0,4.0,0.0,189.0,84.0,1.0,2.0,2.0,3.0,2.0,3.0,2.0,3.0,1.0,3.0,2.0,5.0,5.0,10.0,6.0,11.0,11.0,15.0,10.0,12.0,14.0,11.0,11.0,14.0,11.0,10.0,13.0,12.0,11.0,12.0,10.0,11.0,12.0,12.0,12.0,10.0,12.0,14.0,12.0,14.0,13.0,14.0,15.0,20.0,15.0,13.0,6.0,14.0,15.0,11.0,5.0,15.0,5.0,6.0,6.0,8.0,10.0,12.0,10.0,12.0,10.0,12.0,29.0,0.0,0.0,0.0,0.0,188.0,84.0,3.0,1.0,2.0,3.0,1.0,4.0,2.0,1.0,1.0,1.0,1.0,5.0,5.0,10.0,8.0,11.0,13.0,14.0,8.0,10.0,15.0,12.0,16.0,15.0,14.0,12.0,13.0,13.0,13.0,14.0,12.0,13.0,16.0,10.0,14.0,11.0,13.0,15.0,13.0,13.0,12.0,10.0,15.0,8.0,13.0,14.0,20.0,14.0,15.0,16.0,9.0,13.0,5.0,10.0,12.0,13.0,11.0,11.0,13.0,13.0,10.0,3.0,20.0,0.0,0.0,0.0,0.0,174.0,60.0,3.0,2.0,3.0,1.0,2.0,1.0,3.0,1.0,2.0,1.0,3.0,9.0,12.0,14.0,9.0,12.0,7.0,6.0,7.0,5.0,7.0,7.0,6.0,8.0,10.0,9.0,9.0,2.0,7.0,7.0,6.0,7.0,4.0,9.0,4.0,9.0,6.0,8.0,9.0,13.0,14.0,9.0,6.0,10.0,13.0,14.0,20.0,10.0,6.0,8.0,9.0,9.0,7.0,9.0,11.0,9.0,11.0,14.0,11.0,10.0,17.0,1.0,23.0,0.0,0.0,22.0,1.0,184.0,78.0,3.0,3.0,2.0,3.0,3.0,2.0,1.0,1.0,1.0,2.0,3.0,11.0,13.0,11.0,8.0,11.0,9.0,11.0,9.0,13.0,11.0,12.0,4.0,13.0,11.0,12.0,11.0,13.0,12.0,12.0,9.0,10.0,13.0,8.0,13.0,11.0,13.0,14.0,15.0,14.0,11.0,14.0,11.0,20.0,13.0,15.0,8.0,16.0,13.0,13.0,9.0,14.0,8.0,12.0,10.0,13.0,14.0,11.0,15.0,14.0,14.0,5.0,26.0,25.0,1.0,7.0,0.0,189.0,78.0,1.0,1.0,1.0,1.0,1.0,1.0,1.0,1.0,1.0,1.0,1.0,8.0,9.0,10.0,6.0,12.0,8.0,13.0,14.0,7.0,11.0,14.0,11.0,13.0,13.0,13.0,13.0,16.0,13.0,13.0,12.0,13.0,14.0,10.0,10.0,12.0,13.0,15.0,15.0,12.0,11.0,9.0,15.0,10.0,14.0,13.0,20.0,14.0,14.0,12.0,13.0,11.0,14.0,12.0,14.0,11.0,14.0,12.0,16.0,15.0,13.0,5.0,30.0,0.0,0.0,0.0,0.0,174.0,71.0,2.0,2.0,2.0,2.0,1.0,1.0,1.0,3.0,3.0,4.0,3.0,11.0,13.0,12.0,10.0,14.0,12.0,8.0,15.0,9.0,7.0,15.0,9.0,9.0,14.0,10.0,14.0,10.0,14.0,14.0,15.0,15.0,8.0,12.0,9.0,13.0,12.0,15.0,14.0,11.0,13.0,11.0,7.0,20.0,10.0,13.0,8.0,13.0,9.0,11.0,9.0,10.0,11.0,13.0,9.0,10.0,11.0,12.0,9.0,11.0,20.0,7.0,30.0,0.0,0.0,0.0,0.0,178.0,73.0,3.0,3.0,4.0,2.0,3.0,3.0,3.0,1.0,1.0,2.0,2.0,6.0,10.0,13.0,11.0,9.0,7.0,8.0,10.0,5.0,6.0,10.0,7.0,5.0,13.0,11.0,10.0,8.0,12.0,8.0,7.0,7.0,10.0,14.0,7.0,13.0,5.0,10.0,14.0,15.0,15.0,13.0,9.0,9.0,14.0,16.0,20.0,14.0,13.0,14.0,11.0,10.0,5.0,12.0,18.0,12.0,9.0,12.0,7.0,10.0,7.0,14.0,25.0,0.0,0.0,0.0,0.0,182.0,74.0,3.0,1.0,1.0,3.0,3.0,2.0,1.0,3.0,1.0,1.0,3.0,13.0,12.0,14.0,12.0,14.0,13.0,9.0,13.0,6.0,4.0,12.0,13.0,11.0,17.0,8.0,15.0,7.0,13.0,11.0,15.0,10.0,12.0,18.0,8.0,13.0,7.0,7.0,13.0,13.0,14.0,15.0,10.0,20.0,15.0,13.0,9.0,12.0,9.0,11.0,6.0,14.0,7.0,12.0,8.0,16.0,12.0,12.0,15.0,12.0,14.0,14.0,20.0,0.0,0.0,4.0,2.0,186.0,86.0,2.0,1.0,3.0,1.0,2.0,3.0,1.0,3.0,3.0,2.0,3.0,8.0,11.0,14.0,13.0,11.0,9.0,8.0,12.0,4.0,6.0,10.0,11.0,7.0,14.0,8.0,12.0,11.0,11.0,9.0,9.0,10.0,8.0,16.0,7.0,13.0,4.0,10.0,12.0,14.0,12.0,13.0,11.0,10.0,15.0,16.0,20.0,13.0,15.0,11.0,7.0,11.0,6.0,14.0,13.0,14.0,12.0,7.0,7.0,10.0,7.0,14.0,29.0,25.0,7.0,0.0,0.0,180.0,70.0,2.0,3.0,1.0,2.0,3.0,2.0,3.0,2.0,1.0,2.0,2.0,6.0,10.0,16.0,15.0,15.0,7.0,14.0,10.0,5.0,3.0,12.0,17.0,2.0,16.0,9.0,13.0,11.0,12.0,11.0,11.0,12.0,15.0,14.0,11.0,14.0,8.0,9.0,10.0,15.0,14.0,13.0,12.0,12.0,14.0,12.0,20.0,14.0,14.0,13.0,9.0,15.0,6.0,7.0,12.0,15.0,13.0,14.0,12.0,12.0,12.0,12.0
2,1,29.0,0.0,0.0,0.0,0.0,189.0,79.0,14.0,15.0,14.0,5.0,14.0,14.0,11.0,13.0,10.0,7.0,12.0,6.0,2.0,3.0,2.0,8.0,11.0,7.0,2.0,3.0,1.0,8.0,2.0,1.0,7.0,10.0,12.0,14.0,11.0,11.0,6.0,14.0,13.0,3.0,12.0,3.0,11.0,12.0,5.0,8.0,11.0,12.0,13.0,5.0,8.0,7.0,20.0,8.0,13.0,11.0,9.0,8.0,7.0,11.0,13.0,14.0,15.0,14.0,12.0,12.0,8.0,3.0,33.0,0.0,0.0,0.0,0.0,192.0,81.0,1.0,1.0,2.0,3.0,1.0,2.0,2.0,3.0,1.0,1.0,3.0,4.0,5.0,5.0,2.0,10.0,4.0,17.0,5.0,7.0,15.0,12.0,5.0,14.0,8.0,15.0,14.0,17.0,11.0,16.0,6.0,13.0,13.0,5.0,15.0,5.0,14.0,15.0,14.0,8.0,8.0,9.0,17.0,8.0,13.0,9.0,20.0,14.0,15.0,14.0,10.0,13.0,8.0,6.0,7.0,14.0,16.0,13.0,15.0,15.0,12.0,6.0,22.0,1.0,0.0,7.0,0.0,186.0,75.0,1.0,4.0,3.0,2.0,1.0,2.0,3.0,4.0,3.0,4.0,3.0,8.0,10.0,9.0,6.0,14.0,6.0,14.0,6.0,13.0,15.0,13.0,9.0,16.0,14.0,15.0,14.0,18.0,11.0,15.0,9.0,15.0,8.0,6.0,11.0,7.0,16.0,15.0,16.0,12.0,10.0,8.0,13.0,10.0,12.0,12.0,20.0,14.0,13.0,11.0,12.0,10.0,9.0,15.0,9.0,12.0,12.0,9.0,12.0,13.0,17.0,5.0,35.0,103.0,2.0,16.0,0.0,178.0,72.0,3.0,3.0,3.0,1.0,2.0,1.0,2.0,2.0,1.0,3.0,2.0,16.0,15.0,12.0,10.0,14.0,16.0,10.0,13.0,13.0,12.0,13.0,9.0,14.0,15.0,11.0,12.0,12.0,12.0,12.0,12.0,13.0,13.0,8.0,16.0,14.0,10.0,14.0,15.0,13.0,12.0,10.0,9.0,20.0,16.0,12.0,8.0,13.0,10.0,14.0,4.0,15.0,6.0,10.0,19.0,14.0,16.0,16.0,14.0,15.0,16.0,3.0,28.0,0.0,0.0,0.0,0.0,182.0,0.0,3.0,2.0,2.0,2.0,2.0,3.0,1.0,2.0,1.0,1.0,1.0,6.0,5.0,10.0,4.0,13.0,4.0,6.0,9.0,1.0,6.0,12.0,5.0,4.0,13.0,9.0,7.0,4.0,10.0,7.0,11.0,9.0,5.0,13.0,4.0,9.0,6.0,7.0,12.0,13.0,11.0,7.0,5.0,7.0,11.0,10.0,20.0,13.0,9.0,9.0,9.0,9.0,8.0,9.0,7.0,12.0,9.0,14.0,12.0,11.0,15.0,4.0,35.0,0.0,0.0,0.0,0.0,177.0,70.0,1.0,4.0,4.0,3.0,1.0,2.0,3.0,2.0,3.0,3.0,1.0,15.0,14.0,12.0,12.0,17.0,17.0,10.0,14.0,7.0,3.0,18.0,16.0,4.0,17.0,10.0,13.0,8.0,14.0,13.0,18.0,17.0,12.0,17.0,15.0,11.0,8.0,12.0,9.0,9.0,8.0,10.0,7.0,16.0,11.0,9.0,20.0,12.0,9.0,13.0,6.0,12.0,12.0,11.0,12.0,15.0,9.0,12.0,13.0,11.0,12.0,10.0,27.0,0.0,0.0,1.0,0.0,180.0,73.0,4.0,1.0,1.0,3.0,2.0,1.0,3.0,3.0,3.0,2.0,2.0,9.0,9.0,11.0,8.0,12.0,10.0,10.0,11.0,6.0,12.0,13.0,11.0,12.0,12.0,9.0,13.0,14.0,14.0,15.0,13.0,14.0,11.0,10.0,13.0,12.0,14.0,15.0,15.0,13.0,12.0,10.0,10.0,12.0,10.0,11.0,20.0,13.0,12.0,13.0,8.0,11.0,13.0,12.0,12.0,10.0,11.0,13.0,13.0,12.0,9.0,13.0,29.0,4.0,3.0,0.0,0.0,185.0,81.0,1.0,4.0,2.0,3.0,3.0,1.0,2.0,1.0,2.0,3.0,3.0,10.0,14.0,15.0,13.0,15.0,16.0,13.0,14.0,8.0,9.0,15.0,14.0,10.0,15.0,16.0,15.0,16.0,14.0,17.0,14.0,14.0,14.0,14.0,11.0,14.0,11.0,16.0,15.0,10.0,13.0,10.0,14.0,20.0,11.0,14.0,10.0,14.0,14.0,8.0,14.0,11.0,13.0,15.0,12.0,15.0,10.0,9.0,14.0,13.0,8.0,8.0,25.0,0.0,0.0,6.0,1.0,190.0,78.0,3.0,3.0,3.0,3.0,1.0,2.0,3.0,3.0,3.0,2.0,3.0,10.0,10.0,13.0,11.0,12.0,13.0,11.0,16.0,8.0,4.0,12.0,13.0,8.0,14.0,10.0,8.0,8.0,7.0,7.0,8.0,9.0,14.0,17.0,5.0,13.0,7.0,9.0,13.0,17.0,13.0,12.0,15.0,12.0,17.0,16.0,20.0,16.0,17.0,10.0,7.0,9.0,7.0,12.0,6.0,17.0,10.0,12.0,10.0,12.0,12.0,10.0,25.0,0.0,0.0,0.0,0.0,180.0,67.0,3.0,3.0,2.0,4.0,2.0,2.0,2.0,3.0,1.0,3.0,2.0,12.0,13.0,12.0,13.0,13.0,11.0,7.0,12.0,5.0,7.0,14.0,12.0,9.0,14.0,9.0,14.0,9.0,14.0,14.0,14.0,13.0,14.0,14.0,11.0,14.0,10.0,12.0,10.0,13.0,15.0,11.0,8.0,14.0,14.0,12.0,20.0,13.0,10.0,10.0,5.0,12.0,10.0,10.0,15.0,13.0,13.0,12.0,12.0,14.0,16.0,9.0,34.0,0.0,0.0,0.0,0.0,179.0,77.0,1.0,4.0,3.0,1.0,4.0,1.0,1.0,3.0,2.0,1.0,1.0,7.0,11.0,13.0,15.0,15.0,8.0,13.0,12.0,5.0,4.0,13.0,13.0,7.0,14.0,8.0,13.0,14.0,14.0,13.0,13.0,13.0,13.0,16.0,9.0,14.0,7.0,14.0,13.0,12.0,13.0,14.0,12.0,12.0,12.0,12.0,20.0,13.0,13.0,13.0,5.0,12.0,8.0,5.0,3.0,13.0,12.0,12.0,13.0,12.0,11.0,9.0,28.0,0.0,0.0,0.0,0.0,177.0,70.0,2.0,1.0,1.0,2.0,1.0,1.0,1.0,1.0,2.0,1.0,1.0,8.0,8.0,8.0,10.0,14.0,8.0,8.0,13.0,6.0,11.0,14.0,7.0,14.0,14.0,3.0,10.0,9.0,9.0,8.0,7.0,9.0,6.0,5.0,10.0,10.0,10.0,10.0,12.0,14.0,14.0,10.0,6.0,8.0,13.0,14.0,20.0,8.0,6.0,10.0,10.0,10.0,10.0,10.0,18.0,12.0,11.0,9.0,11.0,11.0,8.0,8.0,26.0,0.0,0.0,0.0,0.0,187.0,76.0,2.0,3.0,2.0,2.0,3.0,1.0,3.0,4.0,2.0,3.0,1.0,5.0,3.0,4.0,6.0,8.0,7.0,12.0,4.0,1.0,10.0,9.0,5.0,13.0,4.0,6.0,14.0,9.0,8.0,11.0,6.0,10.0,2.0,5.0,7.0,5.0,12.0,8.0,9.0,14.0,11.0,9.0,14.0,20.0,9.0,10.0,10.0,14.0,13.0,10.0,10.0,10.0,4.0,10.0,17.0,9.0,8.0,11.0,11.0,6.0,10.0,3.0,19.0,0.0,0.0,1.0,0.0,182.0,77.0,2.0,4.0,2.0,3.0,1.0,1.0,3.0,1.0,1.0,2.0,3.0,6.0,7.0,11.0,7.0,12.0,7.0,13.0,7.0,8.0,15.0,14.0,6.0,14.0,14.0,8.0,14.0,13.0,14.0,13.0,12.0,12.0,12.0,12.0,14.0,11.0,14.0,15.0,16.0,12.0,14.0,9.0,9.0,11.0,16.0,13.0,20.0,17.0,16.0,15.0,12.0,14.0,5.0,4.0,19.0,10.0,10.0,11.0,12.0,11.0,14.0,3.0,16.0,0.0,0.0,0.0,0.0,189.0,0.0,3.0,3.0,3.0,1.0,1.0,3.0,1.0,3.0,1.0,1.0,2.0,5.0,7.0,5.0,4.0,6.0,6.0,1.0,1.0,4.0,2.0,5.0,3.0,5.0,10.0,10.0,4.0,5.0,6.0,3.0,7.0,7.0,5.0,11.0,3.0,4.0,3.0,7.0,7.0,11.0,7.0,4.0,12.0,20.0,9.0,9.0,9.0,9.0,6.0,5.0,11.0,4.0,10.0,12.0,10.0,11.0,12.0,12.0,9.0,7.0,7.0,10.0,28.0,0.0,0.0,19.0,0.0,180.0,73.0,1.0,1.0,3.0,3.0,1.0,3.0,4.0,3.0,1.0,3.0,1.0,12.0,13.0,11.0,10.0,11.0,9.0,9.0,9.0,13.0,11.0,15.0,12.0,13.0,13.0,6.0,9.0,9.0,10.0,11.0,11.0,12.0,12.0,11.0,14.0,13.0,11.0,17.0,15.0,12.0,11.0,11.0,9.0,20.0,12.0,12.0,10.0,13.0,11.0,12.0,4.0,14.0,12.0,12.0,9.0,10.0,16.0,9.0,12.0,13.0,11.0,6.0,23.0,0.0,0.0,0.0,0.0,190.0,76.0,2.0,1.0,2.0,1.0,2.0,3.0,2.0,4.0,2.0,4.0,3.0,6.0,10.0,12.0,9.0,12.0,9.0,10.0,11.0,5.0,12.0,14.0,12.0,11.0,13.0,12.0,12.0,12.0,13.0,12.0,14.0,11.0,12.0,14.0,9.0,14.0,13.0,15.0,14.0,12.0,11.0,11.0,9.0,11.0,15.0,11.0,20.0,14.0,12.0,13.0,9.0,14.0,7.0,5.0,11.0,11.0,15.0,12.0,11.0,9.0,19.0,8.0,23.0,0.0,0.0,0.0,0.0,181.0,74.0,2.0,3.0,2.0,3.0,3.0,1.0,1.0,3.0,3.0,3.0,4.0,13.0,13.0,11.0,10.0,15.0,11.0,6.0,12.0,6.0,10.0,14.0,14.0,11.0,16.0,14.0,16.0,15.0,16.0,12.0,13.0,14.0,15.0,11.0,8.0,12.0,13.0,16.0,15.0,11.0,13.0,15.0,9.0,9.0,14.0,11.0,20.0,17.0,12.0,10.0,13.0,12.0,8.0,10.0,12.0,14.0,12.0,14.0,15.0,9.0,11.0,4.0,27.0,0.0,0.0,0.0,0.0,171.0,63.0,2.0,1.0,1.0,3.0,1.0,2.0,4.0,2.0,2.0,2.0,3.0,8.0,4.0,6.0,6.0,13.0,8.0,8.0,6.0,1.0,14.0,13.0,5.0,8.0,14.0,6.0,10.0,9.0,8.0,9.0,14.0,12.0,10.0,10.0,11.0,12.0,11.0,9.0,13.0,14.0,14.0,9.0,5.0,5.0,10.0,14.0,20.0,9.0,6.0,10.0,7.0,10.0,10.0,10.0,13.0,13.0,9.0,9.0,12.0,11.0,14.0,2.0,20.0,9.0,0.0,6.0,0.0,170.0,61.0,3.0,3.0,4.0,1.0,3.0,2.0,3.0,2.0,3.0,3.0,2.0,14.0,12.0,18.0,12.0,17.0,11.0,5.0,14.0,6.0,5.0,13.0,11.0,7.0,17.0,9.0,11.0,7.0,13.0,9.0,15.0,10.0,11.0,18.0,6.0,12.0,7.0,8.0,9.0,15.0,17.0,10.0,6.0,20.0,12.0,12.0,10.0,11.0,7.0,11.0,10.0,11.0,6.0,12.0,10.0,18.0,7.0,13.0,10.0,8.0,10.0,14.0,20.0,5.0,0.0,5.0,0.0,181.0,74.0,3.0,1.0,2.0,1.0,1.0,3.0,3.0,2.0,3.0,1.0,1.0,7.0,9.0,15.0,15.0,17.0,7.0,12.0,11.0,5.0,5.0,9.0,7.0,6.0,16.0,13.0,12.0,14.0,12.0,10.0,13.0,10.0,12.0,11.0,9.0,13.0,12.0,11.0,10.0,14.0,15.0,13.0,9.0,12.0,12.0,12.0,20.0,13.0,12.0,9.0,9.0,8.0,13.0,9.0,11.0,13.0,12.0,11.0,12.0,6.0,17.0,4.0,25.0,0.0,0.0,0.0,0.0,181.0,77.0,3.0,1.0,1.0,2.0,1.0,2.0,1.0,3.0,3.0,3.0,2.0,9.0,10.0,11.0,12.0,11.0,14.0,13.0,10.0,6.0,9.0,11.0,15.0,9.0,11.0,15.0,11.0,15.0,12.0,12.0,12.0,12.0,9.0,12.0,12.0,13.0,10.0,14.0,15.0,12.0,12.0,11.0,12.0,12.0,15.0,12.0,20.0,14.0,16.0,12.0,9.0,17.0,12.0,11.0,16.0,10.0,11.0,11.0,13.0,13.0,17.0,6.0
1,1,32.0,0.0,0.0,10.0,0.0,185.0,76.0,13.0,12.0,11.0,6.0,14.0,13.0,14.0,14.0,12.0,12.0,11.0,6.0,2.0,2.0,1.0,7.0,9.0,3.0,3.0,2.0,3.0,8.0,4.0,3.0,7.0,13.0,13.0,16.0,15.0,14.0,3.0,14.0,13.0,7.0,14.0,5.0,13.0,10.0,10.0,11.0,13.0,14.0,13.0,9.0,14.0,12.0,20.0,14.0,11.0,14.0,7.0,14.0,6.0,12.0,14.0,14.0,10.0,14.0,14.0,13.0,8.0,12.0,26.0,0.0,0.0,0.0,0.0,180.0,76.0,2.0,2.0,1.0,1.0,2.0,2.0,3.0,3.0,3.0,2.0,2.0,4.0,7.0,4.0,3.0,10.0,6.0,16.0,11.0,10.0,15.0,9.0,8.0,14.0,8.0,12.0,15.0,13.0,12.0,13.0,9.0,11.0,13.0,5.0,11.0,6.0,14.0,15.0,15.0,13.0,11.0,12.0,13.0,9.0,15.0,14.0,20.0,13.0,14.0,14.0,11.0,11.0,11.0,9.0,13.0,12.0,15.0,13.0,11.0,13.0,10.0,7.0,24.0,0.0,0.0,21.0,1.0,184.0,77.0,1.0,3.0,3.0,1.0,1.0,2.0,1.0,2.0,1.0,3.0,2.0,12.0,14.0,11.0,4.0,12.0,8.0,14.0,8.0,8.0,14.0,12.0,11.0,14.0,12.0,9.0,14.0,13.0,12.0,13.0,12.0,11.0,10.0,9.0,10.0,12.0,13.0,11.0,13.0,12.0,12.0,10.0,13.0,10.0,9.0,15.0,20.0,13.0,14.0,15.0,7.0,12.0,11.0,9.0,10.0,10.0,11.0,10.0,10.0,10.0,10.0,9.0,22.0,0.0,0.0,0.0,0.0,175.0,65.0,1.0,2.0,3.0,1.0,3.0,2.0,2.0,2.0,2.0,1.0,1.0,11.0,14.0,12.0,8.0,11.0,7.0,7.0,8.0,13.0,11.0,11.0,8.0,13.0,13.0,10.0,14.0,11.0,12.0,14.0,11.0,13.0,9.0,8.0,7.0,14.0,12.0,13.0,13.0,14.0,13.0,13.0,8.0,20.0,12.0,14.0,8.0,13.0,10.0,14.0,8.0,11.0,5.0,11.0,19.0,11.0,11.0,10.0,13.0,9.0,13.0,7.0,24.0,0.0,0.0,0.0,0.0,176.0,68.0,3.0,1.0,1.0,1.0,3.0,3.0,1.0,1.0,2.0,1.0,2.0,10.0,13.0,13.0,10.0,11.0,8.0,8.0,9.0,11.0,11.0,12.0,11.0,11.0,12.0,11.0,14.0,12.0,13.0,13.0,9.0,13.0,12.0,13.0,11.0,14.0,12.0,15.0,12.0,15.0,13.0,10.0,8.0,10.0,13.0,14.0,20.0,14.0,13.0,13.0,8.0,15.0,7.0,14.0,9.0,13.0,11.0,13.0,13.0,12.0,11.0,8.0,17.0,0.0,0.0,0.0,0.0,170.0,0.0,3.0,4.0,2.0,2.0,1.0,1.0,1.0,1.0,4.0,1.0,2.0,6.0,7.0,6.0,8.0,14.0,6.0,6.0,6.0,1.0,5.0,5.0,1.0,6.0,9.0,8.0,8.0,3.0,4.0,6.0,9.0,7.0,8.0,8.0,10.0,8.0,5.0,8.0,12.0,14.0,14.0,6.0,7.0,8.0,9.0,10.0,20.0,8.0,4.0,1.0,7.0,5.0,8.0,8.0,8.0,12.0,10.0,10.0,11.0,12.0,17.0,5.0,28.0,19.0,2.0,2.0,0.0,169.0,59.0,1.0,1.0,3.0,1.0,3.0,3.0,1.0,3.0,3.0,1.0,3.0,13.0,12.0,16.0,10.0,15.0,12.0,10.0,10.0,5.0,5.0,14.0,8.0,7.0,16.0,14.0,11.0,6.0,11.0,9.0,14.0,10.0,9.0,18.0,4.0,13.0,6.0,11.0,14.0,17.0,17.0,7.0,6.0,8.0,15.0,14.0,20.0,13.0,5.0,8.0,4.0,8.0,3.0,14.0,10.0,12.0,10.0,8.0,17.0,15.0,18.0,2.0,28.0,2.0,1.0,19.0,9.0,183.0,73.0,3.0,1.0,4.0,3.0,2.0,2.0,3.0,1.0,3.0,3.0,2.0,10.0,11.0,15.0,13.0,16.0,7.0,11.0,10.0,5.0,5.0,14.0,14.0,5.0,15.0,7.0,11.0,8.0,15.0,11.0,13.0,13.0,14.0,15.0,7.0,15.0,7.0,9.0,7.0,12.0,14.0,13.0,11.0,14.0,8.0,13.0,20.0,12.0,11.0,10.0,6.0,14.0,13.0,7.0,11.0,13.0,9.0,9.0,13.0,11.0,12.0,9.0,30.0,0.0,0.0,0.0,0.0,178.0,78.0,2.0,2.0,2.0,2.0,3.0,1.0,1.0,1.0,1.0,3.0,2.0,13.0,15.0,14.0,13.0,10.0,11.0,11.0,15.0,5.0,5.0,15.0,13.0,5.0,14.0,10.0,12.0,11.0,13.0,11.0,12.0,13.0,12.0,14.0,9.0,14.0,8.0,8.0,8.0,15.0,11.0,13.0,9.0,20.0,12.0,13.0,10.0,12.0,13.0,10.0,10.0,12.0,5.0,12.0,8.0,15.0,5.0,11.0,8.0,12.0,8.0,15.0,23.0,0.0,0.0,0.0,0.0,191.0,79.0,2.0,2.0,1.0,1.0,3.0,1.0,1.0,3.0,2.0,1.0,3.0,7.0,10.0,13.0,16.0,14.0,8.0,13.0,11.0,9.0,6.0,11.0,12.0,7.0,13.0,12.0,16.0,11.0,15.0,13.0,11.0,15.0,13.0,11.0,11.0,16.0,9.0,12.0,15.0,10.0,13.0,11.0,15.0,13.0,14.0,13.0,20.0,12.0,13.0,13.0,8.0,9.0,8.0,5.0,2.0,12.0,14.0,12.0,13.0,13.0,13.0,6.0,26.0,0.0,0.0,0.0,0.0,181.0,77.0,2.0,2.0,3.0,3.0,1.0,1.0,3.0,1.0,3.0,3.0,1.0,6.0,9.0,13.0,14.0,13.0,9.0,13.0,12.0,8.0,4.0,12.0,12.0,6.0,13.0,7.0,12.0,9.0,13.0,13.0,9.0,13.0,8.0,10.0,11.0,16.0,12.0,11.0,14.0,14.0,13.0,14.0,12.0,8.0,14.0,15.0,20.0,15.0,12.0,13.0,5.0,12.0,11.0,11.0,15.0,10.0,8.0,7.0,11.0,10.0,20.0,7.0,18.0,0.0,0.0,0.0,0.0,180.0,0.0,3.0,2.0,1.0,3.0,2.0,2.0,3.0,2.0,4.0,2.0,1.0,8.0,7.0,6.0,9.0,7.0,6.0,8.0,12.0,4.0,12.0,11.0,1.0,11.0,11.0,9.0,9.0,8.0,10.0,9.0,11.0,15.0,9.0,6.0,1.0,8.0,10.0,9.0,8.0,11.0,12.0,5.0,7.0,8.0,10.0,10.0,20.0,6.0,11.0,9.0,9.0,4.0,6.0,9.0,8.0,12.0,12.0,12.0,11.0,4.0,10.0,3.0,30.0,0.0,0.0,6.0,0.0,183.0,81.0,1.0,3.0,1.0,1.0,1.0,2.0,1.0,2.0,2.0,2.0,1.0,5.0,7.0,7.0,5.0,9.0,7.0,15.0,6.0,9.0,17.0,11.0,8.0,16.0,8.0,17.0,15.0,18.0,12.0,13.0,9.0,15.0,15.0,6.0,16.0,6.0,17.0,16.0,16.0,12.0,11.0,9.0,13.0,8.0,16.0,14.0,20.0,13.0,16.0,14.0,17.0,15.0,6.0,12.0,14.0,15.0,13.0,14.0,13.0,7.0,9.0,11.0,23.0,0.0,0.0,39.0,1.0,183.0,75.0,3.0,1.0,4.0,1.0,2.0,2.0,1.0,2.0,3.0,4.0,2.0,6.0,9.0,10.0,8.0,12.0,7.0,14.0,9.0,12.0,14.0,16.0,9.0,15.0,14.0,10.0,14.0,13.0,14.0,12.0,14.0,14.0,12.0,7.0,14.0,8.0,17.0,16.0,14.0,12.0,9.0,9.0,13.0,8.0,13.0,15.0,20.0,13.0,14.0,15.0,9.0,12.0,10.0,6.0,9.0,13.0,10.0,13.0,13.0,10.0,15.0,3.0,17.0,0.0,0.0,0.0,0.0,173.0,0.0,1.0,4.0,2.0,1.0,1.0,4.0,1.0,4.0,2.0,1.0,3.0,4.0,2.0,13.0,13.0,13.0,6.0,13.0,7.0,1.0,4.0,7.0,3.0,1.0,13.0,9.0,10.0,7.0,6.0,3.0,2.0,13.0,3.0,13.0,11.0,11.0,2.0,6.0,7.0,13.0,13.0,7.0,7.0,4.0,9.0,13.0,20.0,7.0,8.0,9.0,9.0,9.0,9.0,9.0,8.0,14.0,9.0,12.0,12.0,6.0,19.0,2.0,25.0,0.0,0.0,44.0,0.0,173.0,76.0,3.0,1.0,2.0,1.0,3.0,4.0,3.0,3.0,3.0,2.0,3.0,9.0,11.0,10.0,7.0,12.0,9.0,12.0,8.0,13.0,12.0,13.0,8.0,13.0,12.0,16.0,14.0,13.0,12.0,15.0,12.0,13.0,12.0,8.0,12.0,13.0,13.0,14.0,17.0,14.0,12.0,14.0,7.0,20.0,15.0,12.0,8.0,16.0,13.0,13.0,10.0,11.0,7.0,11.0,9.0,11.0,9.0,11.0,10.0,10.0,13.0,6.0,23.0,0.0,0.0,15.0,0.0,181.0,72.0,1.0,2.0,1.0,3.0,2.0,2.0,3.0,3.0,1.0,3.0,1.0,10.0,11.0,10.0,9.0,12.0,9.0,12.0,13.0,8.0,14.0,13.0,11.0,12.0,11.0,13.0,14.0,15.0,12.0,16.0,12.0,14.0,13.0,11.0,17.0,9.0,17.0,15.0,14.0,14.0,12.0,10.0,12.0,13.0,12.0,11.0,20.0,14.0,13.0,15.0,8.0,15.0,8.0,16.0,12.0,11.0,12.0,11.0,12.0,12.0,13.0,9.0,29.0,4.0,3.0,0.0,0.0,185.0,81.0,1.0,4.0,2.0,3.0,3.0,1.0,2.0,1.0,2.0,3.0,3.0,10.0,14.0,15.0,13.0,15.0,16.0,13.0,14.0,8.0,9.0,15.0,14.0,10.0,15.0,16.0,15.0,16.0,14.0,17.0,14.0,14.0,14.0,14.0,11.0,14.0,11.0,16.0,15.0,10.0,13.0,10.0,14.0,20.0,11.0,14.0,10.0,14.0,14.0,8.0,14.0,11.0,13.0,15.0,12.0,15.0,10.0,9.0,14.0,13.0,8.0,8.0,30.0,9.0,1.0,0.0,0.0,177.0,74.0,3.0,2.0,2.0,1.0,3.0,1.0,3.0,3.0,3.0,4.0,3.0,11.0,16.0,14.0,11.0,15.0,6.0,8.0,10.0,5.0,8.0,13.0,8.0,12.0,13.0,15.0,15.0,15.0,14.0,15.0,13.0,16.0,16.0,12.0,7.0,13.0,13.0,16.0,17.0,13.0,14.0,12.0,9.0,14.0,14.0,13.0,20.0,15.0,12.0,16.0,13.0,13.0,12.0,12.0,9.0,13.0,15.0,13.0,15.0,15.0,10.0,8.0,30.0,39.0,2.0,0.0,0.0,171.0,58.0,2.0,1.0,3.0,1.0,3.0,3.0,1.0,2.0,3.0,3.0,1.0,15.0,16.0,15.0,12.0,14.0,11.0,8.0,11.0,8.0,7.0,13.0,14.0,8.0,14.0,12.0,13.0,11.0,8.0,12.0,13.0,11.0,11.0,13.0,9.0,16.0,9.0,13.0,13.0,17.0,17.0,17.0,6.0,12.0,13.0,15.0,20.0,12.0,8.0,11.0,13.0,13.0,7.0,7.0,10.0,10.0,9.0,14.0,10.0,13.0,7.0,12.0,29.0,13.0,5.0,0.0,0.0,175.0,73.0,1.0,3.0,3.0,3.0,3.0,1.0,1.0,2.0,1.0,3.0,3.0,15.0,12.0,15.0,14.0,15.0,12.0,9.0,13.0,6.0,4.0,13.0,15.0,10.0,16.0,9.0,13.0,12.0,14.0,13.0,13.0,14.0,10.0,16.0,14.0,15.0,10.0,12.0,10.0,15.0,15.0,14.0,9.0,15.0,12.0,13.0,20.0,14.0,13.0,12.0,14.0,14.0,7.0,12.0,12.0,14.0,12.0,10.0,10.0,7.0,10.0,12.0,20.0,0.0,0.0,4.0,1.0,177.0,70.0,3.0,2.0,3.0,4.0,1.0,1.0,2.0,3.0,2.0,2.0,1.0,10.0,10.0,15.0,12.0,14.0,10.0,7.0,10.0,9.0,6.0,13.0,6.0,7.0,14.0,15.0,12.0,13.0,11.0,13.0,9.0,9.0,10.0,15.0,9.0,13.0,6.0,13.0,13.0,17.0,16.0,12.0,13.0,20.0,12.0,16.0,12.0,12.0,10.0,12.0,9.0,14.0,7.0,12.0,17.0,14.0,11.0,12.0,8.0,10.0,8.0,2.0
0,0,18.0,0.0,0.0,0.0,0.0,180.0,0.0,3.0,2.0,1.0,3.0,2.0,2.0,3.0,2.0,4.0,2.0,1.0,8.0,7.0,6.0,9.0,7.0,6.0,8.0,12.0,4.0,12.0,11.0,1.0,11.0,11.0,9.0,9.0,8.0,10.0,9.0,11.0,15.0,9.0,6.0,1.0,8.0,10.0,9.0,8.0,11.0,12.0,5.0,7.0,8.0,10.0,10.0,20.0,6.0,11.0,9.0,9.0,4.0,6.0,9.0,8.0,12.0,12.0,12.0,11.0,4.0,10.0,3.0,30.0,0.0,0.0,6.0,0.0,183.0,81.0,1.0,3.0,1.0,1.0,1.0,2.0,1.0,2.0,2.0,2.0,1.0,5.0,7.0,7.0,5.0,9.0,7.0,15.0,6.0,9.0,17.0,11.0,8.0,16.0,8.0,17.0,15.0,18.0,12.0,13.0,9.0,15.0,15.0,6.0,16.0,6.0,17.0,16.0,16.0,12.0,11.0,9.0,13.0,8.0,16.0,14.0,20.0,13.0,16.0,14.0,17.0,15.0,6.0,12.0,14.0,15.0,13.0,14.0,13.0,7.0,9.0,11.0,23.0,0.0,0.0,39.0,1.0,183.0,75.0,3.0,1.0,4.0,1.0,2.0,2.0,1.0,2.0,3.0,4.0,2.0,6.0,9.0,10.0,8.0,12.0,7.0,14.0,9.0,12.0,14.0,16.0,9.0,15.0,14.0,10.0,14.0,13.0,14.0,12.0,14.0,14.0,12.0,7.0,14.0,8.0,17.0,16.0,14.0,12.0,9.0,9.0,13.0,8.0,13.0,15.0,20.0,13.0,14.0,15.0,9.0,12.0,10.0,6.0,9.0,13.0,10.0,13.0,13.0,10.0,15.0,3.0,25.0,0.0,0.0,12.0,0.0,174.0,75.0,1.0,2.0,1.0,3.0,2.0,2.0,3.0,1.0,3.0,3.0,1.0,4.0,13.0,10.0,6.0,12.0,7.0,9.0,6.0,14.0,13.0,12.0,9.0,15.0,12.0,16.0,14.0,16.0,14.0,16.0,10.0,13.0,15.0,7.0,12.0,13.0,15.0,15.0,16.0,15.0,13.0,13.0,9.0,12.0,13.0,14.0,20.0,15.0,14.0,15.0,9.0,13.0,7.0,8.0,19.0,13.0,15.0,11.0,11.0,8.0,6.0,3.0,17.0,0.0,0.0,0.0,0.0,173.0,0.0,1.0,4.0,2.0,1.0,1.0,4.0,1.0,4.0,2.0,1.0,3.0,4.0,2.0,13.0,13.0,13.0,6.0,13.0,7.0,1.0,4.0,7.0,3.0,1.0,13.0,9.0,10.0,7.0,6.0,3.0,2.0,13.0,3.0,13.0,11.0,11.0,2.0,6.0,7.0,13.0,13.0,7.0,7.0,4.0,9.0,13.0,20.0,7.0,8.0,9.0,9.0,9.0,9.0,9.0,8.0,14.0,9.0,12.0,12.0,6.0,19.0,2.0,23.0,0.0,0.0,15.0,0.0,181.0,72.0,1.0,2.0,1.0,3.0,2.0,2.0,3.0,3.0,1.0,3.0,1.0,10.0,11.0,10.0,9.0,12.0,9.0,12.0,13.0,8.0,14.0,13.0,11.0,12.0,11.0,13.0,14.0,15.0,12.0,16.0,12.0,14.0,13.0,11.0,17.0,9.0,17.0,15.0,14.0,14.0,12.0,10.0,12.0,13.0,12.0,11.0,20.0,14.0,13.0,15.0,8.0,15.0,8.0,16.0,12.0,11.0,12.0,11.0,12.0,12.0,13.0,9.0,27.0,14.0,0.0,14.0,0.0,178.0,70.0,1.0,1.0,3.0,3.0,3.0,2.0,1.0,1.0,1.0,3.0,2.0,13.0,13.0,12.0,9.0,14.0,16.0,11.0,11.0,14.0,11.0,13.0,9.0,13.0,14.0,14.0,13.0,12.0,11.0,13.0,11.0,11.0,13.0,11.0,8.0,11.0,10.0,12.0,13.0,14.0,12.0,12.0,11.0,9.0,12.0,13.0,20.0,13.0,11.0,15.0,10.0,14.0,7.0,19.0,17.0,16.0,13.0,17.0,15.0,13.0,10.0,7.0,29.0,4.0,3.0,0.0,0.0,185.0,81.0,1.0,4.0,2.0,3.0,3.0,1.0,2.0,1.0,2.0,3.0,3.0,10.0,14.0,15.0,13.0,15.0,16.0,13.0,14.0,8.0,9.0,15.0,14.0,10.0,15.0,16.0,15.0,16.0,14.0,17.0,14.0,14.0,14.0,14.0,11.0,14.0,11.0,16.0,15.0,10.0,13.0,10.0,14.0,20.0,11.0,14.0,10.0,14.0,14.0,8.0,14.0,11.0,13.0,15.0,12.0,15.0,10.0,9.0,14.0,13.0,8.0,8.0,30.0,39.0,2.0,0.0,0.0,171.0,58.0,2.0,1.0,3.0,1.0,3.0,3.0,1.0,2.0,3.0,3.0,1.0,15.0,16.0,15.0,12.0,14.0,11.0,8.0,11.0,8.0,7.0,13.0,14.0,8.0,14.0,12.0,13.0,11.0,8.0,12.0,13.0,11.0,11.0,13.0,9.0,16.0,9.0,13.0,13.0,17.0,17.0,17.0,6.0,12.0,13.0,15.0,20.0,12.0,8.0,11.0,13.0,13.0,7.0,7.0,10.0,10.0,9.0,14.0,10.0,13.0,7.0,12.0,29.0,13.0,5.0,0.0,0.0,175.0,73.0,1.0,3.0,3.0,3.0,3.0,1.0,1.0,2.0,1.0,3.0,3.0,15.0,12.0,15.0,14.0,15.0,12.0,9.0,13.0,6.0,4.0,13.0,15.0,10.0,16.0,9.0,13.0,12.0,14.0,13.0,13.0,14.0,10.0,16.0,14.0,15.0,10.0,12.0,10.0,15.0,15.0,14.0,9.0,15.0,12.0,13.0,20.0,14.0,13.0,12.0,14.0,14.0,7.0,12.0,12.0,14.0,12.0,10.0,10.0,7.0,10.0,12.0,28.0,0.0,0.0,0.0,0.0,176.0,67.0,2.0,1.0,1.0,3.0,3.0,2.0,3.0,4.0,2.0,1.0,4.0,13.0,11.0,15.0,15.0,16.0,15.0,14.0,14.0,7.0,6.0,14.0,16.0,7.0,14.0,12.0,15.0,15.0,14.0,14.0,14.0,14.0,15.0,15.0,10.0,16.0,7.0,11.0,16.0,15.0,14.0,13.0,11.0,20.0,15.0,15.0,10.0,14.0,9.0,12.0,6.0,16.0,5.0,14.0,10.0,14.0,16.0,13.0,11.0,8.0,6.0,15.0,29.0,0.0,0.0,0.0,0.0,190.0,80.0,14.0,13.0,13.0,6.0,15.0,14.0,12.0,15.0,13.0,17.0,15.0,7.0,1.0,3.0,2.0,8.0,9.0,8.0,2.0,3.0,3.0,8.0,2.0,3.0,10.0,6.0,13.0,13.0,7.0,15.0,10.0,13.0,15.0,3.0,9.0,2.0,16.0,11.0,11.0,9.0,13.0,14.0,15.0,8.0,13.0,11.0,20.0,14.0,13.0,10.0,4.0,12.0,6.0,12.0,12.0,15.0,13.0,11.0,14.0,15.0,11.0,8.0,27.0,3.0,0.0,0.0,0.0,191.0,83.0,3.0,1.0,3.0,1.0,3.0,2.0,1.0,3.0,3.0,2.0,3.0,6.0,11.0,12.0,8.0,12.0,5.0,15.0,11.0,11.0,14.0,13.0,14.0,15.0,13.0,12.0,13.0,12.0,16.0,13.0,7.0,13.0,12.0,9.0,11.0,9.0,14.0,13.0,14.0,11.0,9.0,16.0,17.0,7.0,14.0,11.0,20.0,14.0,15.0,10.0,11.0,11.0,14.0,12.0,16.0,14.0,13.0,11.0,16.0,11.0,13.0,4.0,21.0,0.0,0.0,0.0,0.0,189.0,0.0,1.0,1.0,3.0,3.0,2.0,1.0,2.0,2.0,3.0,2.0,2.0,3.0,1.0,4.0,1.0,7.0,1.0,7.0,3.0,1.0,13.0,7.0,2.0,13.0,6.0,7.0,5.0,9.0,7.0,6.0,1.0,13.0,9.0,1.0,10.0,3.0,12.0,6.0,7.0,9.0,9.0,7.0,13.0,10.0,9.0,12.0,20.0,4.0,10.0,9.0,9.0,9.0,6.0,9.0,8.0,11.0,10.0,10.0,11.0,9.0,14.0,8.0,21.0,0.0,0.0,0.0,0.0,183.0,70.0,3.0,1.0,3.0,1.0,3.0,1.0,1.0,3.0,3.0,1.0,1.0,8.0,11.0,12.0,7.0,12.0,8.0,11.0,8.0,8.0,13.0,9.0,5.0,13.0,10.0,12.0,12.0,10.0,12.0,12.0,9.0,12.0,19.0,4.0,8.0,13.0,12.0,13.0,13.0,13.0,12.0,10.0,13.0,12.0,14.0,14.0,20.0,14.0,12.0,12.0,11.0,11.0,10.0,14.0,13.0,11.0,13.0,13.0,10.0,9.0,11.0,1.0,28.0,0.0,0.0,26.0,0.0,173.0,74.0,1.0,1.0,1.0,1.0,3.0,2.0,2.0,2.0,1.0,1.0,2.0,18.0,14.0,13.0,7.0,12.0,14.0,7.0,13.0,14.0,11.0,13.0,3.0,13.0,13.0,16.0,11.0,18.0,8.0,11.0,11.0,10.0,12.0,15.0,11.0,15.0,10.0,16.0,17.0,14.0,14.0,15.0,9.0,8.0,15.0,11.0,20.0,16.0,10.0,11.0,14.0,10.0,4.0,15.0,12.0,11.0,7.0,6.0,11.0,7.0,14.0,5.0,22.0,0.0,0.0,0.0,0.0,186.0,0.0,3.0,1.0,3.0,1.0,2.0,2.0,2.0,1.0,1.0,1.0,1.0,8.0,3.0,8.0,6.0,11.0,3.0,12.0,6.0,5.0,11.0,11.0,4.0,11.0,6.0,10.0,8.0,11.0,7.0,9.0,9.0,13.0,9.0,7.0,11.0,10.0,13.0,10.0,12.0,12.0,10.0,11.0,13.0,20.0,10.0,11.0,8.0,12.0,12.0,10.0,10.0,6.0,5.0,10.0,18.0,11.0,9.0,13.0,9.0,4.0,5.0,1.0,22.0,0.0,0.0,1.0,0.0,176.0,72.0,3.0,2.0,1.0,2.0,1.0,2.0,1.0,1.0,3.0,3.0,2.0,10.0,11.0,13.0,11.0,16.0,12.0,7.0,15.0,7.0,8.0,15.0,13.0,10.0,15.0,13.0,13.0,12.0,13.0,12.0,14.0,13.0,15.0,13.0,10.0,13.0,11.0,14.0,14.0,13.0,14.0,11.0,8.0,13.0,13.0,13.0,20.0,13.0,10.0,13.0,11.0,14.0,11.0,14.0,19.0,14.0,16.0,13.0,14.0,12.0,13.0,7.0,31.0,0.0,0.0,0.0,0.0,187.0,73.0,4.0,4.0,2.0,2.0,2.0,1.0,3.0,3.0,2.0,3.0,1.0,14.0,15.0,14.0,13.0,14.0,10.0,9.0,14.0,11.0,7.0,13.0,12.0,8.0,13.0,11.0,13.0,14.0,13.0,10.0,12.0,14.0,13.0,16.0,11.0,15.0,9.0,12.0,14.0,12.0,12.0,12.0,13.0,10.0,8.0,16.0,20.0,12.0,11.0,11.0,8.0,13.0,12.0,15.0,10.0,13.0,12.0,9.0,14.0,13.0,14.0,8.0,22.0,0.0,0.0,0.0,0.0,189.0,0.0,3.0,1.0,1.0,3.0,2.0,3.0,3.0,2.0,3.0,2.0,1.0,7.0,11.0,13.0,9.0,11.0,7.0,4.0,9.0,4.0,7.0,10.0,8.0,4.0,11.0,10.0,6.0,9.0,5.0,7.0,10.0,11.0,10.0,10.0,10.0,9.0,7.0,8.0,12.0,13.0,11.0,5.0,12.0,10.0,7.0,11.0,20.0,13.0,9.0,10.0,7.0,9.0,10.0,10.0,11.0,10.0,10.0,13.0,10.0,3.0,8.0,4.0,24.0,0.0,0.0,13.0,2.0,174.0,70.0,1.0,1.0,3.0,3.0,1.0,2.0,2.0,3.0,3.0,1.0,3.0,14.0,15.0,16.0,11.0,16.0,16.0,8.0,12.0,5.0,8.0,16.0,12.0,6.0,17.0,10.0,11.0,10.0,12.0,11.0,15.0,12.0,9.0,16.0,8.0,14.0,5.0,11.0,10.0,15.0,16.0,9.0,7.0,20.0,12.0,14.0,8.0,13.0,9.0,12.0,9.0,15.0,10.0,14.0,17.0,12.0,10.0,12.0,13.0,14.0,10.0,10.0,25.0,0.0,0.0,1.0,0.0,182.0,71.0,1.0,2.0,3.0,1.0,4.0,3.0,3.0,3.0,2.0,3.0,3.0,9.0,13.0,14.0,14.0,12.0,10.0,13.0,12.0,8.0,7.0,12.0,11.0,7.0,14.0,9.0,13.0,13.0,12.0,13.0,13.0,11.0,11.0,12.0,8.0,14.0,7.0,12.0,12.0,13.0,14.0,12.0,12.0,12.0,12.0,15.0,20.0,14.0,12.0,11.0,7.0,12.0,14.0,8.0,19.0,14.0,11.0,12.0,13.0,12.0,12.0,12.0
1,2,21.0,0.0,0.0,1.0,0.0,188.0,74.0,14.0,15.0,14.0,7.0,15.0,13.0,12.0,15.0,13.0,7.0,16.0,6.0,3.0,2.0,3.0,8.0,11.0,2.0,2.0,3.0,2.0,4.0,6.0,1.0,9.0,11.0,14.0,13.0,15.0,15.0,11.0,14.0,19.0,1.0,11.0,1.0,16.0,14.0,12.0,11.0,14.0,14.0,16.0,9.0,13.0,10.0,20.0,13.0,12.0,16.0,9.0,13.0,6.0,12.0,13.0,13.0,11.0,12.0,12.0,10.0,19.0,7.0,16.0,0.0,0.0,0.0,0.0,186.0,0.0,2.0,2.0,1.0,1.0,3.0,1.0,2.0,3.0,3.0,3.0,3.0,3.0,3.0,4.0,4.0,5.0,2.0,7.0,2.0,4.0,6.0,7.0,3.0,12.0,7.0,12.0,7.0,15.0,6.0,8.0,4.0,6.0,6.0,7.0,10.0,4.0,9.0,18.0,14.0,9.0,6.0,12.0,13.0,7.0,14.0,10.0,20.0,10.0,7.0,7.0,9.0,7.0,11.0,6.0,5.0,9.0,14.0,13.0,13.0,10.0,7.0,5.0,23.0,4.0,1.0,0.0,0.0,190.0,80.0,2.0,3.0,2.0,2.0,1.0,3.0,2.0,2.0,3.0,1.0,2.0,4.0,6.0,5.0,4.0,10.0,5.0,15.0,7.0,6.0,15.0,10.0,4.0,15.0,9.0,16.0,11.0,16.0,10.0,10.0,11.0,11.0,13.0,10.0,10.0,8.0,13.0,13.0,13.0,13.0,9.0,15.0,15.0,8.0,16.0,13.0,20.0,15.0,15.0,10.0,9.0,10.0,4.0,8.0,9.0,13.0,13.0,12.0,13.0,11.0,11.0,8.0,16.0,0.0,0.0,0.0,0.0,151.0,0.0,4.0,1.0,2.0,2.0,1.0,3.0,2.0,2.0,1.0,3.0,2.0,9.0,6.0,5.0,4.0,4.0,11.0,3.0,3.0,1.0,2.0,5.0,3.0,2.0,5.0,17.0,3.0,9.0,4.0,4.0,6.0,9.0,6.0,8.0,13.0,4.0,1.0,9.0,12.0,14.0,11.0,3.0,2.0,9.0,15.0,13.0,20.0,8.0,3.0,5.0,14.0,9.0,9.0,4.0,10.0,15.0,6.0,11.0,8.0,7.0,9.0,6.0,29.0,0.0,0.0,0.0,0.0,177.0,75.0,1.0,1.0,2.0,3.0,2.0,2.0,2.0,1.0,3.0,2.0,3.0,10.0,11.0,12.0,9.0,10.0,14.0,10.0,15.0,12.0,11.0,10.0,9.0,13.0,10.0,12.0,11.0,14.0,9.0,14.0,9.0,12.0,10.0,9.0,7.0,12.0,13.0,15.0,14.0,13.0,13.0,10.0,9.0,15.0,12.0,12.0,20.0,14.0,10.0,14.0,7.0,4.0,8.0,17.0,12.0,11.0,8.0,8.0,10.0,11.0,10.0,7.0,20.0,0.0,0.0,2.0,0.0,180.0,75.0,2.0,3.0,1.0,1.0,3.0,3.0,1.0,1.0,2.0,2.0,1.0,10.0,10.0,9.0,7.0,13.0,12.0,9.0,9.0,11.0,13.0,13.0,3.0,14.0,12.0,11.0,14.0,13.0,13.0,13.0,12.0,13.0,11.0,8.0,13.0,11.0,15.0,14.0,13.0,13.0,13.0,13.0,8.0,20.0,7.0,14.0,7.0,14.0,11.0,13.0,9.0,11.0,11.0,11.0,18.0,12.0,12.0,9.0,11.0,12.0,12.0,4.0,16.0,0.0,0.0,0.0,0.0,176.0,0.0,3.0,3.0,3.0,4.0,2.0,3.0,4.0,3.0,2.0,1.0,2.0,2.0,2.0,1.0,1.0,4.0,2.0,5.0,3.0,4.0,4.0,4.0,2.0,8.0,3.0,6.0,5.0,6.0,2.0,4.0,3.0,11.0,12.0,7.0,8.0,3.0,7.0,7.0,12.0,9.0,8.0,4.0,6.0,20.0,10.0,7.0,9.0,7.0,6.0,8.0,7.0,9.0,9.0,6.0,9.0,6.0,12.0,14.0,7.0,13.0,12.0,3.0,29.0,0.0,0.0,0.0,0.0,177.0,67.0,2.0,3.0,2.0,1.0,1.0,1.0,3.0,1.0,1.0,3.0,1.0,6.0,10.0,10.0,7.0,13.0,7.0,12.0,10.0,7.0,13.0,14.0,8.0,15.0,12.0,14.0,14.0,17.0,13.0,15.0,12.0,14.0,15.0,7.0,15.0,10.0,16.0,16.0,18.0,12.0,12.0,13.0,9.0,8.0,14.0,12.0,20.0,14.0,12.0,14.0,12.0,12.0,8.0,13.0,14.0,12.0,18.0,6.0,14.0,13.0,12.0,5.0,16.0,0.0,0.0,0.0,0.0,168.0,0.0,1.0,2.0,1.0,1.0,1.0,3.0,4.0,1.0,2.0,3.0,1.0,1.0,3.0,5.0,4.0,5.0,1.0,1.0,3.0,3.0,3.0,2.0,2.0,2.0,9.0,10.0,3.0,5.0,4.0,4.0,5.0,7.0,2.0,9.0,11.0,5.0,4.0,4.0,9.0,13.0,9.0,11.0,3.0,9.0,14.0,12.0,20.0,9.0,4.0,3.0,6.0,12.0,7.0,9.0,9.0,1.0,15.0,14.0,10.0,18.0,2.0,14.0,20.0,1.0,0.0,2.0,0.0,181.0,70.0,3.0,2.0,1.0,1.0,1.0,2.0,1.0,1.0,2.0,1.0,1.0,16.0,15.0,17.0,13.0,17.0,15.0,8.0,14.0,7.0,5.0,16.0,14.0,8.0,18.0,8.0,14.0,9.0,14.0,9.0,15.0,13.0,15.0,17.0,9.0,12.0,8.0,8.0,10.0,15.0,15.0,11.0,10.0,20.0,15.0,15.0,8.0,12.0,10.0,9.0,10.0,16.0,8.0,10.0,14.0,17.0,9.0,14.0,13.0,11.0,12.0,7.0,27.0,55.0,15.0,0.0,0.0,187.0,81.0,3.0,2.0,1.0,1.0,2.0,1.0,3.0,3.0,1.0,1.0,2.0,7.0,12.0,12.0,15.0,12.0,9.0,14.0,15.0,7.0,7.0,12.0,14.0,8.0,14.0,14.0,14.0,14.0,15.0,13.0,13.0,13.0,15.0,14.0,9.0,11.0,8.0,11.0,10.0,14.0,14.0,12.0,14.0,20.0,12.0,14.0,10.0,16.0,14.0,12.0,8.0,11.0,11.0,8.0,15.0,17.0,10.0,10.0,15.0,15.0,12.0,5.0,28.0,0.0,0.0,0.0,0.0,177.0,70.0,2.0,1.0,1.0,2.0,1.0,1.0,1.0,1.0,2.0,1.0,1.0,8.0,8.0,8.0,10.0,14.0,8.0,8.0,13.0,6.0,11.0,14.0,7.0,14.0,14.0,3.0,10.0,9.0,9.0,8.0,7.0,9.0,6.0,5.0,10.0,10.0,10.0,10.0,12.0,14.0,14.0,10.0,6.0,8.0,13.0,14.0,20.0,8.0,6.0,10.0,10.0,10.0,10.0,10.0,18.0,12.0,11.0,9.0,11.0,11.0,8.0,8.0,16.0,0.0,0.0,0.0,0.0,189.0,0.0,3.0,3.0,3.0,1.0,1.0,3.0,1.0,3.0,1.0,1.0,2.0,5.0,7.0,5.0,4.0,6.0,6.0,1.0,1.0,4.0,2.0,5.0,3.0,5.0,10.0,10.0,4.0,5.0,6.0,3.0,7.0,7.0,5.0,11.0,3.0,4.0,3.0,7.0,7.0,11.0,7.0,4.0,12.0,20.0,9.0,9.0,9.0,9.0,6.0,5.0,11.0,4.0,10.0,12.0,10.0,11.0,12.0,12.0,9.0,7.0,7.0,10.0,26.0,0.0,0.0,0.0,0.0,187.0,76.0,2.0,3.0,2.0,2.0,3.0,1.0,3.0,4.0,2.0,3.0,1.0,5.0,3.0,4.0,6.0,8.0,7.0,12.0,4.0,1.0,10.0,9.0,5.0,13.0,4.0,6.0,14.0,9.0,8.0,11.0,6.0,10.0,2.0,5.0,7.0,5.0,12.0,8.0,9.0,14.0,11.0,9.0,14.0,20.0,9.0,10.0,10.0,14.0,13.0,10.0,10.0,10.0,4.0,10.0,17.0,9.0,8.0,11.0,11.0,6.0,10.0,3.0,29.0,0.0,0.0,0.0,0.0,168.0,67.0,2.0,2.0,1.0,2.0,3.0,2.0,3.0,3.0,2.0,3.0,2.0,7.0,11.0,10.0,9.0,12.0,4.0,11.0,12.0,10.0,12.0,13.0,12.0,12.0,12.0,12.0,12.0,17.0,16.0,11.0,9.0,10.0,12.0,13.0,16.0,9.0,11.0,15.0,16.0,11.0,12.0,15.0,5.0,10.0,12.0,11.0,20.0,15.0,14.0,10.0,11.0,16.0,13.0,20.0,14.0,10.0,14.0,13.0,18.0,17.0,20.0,1.0,24.0,0.0,0.0,0.0,0.0,181.0,72.0,3.0,4.0,2.0,2.0,2.0,2.0,3.0,1.0,2.0,2.0,3.0,8.0,13.0,12.0,10.0,11.0,10.0,9.0,11.0,15.0,10.0,13.0,9.0,12.0,12.0,12.0,11.0,11.0,12.0,11.0,14.0,11.0,18.0,14.0,8.0,12.0,11.0,13.0,13.0,11.0,13.0,9.0,8.0,20.0,12.0,15.0,10.0,12.0,9.0,13.0,5.0,14.0,14.0,15.0,18.0,13.0,13.0,12.0,11.0,11.0,13.0,6.0,28.0,0.0,0.0,19.0,0.0,180.0,73.0,1.0,1.0,3.0,3.0,1.0,3.0,4.0,3.0,1.0,3.0,1.0,12.0,13.0,11.0,10.0,11.0,9.0,9.0,9.0,13.0,11.0,15.0,12.0,13.0,13.0,6.0,9.0,9.0,10.0,11.0,11.0,12.0,12.0,11.0,14.0,13.0,11.0,17.0,15.0,12.0,11.0,11.0,9.0,20.0,12.0,12.0,10.0,13.0,11.0,12.0,4.0,14.0,12.0,12.0,9.0,10.0,16.0,9.0,12.0,13.0,11.0,6.0,28.0,0.0,0.0,0.0,0.0,175.0,66.0,1.0,3.0,4.0,3.0,2.0,3.0,2.0,2.0,3.0,3.0,4.0,12.0,12.0,11.0,10.0,13.0,12.0,7.0,12.0,7.0,12.0,14.0,13.0,12.0,14.0,11.0,12.0,13.0,11.0,13.0,14.0,13.0,12.0,14.0,11.0,11.0,13.0,15.0,14.0,11.0,12.0,12.0,8.0,20.0,11.0,11.0,10.0,12.0,11.0,12.0,7.0,12.0,10.0,5.0,10.0,9.0,14.0,11.0,10.0,12.0,18.0,2.0,18.0,0.0,0.0,0.0,0.0,180.0,0.0,3.0,2.0,1.0,3.0,2.0,2.0,3.0,2.0,4.0,2.0,1.0,8.0,7.0,6.0,9.0,7.0,6.0,8.0,12.0,4.0,12.0,11.0,1.0,11.0,11.0,9.0,9.0,8.0,10.0,9.0,11.0,15.0,9.0,6.0,1.0,8.0,10.0,9.0,8.0,11.0,12.0,5.0,7.0,8.0,10.0,10.0,20.0,6.0,11.0,9.0,9.0,4.0,6.0,9.0,8.0,12.0,12.0,12.0,11.0,4.0,10.0,3.0,27.0,0.0,0.0,0.0,0.0,171.0,63.0,2.0,1.0,1.0,3.0,1.0,2.0,4.0,2.0,2.0,2.0,3.0,8.0,4.0,6.0,6.0,13.0,8.0,8.0,6.0,1.0,14.0,13.0,5.0,8.0,14.0,6.0,10.0,9.0,8.0,9.0,14.0,12.0,10.0,10.0,11.0,12.0,11.0,9.0,13.0,14.0,14.0,9.0,5.0,5.0,10.0,14.0,20.0,9.0,6.0,10.0,7.0,10.0,10.0,10.0,13.0,13.0,9.0,9.0,12.0,11.0,14.0,2.0,20.0,9.0,0.0,6.0,0.0,170.0,61.0,3.0,3.0,4.0,1.0,3.0,2.0,3.0,2.0,3.0,3.0,2.0,14.0,12.0,18.0,12.0,17.0,11.0,5.0,14.0,6.0,5.0,13.0,11.0,7.0,17.0,9.0,11.0,7.0,13.0,9.0,15.0,10.0,11.0,18.0,6.0,12.0,7.0,8.0,9.0,15.0,17.0,10.0,6.0,20.0,12.0,12.0,10.0,11.0,7.0,11.0,10.0,11.0,6.0,12.0,10.0,18.0,7.0,13.0,10.0,8.0,10.0,14.0,20.0,5.0,0.0,5.0,0.0,181.0,74.0,3.0,1.0,2.0,1.0,1.0,3.0,3.0,2.0,3.0,1.0,1.0,7.0,9.0,15.0,15.0,17.0,7.0,12.0,11.0,5.0,5.0,9.0,7.0,6.0,16.0,13.0,12.0,14.0,12.0,10.0,13.0,10.0,12.0,11.0,9.0,13.0,12.0,11.0,10.0,14.0,15.0,13.0,9.0,12.0,12.0,12.0,20.0,13.0,12.0,9.0,9.0,8.0,13.0,9.0,11.0,13.0,12.0,11.0,12.0,6.0,17.0,4.0
3,3,28.0,0.0,0.0,0.0,0.0,177.0,70.0,2.0,1.0,1.0,2.0,1.0,1.0,1.0,1.0,2.0,1.0,1.0,8.0,8.0,8.0,10.0,14.0,8.0,8.0,13.0,6.0,11.0,14.0,7.0,14.0,14.0,3.0,10.0,9.0,9.0,8.0,7.0,9.0,6.0,5.0,10.0,10.0,10.0,10.0,12.0,14.0,14.0,10.0,6.0,8.0,13.0,14.0,20.0,8.0,6.0,10.0,10.0,10.0,10.0,10.0,18.0,12.0,11.0,9.0,11.0,11.0,8.0,8.0,16.0,0.0,0.0,0.0,0.0,189.0,0.0,3.0,3.0,3.0,1.0,1.0,3.0,1.0,3.0,1.0,1.0,2.0,5.0,7.0,5.0,4.0,6.0,6.0,1.0,1.0,4.0,2.0,5.0,3.0,5.0,10.0,10.0,4.0,5.0,6.0,3.0,7.0,7.0,5.0,11.0,3.0,4.0,3.0,7.0,7.0,11.0,7.0,4.0,12.0,20.0,9.0,9.0,9.0,9.0,6.0,5.0,11.0,4.0,10.0,12.0,10.0,11.0,12.0,12.0,9.0,7.0,7.0,10.0,26.0,0.0,0.0,0.0,0.0,187.0,76.0,2.0,3.0,2.0,2.0,3.0,1.0,3.0,4.0,2.0,3.0,1.0,5.0,3.0,4.0,6.0,8.0,7.0,12.0,4.0,1.0,10.0,9.0,5.0,13.0,4.0,6.0,14.0,9.0,8.0,11.0,6.0,10.0,2.0,5.0,7.0,5.0,12.0,8.0,9.0,14.0,11.0,9.0,14.0,20.0,9.0,10.0,10.0,14.0,13.0,10.0,10.0,10.0,4.0,10.0,17.0,9.0,8.0,11.0,11.0,6.0,10.0,3.0,24.0,0.0,0.0,0.0,0.0,181.0,72.0,3.0,4.0,2.0,2.0,2.0,2.0,3.0,1.0,2.0,2.0,3.0,8.0,13.0,12.0,10.0,11.0,10.0,9.0,11.0,15.0,10.0,13.0,9.0,12.0,12.0,12.0,11.0,11.0,12.0,11.0,14.0,11.0,18.0,14.0,8.0,12.0,11.0,13.0,13.0,11.0,13.0,9.0,8.0,20.0,12.0,15.0,10.0,12.0,9.0,13.0,5.0,14.0,14.0,15.0,18.0,13.0,13.0,12.0,11.0,11.0,13.0,6.0,29.0,0.0,0.0,0.0,0.0,168.0,67.0,2.0,2.0,1.0,2.0,3.0,2.0,3.0,3.0,2.0,3.0,2.0,7.0,11.0,10.0,9.0,12.0,4.0,11.0,12.0,10.0,12.0,13.0,12.0,12.0,12.0,12.0,12.0,17.0,16.0,11.0,9.0,10.0,12.0,13.0,16.0,9.0,11.0,15.0,16.0,11.0,12.0,15.0,5.0,10.0,12.0,11.0,20.0,15.0,14.0,10.0,11.0,16.0,13.0,20.0,14.0,10.0,14.0,13.0,18.0,17.0,20.0,1.0,28.0,0.0,0.0,19.0,0.0,180.0,73.0,1.0,1.0,3.0,3.0,1.0,3.0,4.0,3.0,1.0,3.0,1.0,12.0,13.0,11.0,10.0,11.0,9.0,9.0,9.0,13.0,11.0,15.0,12.0,13.0,13.0,6.0,9.0,9.0,10.0,11.0,11.0,12.0,12.0,11.0,14.0,13.0,11.0,17.0,15.0,12.0,11.0,11.0,9.0,20.0,12.0,12.0,10.0,13.0,11.0,12.0,4.0,14.0,12.0,12.0,9.0,10.0,16.0,9.0,12.0,13.0,11.0,6.0,18.0,0.0,0.0,0.0,0.0,180.0,0.0,3.0,2.0,1.0,3.0,2.0,2.0,3.0,2.0,4.0,2.0,1.0,8.0,7.0,6.0,9.0,7.0,6.0,8.0,12.0,4.0,12.0,11.0,1.0,11.0,11.0,9.0,9.0,8.0,10.0,9.0,11.0,15.0,9.0,6.0,1.0,8.0,10.0,9.0,8.0,11.0,12.0,5.0,7.0,8.0,10.0,10.0,20.0,6.0,11.0,9.0,9.0,4.0,6.0,9.0,8.0,12.0,12.0,12.0,11.0,4.0,10.0,3.0,28.0,0.0,0.0,0.0,0.0,175.0,66.0,1.0,3.0,4.0,3.0,2.0,3.0,2.0,2.0,3.0,3.0,4.0,12.0,12.0,11.0,10.0,13.0,12.0,7.0,12.0,7.0,12.0,14.0,13.0,12.0,14.0,11.0,12.0,13.0,11.0,13.0,14.0,13.0,12.0,14.0,11.0,11.0,13.0,15.0,14.0,11.0,12.0,12.0,8.0,20.0,11.0,11.0,10.0,12.0,11.0,12.0,7.0,12.0,10.0,5.0,10.0,9.0,14.0,11.0,10.0,12.0,18.0,2.0,27.0,0.0,0.0,0.0,0.0,171.0,63.0,2.0,1.0,1.0,3.0,1.0,2.0,4.0,2.0,2.0,2.0,3.0,8.0,4.0,6.0,6.0,13.0,8.0,8.0,6.0,1.0,14.0,13.0,5.0,8.0,14.0,6.0,10.0,9.0,8.0,9.0,14.0,12.0,10.0,10.0,11.0,12.0,11.0,9.0,13.0,14.0,14.0,9.0,5.0,5.0,10.0,14.0,20.0,9.0,6.0,10.0,7.0,10.0,10.0,10.0,13.0,13.0,9.0,9.0,12.0,11.0,14.0,2.0,20.0,9.0,0.0,6.0,0.0,170.0,61.0,3.0,3.0,4.0,1.0,3.0,2.0,3.0,2.0,3.0,3.0,2.0,14.0,12.0,18.0,12.0,17.0,11.0,5.0,14.0,6.0,5.0,13.0,11.0,7.0,17.0,9.0,11.0,7.0,13.0,9.0,15.0,10.0,11.0,18.0,6.0,12.0,7.0,8.0,9.0,15.0,17.0,10.0,6.0,20.0,12.0,12.0,10.0,11.0,7.0,11.0,10.0,11.0,6.0,12.0,10.0,18.0,7.0,13.0,10.0,8.0,10.0,14.0,17.0,0.0,0.0,0.0,0.0,183.0,0.0,1.0,1.0,3.0,2.0,2.0,3.0,1.0,1.0,3.0,3.0,1.0,6.0,4.0,5.0,3.0,7.0,2.0,12.0,5.0,3.0,13.0,5.0,5.0,11.0,4.0,11.0,12.0,7.0,5.0,8.0,6.0,13.0,8.0,5.0,5.0,5.0,9.0,7.0,11.0,11.0,8.0,11.0,10.0,2.0,11.0,8.0,20.0,8.0,10.0,7.0,11.0,13.0,13.0,7.0,5.0,9.0,9.0,7.0,16.0,11.0,14.0,8.0,29.0,0.0,0.0,0.0,0.0,184.0,86.0,13.0,13.0,12.0,6.0,14.0,12.0,14.0,17.0,11.0,9.0,13.0,7.0,1.0,2.0,2.0,8.0,9.0,6.0,1.0,2.0,2.0,10.0,3.0,2.0,9.0,10.0,12.0,13.0,11.0,13.0,6.0,13.0,8.0,6.0,11.0,2.0,15.0,11.0,13.0,10.0,14.0,13.0,11.0,11.0,13.0,12.0,20.0,14.0,15.0,16.0,7.0,12.0,7.0,12.0,9.0,10.0,13.0,11.0,8.0,12.0,11.0,3.0,29.0,0.0,0.0,0.0,0.0,188.0,84.0,3.0,1.0,2.0,3.0,1.0,4.0,2.0,1.0,1.0,1.0,1.0,5.0,5.0,10.0,8.0,11.0,13.0,14.0,8.0,10.0,15.0,12.0,16.0,15.0,14.0,12.0,13.0,13.0,13.0,14.0,12.0,13.0,16.0,10.0,14.0,11.0,13.0,15.0,13.0,13.0,12.0,10.0,15.0,8.0,13.0,14.0,20.0,14.0,15.0,16.0,9.0,13.0,5.0,10.0,12.0,13.0,11.0,11.0,13.0,13.0,10.0,3.0,21.0,1.0,0.0,4.0,0.0,189.0,84.0,1.0,2.0,2.0,3.0,2.0,3.0,2.0,3.0,1.0,3.0,2.0,5.0,5.0,10.0,6.0,11.0,11.0,15.0,10.0,12.0,14.0,11.0,11.0,14.0,11.0,10.0,13.0,12.0,11.0,12.0,10.0,11.0,12.0,12.0,12.0,10.0,12.0,14.0,12.0,14.0,13.0,14.0,15.0,20.0,15.0,13.0,6.0,14.0,15.0,11.0,5.0,15.0,5.0,6.0,6.0,8.0,10.0,12.0,10.0,12.0,10.0,12.0,23.0,0.0,0.0,22.0,1.0,184.0,78.0,3.0,3.0,2.0,3.0,3.0,2.0,1.0,1.0,1.0,2.0,3.0,11.0,13.0,11.0,8.0,11.0,9.0,11.0,9.0,13.0,11.0,12.0,4.0,13.0,11.0,12.0,11.0,13.0,12.0,12.0,9.0,10.0,13.0,8.0,13.0,11.0,13.0,14.0,15.0,14.0,11.0,14.0,11.0,20.0,13.0,15.0,8.0,16.0,13.0,13.0,9.0,14.0,8.0,12.0,10.0,13.0,14.0,11.0,15.0,14.0,14.0,5.0,20.0,0.0,0.0,0.0,0.0,174.0,60.0,3.0,2.0,3.0,1.0,2.0,1.0,3.0,1.0,2.0,1.0,3.0,9.0,12.0,14.0,9.0,12.0,7.0,6.0,7.0,5.0,7.0,7.0,6.0,8.0,10.0,9.0,9.0,2.0,7.0,7.0,6.0,7.0,4.0,9.0,4.0,9.0,6.0,8.0,9.0,13.0,14.0,9.0,6.0,10.0,13.0,14.0,20.0,10.0,6.0,8.0,9.0,9.0,7.0,9.0,11.0,9.0,11.0,14.0,11.0,10.0,17.0,1.0,26.0,25.0,1.0,7.0,0.0,189.0,78.0,1.0,1.0,1.0,1.0,1.0,1.0,1.0,1.0,1.0,1.0,1.0,8.0,9.0,10.0,6.0,12.0,8.0,13.0,14.0,7.0,11.0,14.0,11.0,13.0,13.0,13.0,13.0,16.0,13.0,13.0,12.0,13.0,14.0,10.0,10.0,12.0,13.0,15.0,15.0,12.0,11.0,9.0,15.0,10.0,14.0,13.0,20.0,14.0,14.0,12.0,13.0,11.0,14.0,12.0,14.0,11.0,14.0,12.0,16.0,15.0,13.0,5.0,27.0,0.0,0.0,5.0,0.0,178.0,76.0,2.0,4.0,2.0,2.0,1.0,1.0,1.0,3.0,4.0,1.0,3.0,9.0,12.0,12.0,8.0,15.0,8.0,8.0,11.0,6.0,11.0,14.0,10.0,12.0,13.0,14.0,14.0,13.0,14.0,17.0,12.0,14.0,15.0,13.0,13.0,11.0,14.0,14.0,13.0,13.0,13.0,13.0,11.0,9.0,12.0,12.0,20.0,16.0,14.0,16.0,12.0,13.0,7.0,13.0,13.0,14.0,13.0,14.0,15.0,11.0,13.0,7.0,30.0,0.0,0.0,0.0,0.0,174.0,71.0,2.0,2.0,2.0,2.0,1.0,1.0,1.0,3.0,3.0,4.0,3.0,11.0,13.0,12.0,10.0,14.0,12.0,8.0,15.0,9.0,7.0,15.0,9.0,9.0,14.0,10.0,14.0,10.0,14.0,14.0,15.0,15.0,8.0,12.0,9.0,13.0,12.0,15.0,14.0,11.0,13.0,11.0,7.0,20.0,10.0,13.0,8.0,13.0,9.0,11.0,9.0,10.0,11.0,13.0,9.0,10.0,11.0,12.0,9.0,11.0,20.0,7.0,35.0,0.0,0.0,0.0,0.0,179.0,78.0,1.0,3.0,2.0,1.0,2.0,1.0,3.0,2.0,4.0,2.0,3.0,12.0,14.0,13.0,14.0,13.0,15.0,10.0,14.0,6.0,5.0,14.0,16.0,7.0,16.0,12.0,12.0,10.0,12.0,11.0,14.0,12.0,14.0,14.0,13.0,14.0,7.0,12.0,11.0,13.0,12.0,11.0,9.0,20.0,10.0,12.0,6.0,10.0,11.0,15.0,8.0,11.0,12.0,9.0,10.0,13.0,16.0,11.0,15.0,12.0,10.0,7.0,29.0,25.0,7.0,0.0,0.0,180.0,70.0,2.0,3.0,1.0,2.0,3.0,2.0,3.0,2.0,1.0,2.0,2.0,6.0,10.0,16.0,15.0,15.0,7.0,14.0,10.0,5.0,3.0,12.0,17.0,2.0,16.0,9.0,13.0,11.0,12.0,11.0,11.0,12.0,15.0,14.0,11.0,14.0,8.0,9.0,10.0,15.0,14.0,13.0,12.0,12.0,14.0,12.0,20.0,14.0,14.0,13.0,9.0,15.0,6.0,7.0,12.0,15.0,13.0,14.0,12.0,12.0,12.0,12.0,20.0,0.0,0.0,4.0,2.0,186.0,86.0,2.0,1.0,3.0,1.0,2.0,3.0,1.0,3.0,3.0,2.0,3.0,8.0,11.0,14.0,13.0,11.0,9.0,8.0,12.0,4.0,6.0,10.0,11.0,7.0,14.0,8.0,12.0,11.0,11.0,9.0,9.0,10.0,8.0,16.0,7.0,13.0,4.0,10.0,12.0,14.0,12.0,13.0,11.0,10.0,15.0,16.0,20.0,13.0,15.0,11.0,7.0,11.0,6.0,14.0,13.0,14.0,12.0,7.0,7.0,10.0,7.0,14.0
3,0,29.0,0.0,0.0,0.0,0.0,189.0,79.0,14.0,15.0,14.0,5.0,14.0,14.0,11.0,13.0,10.0,7.0,12.0,6.0,2.0,3.0,2.0,8.0,11.0,7.0,2.0,3.0,1.0,8.0,2.0,1.0,7.0,10.0,12.0,14.0,11.0,11.0,6.0,14.0,13.0,3.0,12.0,3.0,11.0,12.0,5.0,8.0,11.0,12.0,13.0,5.0,8.0,7.0,20.0,8.0,13.0,11.0,9.0,8.0,7.0,11.0,13.0,14.0,15.0,14.0,12.0,12.0,8.0,3.0,33.0,1.0,0.0,15.0,1.0,183.0,77.0,2.0,3.0,3.0,1.0,3.0,3.0,3.0,3.0,3.0,2.0,1.0,8.0,10.0,10.0,7.0,14.0,10.0,15.0,7.0,10.0,14.0,15.0,10.0,14.0,14.0,12.0,14.0,11.0,11.0,14.0,12.0,13.0,9.0,11.0,12.0,9.0,15.0,11.0,12.0,11.0,11.0,12.0,12.0,12.0,9.0,12.0,20.0,12.0,12.0,14.0,7.0,13.0,14.0,9.0,12.0,15.0,8.0,7.0,10.0,13.0,14.0,8.0,22.0,1.0,0.0,7.0,0.0,186.0,75.0,1.0,4.0,3.0,2.0,1.0,2.0,3.0,4.0,3.0,4.0,3.0,8.0,10.0,9.0,6.0,14.0,6.0,14.0,6.0,13.0,15.0,13.0,9.0,16.0,14.0,15.0,14.0,18.0,11.0,15.0,9.0,15.0,8.0,6.0,11.0,7.0,16.0,15.0,16.0,12.0,10.0,8.0,13.0,10.0,12.0,12.0,20.0,14.0,13.0,11.0,12.0,10.0,9.0,15.0,9.0,12.0,12.0,9.0,12.0,13.0,17.0,5.0,35.0,103.0,2.0,16.0,0.0,178.0,72.0,3.0,3.0,3.0,1.0,2.0,1.0,2.0,2.0,1.0,3.0,2.0,16.0,15.0,12.0,10.0,14.0,16.0,10.0,13.0,13.0,12.0,13.0,9.0,14.0,15.0,11.0,12.0,12.0,12.0,12.0,12.0,13.0,13.0,8.0,16.0,14.0,10.0,14.0,15.0,13.0,12.0,10.0,9.0,20.0,16.0,12.0,8.0,13.0,10.0,14.0,4.0,15.0,6.0,10.0,19.0,14.0,16.0,16.0,14.0,15.0,16.0,3.0,31.0,0.0,0.0,0.0,0.0,183.0,73.0,1.0,2.0,1.0,3.0,2.0,1.0,2.0,3.0,2.0,2.0,4.0,8.0,9.0,10.0,7.0,12.0,5.0,12.0,10.0,7.0,11.0,12.0,8.0,13.0,9.0,12.0,12.0,13.0,8.0,11.0,10.0,14.0,11.0,7.0,8.0,8.0,14.0,14.0,14.0,12.0,12.0,10.0,14.0,8.0,13.0,11.0,20.0,14.0,13.0,12.0,13.0,10.0,14.0,9.0,8.0,7.0,12.0,12.0,12.0,11.0,20.0,10.0,35.0,0.0,0.0,0.0,0.0,177.0,70.0,1.0,4.0,4.0,3.0,1.0,2.0,3.0,2.0,3.0,3.0,1.0,15.0,14.0,12.0,12.0,17.0,17.0,10.0,14.0,7.0,3.0,18.0,16.0,4.0,17.0,10.0,13.0,8.0,14.0,13.0,18.0,17.0,12.0,17.0,15.0,11.0,8.0,12.0,9.0,9.0,8.0,10.0,7.0,16.0,11.0,9.0,20.0,12.0,9.0,13.0,6.0,12.0,12.0,11.0,12.0,15.0,9.0,12.0,13.0,11.0,12.0,10.0,27.0,0.0,0.0,1.0,0.0,180.0,73.0,4.0,1.0,1.0,3.0,2.0,1.0,3.0,3.0,3.0,2.0,2.0,9.0,9.0,11.0,8.0,12.0,10.0,10.0,11.0,6.0,12.0,13.0,11.0,12.0,12.0,9.0,13.0,14.0,14.0,15.0,13.0,14.0,11.0,10.0,13.0,12.0,14.0,15.0,15.0,13.0,12.0,10.0,10.0,12.0,10.0,11.0,20.0,13.0,12.0,13.0,8.0,11.0,13.0,12.0,12.0,10.0,11.0,13.0,13.0,12.0,9.0,13.0,29.0,0.0,0.0,13.0,1.0,176.0,76.0,1.0,2.0,1.0,1.0,3.0,2.0,4.0,4.0,2.0,1.0,2.0,14.0,15.0,12.0,9.0,13.0,15.0,7.0,13.0,9.0,11.0,13.0,12.0,13.0,13.0,14.0,11.0,15.0,10.0,11.0,10.0,8.0,14.0,14.0,10.0,12.0,9.0,7.0,15.0,14.0,15.0,12.0,8.0,14.0,14.0,13.0,20.0,14.0,10.0,15.0,10.0,11.0,11.0,12.0,9.0,9.0,11.0,10.0,11.0,14.0,8.0,15.0,25.0,0.0,0.0,0.0,0.0,180.0,67.0,3.0,3.0,2.0,4.0,2.0,2.0,2.0,3.0,1.0,3.0,2.0,12.0,13.0,12.0,13.0,13.0,11.0,7.0,12.0,5.0,7.0,14.0,12.0,9.0,14.0,9.0,14.0,9.0,14.0,14.0,14.0,13.0,14.0,14.0,11.0,14.0,10.0,12.0,10.0,13.0,15.0,11.0,8.0,14.0,14.0,12.0,20.0,13.0,10.0,10.0,5.0,12.0,10.0,10.0,15.0,13.0,13.0,12.0,12.0,14.0,16.0,9.0,34.0,0.0,0.0,0.0,0.0,179.0,77.0,1.0,4.0,3.0,1.0,4.0,1.0,1.0,3.0,2.0,1.0,1.0,7.0,11.0,13.0,15.0,15.0,8.0,13.0,12.0,5.0,4.0,13.0,13.0,7.0,14.0,8.0,13.0,14.0,14.0,13.0,13.0,13.0,13.0,16.0,9.0,14.0,7.0,14.0,13.0,12.0,13.0,14.0,12.0,12.0,12.0,12.0,20.0,13.0,13.0,13.0,5.0,12.0,8.0,5.0,3.0,13.0,12.0,12.0,13.0,12.0,11.0,9.0,25.0,0.0,0.0,0.0,0.0,175.0,74.0,3.0,3.0,3.0,3.0,3.0,3.0,3.0,1.0,3.0,2.0,3.0,7.0,7.0,4.0,7.0,14.0,7.0,7.0,10.0,4.0,9.0,14.0,4.0,14.0,10.0,9.0,9.0,8.0,6.0,9.0,11.0,14.0,3.0,1.0,10.0,5.0,14.0,8.0,11.0,14.0,10.0,8.0,6.0,4.0,10.0,11.0,20.0,10.0,7.0,9.0,5.0,8.0,3.0,9.0,14.0,12.0,13.0,10.0,12.0,11.0,18.0,1.0,21.0,0.0,0.0,1.0,0.0,188.0,74.0,14.0,15.0,14.0,7.0,15.0,13.0,12.0,15.0,13.0,7.0,16.0,6.0,3.0,2.0,3.0,8.0,11.0,2.0,2.0,3.0,2.0,4.0,6.0,1.0,9.0,11.0,14.0,13.0,15.0,15.0,11.0,14.0,19.0,1.0,11.0,1.0,16.0,14.0,12.0,11.0,14.0,14.0,16.0,9.0,13.0,10.0,20.0,13.0,12.0,16.0,9.0,13.0,6.0,12.0,13.0,13.0,11.0,12.0,12.0,10.0,19.0,7.0,16.0,0.0,0.0,0.0,0.0,186.0,0.0,2.0,2.0,1.0,1.0,3.0,1.0,2.0,3.0,3.0,3.0,3.0,3.0,3.0,4.0,4.0,5.0,2.0,7.0,2.0,4.0,6.0,7.0,3.0,12.0,7.0,12.0,7.0,15.0,6.0,8.0,4.0,6.0,6.0,7.0,10.0,4.0,9.0,18.0,14.0,9.0,6.0,12.0,13.0,7.0,14.0,10.0,20.0,10.0,7.0,7.0,9.0,7.0,11.0,6.0,5.0,9.0,14.0,13.0,13.0,10.0,7.0,5.0,23.0,4.0,1.0,0.0,0.0,190.0,80.0,2.0,3.0,2.0,2.0,1.0,3.0,2.0,2.0,3.0,1.0,2.0,4.0,6.0,5.0,4.0,10.0,5.0,15.0,7.0,6.0,15.0,10.0,4.0,15.0,9.0,16.0,11.0,16.0,10.0,10.0,11.0,11.0,13.0,10.0,10.0,8.0,13.0,13.0,13.0,13.0,9.0,15.0,15.0,8.0,16.0,13.0,20.0,15.0,15.0,10.0,9.0,10.0,4.0,8.0,9.0,13.0,13.0,12.0,13.0,11.0,11.0,8.0,16.0,0.0,0.0,0.0,0.0,151.0,0.0,4.0,1.0,2.0,2.0,1.0,3.0,2.0,2.0,1.0,3.0,2.0,9.0,6.0,5.0,4.0,4.0,11.0,3.0,3.0,1.0,2.0,5.0,3.0,2.0,5.0,17.0,3.0,9.0,4.0,4.0,6.0,9.0,6.0,8.0,13.0,4.0,1.0,9.0,12.0,14.0,11.0,3.0,2.0,9.0,15.0,13.0,20.0,8.0,3.0,5.0,14.0,9.0,9.0,4.0,10.0,15.0,6.0,11.0,8.0,7.0,9.0,6.0,26.0,0.0,0.0,0.0,0.0,178.0,70.0,3.0,2.0,3.0,3.0,1.0,1.0,3.0,1.0,1.0,1.0,3.0,8.0,12.0,10.0,7.0,12.0,6.0,7.0,9.0,13.0,14.0,11.0,8.0,15.0,10.0,15.0,12.0,16.0,11.0,12.0,9.0,12.0,13.0,7.0,12.0,14.0,15.0,16.0,16.0,13.0,12.0,12.0,9.0,20.0,13.0,14.0,8.0,14.0,12.0,14.0,11.0,7.0,7.0,12.0,12.0,11.0,13.0,11.0,13.0,11.0,13.0,5.0,29.0,0.0,0.0,0.0,0.0,177.0,75.0,1.0,1.0,2.0,3.0,2.0,2.0,2.0,1.0,3.0,2.0,3.0,10.0,11.0,12.0,9.0,10.0,14.0,10.0,15.0,12.0,11.0,10.0,9.0,13.0,10.0,12.0,11.0,14.0,9.0,14.0,9.0,12.0,10.0,9.0,7.0,12.0,13.0,15.0,14.0,13.0,13.0,10.0,9.0,15.0,12.0,12.0,20.0,14.0,10.0,14.0,7.0,4.0,8.0,17.0,12.0,11.0,8.0,8.0,10.0,11.0,10.0,7.0,29.0,0.0,0.0,0.0,0.0,177.0,67.0,2.0,3.0,2.0,1.0,1.0,1.0,3.0,1.0,1.0,3.0,1.0,6.0,10.0,10.0,7.0,13.0,7.0,12.0,10.0,7.0,13.0,14.0,8.0,15.0,12.0,14.0,14.0,17.0,13.0,15.0,12.0,14.0,15.0,7.0,15.0,10.0,16.0,16.0,18.0,12.0,12.0,13.0,9.0,8.0,14.0,12.0,20.0,14.0,12.0,14.0,12.0,12.0,8.0,13.0,14.0,12.0,18.0,6.0,14.0,13.0,12.0,5.0,16.0,0.0,0.0,0.0,0.0,176.0,0.0,3.0,3.0,3.0,4.0,2.0,3.0,4.0,3.0,2.0,1.0,2.0,2.0,2.0,1.0,1.0,4.0,2.0,5.0,3.0,4.0,4.0,4.0,2.0,8.0,3.0,6.0,5.0,6.0,2.0,4.0,3.0,11.0,12.0,7.0,8.0,3.0,7.0,7.0,12.0,9.0,8.0,4.0,6.0,20.0,10.0,7.0,9.0,7.0,6.0,8.0,7.0,9.0,9.0,6.0,9.0,6.0,12.0,14.0,7.0,13.0,12.0,3.0,16.0,0.0,0.0,0.0,0.0,168.0,0.0,1.0,2.0,1.0,1.0,1.0,3.0,4.0,1.0,2.0,3.0,1.0,1.0,3.0,5.0,4.0,5.0,1.0,1.0,3.0,3.0,3.0,2.0,2.0,2.0,9.0,10.0,3.0,5.0,4.0,4.0,5.0,7.0,2.0,9.0,11.0,5.0,4.0,4.0,9.0,13.0,9.0,11.0,3.0,9.0,14.0,12.0,20.0,9.0,4.0,3.0,6.0,12.0,7.0,9.0,9.0,1.0,15.0,14.0,10.0,18.0,2.0,14.0,20.0,1.0,0.0,2.0,0.0,181.0,70.0,3.0,2.0,1.0,1.0,1.0,2.0,1.0,1.0,2.0,1.0,1.0,16.0,15.0,17.0,13.0,17.0,15.0,8.0,14.0,7.0,5.0,16.0,14.0,8.0,18.0,8.0,14.0,9.0,14.0,9.0,15.0,13.0,15.0,17.0,9.0,12.0,8.0,8.0,10.0,15.0,15.0,11.0,10.0,20.0,15.0,15.0,8.0,12.0,10.0,9.0,10.0,16.0,8.0,10.0,14.0,17.0,9.0,14.0,13.0,11.0,12.0,7.0,27.0,55.0,15.0,0.0,0.0,187.0,81.0,3.0,2.0,1.0,1.0,2.0,1.0,3.0,3.0,1.0,1.0,2.0,7.0,12.0,12.0,15.0,12.0,9.0,14.0,15.0,7.0,7.0,12.0,14.0,8.0,14.0,14.0,14.0,14.0,15.0,13.0,13.0,13.0,15.0,14.0,9.0,11.0,8.0,11.0,10.0,14.0,14.0,12.0,14.0,20.0,12.0,14.0,10.0,16.0,14.0,12.0,8.0,11.0,11.0,8.0,15.0,17.0,10.0,10.0,15.0,15.0,12.0,5.0
1,3,18.0,0.0,0.0,0.0,0.0,180.0,0.0,3.0,2.0,1.0,3.0,2.0,2.0,3.0,2.0,4.0,2.0,1.0,8.0,7.0,6.0,9.0,7.0,6.0,8.0,12.0,4.0,12.0,11.0,1.0,11.0,11.0,9.0,9.0,8.0,10.0,9.0,11.0,15.0,9.0,6.0,1.0,8.0,10.0,9.0,8.0,11.0,12.0,5.0,7.0,8.0,10.0,10.0,20.0,6.0,11.0,9.0,9.0,4.0,6.0,9.0,8.0,12.0,12.0,12.0,11.0,4.0,10.0,3.0,30.0,0.0,0.0,6.0,0.0,183.0,81.0,1.0,3.0,1.0,1.0,1.0,2.0,1.0,2.0,2.0,2.0,1.0,5.0,7.0,7.0,5.0,9.0,7.0,15.0,6.0,9.0,17.0,11.0,8.0,16.0,8.0,17.0,15.0,18.0,12.0,13.0,9.0,15.0,15.0,6.0,16.0,6.0,17.0,16.0,16.0,12.0,11.0,9.0,13.0,8.0,16.0,14.0,20.0,13.0,16.0,14.0,17.0,15.0,6.0,12.0,14.0,15.0,13.0,14.0,13.0,7.0,9.0,11.0,23.0,0.0,0.0,39.0,1.0,183.0,75.0,3.0,1.0,4.0,1.0,2.0,2.0,1.0,2.0,3.0,4.0,2.0,6.0,9.0,10.0,8.0,12.0,7.0,14.0,9.0,12.0,14.0,16.0,9.0,15.0,14.0,10.0,14.0,13.0,14.0,12.0,14.0,14.0,12.0,7.0,14.0,8.0,17.0,16.0,14.0,12.0,9.0,9.0,13.0,8.0,13.0,15.0,20.0,13.0,14.0,15.0,9.0,12.0,10.0,6.0,9.0,13.0,10.0,13.0,13.0,10.0,15.0,3.0,25.0,0.0,0.0,12.0,0.0,174.0,75.0,1.0,2.0,1.0,3.0,2.0,2.0,3.0,1.0,3.0,3.0,1.0,4.0,13.0,10.0,6.0,12.0,7.0,9.0,6.0,14.0,13.0,12.0,9.0,15.0,12.0,16.0,14.0,16.0,14.0,16.0,10.0,13.0,15.0,7.0,12.0,13.0,15.0,15.0,16.0,15.0,13.0,13.0,9.0,12.0,13.0,14.0,20.0,15.0,14.0,15.0,9.0,13.0,7.0,8.0,19.0,13.0,15.0,11.0,11.0,8.0,6.0,3.0,17.0,0.0,0.0,0.0,0.0,173.0,0.0,1.0,4.0,2.0,1.0,1.0,4.0,1.0,4.0,2.0,1.0,3.0,4.0,2.0,13.0,13.0,13.0,6.0,13.0,7.0,1.0,4.0,7.0,3.0,1.0,13.0,9.0,10.0,7.0,6.0,3.0,2.0,13.0,3.0,13.0,11.0,11.0,2.0,6.0,7.0,13.0,13.0,7.0,7.0,4.0,9.0,13.0,20.0,7.0,8.0,9.0,9.0,9.0,9.0,9.0,8.0,14.0,9.0,12.0,12.0,6.0,19.0,2.0,27.0,14.0,0.0,14.0,0.0,178.0,70.0,1.0,1.0,3.0,3.0,3.0,2.0,1.0,1.0,1.0,3.0,2.0,13.0,13.0,12.0,9.0,14.0,16.0,11.0,11.0,14.0,11.0,13.0,9.0,13.0,14.0,14.0,13.0,12.0,11.0,13.0,11.0,11.0,13.0,11.0,8.0,11.0,10.0,12.0,13.0,14.0,12.0,12.0,11.0,9.0,12.0,13.0,20.0,13.0,11.0,15.0,10.0,14.0,7.0,19.0,17.0,16.0,13.0,17.0,15.0,13.0,10.0,7.0,29.0,4.0,3.0,0.0,0.0,185.0,81.0,1.0,4.0,2.0,3.0,3.0,1.0,2.0,1.0,2.0,3.0,3.0,10.0,14.0,15.0,13.0,15.0,16.0,13.0,14.0,8.0,9.0,15.0,14.0,10.0,15.0,16.0,15.0,16.0,14.0,17.0,14.0,14.0,14.0,14.0,11.0,14.0,11.0,16.0,15.0,10.0,13.0,10.0,14.0,20.0,11.0,14.0,10.0,14.0,14.0,8.0,14.0,11.0,13.0,15.0,12.0,15.0,10.0,9.0,14.0,13.0,8.0,8.0,30.0,9.0,1.0,0.0,0.0,177.0,74.0,3.0,2.0,2.0,1.0,3.0,1.0,3.0,3.0,3.0,4.0,3.0,11.0,16.0,14.0,11.0,15.0,6.0,8.0,10.0,5.0,8.0,13.0,8.0,12.0,13.0,15.0,15.0,15.0,14.0,15.0,13.0,16.0,16.0,12.0,7.0,13.0,13.0,16.0,17.0,13.0,14.0,12.0,9.0,14.0,14.0,13.0,20.0,15.0,12.0,16.0,13.0,13.0,12.0,12.0,9.0,13.0,15.0,13.0,15.0,15.0,10.0,8.0,30.0,39.0,2.0,0.0,0.0,171.0,58.0,2.0,1.0,3.0,1.0,3.0,3.0,1.0,2.0,3.0,3.0,1.0,15.0,16.0,15.0,12.0,14.0,11.0,8.0,11.0,8.0,7.0,13.0,14.0,8.0,14.0,12.0,13.0,11.0,8.0,12.0,13.0,11.0,11.0,13.0,9.0,16.0,9.0,13.0,13.0,17.0,17.0,17.0,6.0,12.0,13.0,15.0,20.0,12.0,8.0,11.0,13.0,13.0,7.0,7.0,10.0,10.0,9.0,14.0,10.0,13.0,7.0,12.0,29.0,13.0,5.0,0.0,0.0,175.0,73.0,1.0,3.0,3.0,3.0,3.0,1.0,1.0,2.0,1.0,3.0,3.0,15.0,12.0,15.0,14.0,15.0,12.0,9.0,13.0,6.0,4.0,13.0,15.0,10.0,16.0,9.0,13.0,12.0,14.0,13.0,13.0,14.0,10.0,16.0,14.0,15.0,10.0,12.0,10.0,15.0,15.0,14.0,9.0,15.0,12.0,13.0,20.0,14.0,13.0,12.0,14.0,14.0,7.0,12.0,12.0,14.0,12.0,10.0,10.0,7.0,10.0,12.0,28.0,0.0,0.0,0.0,0.0,176.0,67.0,2.0,1.0,1.0,3.0,3.0,2.0,3.0,4.0,2.0,1.0,4.0,13.0,11.0,15.0,15.0,16.0,15.0,14.0,14.0,7.0,6.0,14.0,16.0,7.0,14.0,12.0,15.0,15.0,14.0,14.0,14.0,14.0,15.0,15.0,10.0,16.0,7.0,11.0,16.0,15.0,14.0,13.0,11.0,20.0,15.0,15.0,10.0,14.0,9.0,12.0,6.0,16.0,5.0,14.0,10.0,14.0,16.0,13.0,11.0,8.0,6.0,15.0,29.0,66.0,0.0,0.0,0.0,184.0,78.0,10.0,15.0,15.0,4.0,12.0,13.0,17.0,19.0,10.0,16.0,15.0,10.0,1.0,3.0,3.0,8.0,12.0,9.0,1.0,1.0,1.0,9.0,3.0,2.0,6.0,11.0,15.0,15.0,13.0,18.0,8.0,15.0,16.0,8.0,12.0,3.0,13.0,15.0,15.0,12.0,18.0,14.0,12.0,9.0,17.0,14.0,20.0,14.0,13.0,16.0,4.0,17.0,9.0,12.0,14.0,15.0,16.0,15.0,20.0,16.0,19.0,3.0,23.0,28.0,2.0,15.0,3.0,191.0,83.0,1.0,2.0,2.0,1.0,3.0,1.0,3.0,1.0,1.0,1.0,4.0,5.0,9.0,11.0,6.0,13.0,8.0,15.0,9.0,10.0,17.0,14.0,10.0,17.0,14.0,11.0,15.0,13.0,14.0,18.0,11.0,14.0,12.0,11.0,9.0,8.0,17.0,14.0,14.0,15.0,13.0,11.0,17.0,8.0,16.0,16.0,20.0,14.0,14.0,17.0,6.0,15.0,14.0,14.0,12.0,16.0,13.0,17.0,14.0,17.0,16.0,8.0,27.0,0.0,0.0,0.0,0.0,183.0,0.0,2.0,4.0,1.0,2.0,2.0,2.0,1.0,2.0,3.0,1.0,3.0,2.0,4.0,5.0,4.0,12.0,6.0,6.0,4.0,3.0,11.0,13.0,1.0,11.0,7.0,9.0,8.0,5.0,8.0,7.0,8.0,13.0,9.0,4.0,13.0,6.0,8.0,7.0,12.0,13.0,13.0,7.0,8.0,8.0,11.0,13.0,20.0,7.0,7.0,9.0,9.0,2.0,15.0,9.0,8.0,13.0,9.0,10.0,11.0,12.0,20.0,2.0,27.0,0.0,0.0,0.0,0.0,184.0,81.0,1.0,1.0,1.0,3.0,3.0,2.0,2.0,2.0,1.0,2.0,3.0,8.0,6.0,8.0,12.0,10.0,8.0,12.0,9.0,1.0,3.0,8.0,14.0,4.0,9.0,4.0,11.0,12.0,11.0,8.0,8.0,11.0,10.0,9.0,8.0,11.0,9.0,8.0,11.0,10.0,8.0,13.0,13.0,9.0,13.0,9.0,20.0,12.0,13.0,13.0,9.0,2.0,9.0,9.0,15.0,10.0,12.0,10.0,11.0,6.0,4.0,6.0,27.0,0.0,0.0,0.0,0.0,185.0,0.0,4.0,1.0,3.0,3.0,1.0,1.0,3.0,3.0,1.0,1.0,1.0,7.0,5.0,6.0,8.0,13.0,7.0,2.0,10.0,3.0,11.0,7.0,7.0,10.0,9.0,9.0,9.0,9.0,9.0,9.0,7.0,13.0,10.0,10.0,9.0,7.0,8.0,8.0,12.0,13.0,13.0,8.0,9.0,10.0,12.0,12.0,20.0,13.0,9.0,10.0,10.0,1.0,10.0,10.0,20.0,11.0,10.0,10.0,10.0,2.0,17.0,6.0,24.0,11.0,0.0,15.0,3.0,184.0,83.0,1.0,3.0,3.0,2.0,4.0,1.0,3.0,3.0,3.0,3.0,1.0,10.0,11.0,12.0,9.0,14.0,10.0,13.0,12.0,10.0,13.0,14.0,11.0,15.0,13.0,18.0,14.0,16.0,15.0,16.0,12.0,15.0,13.0,12.0,10.0,12.0,16.0,17.0,19.0,12.0,12.0,15.0,13.0,13.0,15.0,14.0,20.0,19.0,17.0,16.0,9.0,11.0,5.0,12.0,13.0,12.0,10.0,14.0,12.0,10.0,13.0,14.0,26.0,71.0,11.0,10.0,2.0,182.0,78.0,1.0,2.0,3.0,3.0,2.0,3.0,2.0,4.0,3.0,2.0,2.0,18.0,18.0,14.0,13.0,18.0,14.0,7.0,17.0,8.0,8.0,20.0,13.0,9.0,16.0,10.0,17.0,10.0,18.0,14.0,18.0,19.0,9.0,11.0,12.0,14.0,12.0,18.0,13.0,12.0,9.0,12.0,10.0,15.0,12.0,13.0,20.0,16.0,14.0,13.0,10.0,14.0,7.0,13.0,8.0,14.0,8.0,14.0,17.0,18.0,17.0,7.0,30.0,93.0,11.0,15.0,2.0,173.0,65.0,3.0,2.0,2.0,3.0,3.0,3.0,4.0,1.0,1.0,1.0,1.0,16.0,16.0,17.0,9.0,19.0,13.0,8.0,12.0,7.0,8.0,19.0,14.0,11.0,18.0,12.0,17.0,13.0,15.0,16.0,18.0,18.0,16.0,13.0,13.0,12.0,12.0,16.0,17.0,14.0,17.0,13.0,7.0,13.0,13.0,13.0,20.0,17.0,8.0,15.0,12.0,14.0,11.0,16.0,10.0,15.0,13.0,17.0,16.0,16.0,17.0,5.0,25.0,2.0,0.0,0.0,0.0,173.0,70.0,1.0,1.0,3.0,1.0,2.0,4.0,1.0,2.0,3.0,2.0,4.0,14.0,14.0,14.0,11.0,14.0,11.0,10.0,11.0,8.0,8.0,13.0,12.0,12.0,14.0,15.0,13.0,13.0,11.0,13.0,12.0,13.0,14.0,14.0,11.0,15.0,10.0,13.0,16.0,16.0,15.0,15.0,7.0,12.0,14.0,14.0,20.0,15.0,9.0,14.0,8.0,12.0,6.0,15.0,16.0,10.0,14.0,13.0,15.0,14.0,16.0,4.0,23.0,0.0,0.0,5.0,2.0,178.0,73.0,3.0,1.0,2.0,1.0,1.0,3.0,2.0,2.0,1.0,1.0,3.0,13.0,9.0,15.0,14.0,16.0,12.0,8.0,12.0,5.0,4.0,13.0,13.0,5.0,17.0,13.0,13.0,11.0,12.0,8.0,12.0,9.0,14.0,16.0,8.0,16.0,7.0,10.0,9.0,15.0,16.0,14.0,9.0,10.0,9.0,15.0,20.0,12.0,11.0,7.0,10.0,11.0,12.0,14.0,6.0,9.0,13.0,10.0,8.0,4.0,6.0,10.0,31.0,133.0,61.0,10.0,3.0,186.0,84.0,2.0,1.0,3.0,1.0,3.0,2.0,2.0,3.0,1.0,3.0,2.0,12.0,14.0,15.0,19.0,16.0,14.0,18.0,19.0,6.0,2.0,14.0,19.0,8.0,15.0,6.0,17.0,16.0,13.0,16.0,13.0,17.0,20.0,18.0,15.0,18.0,5.0,6.0,7.0,13.0,12.0,13.0,16.0,15.0,19.0,17.0,20.0,17.0,16.0,17.0,12.0,14.0,7.0,10.0,18.0,20.0,13.0,19.0,20.0,7.0,7.0,12.0
1,0,32.0,0.0,0.0,10.0,0.0,185.0,76.0,13.0,12.0,11.0,6.0,14.0,13.0,14.0,14.0,12.0,12.0,11.0,6.0,2.0,2.0,1.0,7.0,9.0,3.0,3.0,2.0,3.0,8.0,4.0,3.0,7.0,13.0,13.0,16.0,15.0,14.0,3.0,14.0,13.0,7.0,14.0,5.0,13.0,10.0,10.0,11.0,13.0,14.0,13.0,9.0,14.0,12.0,20.0,14.0,11.0,14.0,7.0,14.0,6.0,12.0,14.0,14.0,10.0,14.0,14.0,13.0,8.0,12.0,26.0,0.0,0.0,0.0,0.0,180.0,76.0,2.0,2.0,1.0,1.0,2.0,2.0,3.0,3.0,3.0,2.0,2.0,4.0,7.0,4.0,3.0,10.0,6.0,16.0,11.0,10.0,15.0,9.0,8.0,14.0,8.0,12.0,15.0,13.0,12.0,13.0,9.0,11.0,13.0,5.0,11.0,6.0,14.0,15.0,15.0,13.0,11.0,12.0,13.0,9.0,15.0,14.0,20.0,13.0,14.0,14.0,11.0,11.0,11.0,9.0,13.0,12.0,15.0,13.0,11.0,13.0,10.0,7.0,24.0,0.0,0.0,21.0,1.0,184.0,77.0,1.0,3.0,3.0,1.0,1.0,2.0,1.0,2.0,1.0,3.0,2.0,12.0,14.0,11.0,4.0,12.0,8.0,14.0,8.0,8.0,14.0,12.0,11.0,14.0,12.0,9.0,14.0,13.0,12.0,13.0,12.0,11.0,10.0,9.0,10.0,12.0,13.0,11.0,13.0,12.0,12.0,10.0,13.0,10.0,9.0,15.0,20.0,13.0,14.0,15.0,7.0,12.0,11.0,9.0,10.0,10.0,11.0,10.0,10.0,10.0,10.0,9.0,22.0,0.0,0.0,0.0,0.0,175.0,65.0,1.0,2.0,3.0,1.0,3.0,2.0,2.0,2.0,2.0,1.0,1.0,11.0,14.0,12.0,8.0,11.0,7.0,7.0,8.0,13.0,11.0,11.0,8.0,13.0,13.0,10.0,14.0,11.0,12.0,14.0,11.0,13.0,9.0,8.0,7.0,14.0,12.0,13.0,13.0,14.0,13.0,13.0,8.0,20.0,12.0,14.0,8.0,13.0,10.0,14.0,8.0,11.0,5.0,11.0,19.0,11.0,11.0,10.0,13.0,9.0,13.0,7.0,24.0,0.0,0.0,0.0,0.0,176.0,68.0,3.0,1.0,1.0,1.0,3.0,3.0,1.0,1.0,2.0,1.0,2.0,10.0,13.0,13.0,10.0,11.0,8.0,8.0,9.0,11.0,11.0,12.0,11.0,11.0,12.0,11.0,14.0,12.0,13.0,13.0,9.0,13.0,12.0,13.0,11.0,14.0,12.0,15.0,12.0,15.0,13.0,10.0,8.0,10.0,13.0,14.0,20.0,14.0,13.0,13.0,8.0,15.0,7.0,14.0,9.0,13.0,11.0,13.0,13.0,12.0,11.0,8.0,23.0,0.0,0.0,0.0,0.0,183.0,75.0,2.0,3.0,2.0,2.0,1.0,3.0,2.0,1.0,1.0,3.0,2.0,10.0,12.0,11.0,10.0,14.0,10.0,13.0,13.0,8.0,12.0,13.0,8.0,15.0,12.0,16.0,14.0,15.0,12.0,14.0,11.0,15.0,5.0,9.0,11.0,12.0,15.0,15.0,14.0,13.0,12.0,13.0,11.0,8.0,13.0,13.0,20.0,14.0,12.0,13.0,16.0,12.0,9.0,13.0,14.0,12.0,11.0,13.0,13.0,8.0,9.0,6.0,17.0,0.0,0.0,0.0,0.0,170.0,0.0,3.0,4.0,2.0,2.0,1.0,1.0,1.0,1.0,4.0,1.0,2.0,6.0,7.0,6.0,8.0,14.0,6.0,6.0,6.0,1.0,5.0,5.0,1.0,6.0,9.0,8.0,8.0,3.0,4.0,6.0,9.0,7.0,8.0,8.0,10.0,8.0,5.0,8.0,12.0,14.0,14.0,6.0,7.0,8.0,9.0,10.0,20.0,8.0,4.0,1.0,7.0,5.0,8.0,8.0,8.0,12.0,10.0,10.0,11.0,12.0,17.0,5.0,23.0,0.0,0.0,5.0,1.0,171.0,62.0,1.0,1.0,1.0,2.0,1.0,1.0,1.0,3.0,1.0,3.0,1.0,12.0,12.0,12.0,10.0,10.0,14.0,5.0,11.0,4.0,4.0,14.0,11.0,6.0,14.0,12.0,11.0,12.0,13.0,13.0,13.0,14.0,14.0,14.0,11.0,13.0,5.0,14.0,13.0,15.0,13.0,11.0,6.0,20.0,11.0,14.0,12.0,13.0,13.0,12.0,5.0,11.0,5.0,16.0,16.0,14.0,18.0,11.0,17.0,16.0,14.0,4.0,24.0,0.0,0.0,0.0,0.0,172.0,67.0,1.0,2.0,3.0,1.0,1.0,3.0,2.0,2.0,1.0,3.0,2.0,14.0,15.0,14.0,13.0,13.0,9.0,6.0,12.0,7.0,4.0,14.0,10.0,7.0,14.0,10.0,15.0,11.0,12.0,11.0,14.0,13.0,18.0,15.0,8.0,14.0,7.0,9.0,11.0,15.0,15.0,15.0,6.0,12.0,14.0,15.0,20.0,13.0,10.0,12.0,6.0,10.0,6.0,12.0,13.0,16.0,14.0,14.0,13.0,15.0,11.0,7.0,23.0,0.0,0.0,0.0,0.0,191.0,79.0,2.0,2.0,1.0,1.0,3.0,1.0,1.0,3.0,2.0,1.0,3.0,7.0,10.0,13.0,16.0,14.0,8.0,13.0,11.0,9.0,6.0,11.0,12.0,7.0,13.0,12.0,16.0,11.0,15.0,13.0,11.0,15.0,13.0,11.0,11.0,16.0,9.0,12.0,15.0,10.0,13.0,11.0,15.0,13.0,14.0,13.0,20.0,12.0,13.0,13.0,8.0,9.0,8.0,5.0,2.0,12.0,14.0,12.0,13.0,13.0,13.0,6.0,30.0,0.0,0.0,0.0,0.0,178.0,78.0,2.0,2.0,2.0,2.0,3.0,1.0,1.0,1.0,1.0,3.0,2.0,13.0,15.0,14.0,13.0,10.0,11.0,11.0,15.0,5.0,5.0,15.0,13.0,5.0,14.0,10.0,12.0,11.0,13.0,11.0,12.0,13.0,12.0,14.0,9.0,14.0,8.0,8.0,8.0,15.0,11.0,13.0,9.0,20.0,12.0,13.0,10.0,12.0,13.0,10.0,10.0,12.0,5.0,12.0,8.0,15.0,5.0,11.0,8.0,12.0,8.0,15.0,29.0,0.0,0.0,0.0,0.0,189.0,79.0,14.0,15.0,14.0,5.0,14.0,14.0,11.0,13.0,10.0,7.0,12.0,6.0,2.0,3.0,2.0,8.0,11.0,7.0,2.0,3.0,1.0,8.0,2.0,1.0,7.0,10.0,12.0,14.0,11.0,11.0,6.0,14.0,13.0,3.0,12.0,3.0,11.0,12.0,5.0,8.0,11.0,12.0,13.0,5.0,8.0,7.0,20.0,8.0,13.0,11.0,9.0,8.0,7.0,11.0,13.0,14.0,15.0,14.0,12.0,12.0,8.0,3.0,22.0,1.0,0.0,7.0,0.0,186.0,75.0,1.0,4.0,3.0,2.0,1.0,2.0,3.0,4.0,3.0,4.0,3.0,8.0,10.0,9.0,6.0,14.0,6.0,14.0,6.0,13.0,15.0,13.0,9.0,16.0,14.0,15.0,14.0,18.0,11.0,15.0,9.0,15.0,8.0,6.0,11.0,7.0,16.0,15.0,16.0,12.0,10.0,8.0,13.0,10.0,12.0,12.0,20.0,14.0,13.0,11.0,12.0,10.0,9.0,15.0,9.0,12.0,12.0,9.0,12.0,13.0,17.0,5.0,33.0,1.0,0.0,15.0,1.0,183.0,77.0,2.0,3.0,3.0,1.0,3.0,3.0,3.0,3.0,3.0,2.0,1.0,8.0,10.0,10.0,7.0,14.0,10.0,15.0,7.0,10.0,14.0,15.0,10.0,14.0,14.0,12.0,14.0,11.0,11.0,14.0,12.0,13.0,9.0,11.0,12.0,9.0,15.0,11.0,12.0,11.0,11.0,12.0,12.0,12.0,9.0,12.0,20.0,12.0,12.0,14.0,7.0,13.0,14.0,9.0,12.0,15.0,8.0,7.0,10.0,13.0,14.0,8.0,31.0,0.0,0.0,0.0,0.0,183.0,73.0,1.0,2.0,1.0,3.0,2.0,1.0,2.0,3.0,2.0,2.0,4.0,8.0,9.0,10.0,7.0,12.0,5.0,12.0,10.0,7.0,11.0,12.0,8.0,13.0,9.0,12.0,12.0,13.0,8.0,11.0,10.0,14.0,11.0,7.0,8.0,8.0,14.0,14.0,14.0,12.0,12.0,10.0,14.0,8.0,13.0,11.0,20.0,14.0,13.0,12.0,13.0,10.0,14.0,9.0,8.0,7.0,12.0,12.0,12.0,11.0,20.0,10.0,35.0,103.0,2.0,16.0,0.0,178.0,72.0,3.0,3.0,3.0,1.0,2.0,1.0,2.0,2.0,1.0,3.0,2.0,16.0,15.0,12.0,10.0,14.0,16.0,10.0,13.0,13.0,12.0,13.0,9.0,14.0,15.0,11.0,12.0,12.0,12.0,12.0,12.0,13.0,13.0,8.0,16.0,14.0,10.0,14.0,15.0,13.0,12.0,10.0,9.0,20.0,16.0,12.0,8.0,13.0,10.0,14.0,4.0,15.0,6.0,10.0,19.0,14.0,16.0,16.0,14.0,15.0,16.0,3.0,35.0,0.0,0.0,0.0,0.0,177.0,70.0,1.0,4.0,4.0,3.0,1.0,2.0,3.0,2.0,3.0,3.0,1.0,15.0,14.0,12.0,12.0,17.0,17.0,10.0,14.0,7.0,3.0,18.0,16.0,4.0,17.0,10.0,13.0,8.0,14.0,13.0,18.0,17.0,12.0,17.0,15.0,11.0,8.0,12.0,9.0,9.0,8.0,10.0,7.0,16.0,11.0,9.0,20.0,12.0,9.0,13.0,6.0,12.0,12.0,11.0,12.0,15.0,9.0,12.0,13.0,11.0,12.0,10.0,27.0,0.0,0.0,1.0,0.0,180.0,73.0,4.0,1.0,1.0,3.0,2.0,1.0,3.0,3.0,3.0,2.0,2.0,9.0,9.0,11.0,8.0,12.0,10.0,10.0,11.0,6.0,12.0,13.0,11.0,12.0,12.0,9.0,13.0,14.0,14.0,15.0,13.0,14.0,11.0,10.0,13.0,12.0,14.0,15.0,15.0,13.0,12.0,10.0,10.0,12.0,10.0,11.0,20.0,13.0,12.0,13.0,8.0,11.0,13.0,12.0,12.0,10.0,11.0,13.0,13.0,12.0,9.0,13.0,29.0,0.0,0.0,13.0,1.0,176.0,76.0,1.0,2.0,1.0,1.0,3.0,2.0,4.0,4.0,2.0,1.0,2.0,14.0,15.0,12.0,9.0,13.0,15.0,7.0,13.0,9.0,11.0,13.0,12.0,13.0,13.0,14.0,11.0,15.0,10.0,11.0,10.0,8.0,14.0,14.0,10.0,12.0,9.0,7.0,15.0,14.0,15.0,12.0,8.0,14.0,14.0,13.0,20.0,14.0,10.0,15.0,10.0,11.0,11.0,12.0,9.0,9.0,11.0,10.0,11.0,14.0,8.0,15.0,25.0,0.0,0.0,0.0,0.0,180.0,67.0,3.0,3.0,2.0,4.0,2.0,2.0,2.0,3.0,1.0,3.0,2.0,12.0,13.0,12.0,13.0,13.0,11.0,7.0,12.0,5.0,7.0,14.0,12.0,9.0,14.0,9.0,14.0,9.0,14.0,14.0,14.0,13.0,14.0,14.0,11.0,14.0,10.0,12.0,10.0,13.0,15.0,11.0,8.0,14.0,14.0,12.0,20.0,13.0,10.0,10.0,5.0,12.0,10.0,10.0,15.0,13.0,13.0,12.0,12.0,14.0,16.0,9.0,25.0,0.0,0.0,6.0,1.0,190.0,78.0,3.0,3.0,3.0,3.0,1.0,2.0,3.0,3.0,3.0,2.0,3.0,10.0,10.0,13.0,11.0,12.0,13.0,11.0,16.0,8.0,4.0,12.0,13.0,8.0,14.0,10.0,8.0,8.0,7.0,7.0,8.0,9.0,14.0,17.0,5.0,13.0,7.0,9.0,13.0,17.0,13.0,12.0,15.0,12.0,17.0,16.0,20.0,16.0,17.0,10.0,7.0,9.0,7.0,12.0,6.0,17.0,10.0,12.0,10.0,12.0,12.0,10.0,34.0,0.0,0.0,0.0,0.0,179.0,77.0,1.0,4.0,3.0,1.0,4.0,1.0,1.0,3.0,2.0,1.0,1.0,7.0,11.0,13.0,15.0,15.0,8.0,13.0,12.0,5.0,4.0,13.0,13.0,7.0,14.0,8.0,13.0,14.0,14.0,13.0,13.0,13.0,13.0,16.0,9.0,14.0,7.0,14.0,13.0,12.0,13.0,14.0,12.0,12.0,12.0,12.0,20.0,13.0,13.0,13.0,5.0,12.0,8.0,5.0,3.0,13.0,12.0,12.0,13.0,12.0,11.0,9.0
1,0,23.0,8.0,0.0,19.0,0.0,185.0,77.0,15.0,14.0,14.0,4.0,19.0,17.0,17.0,19.0,15.0,9.0,15.0,10.0,1.0,2.0,2.0,13.0,12.0,4.0,3.0,2.0,1.0,5.0,12.0,2.0,12.0,8.0,12.0,12.0,16.0,17.0,14.0,16.0,15.0,3.0,6.0,3.0,17.0,14.0,14.0,12.0,14.0,14.0,14.0,8.0,9.0,14.0,20.0,14.0,14.0,15.0,8.0,15.0,5.0,13.0,14.0,19.0,6.0,16.0,7.0,15.0,14.0,7.0,30.0,91.0,4.0,9.0,0.0,185.0,73.0,1.0,3.0,3.0,1.0,3.0,1.0,2.0,2.0,3.0,1.0,2.0,4.0,5.0,8.0,10.0,11.0,5.0,18.0,7.0,9.0,17.0,11.0,11.0,16.0,11.0,14.0,16.0,18.0,16.0,16.0,8.0,17.0,16.0,6.0,15.0,7.0,16.0,16.0,16.0,11.0,12.0,11.0,16.0,11.0,15.0,14.0,20.0,15.0,14.0,16.0,14.0,15.0,6.0,5.0,16.0,13.0,12.0,13.0,14.0,11.0,10.0,6.0,22.0,0.0,0.0,0.0,0.0,174.0,70.0,2.0,1.0,2.0,1.0,2.0,2.0,3.0,2.0,2.0,2.0,3.0,13.0,12.0,13.0,9.0,13.0,8.0,6.0,8.0,3.0,3.0,12.0,6.0,3.0,13.0,10.0,10.0,8.0,9.0,6.0,11.0,9.0,8.0,14.0,3.0,12.0,6.0,8.0,8.0,14.0,15.0,8.0,8.0,20.0,8.0,14.0,15.0,8.0,8.0,8.0,8.0,1.0,6.0,11.0,13.0,9.0,12.0,10.0,12.0,12.0,14.0,13.0,27.0,0.0,0.0,0.0,0.0,180.0,69.0,2.0,1.0,3.0,3.0,1.0,1.0,3.0,2.0,2.0,3.0,2.0,12.0,16.0,14.0,10.0,13.0,11.0,6.0,13.0,14.0,9.0,13.0,8.0,5.0,14.0,7.0,13.0,14.0,11.0,13.0,13.0,12.0,12.0,14.0,13.0,14.0,12.0,14.0,10.0,15.0,14.0,11.0,9.0,11.0,12.0,16.0,20.0,13.0,9.0,12.0,8.0,11.0,6.0,17.0,12.0,14.0,13.0,10.0,15.0,15.0,8.0,7.0,30.0,26.0,1.0,23.0,7.0,182.0,79.0,2.0,1.0,2.0,1.0,1.0,3.0,3.0,3.0,3.0,2.0,1.0,13.0,15.0,15.0,12.0,15.0,13.0,9.0,13.0,12.0,12.0,14.0,14.0,12.0,16.0,13.0,15.0,14.0,15.0,14.0,14.0,14.0,16.0,13.0,11.0,15.0,11.0,14.0,16.0,15.0,15.0,11.0,13.0,20.0,9.0,14.0,10.0,16.0,11.0,15.0,12.0,15.0,10.0,13.0,10.0,13.0,13.0,10.0,14.0,10.0,7.0,12.0,35.0,66.0,3.0,21.0,3.0,183.0,75.0,1.0,2.0,1.0,1.0,1.0,2.0,1.0,3.0,3.0,3.0,1.0,14.0,12.0,13.0,12.0,16.0,13.0,12.0,14.0,11.0,12.0,16.0,12.0,12.0,15.0,9.0,13.0,12.0,14.0,14.0,16.0,16.0,12.0,9.0,7.0,12.0,15.0,14.0,13.0,11.0,11.0,10.0,10.0,14.0,13.0,11.0,20.0,15.0,12.0,15.0,13.0,14.0,9.0,10.0,7.0,12.0,15.0,8.0,16.0,13.0,12.0,6.0,31.0,0.0,0.0,0.0,0.0,178.0,74.0,2.0,3.0,1.0,2.0,4.0,1.0,1.0,1.0,1.0,3.0,1.0,3.0,2.0,7.0,2.0,7.0,4.0,7.0,1.0,3.0,14.0,7.0,6.0,12.0,3.0,9.0,8.0,10.0,6.0,10.0,3.0,9.0,6.0,2.0,3.0,7.0,13.0,8.0,9.0,14.0,10.0,9.0,7.0,20.0,6.0,13.0,5.0,7.0,7.0,9.0,1.0,9.0,9.0,9.0,7.0,10.0,13.0,9.0,10.0,8.0,20.0,5.0,22.0,9.0,1.0,7.0,1.0,180.0,66.0,1.0,1.0,2.0,2.0,2.0,3.0,1.0,3.0,2.0,2.0,1.0,14.0,13.0,17.0,14.0,14.0,15.0,8.0,13.0,6.0,4.0,14.0,15.0,4.0,17.0,11.0,12.0,11.0,14.0,11.0,15.0,13.0,15.0,15.0,8.0,16.0,7.0,10.0,13.0,16.0,14.0,14.0,10.0,13.0,12.0,17.0,20.0,13.0,11.0,12.0,10.0,13.0,11.0,12.0,10.0,16.0,10.0,13.0,12.0,12.0,16.0,7.0,24.0,24.0,0.0,9.0,1.0,178.0,73.0,3.0,1.0,2.0,3.0,1.0,3.0,2.0,1.0,1.0,3.0,1.0,16.0,16.0,13.0,13.0,15.0,14.0,9.0,14.0,6.0,13.0,16.0,10.0,14.0,14.0,14.0,15.0,15.0,16.0,17.0,15.0,16.0,15.0,10.0,14.0,15.0,15.0,17.0,16.0,13.0,13.0,15.0,9.0,14.0,14.0,13.0,20.0,15.0,12.0,15.0,10.0,13.0,6.0,18.0,12.0,14.0,16.0,13.0,15.0,11.0,12.0,6.0,25.0,34.0,13.0,6.0,2.0,175.0,72.0,3.0,1.0,4.0,14.0,1.0,1.0,1.0,3.0,2.0,2.0,2.0,14.0,17.0,17.0,18.0,19.0,15.0,15.0,14.0,4.0,5.0,14.0,13.0,11.0,17.0,13.0,15.0,13.0,14.0,15.0,15.0,15.0,17.0,17.0,14.0,18.0,10.0,12.0,15.0,15.0,15.0,15.0,9.0,20.0,15.0,14.0,15.0,13.0,10.0,16.0,6.0,14.0,5.0,14.0,13.0,18.0,12.0,12.0,14.0,14.0,8.0,13.0,29.0,39.0,10.0,0.0,0.0,185.0,80.0,3.0,2.0,3.0,1.0,2.0,1.0,1.0,1.0,1.0,3.0,2.0,6.0,9.0,12.0,16.0,13.0,5.0,15.0,10.0,4.0,4.0,11.0,14.0,4.0,13.0,13.0,15.0,13.0,17.0,15.0,12.0,14.0,16.0,14.0,15.0,15.0,12.0,15.0,15.0,13.0,11.0,16.0,15.0,12.0,18.0,13.0,20.0,15.0,17.0,15.0,7.0,14.0,9.0,6.0,16.0,16.0,16.0,17.0,18.0,16.0,16.0,6.0,32.0,0.0,0.0,1.0,0.0,187.0,79.0,14.0,14.0,14.0,15.0,15.0,13.0,16.0,15.0,15.0,16.0,15.0,7.0,12.0,12.0,3.0,12.0,11.0,8.0,15.0,3.0,2.0,12.0,2.0,2.0,11.0,10.0,12.0,14.0,14.0,12.0,12.0,11.0,14.0,12.0,17.0,7.0,13.0,11.0,11.0,14.0,12.0,10.0,13.0,20.0,13.0,12.0,10.0,11.0,10.0,13.0,10.0,17.0,11.0,11.0,18.0,13.0,15.0,13.0,10.0,11.0,7.0,13.0,16.0,0.0,0.0,0.0,0.0,189.0,0.0,3.0,3.0,3.0,1.0,1.0,3.0,1.0,3.0,1.0,1.0,2.0,5.0,7.0,5.0,4.0,6.0,6.0,1.0,1.0,4.0,2.0,5.0,3.0,5.0,10.0,10.0,4.0,5.0,6.0,3.0,7.0,7.0,5.0,11.0,3.0,4.0,3.0,7.0,7.0,11.0,7.0,4.0,12.0,20.0,9.0,9.0,9.0,9.0,6.0,5.0,11.0,4.0,10.0,12.0,10.0,11.0,12.0,12.0,9.0,7.0,7.0,10.0,26.0,0.0,0.0,0.0,0.0,187.0,76.0,2.0,3.0,2.0,2.0,3.0,1.0,3.0,4.0,2.0,3.0,1.0,5.0,3.0,4.0,6.0,8.0,7.0,12.0,4.0,1.0,10.0,9.0,5.0,13.0,4.0,6.0,14.0,9.0,8.0,11.0,6.0,10.0,2.0,5.0,7.0,5.0,12.0,8.0,9.0,14.0,11.0,9.0,14.0,20.0,9.0,10.0,10.0,14.0,13.0,10.0,10.0,10.0,4.0,10.0,17.0,9.0,8.0,11.0,11.0,6.0,10.0,3.0,29.0,0.0,0.0,0.0,0.0,168.0,67.0,2.0,2.0,1.0,2.0,3.0,2.0,3.0,3.0,2.0,3.0,2.0,7.0,11.0,10.0,9.0,12.0,4.0,11.0,12.0,10.0,12.0,13.0,12.0,12.0,12.0,12.0,12.0,17.0,16.0,11.0,9.0,10.0,12.0,13.0,16.0,9.0,11.0,15.0,16.0,11.0,12.0,15.0,5.0,10.0,12.0,11.0,20.0,15.0,14.0,10.0,11.0,16.0,13.0,20.0,14.0,10.0,14.0,13.0,18.0,17.0,20.0,1.0,24.0,0.0,0.0,0.0,0.0,181.0,72.0,3.0,4.0,2.0,2.0,2.0,2.0,3.0,1.0,2.0,2.0,3.0,8.0,13.0,12.0,10.0,11.0,10.0,9.0,11.0,15.0,10.0,13.0,9.0,12.0,12.0,12.0,11.0,11.0,12.0,11.0,14.0,11.0,18.0,14.0,8.0,12.0,11.0,13.0,13.0,11.0,13.0,9.0,8.0,20.0,12.0,15.0,10.0,12.0,9.0,13.0,5.0,14.0,14.0,15.0,18.0,13.0,13.0,12.0,11.0,11.0,13.0,6.0,18.0,0.0,0.0,0.0,0.0,180.0,0.0,3.0,2.0,1.0,3.0,2.0,2.0,3.0,2.0,4.0,2.0,1.0,8.0,7.0,6.0,9.0,7.0,6.0,8.0,12.0,4.0,12.0,11.0,1.0,11.0,11.0,9.0,9.0,8.0,10.0,9.0,11.0,15.0,9.0,6.0,1.0,8.0,10.0,9.0,8.0,11.0,12.0,5.0,7.0,8.0,10.0,10.0,20.0,6.0,11.0,9.0,9.0,4.0,6.0,9.0,8.0,12.0,12.0,12.0,11.0,4.0,10.0,3.0,23.0,0.0,0.0,0.0,0.0,181.0,74.0,2.0,3.0,2.0,3.0,3.0,1.0,1.0,3.0,3.0,3.0,4.0,13.0,13.0,11.0,10.0,15.0,11.0,6.0,12.0,6.0,10.0,14.0,14.0,11.0,16.0,14.0,16.0,15.0,16.0,12.0,13.0,14.0,15.0,11.0,8.0,12.0,13.0,16.0,15.0,11.0,13.0,15.0,9.0,9.0,14.0,11.0,20.0,17.0,12.0,10.0,13.0,12.0,8.0,10.0,12.0,14.0,12.0,14.0,15.0,9.0,11.0,4.0,20.0,9.0,0.0,6.0,0.0,170.0,61.0,3.0,3.0,4.0,1.0,3.0,2.0,3.0,2.0,3.0,3.0,2.0,14.0,12.0,18.0,12.0,17.0,11.0,5.0,14.0,6.0,5.0,13.0,11.0,7.0,17.0,9.0,11.0,7.0,13.0,9.0,15.0,10.0,11.0,18.0,6.0,12.0,7.0,8.0,9.0,15.0,17.0,10.0,6.0,20.0,12.0,12.0,10.0,11.0,7.0,11.0,10.0,11.0,6.0,12.0,10.0,18.0,7.0,13.0,10.0,8.0,10.0,14.0,27.0,0.0,0.0,0.0,0.0,171.0,63.0,2.0,1.0,1.0,3.0,1.0,2.0,4.0,2.0,2.0,2.0,3.0,8.0,4.0,6.0,6.0,13.0,8.0,8.0,6.0,1.0,14.0,13.0,5.0,8.0,14.0,6.0,10.0,9.0,8.0,9.0,14.0,12.0,10.0,10.0,11.0,12.0,11.0,9.0,13.0,14.0,14.0,9.0,5.0,5.0,10.0,14.0,20.0,9.0,6.0,10.0,7.0,10.0,10.0,10.0,13.0,13.0,9.0,9.0,12.0,11.0,14.0,2.0,17.0,0.0,0.0,0.0,0.0,176.0,0.0,3.0,3.0,3.0,2.0,1.0,3.0,1.0,3.0,2.0,4.0,3.0,1.0,1.0,1.0,2.0,6.0,1.0,12.0,2.0,2.0,8.0,2.0,1.0,8.0,1.0,15.0,8.0,5.0,1.0,5.0,3.0,10.0,4.0,2.0,9.0,1.0,6.0,7.0,10.0,5.0,7.0,12.0,7.0,13.0,15.0,7.0,20.0,6.0,5.0,14.0,9.0,12.0,2.0,6.0,7.0,5.0,12.0,7.0,8.0,9.0,10.0,10.0,25.0,0.0,0.0,0.0,0.0,181.0,77.0,3.0,1.0,1.0,2.0,1.0,2.0,1.0,3.0,3.0,3.0,2.0,9.0,10.0,11.0,12.0,11.0,14.0,13.0,10.0,6.0,9.0,11.0,15.0,9.0,11.0,15.0,11.0,15.0,12.0,12.0,12.0,12.0,9.0,12.0,12.0,13.0,10.0,14.0,15.0,12.0,12.0,11.0,12.0,12.0,15.0,12.0,20.0,14.0,16.0,12.0,9.0,17.0,12.0,11.0,16.0,10.0,11.0,11.0,13.0,13.0,17.0,6.0
1,1,29.0,0.0,0.0,0.0,0.0,190.0,80.0,14.0,13.0,13.0,6.0,15.0,14.0,12.0,15.0,13.0,17.0,15.0,7.0,1.0,3.0,2.0,8.0,9.0,8.0,2.0,3.0,3.0,8.0,2.0,3.0,10.0,6.0,13.0,13.0,7.0,15.0,10.0,13.0,15.0,3.0,9.0,2.0,16.0,11.0,11.0,9.0,13.0,14.0,15.0,8.0,13.0,11.0,20.0,14.0,13.0,10.0,4.0,12.0,6.0,12.0,12.0,15.0,13.0,11.0,14.0,15.0,11.0,8.0,22.0,1.0,0.0,25.0,0.0,185.0,79.0,2.0,1.0,1.0,1.0,1.0,1.0,2.0,2.0,2.0,1.0,2.0,7.0,10.0,11.0,10.0,12.0,2.0,15.0,7.0,10.0,14.0,10.0,5.0,12.0,12.0,13.0,12.0,14.0,12.0,14.0,8.0,12.0,14.0,6.0,14.0,14.0,13.0,14.0,14.0,12.0,12.0,14.0,13.0,10.0,11.0,12.0,20.0,13.0,14.0,13.0,13.0,13.0,10.0,12.0,11.0,13.0,12.0,13.0,12.0,9.0,10.0,6.0,26.0,0.0,0.0,0.0,0.0,185.0,80.0,3.0,1.0,1.0,2.0,2.0,3.0,2.0,2.0,2.0,2.0,3.0,6.0,8.0,10.0,9.0,10.0,7.0,13.0,10.0,13.0,13.0,12.0,5.0,13.0,13.0,14.0,12.0,14.0,14.0,12.0,8.0,13.0,14.0,8.0,12.0,8.0,14.0,15.0,14.0,13.0,12.0,13.0,13.0,10.0,12.0,12.0,20.0,14.0,14.0,11.0,14.0,12.0,8.0,12.0,12.0,16.0,14.0,11.0,14.0,11.0,12.0,11.0,30.0,0.0,0.0,0.0,0.0,178.0,76.0,3.0,1.0,3.0,1.0,1.0,3.0,2.0,1.0,2.0,2.0,1.0,9.0,13.0,12.0,7.0,13.0,12.0,10.0,12.0,12.0,12.0,10.0,9.0,13.0,10.0,10.0,12.0,14.0,13.0,13.0,8.0,14.0,11.0,6.0,14.0,6.0,15.0,15.0,14.0,12.0,12.0,12.0,9.0,20.0,15.0,13.0,10.0,15.0,11.0,13.0,7.0,11.0,10.0,10.0,16.0,14.0,11.0,14.0,11.0,13.0,15.0,5.0,21.0,0.0,0.0,0.0,0.0,183.0,70.0,3.0,1.0,3.0,1.0,3.0,1.0,1.0,3.0,3.0,1.0,1.0,8.0,11.0,12.0,7.0,12.0,8.0,11.0,8.0,8.0,13.0,9.0,5.0,13.0,10.0,12.0,12.0,10.0,12.0,12.0,9.0,12.0,19.0,4.0,8.0,13.0,12.0,13.0,13.0,13.0,12.0,10.0,13.0,12.0,14.0,14.0,20.0,14.0,12.0,12.0,11.0,11.0,10.0,14.0,13.0,11.0,13.0,13.0,10.0,9.0,11.0,1.0,32.0,44.0,0.0,0.0,0.0,176.0,60.0,1.0,3.0,2.0,1.0,1.0,3.0,2.0,2.0,1.0,3.0,2.0,7.0,9.0,10.0,7.0,13.0,13.0,12.0,14.0,12.0,13.0,11.0,11.0,15.0,11.0,15.0,14.0,17.0,10.0,13.0,10.0,14.0,15.0,8.0,12.0,12.0,14.0,17.0,17.0,13.0,13.0,13.0,10.0,20.0,17.0,13.0,10.0,16.0,12.0,14.0,14.0,15.0,7.0,14.0,17.0,14.0,8.0,15.0,15.0,9.0,8.0,10.0,22.0,0.0,0.0,0.0,0.0,186.0,0.0,3.0,1.0,3.0,1.0,2.0,2.0,2.0,1.0,1.0,1.0,1.0,8.0,3.0,8.0,6.0,11.0,3.0,12.0,6.0,5.0,11.0,11.0,4.0,11.0,6.0,10.0,8.0,11.0,7.0,9.0,9.0,13.0,9.0,7.0,11.0,10.0,13.0,10.0,12.0,12.0,10.0,11.0,13.0,20.0,10.0,11.0,8.0,12.0,12.0,10.0,10.0,6.0,5.0,10.0,18.0,11.0,9.0,13.0,9.0,4.0,5.0,1.0,22.0,0.0,0.0,0.0,0.0,189.0,0.0,3.0,1.0,1.0,3.0,2.0,3.0,3.0,2.0,3.0,2.0,1.0,7.0,11.0,13.0,9.0,11.0,7.0,4.0,9.0,4.0,7.0,10.0,8.0,4.0,11.0,10.0,6.0,9.0,5.0,7.0,10.0,11.0,10.0,10.0,10.0,9.0,7.0,8.0,12.0,13.0,11.0,5.0,12.0,10.0,7.0,11.0,20.0,13.0,9.0,10.0,7.0,9.0,10.0,10.0,11.0,10.0,10.0,13.0,10.0,3.0,8.0,4.0,31.0,0.0,0.0,0.0,0.0,187.0,73.0,4.0,4.0,2.0,2.0,2.0,1.0,3.0,3.0,2.0,3.0,1.0,14.0,15.0,14.0,13.0,14.0,10.0,9.0,14.0,11.0,7.0,13.0,12.0,8.0,13.0,11.0,13.0,14.0,13.0,10.0,12.0,14.0,13.0,16.0,11.0,15.0,9.0,12.0,14.0,12.0,12.0,12.0,13.0,10.0,8.0,16.0,20.0,12.0,11.0,11.0,8.0,13.0,12.0,15.0,10.0,13.0,12.0,9.0,14.0,13.0,14.0,8.0,25.0,0.0,0.0,1.0,0.0,182.0,71.0,1.0,2.0,3.0,1.0,4.0,3.0,3.0,3.0,2.0,3.0,3.0,9.0,13.0,14.0,14.0,12.0,10.0,13.0,12.0,8.0,7.0,12.0,11.0,7.0,14.0,9.0,13.0,13.0,12.0,13.0,13.0,11.0,11.0,12.0,8.0,14.0,7.0,12.0,12.0,13.0,14.0,12.0,12.0,12.0,12.0,15.0,20.0,14.0,12.0,11.0,7.0,12.0,14.0,8.0,19.0,14.0,11.0,12.0,13.0,12.0,12.0,12.0,24.0,0.0,0.0,13.0,2.0,174.0,70.0,1.0,1.0,3.0,3.0,1.0,2.0,2.0,3.0,3.0,1.0,3.0,14.0,15.0,16.0,11.0,16.0,16.0,8.0,12.0,5.0,8.0,16.0,12.0,6.0,17.0,10.0,11.0,10.0,12.0,11.0,15.0,12.0,9.0,16.0,8.0,14.0,5.0,11.0,10.0,15.0,16.0,9.0,7.0,20.0,12.0,14.0,8.0,13.0,9.0,12.0,9.0,15.0,10.0,14.0,17.0,12.0,10.0,12.0,13.0,14.0,10.0,10.0,28.0,0.0,0.0,0.0,0.0,180.0,78.0,11.0,11.0,10.0,12.0,11.0,11.0,17.0,15.0,14.0,10.0,12.0,5.0,3.0,3.0,1.0,8.0,8.0,6.0,3.0,1.0,3.0,10.0,3.0,1.0,8.0,8.0,11.0,11.0,12.0,12.0,6.0,11.0,13.0,4.0,12.0,2.0,14.0,13.0,12.0,12.0,15.0,11.0,10.0,11.0,13.0,12.0,20.0,12.0,10.0,12.0,7.0,14.0,4.0,11.0,19.0,9.0,17.0,11.0,15.0,12.0,13.0,6.0,33.0,0.0,0.0,0.0,0.0,180.0,70.0,1.0,3.0,1.0,2.0,3.0,2.0,3.0,2.0,1.0,1.0,1.0,5.0,8.0,6.0,4.0,10.0,6.0,12.0,7.0,9.0,15.0,12.0,4.0,13.0,11.0,11.0,15.0,14.0,12.0,17.0,9.0,13.0,13.0,4.0,12.0,6.0,16.0,17.0,15.0,10.0,11.0,10.0,10.0,20.0,13.0,11.0,8.0,10.0,10.0,19.0,6.0,13.0,3.0,13.0,13.0,11.0,14.0,13.0,17.0,15.0,16.0,5.0,22.0,1.0,0.0,7.0,0.0,186.0,75.0,1.0,4.0,3.0,2.0,1.0,2.0,3.0,4.0,3.0,4.0,3.0,8.0,10.0,9.0,6.0,14.0,6.0,14.0,6.0,13.0,15.0,13.0,9.0,16.0,14.0,15.0,14.0,18.0,11.0,15.0,9.0,15.0,8.0,6.0,11.0,7.0,16.0,15.0,16.0,12.0,10.0,8.0,13.0,10.0,12.0,12.0,20.0,14.0,13.0,11.0,12.0,10.0,9.0,15.0,9.0,12.0,12.0,9.0,12.0,13.0,17.0,5.0,28.0,0.0,0.0,0.0,0.0,182.0,0.0,3.0,2.0,2.0,2.0,2.0,3.0,1.0,2.0,1.0,1.0,1.0,6.0,5.0,10.0,4.0,13.0,4.0,6.0,9.0,1.0,6.0,12.0,5.0,4.0,13.0,9.0,7.0,4.0,10.0,7.0,11.0,9.0,5.0,13.0,4.0,9.0,6.0,7.0,12.0,13.0,11.0,7.0,5.0,7.0,11.0,10.0,20.0,13.0,9.0,9.0,9.0,9.0,8.0,9.0,7.0,12.0,9.0,14.0,12.0,11.0,15.0,4.0,31.0,0.0,0.0,0.0,0.0,183.0,73.0,1.0,2.0,1.0,3.0,2.0,1.0,2.0,3.0,2.0,2.0,4.0,8.0,9.0,10.0,7.0,12.0,5.0,12.0,10.0,7.0,11.0,12.0,8.0,13.0,9.0,12.0,12.0,13.0,8.0,11.0,10.0,14.0,11.0,7.0,8.0,8.0,14.0,14.0,14.0,12.0,12.0,10.0,14.0,8.0,13.0,11.0,20.0,14.0,13.0,12.0,13.0,10.0,14.0,9.0,8.0,7.0,12.0,12.0,12.0,11.0,20.0,10.0,35.0,0.0,0.0,0.0,0.0,177.0,70.0,1.0,4.0,4.0,3.0,1.0,2.0,3.0,2.0,3.0,3.0,1.0,15.0,14.0,12.0,12.0,17.0,17.0,10.0,14.0,7.0,3.0,18.0,16.0,4.0,17.0,10.0,13.0,8.0,14.0,13.0,18.0,17.0,12.0,17.0,15.0,11.0,8.0,12.0,9.0,9.0,8.0,10.0,7.0,16.0,11.0,9.0,20.0,12.0,9.0,13.0,6.0,12.0,12.0,11.0,12.0,15.0,9.0,12.0,13.0,11.0,12.0,10.0,27.0,0.0,0.0,1.0,0.0,180.0,73.0,4.0,1.0,1.0,3.0,2.0,1.0,3.0,3.0,3.0,2.0,2.0,9.0,9.0,11.0,8.0,12.0,10.0,10.0,11.0,6.0,12.0,13.0,11.0,12.0,12.0,9.0,13.0,14.0,14.0,15.0,13.0,14.0,11.0,10.0,13.0,12.0,14.0,15.0,15.0,13.0,12.0,10.0,10.0,12.0,10.0,11.0,20.0,13.0,12.0,13.0,8.0,11.0,13.0,12.0,12.0,10.0,11.0,13.0,13.0,12.0,9.0,13.0,25.0,0.0,0.0,6.0,1.0,190.0,78.0,3.0,3.0,3.0,3.0,1.0,2.0,3.0,3.0,3.0,2.0,3.0,10.0,10.0,13.0,11.0,12.0,13.0,11.0,16.0,8.0,4.0,12.0,13.0,8.0,14.0,10.0,8.0,8.0,7.0,7.0,8.0,9.0,14.0,17.0,5.0,13.0,7.0,9.0,13.0,17.0,13.0,12.0,15.0,12.0,17.0,16.0,20.0,16.0,17.0,10.0,7.0,9.0,7.0,12.0,6.0,17.0,10.0,12.0,10.0,12.0,12.0,10.0,25.0,0.0,0.0,0.0,0.0,180.0,67.0,3.0,3.0,2.0,4.0,2.0,2.0,2.0,3.0,1.0,3.0,2.0,12.0,13.0,12.0,13.0,13.0,11.0,7.0,12.0,5.0,7.0,14.0,12.0,9.0,14.0,9.0,14.0,9.0,14.0,14.0,14.0,13.0,14.0,14.0,11.0,14.0,10.0,12.0,10.0,13.0,15.0,11.0,8.0,14.0,14.0,12.0,20.0,13.0,10.0,10.0,5.0,12.0,10.0,10.0,15.0,13.0,13.0,12.0,12.0,14.0,16.0,9.0,34.0,0.0,0.0,0.0,0.0,179.0,77.0,1.0,4.0,3.0,1.0,4.0,1.0,1.0,3.0,2.0,1.0,1.0,7.0,11.0,13.0,15.0,15.0,8.0,13.0,12.0,5.0,4.0,13.0,13.0,7.0,14.0,8.0,13.0,14.0,14.0,13.0,13.0,13.0,13.0,16.0,9.0,14.0,7.0,14.0,13.0,12.0,13.0,14.0,12.0,12.0,12.0,12.0,20.0,13.0,13.0,13.0,5.0,12.0,8.0,5.0,3.0,13.0,12.0,12.0,13.0,12.0,11.0,9.0,24.0,0.0,0.0,0.0,0.0,173.0,68.0,2.0,1.0,2.0,2.0,1.0,2.0,3.0,1.0,3.0,3.0,3.0,11.0,13.0,14.0,11.0,13.0,10.0,8.0,11.0,10.0,3.0,12.0,10.0,5.0,13.0,13.0,13.0,12.0,10.0,13.0,12.0,12.0,12.0,13.0,10.0,14.0,8.0,10.0,13.0,14.0,15.0,12.0,7.0,12.0,13.0,14.0,20.0,13.0,9.0,12.0,7.0,14.0,11.0,12.0,12.0,13.0,14.0,14.0,13.0,12.0,14.0,8.0
0,2,32.0,0.0,0.0,10.0,0.0,185.0,76.0,13.0,12.0,11.0,6.0,14.0,13.0,14.0,14.0,12.0,12.0,11.0,6.0,2.0,2.0,1.0,7.0,9.0,3.0,3.0,2.0,3.0,8.0,4.0,3.0,7.0,13.0,13.0,16.0,15.0,14.0,3.0,14.0,13.0,7.0,14.0,5.0,13.0,10.0,10.0,11.0,13.0,14.0,13.0,9.0,14.0,12.0,20.0,14.0,11.0,14.0,7.0,14.0,6.0,12.0,14.0,14.0,10.0,14.0,14.0,13.0,8.0,12.0,26.0,0.0,0.0,0.0,0.0,180.0,76.0,2.0,2.0,1.0,1.0,2.0,2.0,3.0,3.0,3.0,2.0,2.0,4.0,7.0,4.0,3.0,10.0,6.0,16.0,11.0,10.0,15.0,9.0,8.0,14.0,8.0,12.0,15.0,13.0,12.0,13.0,9.0,11.0,13.0,5.0,11.0,6.0,14.0,15.0,15.0,13.0,11.0,12.0,13.0,9.0,15.0,14.0,20.0,13.0,14.0,14.0,11.0,11.0,11.0,9.0,13.0,12.0,15.0,13.0,11.0,13.0,10.0,7.0,24.0,0.0,0.0,21.0,1.0,184.0,77.0,1.0,3.0,3.0,1.0,1.0,2.0,1.0,2.0,1.0,3.0,2.0,12.0,14.0,11.0,4.0,12.0,8.0,14.0,8.0,8.0,14.0,12.0,11.0,14.0,12.0,9.0,14.0,13.0,12.0,13.0,12.0,11.0,10.0,9.0,10.0,12.0,13.0,11.0,13.0,12.0,12.0,10.0,13.0,10.0,9.0,15.0,20.0,13.0,14.0,15.0,7.0,12.0,11.0,9.0,10.0,10.0,11.0,10.0,10.0,10.0,10.0,9.0,22.0,0.0,0.0,0.0,0.0,175.0,65.0,1.0,2.0,3.0,1.0,3.0,2.0,2.0,2.0,2.0,1.0,1.0,11.0,14.0,12.0,8.0,11.0,7.0,7.0,8.0,13.0,11.0,11.0,8.0,13.0,13.0,10.0,14.0,11.0,12.0,14.0,11.0,13.0,9.0,8.0,7.0,14.0,12.0,13.0,13.0,14.0,13.0,13.0,8.0,20.0,12.0,14.0,8.0,13.0,10.0,14.0,8.0,11.0,5.0,11.0,19.0,11.0,11.0,10.0,13.0,9.0,13.0,7.0,24.0,0.0,0.0,0.0,0.0,176.0,68.0,3.0,1.0,1.0,1.0,3.0,3.0,1.0,1.0,2.0,1.0,2.0,10.0,13.0,13.0,10.0,11.0,8.0,8.0,9.0,11.0,11.0,12.0,11.0,11.0,12.0,11.0,14.0,12.0,13.0,13.0,9.0,13.0,12.0,13.0,11.0,14.0,12.0,15.0,12.0,15.0,13.0,10.0,8.0,10.0,13.0,14.0,20.0,14.0,13.0,13.0,8.0,15.0,7.0,14.0,9.0,13.0,11.0,13.0,13.0,12.0,11.0,8.0,23.0,0.0,0.0,0.0,0.0,183.0,75.0,2.0,3.0,2.0,2.0,1.0,3.0,2.0,1.0,1.0,3.0,2.0,10.0,12.0,11.0,10.0,14.0,10.0,13.0,13.0,8.0,12.0,13.0,8.0,15.0,12.0,16.0,14.0,15.0,12.0,14.0,11.0,15.0,5.0,9.0,11.0,12.0,15.0,15.0,14.0,13.0,12.0,13.0,11.0,8.0,13.0,13.0,20.0,14.0,12.0,13.0,16.0,12.0,9.0,13.0,14.0,12.0,11.0,13.0,13.0,8.0,9.0,6.0,17.0,0.0,0.0,0.0,0.0,170.0,0.0,3.0,4.0,2.0,2.0,1.0,1.0,1.0,1.0,4.0,1.0,2.0,6.0,7.0,6.0,8.0,14.0,6.0,6.0,6.0,1.0,5.0,5.0,1.0,6.0,9.0,8.0,8.0,3.0,4.0,6.0,9.0,7.0,8.0,8.0,10.0,8.0,5.0,8.0,12.0,14.0,14.0,6.0,7.0,8.0,9.0,10.0,20.0,8.0,4.0,1.0,7.0,5.0,8.0,8.0,8.0,12.0,10.0,10.0,11.0,12.0,17.0,5.0,28.0,2.0,1.0,19.0,9.0,183.0,73.0,3.0,1.0,4.0,3.0,2.0,2.0,3.0,1.0,3.0,3.0,2.0,10.0,11.0,15.0,13.0,16.0,7.0,11.0,10.0,5.0,5.0,14.0,14.0,5.0,15.0,7.0,11.0,8.0,15.0,11.0,13.0,13.0,14.0,15.0,7.0,15.0,7.0,9.0,7.0,12.0,14.0,13.0,11.0,14.0,8.0,13.0,20.0,12.0,11.0,10.0,6.0,14.0,13.0,7.0,11.0,13.0,9.0,9.0,13.0,11.0,12.0,9.0,28.0,19.0,2.0,2.0,0.0,169.0,59.0,1.0,1.0,3.0,1.0,3.0,3.0,1.0,3.0,3.0,1.0,3.0,13.0,12.0,16.0,10.0,15.0,12.0,10.0,10.0,5.0,5.0,14.0,8.0,7.0,16.0,14.0,11.0,6.0,11.0,9.0,14.0,10.0,9.0,18.0,4.0,13.0,6.0,11.0,14.0,17.0,17.0,7.0,6.0,8.0,15.0,14.0,20.0,13.0,5.0,8.0,4.0,8.0,3.0,14.0,10.0,12.0,10.0,8.0,17.0,15.0,18.0,2.0,30.0,0.0,0.0,0.0,0.0,178.0,78.0,2.0,2.0,2.0,2.0,3.0,1.0,1.0,1.0,1.0,3.0,2.0,13.0,15.0,14.0,13.0,10.0,11.0,11.0,15.0,5.0,5.0,15.0,13.0,5.0,14.0,10.0,12.0,11.0,13.0,11.0,12.0,13.0,12.0,14.0,9.0,14.0,8.0,8.0,8.0,15.0,11.0,13.0,9.0,20.0,12.0,13.0,10.0,12.0,13.0,10.0,10.0,12.0,5.0,12.0,8.0,15.0,5.0,11.0,8.0,12.0,8.0,15.0,26.0,0.0,0.0,0.0,0.0,181.0,77.0,2.0,2.0,3.0,3.0,1.0,1.0,3.0,1.0,3.0,3.0,1.0,6.0,9.0,13.0,14.0,13.0,9.0,13.0,12.0,8.0,4.0,12.0,12.0,6.0,13.0,7.0,12.0,9.0,13.0,13.0,9.0,13.0,8.0,10.0,11.0,16.0,12.0,11.0,14.0,14.0,13.0,14.0,12.0,8.0,14.0,15.0,20.0,15.0,12.0,13.0,5.0,12.0,11.0,11.0,15.0,10.0,8.0,7.0,11.0,10.0,20.0,7.0,29.0,66.0,0.0,0.0,0.0,184.0,78.0,10.0,15.0,15.0,4.0,12.0,13.0,17.0,19.0,10.0,16.0,15.0,10.0,1.0,3.0,3.0,8.0,12.0,9.0,1.0,1.0,1.0,9.0,3.0,2.0,6.0,11.0,15.0,15.0,13.0,18.0,8.0,15.0,16.0,8.0,12.0,3.0,13.0,15.0,15.0,12.0,18.0,14.0,12.0,9.0,17.0,14.0,20.0,14.0,13.0,16.0,4.0,17.0,9.0,12.0,14.0,15.0,16.0,15.0,20.0,16.0,19.0,3.0,18.0,0.0,0.0,0.0,0.0,173.0,0.0,3.0,1.0,2.0,3.0,1.0,3.0,3.0,2.0,1.0,1.0,1.0,5.0,5.0,12.0,10.0,14.0,7.0,7.0,10.0,2.0,6.0,12.0,5.0,8.0,14.0,11.0,6.0,8.0,10.0,7.0,13.0,11.0,7.0,13.0,6.0,7.0,5.0,8.0,11.0,13.0,14.0,7.0,8.0,5.0,13.0,14.0,20.0,9.0,5.0,9.0,6.0,9.0,5.0,9.0,13.0,11.0,8.0,12.0,13.0,1.0,5.0,3.0,28.0,0.0,0.0,0.0,0.0,182.0,0.0,3.0,2.0,2.0,2.0,2.0,3.0,1.0,2.0,1.0,1.0,1.0,6.0,5.0,10.0,4.0,13.0,4.0,6.0,9.0,1.0,6.0,12.0,5.0,4.0,13.0,9.0,7.0,4.0,10.0,7.0,11.0,9.0,5.0,13.0,4.0,9.0,6.0,7.0,12.0,13.0,11.0,7.0,5.0,7.0,11.0,10.0,20.0,13.0,9.0,9.0,9.0,9.0,8.0,9.0,7.0,12.0,9.0,14.0,12.0,11.0,15.0,4.0,24.0,5.0,0.0,10.0,1.0,173.0,73.0,2.0,1.0,3.0,2.0,1.0,2.0,2.0,3.0,3.0,1.0,1.0,11.0,14.0,12.0,8.0,13.0,8.0,10.0,9.0,13.0,14.0,13.0,9.0,15.0,12.0,17.0,14.0,18.0,13.0,16.0,12.0,13.0,16.0,12.0,13.0,17.0,13.0,17.0,19.0,16.0,14.0,17.0,8.0,10.0,16.0,14.0,20.0,18.0,12.0,16.0,12.0,11.0,5.0,13.0,15.0,15.0,17.0,14.0,19.0,8.0,9.0,5.0,27.0,0.0,0.0,0.0,0.0,185.0,0.0,4.0,1.0,3.0,3.0,1.0,1.0,3.0,3.0,1.0,1.0,1.0,7.0,5.0,6.0,8.0,13.0,7.0,2.0,10.0,3.0,11.0,7.0,7.0,10.0,9.0,9.0,9.0,9.0,9.0,9.0,7.0,13.0,10.0,10.0,9.0,7.0,8.0,8.0,12.0,13.0,13.0,8.0,9.0,10.0,12.0,12.0,20.0,13.0,9.0,10.0,10.0,1.0,10.0,10.0,20.0,11.0,10.0,10.0,10.0,2.0,17.0,6.0,26.0,71.0,11.0,10.0,2.0,182.0,78.0,1.0,2.0,3.0,3.0,2.0,3.0,2.0,4.0,3.0,2.0,2.0,18.0,18.0,14.0,13.0,18.0,14.0,7.0,17.0,8.0,8.0,20.0,13.0,9.0,16.0,10.0,17.0,10.0,18.0,14.0,18.0,19.0,9.0,11.0,12.0,14.0,12.0,18.0,13.0,12.0,9.0,12.0,10.0,15.0,12.0,13.0,20.0,16.0,14.0,13.0,10.0,14.0,7.0,13.0,8.0,14.0,8.0,14.0,17.0,18.0,17.0,7.0,24.0,46.0,18.0,8.0,1.0,180.0,77.0,1.0,3.0,1.0,3.0,2.0,1.0,3.0,3.0,3.0,3.0,3.0,17.0,16.0,16.0,15.0,17.0,16.0,12.0,17.0,8.0,7.0,17.0,17.0,6.0,16.0,12.0,15.0,12.0,16.0,15.0,17.0,15.0,14.0,18.0,13.0,17.0,10.0,13.0,14.0,14.0,15.0,15.0,10.0,20.0,12.0,13.0,9.0,16.0,12.0,13.0,11.0,16.0,13.0,17.0,15.0,15.0,9.0,14.0,11.0,16.0,14.0,15.0,22.0,29.0,1.0,7.0,0.0,178.0,77.0,2.0,1.0,3.0,4.0,1.0,3.0,3.0,1.0,2.0,2.0,2.0,13.0,14.0,17.0,12.0,17.0,12.0,10.0,13.0,7.0,12.0,17.0,12.0,12.0,17.0,14.0,15.0,13.0,14.0,11.0,16.0,14.0,17.0,16.0,11.0,13.0,11.0,15.0,14.0,14.0,15.0,16.0,9.0,10.0,12.0,14.0,20.0,15.0,12.0,11.0,12.0,13.0,7.0,15.0,12.0,14.0,12.0,14.0,16.0,14.0,17.0,9.0,30.0,93.0,11.0,15.0,2.0,173.0,65.0,3.0,2.0,2.0,3.0,3.0,3.0,4.0,1.0,1.0,1.0,1.0,16.0,16.0,17.0,9.0,19.0,13.0,8.0,12.0,7.0,8.0,19.0,14.0,11.0,18.0,12.0,17.0,13.0,15.0,16.0,18.0,18.0,16.0,13.0,13.0,12.0,12.0,16.0,17.0,14.0,17.0,13.0,7.0,13.0,13.0,13.0,20.0,17.0,8.0,15.0,12.0,14.0,11.0,16.0,10.0,15.0,13.0,17.0,16.0,16.0,17.0,5.0,26.0,61.0,22.0,13.0,3.0,186.0,82.0,2.0,2.0,2.0,1.0,3.0,2.0,1.0,1.0,2.0,1.0,3.0,14.0,16.0,16.0,17.0,15.0,17.0,19.0,19.0,15.0,6.0,14.0,13.0,9.0,16.0,10.0,14.0,11.0,13.0,11.0,13.0,13.0,16.0,17.0,9.0,18.0,7.0,10.0,10.0,15.0,14.0,14.0,15.0,20.0,13.0,19.0,11.0,18.0,17.0,13.0,10.0,13.0,15.0,16.0,8.0,14.0,11.0,14.0,14.0,17.0,14.0,12.0,31.0,133.0,61.0,10.0,3.0,186.0,84.0,2.0,1.0,3.0,1.0,3.0,2.0,2.0,3.0,1.0,3.0,2.0,12.0,14.0,15.0,19.0,16.0,14.0,18.0,19.0,6.0,2.0,14.0,19.0,8.0,15.0,6.0,17.0,16.0,13.0,16.0,13.0,17.0,20.0,18.0,15.0,18.0,5.0,6.0,7.0,13.0,12.0,13.0,16.0,15.0,19.0,17.0,20.0,17.0,16.0,17.0,12.0,14.0,7.0,10.0,18.0,20.0,13.0,19.0,20.0,7.0,7.0,12.0
4,1,29.0,66.0,0.0,0.0,0.0,184.0,78.0,10.0,15.0,15.0,4.0,12.0,13.0,17.0,19.0,10.0,16.0,15.0,10.0,1.0,3.0,3.0,8.0,12.0,9.0,1.0,1.0,1.0,9.0,3.0,2.0,6.0,11.0,15.0,15.0,13.0,18.0,8.0,15.0,16.0,8.0,12.0,3.0,13.0,15.0,15.0,12.0,18.0,14.0,12.0,9.0,17.0,14.0,20.0,14.0,13.0,16.0,4.0,17.0,9.0,12.0,14.0,15.0,16.0,15.0,20.0,16.0,19.0,3.0,18.0,0.0,0.0,0.0,0.0,173.0,0.0,3.0,1.0,2.0,3.0,1.0,3.0,3.0,2.0,1.0,1.0,1.0,5.0,5.0,12.0,10.0,14.0,7.0,7.0,10.0,2.0,6.0,12.0,5.0,8.0,14.0,11.0,6.0,8.0,10.0,7.0,13.0,11.0,7.0,13.0,6.0,7.0,5.0,8.0,11.0,13.0,14.0,7.0,8.0,5.0,13.0,14.0,20.0,9.0,5.0,9.0,6.0,9.0,5.0,9.0,13.0,11.0,8.0,12.0,13.0,1.0,5.0,3.0,28.0,0.0,0.0,0.0,0.0,182.0,0.0,3.0,2.0,2.0,2.0,2.0,3.0,1.0,2.0,1.0,1.0,1.0,6.0,5.0,10.0,4.0,13.0,4.0,6.0,9.0,1.0,6.0,12.0,5.0,4.0,13.0,9.0,7.0,4.0,10.0,7.0,11.0,9.0,5.0,13.0,4.0,9.0,6.0,7.0,12.0,13.0,11.0,7.0,5.0,7.0,11.0,10.0,20.0,13.0,9.0,9.0,9.0,9.0,8.0,9.0,7.0,12.0,9.0,14.0,12.0,11.0,15.0,4.0,27.0,0.0,0.0,0.0,0.0,185.0,0.0,4.0,1.0,3.0,3.0,1.0,1.0,3.0,3.0,1.0,1.0,1.0,7.0,5.0,6.0,8.0,13.0,7.0,2.0,10.0,3.0,11.0,7.0,7.0,10.0,9.0,9.0,9.0,9.0,9.0,9.0,7.0,13.0,10.0,10.0,9.0,7.0,8.0,8.0,12.0,13.0,13.0,8.0,9.0,10.0,12.0,12.0,20.0,13.0,9.0,10.0,10.0,1.0,10.0,10.0,20.0,11.0,10.0,10.0,10.0,2.0,17.0,6.0,26.0,71.0,11.0,10.0,2.0,182.0,78.0,1.0,2.0,3.0,3.0,2.0,3.0,2.0,4.0,3.0,2.0,2.0,18.0,18.0,14.0,13.0,18.0,14.0,7.0,17.0,8.0,8.0,20.0,13.0,9.0,16.0,10.0,17.0,10.0,18.0,14.0,18.0,19.0,9.0,11.0,12.0,14.0,12.0,18.0,13.0,12.0,9.0,12.0,10.0,15.0,12.0,13.0,20.0,16.0,14.0,13.0,10.0,14.0,7.0,13.0,8.0,14.0,8.0,14.0,17.0,18.0,17.0,7.0,30.0,93.0,11.0,15.0,2.0,173.0,65.0,3.0,2.0,2.0,3.0,3.0,3.0,4.0,1.0,1.0,1.0,1.0,16.0,16.0,17.0,9.0,19.0,13.0,8.0,12.0,7.0,8.0,19.0,14.0,11.0,18.0,12.0,17.0,13.0,15.0,16.0,18.0,18.0,16.0,13.0,13.0,12.0,12.0,16.0,17.0,14.0,17.0,13.0,7.0,13.0,13.0,13.0,20.0,17.0,8.0,15.0,12.0,14.0,11.0,16.0,10.0,15.0,13.0,17.0,16.0,16.0,17.0,5.0,24.0,46.0,18.0,8.0,1.0,180.0,77.0,1.0,3.0,1.0,3.0,2.0,1.0,3.0,3.0,3.0,3.0,3.0,17.0,16.0,16.0,15.0,17.0,16.0,12.0,17.0,8.0,7.0,17.0,17.0,6.0,16.0,12.0,15.0,12.0,16.0,15.0,17.0,15.0,14.0,18.0,13.0,17.0,10.0,13.0,14.0,14.0,15.0,15.0,10.0,20.0,12.0,13.0,9.0,16.0,12.0,13.0,11.0,16.0,13.0,17.0,15.0,15.0,9.0,14.0,11.0,16.0,14.0,15.0,26.0,61.0,22.0,13.0,3.0,186.0,82.0,2.0,2.0,2.0,1.0,3.0,2.0,1.0,1.0,2.0,1.0,3.0,14.0,16.0,16.0,17.0,15.0,17.0,19.0,19.0,15.0,6.0,14.0,13.0,9.0,16.0,10.0,14.0,11.0,13.0,11.0,13.0,13.0,16.0,17.0,9.0,18.0,7.0,10.0,10.0,15.0,14.0,14.0,15.0,20.0,13.0,19.0,11.0,18.0,17.0,13.0,10.0,13.0,15.0,16.0,8.0,14.0,11.0,14.0,14.0,17.0,14.0,12.0,25.0,2.0,0.0,0.0,0.0,173.0,70.0,1.0,1.0,3.0,1.0,2.0,4.0,1.0,2.0,3.0,2.0,4.0,14.0,14.0,14.0,11.0,14.0,11.0,10.0,11.0,8.0,8.0,13.0,12.0,12.0,14.0,15.0,13.0,13.0,11.0,13.0,12.0,13.0,14.0,14.0,11.0,15.0,10.0,13.0,16.0,16.0,15.0,15.0,7.0,12.0,14.0,14.0,20.0,15.0,9.0,14.0,8.0,12.0,6.0,15.0,16.0,10.0,14.0,13.0,15.0,14.0,16.0,4.0,28.0,81.0,27.0,5.0,0.0,184.0,84.0,1.0,3.0,2.0,3.0,3.0,3.0,1.0,1.0,2.0,3.0,3.0,10.0,11.0,17.0,16.0,19.0,12.0,13.0,13.0,7.0,7.0,15.0,14.0,9.0,18.0,8.0,14.0,7.0,18.0,12.0,18.0,17.0,8.0,17.0,10.0,17.0,8.0,15.0,11.0,14.0,14.0,16.0,11.0,17.0,11.0,14.0,20.0,13.0,14.0,9.0,4.0,11.0,8.0,8.0,8.0,11.0,12.0,15.0,9.0,17.0,18.0,20.0,31.0,133.0,61.0,10.0,3.0,186.0,84.0,2.0,1.0,3.0,1.0,3.0,2.0,2.0,3.0,1.0,3.0,2.0,12.0,14.0,15.0,19.0,16.0,14.0,18.0,19.0,6.0,2.0,14.0,19.0,8.0,15.0,6.0,17.0,16.0,13.0,16.0,13.0,17.0,20.0,18.0,15.0,18.0,5.0,6.0,7.0,13.0,12.0,13.0,16.0,15.0,19.0,17.0,20.0,17.0,16.0,17.0,12.0,14.0,7.0,10.0,18.0,20.0,13.0,19.0,20.0,7.0,7.0,12.0,29.0,0.0,0.0,0.0,0.0,190.0,80.0,14.0,13.0,13.0,6.0,15.0,14.0,12.0,15.0,13.0,17.0,15.0,7.0,1.0,3.0,2.0,8.0,9.0,8.0,2.0,3.0,3.0,8.0,2.0,3.0,10.0,6.0,13.0,13.0,7.0,15.0,10.0,13.0,15.0,3.0,9.0,2.0,16.0,11.0,11.0,9.0,13.0,14.0,15.0,8.0,13.0,11.0,20.0,14.0,13.0,10.0,4.0,12.0,6.0,12.0,12.0,15.0,13.0,11.0,14.0,15.0,11.0,8.0,21.0,0.0,0.0,0.0,0.0,189.0,0.0,1.0,1.0,3.0,3.0,2.0,1.0,2.0,2.0,3.0,2.0,2.0,3.0,1.0,4.0,1.0,7.0,1.0,7.0,3.0,1.0,13.0,7.0,2.0,13.0,6.0,7.0,5.0,9.0,7.0,6.0,1.0,13.0,9.0,1.0,10.0,3.0,12.0,6.0,7.0,9.0,9.0,7.0,13.0,10.0,9.0,12.0,20.0,4.0,10.0,9.0,9.0,9.0,6.0,9.0,8.0,11.0,10.0,10.0,11.0,9.0,14.0,8.0,26.0,0.0,0.0,0.0,0.0,185.0,80.0,3.0,1.0,1.0,2.0,2.0,3.0,2.0,2.0,2.0,2.0,3.0,6.0,8.0,10.0,9.0,10.0,7.0,13.0,10.0,13.0,13.0,12.0,5.0,13.0,13.0,14.0,12.0,14.0,14.0,12.0,8.0,13.0,14.0,8.0,12.0,8.0,14.0,15.0,14.0,13.0,12.0,13.0,13.0,10.0,12.0,12.0,20.0,14.0,14.0,11.0,14.0,12.0,8.0,12.0,12.0,16.0,14.0,11.0,14.0,11.0,12.0,11.0,30.0,0.0,0.0,0.0,0.0,178.0,76.0,3.0,1.0,3.0,1.0,1.0,3.0,2.0,1.0,2.0,2.0,1.0,9.0,13.0,12.0,7.0,13.0,12.0,10.0,12.0,12.0,12.0,10.0,9.0,13.0,10.0,10.0,12.0,14.0,13.0,13.0,8.0,14.0,11.0,6.0,14.0,6.0,15.0,15.0,14.0,12.0,12.0,12.0,9.0,20.0,15.0,13.0,10.0,15.0,11.0,13.0,7.0,11.0,10.0,10.0,16.0,14.0,11.0,14.0,11.0,13.0,15.0,5.0,28.0,0.0,0.0,26.0,0.0,173.0,74.0,1.0,1.0,1.0,1.0,3.0,2.0,2.0,2.0,1.0,1.0,2.0,18.0,14.0,13.0,7.0,12.0,14.0,7.0,13.0,14.0,11.0,13.0,3.0,13.0,13.0,16.0,11.0,18.0,8.0,11.0,11.0,10.0,12.0,15.0,11.0,15.0,10.0,16.0,17.0,14.0,14.0,15.0,9.0,8.0,15.0,11.0,20.0,16.0,10.0,11.0,14.0,10.0,4.0,15.0,12.0,11.0,7.0,6.0,11.0,7.0,14.0,5.0,32.0,44.0,0.0,0.0,0.0,176.0,60.0,1.0,3.0,2.0,1.0,1.0,3.0,2.0,2.0,1.0,3.0,2.0,7.0,9.0,10.0,7.0,13.0,13.0,12.0,14.0,12.0,13.0,11.0,11.0,15.0,11.0,15.0,14.0,17.0,10.0,13.0,10.0,14.0,15.0,8.0,12.0,12.0,14.0,17.0,17.0,13.0,13.0,13.0,10.0,20.0,17.0,13.0,10.0,16.0,12.0,14.0,14.0,15.0,7.0,14.0,17.0,14.0,8.0,15.0,15.0,9.0,8.0,10.0,21.0,0.0,0.0,0.0,0.0,175.0,66.0,1.0,3.0,3.0,4.0,3.0,2.0,1.0,1.0,1.0,4.0,2.0,11.0,9.0,15.0,9.0,13.0,12.0,3.0,11.0,11.0,5.0,9.0,7.0,11.0,15.0,9.0,11.0,9.0,11.0,11.0,9.0,11.0,7.0,14.0,1.0,13.0,5.0,11.0,9.0,17.0,15.0,9.0,8.0,20.0,14.0,15.0,12.0,13.0,7.0,11.0,8.0,11.0,8.0,11.0,11.0,15.0,12.0,12.0,8.0,5.0,4.0,1.0,22.0,0.0,0.0,0.0,0.0,189.0,0.0,3.0,1.0,1.0,3.0,2.0,3.0,3.0,2.0,3.0,2.0,1.0,7.0,11.0,13.0,9.0,11.0,7.0,4.0,9.0,4.0,7.0,10.0,8.0,4.0,11.0,10.0,6.0,9.0,5.0,7.0,10.0,11.0,10.0,10.0,10.0,9.0,7.0,8.0,12.0,13.0,11.0,5.0,12.0,10.0,7.0,11.0,20.0,13.0,9.0,10.0,7.0,9.0,10.0,10.0,11.0,10.0,10.0,13.0,10.0,3.0,8.0,4.0,31.0,0.0,0.0,0.0,0.0,187.0,73.0,4.0,4.0,2.0,2.0,2.0,1.0,3.0,3.0,2.0,3.0,1.0,14.0,15.0,14.0,13.0,14.0,10.0,9.0,14.0,11.0,7.0,13.0,12.0,8.0,13.0,11.0,13.0,14.0,13.0,10.0,12.0,14.0,13.0,16.0,11.0,15.0,9.0,12.0,14.0,12.0,12.0,12.0,13.0,10.0,8.0,16.0,20.0,12.0,11.0,11.0,8.0,13.0,12.0,15.0,10.0,13.0,12.0,9.0,14.0,13.0,14.0,8.0,25.0,0.0,0.0,1.0,0.0,182.0,71.0,1.0,2.0,3.0,1.0,4.0,3.0,3.0,3.0,2.0,3.0,3.0,9.0,13.0,14.0,14.0,12.0,10.0,13.0,12.0,8.0,7.0,12.0,11.0,7.0,14.0,9.0,13.0,13.0,12.0,13.0,13.0,11.0,11.0,12.0,8.0,14.0,7.0,12.0,12.0,13.0,14.0,12.0,12.0,12.0,12.0,15.0,20.0,14.0,12.0,11.0,7.0,12.0,14.0,8.0,19.0,14.0,11.0,12.0,13.0,12.0,12.0,12.0,24.0,0.0,0.0,13.0,2.0,174.0,70.0,1.0,1.0,3.0,3.0,1.0,2.0,2.0,3.0,3.0,1.0,3.0,14.0,15.0,16.0,11.0,16.0,16.0,8.0,12.0,5.0,8.0,16.0,12.0,6.0,17.0,10.0,11.0,10.0,12.0,11.0,15.0,12.0,9.0,16.0,8.0,14.0,5.0,11.0,10.0,15.0,16.0,9.0,7.0,20.0,12.0,14.0,8.0,13.0,9.0,12.0,9.0,15.0,10.0,14.0,17.0,12.0,10.0,12.0,13.0,14.0,10.0,10.0
1,1,29.0,0.0,0.0,0.0,0.0,190.0,80.0,14.0,13.0,13.0,6.0,15.0,14.0,12.0,15.0,13.0,17.0,15.0,7.0,1.0,3.0,2.0,8.0,9.0,8.0,2.0,3.0,3.0,8.0,2.0,3.0,10.0,6.0,13.0,13.0,7.0,15.0,10.0,13.0,15.0,3.0,9.0,2.0,16.0,11.0,11.0,9.0,13.0,14.0,15.0,8.0,13.0,11.0,20.0,14.0,13.0,10.0,4.0,12.0,6.0,12.0,12.0,15.0,13.0,11.0,14.0,15.0,11.0,8.0,21.0,0.0,0.0,0.0,0.0,189.0,0.0,1.0,1.0,3.0,3.0,2.0,1.0,2.0,2.0,3.0,2.0,2.0,3.0,1.0,4.0,1.0,7.0,1.0,7.0,3.0,1.0,13.0,7.0,2.0,13.0,6.0,7.0,5.0,9.0,7.0,6.0,1.0,13.0,9.0,1.0,10.0,3.0,12.0,6.0,7.0,9.0,9.0,7.0,13.0,10.0,9.0,12.0,20.0,4.0,10.0,9.0,9.0,9.0,6.0,9.0,8.0,11.0,10.0,10.0,11.0,9.0,14.0,8.0,26.0,0.0,0.0,0.0,0.0,185.0,80.0,3.0,1.0,1.0,2.0,2.0,3.0,2.0,2.0,2.0,2.0,3.0,6.0,8.0,10.0,9.0,10.0,7.0,13.0,10.0,13.0,13.0,12.0,5.0,13.0,13.0,14.0,12.0,14.0,14.0,12.0,8.0,13.0,14.0,8.0,12.0,8.0,14.0,15.0,14.0,13.0,12.0,13.0,13.0,10.0,12.0,12.0,20.0,14.0,14.0,11.0,14.0,12.0,8.0,12.0,12.0,16.0,14.0,11.0,14.0,11.0,12.0,11.0,30.0,0.0,0.0,0.0,0.0,178.0,76.0,3.0,1.0,3.0,1.0,1.0,3.0,2.0,1.0,2.0,2.0,1.0,9.0,13.0,12.0,7.0,13.0,12.0,10.0,12.0,12.0,12.0,10.0,9.0,13.0,10.0,10.0,12.0,14.0,13.0,13.0,8.0,14.0,11.0,6.0,14.0,6.0,15.0,15.0,14.0,12.0,12.0,12.0,9.0,20.0,15.0,13.0,10.0,15.0,11.0,13.0,7.0,11.0,10.0,10.0,16.0,14.0,11.0,14.0,11.0,13.0,15.0,5.0,28.0,0.0,0.0,26.0,0.0,173.0,74.0,1.0,1.0,1.0,1.0,3.0,2.0,2.0,2.0,1.0,1.0,2.0,18.0,14.0,13.0,7.0,12.0,14.0,7.0,13.0,14.0,11.0,13.0,3.0,13.0,13.0,16.0,11.0,18.0,8.0,11.0,11.0,10.0,12.0,15.0,11.0,15.0,10.0,16.0,17.0,14.0,14.0,15.0,9.0,8.0,15.0,11.0,20.0,16.0,10.0,11.0,14.0,10.0,4.0,15.0,12.0,11.0,7.0,6.0,11.0,7.0,14.0,5.0,32.0,44.0,0.0,0.0,0.0,176.0,60.0,1.0,3.0,2.0,1.0,1.0,3.0,2.0,2.0,1.0,3.0,2.0,7.0,9.0,10.0,7.0,13.0,13.0,12.0,14.0,12.0,13.0,11.0,11.0,15.0,11.0,15.0,14.0,17.0,10.0,13.0,10.0,14.0,15.0,8.0,12.0,12.0,14.0,17.0,17.0,13.0,13.0,13.0,10.0,20.0,17.0,13.0,10.0,16.0,12.0,14.0,14.0,15.0,7.0,14.0,17.0,14.0,8.0,15.0,15.0,9.0,8.0,10.0,22.0,0.0,0.0,0.0,0.0,186.0,0.0,3.0,1.0,3.0,1.0,2.0,2.0,2.0,1.0,1.0,1.0,1.0,8.0,3.0,8.0,6.0,11.0,3.0,12.0,6.0,5.0,11.0,11.0,4.0,11.0,6.0,10.0,8.0,11.0,7.0,9.0,9.0,13.0,9.0,7.0,11.0,10.0,13.0,10.0,12.0,12.0,10.0,11.0,13.0,20.0,10.0,11.0,8.0,12.0,12.0,10.0,10.0,6.0,5.0,10.0,18.0,11.0,9.0,13.0,9.0,4.0,5.0,1.0,31.0,0.0,0.0,0.0,0.0,187.0,73.0,4.0,4.0,2.0,2.0,2.0,1.0,3.0,3.0,2.0,3.0,1.0,14.0,15.0,14.0,13.0,14.0,10.0,9.0,14.0,11.0,7.0,13.0,12.0,8.0,13.0,11.0,13.0,14.0,13.0,10.0,12.0,14.0,13.0,16.0,11.0,15.0,9.0,12.0,14.0,12.0,12.0,12.0,13.0,10.0,8.0,16.0,20.0,12.0,11.0,11.0,8.0,13.0,12.0,15.0,10.0,13.0,12.0,9.0,14.0,13.0,14.0,8.0,24.0,0.0,0.0,13.0,2.0,174.0,70.0,1.0,1.0,3.0,3.0,1.0,2.0,2.0,3.0,3.0,1.0,3.0,14.0,15.0,16.0,11.0,16.0,16.0,8.0,12.0,5.0,8.0,16.0,12.0,6.0,17.0,10.0,11.0,10.0,12.0,11.0,15.0,12.0,9.0,16.0,8.0,14.0,5.0,11.0,10.0,15.0,16.0,9.0,7.0,20.0,12.0,14.0,8.0,13.0,9.0,12.0,9.0,15.0,10.0,14.0,17.0,12.0,10.0,12.0,13.0,14.0,10.0,10.0,25.0,0.0,0.0,1.0,0.0,182.0,71.0,1.0,2.0,3.0,1.0,4.0,3.0,3.0,3.0,2.0,3.0,3.0,9.0,13.0,14.0,14.0,12.0,10.0,13.0,12.0,8.0,7.0,12.0,11.0,7.0,14.0,9.0,13.0,13.0,12.0,13.0,13.0,11.0,11.0,12.0,8.0,14.0,7.0,12.0,12.0,13.0,14.0,12.0,12.0,12.0,12.0,15.0,20.0,14.0,12.0,11.0,7.0,12.0,14.0,8.0,19.0,14.0,11.0,12.0,13.0,12.0,12.0,12.0,26.0,8.0,1.0,12.0,7.0,187.0,79.0,8.0,9.0,7.0,4.0,5.0,10.0,3.0,3.0,4.0,4.0,4.0,8.0,10.0,10.0,15.0,13.0,12.0,15.0,12.0,10.0,8.0,9.0,16.0,10.0,11.0,13.0,13.0,13.0,9.0,12.0,12.0,13.0,10.0,14.0,13.0,15.0,14.0,11.0,9.0,11.0,12.0,7.0,14.0,8.0,11.0,12.0,20.0,12.0,14.0,12.0,9.0,12.0,9.0,10.0,12.0,15.0,13.0,14.0,13.0,13.0,11.0,5.0,24.0,0.0,0.0,0.0,0.0,189.0,80.0,13.0,11.0,13.0,6.0,15.0,14.0,18.0,18.0,13.0,8.0,13.0,8.0,1.0,3.0,1.0,11.0,13.0,6.0,1.0,2.0,2.0,14.0,2.0,3.0,14.0,13.0,16.0,15.0,7.0,13.0,10.0,14.0,15.0,3.0,13.0,2.0,13.0,14.0,13.0,12.0,14.0,7.0,14.0,6.0,17.0,11.0,20.0,13.0,12.0,15.0,12.0,13.0,3.0,13.0,15.0,15.0,18.0,10.0,20.0,15.0,10.0,5.0,23.0,27.0,0.0,21.0,1.0,189.0,68.0,1.0,1.0,3.0,2.0,3.0,2.0,4.0,2.0,3.0,1.0,2.0,6.0,7.0,8.0,6.0,14.0,7.0,13.0,8.0,10.0,16.0,12.0,11.0,16.0,12.0,10.0,13.0,13.0,12.0,13.0,11.0,11.0,14.0,7.0,11.0,10.0,15.0,14.0,13.0,12.0,13.0,11.0,16.0,11.0,14.0,14.0,20.0,12.0,10.0,12.0,8.0,10.0,3.0,14.0,13.0,14.0,14.0,9.0,17.0,15.0,16.0,6.0,25.0,2.0,0.0,4.0,0.0,181.0,77.0,4.0,1.0,3.0,3.0,3.0,2.0,2.0,3.0,2.0,3.0,2.0,5.0,6.0,9.0,8.0,12.0,14.0,14.0,16.0,5.0,15.0,15.0,3.0,16.0,14.0,17.0,17.0,16.0,14.0,12.0,13.0,13.0,16.0,13.0,15.0,7.0,16.0,15.0,15.0,14.0,12.0,13.0,12.0,20.0,12.0,13.0,11.0,13.0,15.0,14.0,14.0,13.0,6.0,5.0,14.0,14.0,16.0,13.0,13.0,14.0,11.0,10.0,22.0,0.0,0.0,0.0,0.0,182.0,72.0,3.0,3.0,1.0,3.0,2.0,2.0,1.0,1.0,3.0,2.0,3.0,4.0,12.0,9.0,8.0,12.0,7.0,15.0,12.0,12.0,12.0,12.0,6.0,14.0,13.0,13.0,12.0,16.0,13.0,14.0,14.0,14.0,8.0,4.0,12.0,9.0,13.0,17.0,14.0,12.0,10.0,12.0,13.0,10.0,13.0,14.0,20.0,9.0,12.0,12.0,11.0,9.0,7.0,12.0,12.0,11.0,11.0,12.0,11.0,12.0,14.0,2.0,30.0,0.0,0.0,0.0,0.0,182.0,82.0,2.0,4.0,2.0,2.0,3.0,1.0,3.0,1.0,3.0,1.0,2.0,12.0,12.0,12.0,4.0,11.0,11.0,8.0,11.0,12.0,12.0,12.0,9.0,14.0,12.0,12.0,13.0,14.0,12.0,13.0,12.0,13.0,13.0,10.0,10.0,12.0,13.0,14.0,14.0,14.0,13.0,12.0,10.0,20.0,10.0,13.0,8.0,13.0,14.0,13.0,4.0,12.0,8.0,7.0,12.0,12.0,12.0,12.0,14.0,17.0,16.0,7.0,26.0,0.0,0.0,16.0,0.0,179.0,76.0,2.0,2.0,1.0,2.0,1.0,2.0,1.0,3.0,2.0,2.0,2.0,11.0,10.0,10.0,7.0,15.0,11.0,8.0,11.0,6.0,14.0,17.0,9.0,14.0,14.0,15.0,15.0,14.0,12.0,16.0,15.0,14.0,9.0,7.0,12.0,9.0,17.0,19.0,17.0,11.0,12.0,13.0,10.0,8.0,14.0,12.0,20.0,18.0,14.0,14.0,13.0,12.0,7.0,9.0,13.0,12.0,14.0,9.0,17.0,15.0,15.0,4.0,29.0,0.0,0.0,10.0,2.0,180.0,75.0,1.0,3.0,2.0,1.0,3.0,1.0,3.0,2.0,2.0,4.0,3.0,14.0,13.0,13.0,11.0,13.0,13.0,9.0,12.0,6.0,5.0,13.0,12.0,10.0,13.0,13.0,12.0,13.0,14.0,12.0,14.0,12.0,13.0,14.0,14.0,14.0,11.0,14.0,12.0,12.0,12.0,12.0,10.0,13.0,11.0,12.0,20.0,13.0,10.0,12.0,10.0,13.0,11.0,7.0,13.0,14.0,14.0,13.0,13.0,16.0,15.0,7.0,25.0,0.0,0.0,7.0,5.0,179.0,65.0,1.0,2.0,3.0,1.0,1.0,4.0,3.0,2.0,3.0,1.0,2.0,15.0,13.0,14.0,12.0,17.0,15.0,8.0,13.0,9.0,5.0,17.0,13.0,7.0,17.0,7.0,14.0,8.0,14.0,12.0,15.0,14.0,11.0,17.0,10.0,13.0,10.0,14.0,10.0,13.0,15.0,13.0,8.0,20.0,10.0,12.0,9.0,11.0,10.0,10.0,6.0,18.0,15.0,6.0,15.0,14.0,9.0,12.0,13.0,16.0,14.0,7.0,27.0,43.0,14.0,8.0,0.0,177.0,75.0,3.0,3.0,3.0,1.0,1.0,3.0,3.0,4.0,4.0,1.0,2.0,13.0,14.0,17.0,15.0,16.0,13.0,8.0,13.0,1.0,4.0,15.0,13.0,5.0,17.0,10.0,14.0,12.0,13.0,10.0,15.0,11.0,12.0,17.0,10.0,16.0,8.0,8.0,7.0,17.0,17.0,12.0,7.0,20.0,7.0,16.0,8.0,12.0,7.0,11.0,6.0,14.0,9.0,13.0,9.0,10.0,7.0,13.0,9.0,14.0,13.0,7.0,29.0,0.0,0.0,0.0,0.0,187.0,77.0,3.0,3.0,1.0,2.0,1.0,2.0,1.0,2.0,2.0,1.0,3.0,4.0,14.0,9.0,15.0,11.0,10.0,19.0,10.0,2.0,7.0,17.0,12.0,6.0,15.0,12.0,14.0,16.0,15.0,14.0,15.0,15.0,12.0,14.0,11.0,15.0,13.0,14.0,15.0,11.0,10.0,9.0,14.0,12.0,10.0,13.0,20.0,14.0,15.0,14.0,5.0,12.0,14.0,7.0,13.0,11.0,17.0,12.0,14.0,14.0,13.0,5.0,21.0,0.0,0.0,7.0,2.0,173.0,70.0,4.0,1.0,3.0,3.0,1.0,1.0,2.0,2.0,2.0,1.0,2.0,12.0,10.0,17.0,10.0,14.0,9.0,5.0,11.0,6.0,2.0,11.0,12.0,6.0,16.0,8.0,10.0,6.0,12.0,10.0,11.0,10.0,12.0,18.0,4.0,13.0,7.0,7.0,11.0,19.0,15.0,10.0,6.0,10.0,9.0,18.0,20.0,12.0,7.0,12.0,6.0,13.0,8.0,14.0,16.0,17.0,7.0,12.0,14.0,14.0,14.0,5.0
10,2,29.0,66.0,0.0,0.0,0.0,184.0,78.0,10.0,15.0,15.0,4.0,12.0,13.0,17.0,19.0,10.0,16.0,15.0,10.0,1.0,3.0,3.0,8.0,12.0,9.0,1.0,1.0,1.0,9.0,3.0,2.0,6.0,11.0,15.0,15.0,13.0,18.0,8.0,15.0,16.0,8.0,12.0,3.0,13.0,15.0,15.0,12.0,18.0,14.0,12.0,9.0,17.0,14.0,20.0,14.0,13.0,16.0,4.0,17.0,9.0,12.0,14.0,15.0,16.0,15.0,20.0,16.0,19.0,3.0,18.0,0.0,0.0,0.0,0.0,173.0,0.0,3.0,1.0,2.0,3.0,1.0,3.0,3.0,2.0,1.0,1.0,1.0,5.0,5.0,12.0,10.0,14.0,7.0,7.0,10.0,2.0,6.0,12.0,5.0,8.0,14.0,11.0,6.0,8.0,10.0,7.0,13.0,11.0,7.0,13.0,6.0,7.0,5.0,8.0,11.0,13.0,14.0,7.0,8.0,5.0,13.0,14.0,20.0,9.0,5.0,9.0,6.0,9.0,5.0,9.0,13.0,11.0,8.0,12.0,13.0,1.0,5.0,3.0,27.0,0.0,0.0,0.0,0.0,183.0,0.0,2.0,4.0,1.0,2.0,2.0,2.0,1.0,2.0,3.0,1.0,3.0,2.0,4.0,5.0,4.0,12.0,6.0,6.0,4.0,3.0,11.0,13.0,1.0,11.0,7.0,9.0,8.0,5.0,8.0,7.0,8.0,13.0,9.0,4.0,13.0,6.0,8.0,7.0,12.0,13.0,13.0,7.0,8.0,8.0,11.0,13.0,20.0,7.0,7.0,9.0,9.0,2.0,15.0,9.0,8.0,13.0,9.0,10.0,11.0,12.0,20.0,2.0,27.0,0.0,0.0,0.0,0.0,184.0,81.0,1.0,1.0,1.0,3.0,3.0,2.0,2.0,2.0,1.0,2.0,3.0,8.0,6.0,8.0,12.0,10.0,8.0,12.0,9.0,1.0,3.0,8.0,14.0,4.0,9.0,4.0,11.0,12.0,11.0,8.0,8.0,11.0,10.0,9.0,8.0,11.0,9.0,8.0,11.0,10.0,8.0,13.0,13.0,9.0,13.0,9.0,20.0,12.0,13.0,13.0,9.0,2.0,9.0,9.0,15.0,10.0,12.0,10.0,11.0,6.0,4.0,6.0,27.0,0.0,0.0,0.0,0.0,185.0,0.0,4.0,1.0,3.0,3.0,1.0,1.0,3.0,3.0,1.0,1.0,1.0,7.0,5.0,6.0,8.0,13.0,7.0,2.0,10.0,3.0,11.0,7.0,7.0,10.0,9.0,9.0,9.0,9.0,9.0,9.0,7.0,13.0,10.0,10.0,9.0,7.0,8.0,8.0,12.0,13.0,13.0,8.0,9.0,10.0,12.0,12.0,20.0,13.0,9.0,10.0,10.0,1.0,10.0,10.0,20.0,11.0,10.0,10.0,10.0,2.0,17.0,6.0,26.0,71.0,11.0,10.0,2.0,182.0,78.0,1.0,2.0,3.0,3.0,2.0,3.0,2.0,4.0,3.0,2.0,2.0,18.0,18.0,14.0,13.0,18.0,14.0,7.0,17.0,8.0,8.0,20.0,13.0,9.0,16.0,10.0,17.0,10.0,18.0,14.0,18.0,19.0,9.0,11.0,12.0,14.0,12.0,18.0,13.0,12.0,9.0,12.0,10.0,15.0,12.0,13.0,20.0,16.0,14.0,13.0,10.0,14.0,7.0,13.0,8.0,14.0,8.0,14.0,17.0,18.0,17.0,7.0,26.0,61.0,22.0,13.0,3.0,186.0,82.0,2.0,2.0,2.0,1.0,3.0,2.0,1.0,1.0,2.0,1.0,3.0,14.0,16.0,16.0,17.0,15.0,17.0,19.0,19.0,15.0,6.0,14.0,13.0,9.0,16.0,10.0,14.0,11.0,13.0,11.0,13.0,13.0,16.0,17.0,9.0,18.0,7.0,10.0,10.0,15.0,14.0,14.0,15.0,20.0,13.0,19.0,11.0,18.0,17.0,13.0,10.0,13.0,15.0,16.0,8.0,14.0,11.0,14.0,14.0,17.0,14.0,12.0,24.0,46.0,18.0,8.0,1.0,180.0,77.0,1.0,3.0,1.0,3.0,2.0,1.0,3.0,3.0,3.0,3.0,3.0,17.0,16.0,16.0,15.0,17.0,16.0,12.0,17.0,8.0,7.0,17.0,17.0,6.0,16.0,12.0,15.0,12.0,16.0,15.0,17.0,15.0,14.0,18.0,13.0,17.0,10.0,13.0,14.0,14.0,15.0,15.0,10.0,20.0,12.0,13.0,9.0,16.0,12.0,13.0,11.0,16.0,13.0,17.0,15.0,15.0,9.0,14.0,11.0,16.0,14.0,15.0,30.0,93.0,11.0,15.0,2.0,173.0,65.0,3.0,2.0,2.0,3.0,3.0,3.0,4.0,1.0,1.0,1.0,1.0,16.0,16.0,17.0,9.0,19.0,13.0,8.0,12.0,7.0,8.0,19.0,14.0,11.0,18.0,12.0,17.0,13.0,15.0,16.0,18.0,18.0,16.0,13.0,13.0,12.0,12.0,16.0,17.0,14.0,17.0,13.0,7.0,13.0,13.0,13.0,20.0,17.0,8.0,15.0,12.0,14.0,11.0,16.0,10.0,15.0,13.0,17.0,16.0,16.0,17.0,5.0,31.0,133.0,61.0,10.0,3.0,186.0,84.0,2.0,1.0,3.0,1.0,3.0,2.0,2.0,3.0,1.0,3.0,2.0,12.0,14.0,15.0,19.0,16.0,14.0,18.0,19.0,6.0,2.0,14.0,19.0,8.0,15.0,6.0,17.0,16.0,13.0,16.0,13.0,17.0,20.0,18.0,15.0,18.0,5.0,6.0,7.0,13.0,12.0,13.0,16.0,15.0,19.0,17.0,20.0,17.0,16.0,17.0,12.0,14.0,7.0,10.0,18.0,20.0,13.0,19.0,20.0,7.0,7.0,12.0,28.0,81.0,27.0,5.0,0.0,184.0,84.0,1.0,3.0,2.0,3.0,3.0,3.0,1.0,1.0,2.0,3.0,3.0,10.0,11.0,17.0,16.0,19.0,12.0,13.0,13.0,7.0,7.0,15.0,14.0,9.0,18.0,8.0,14.0,7.0,18.0,12.0,18.0,17.0,8.0,17.0,10.0,17.0,8.0,15.0,11.0,14.0,14.0,16.0,11.0,17.0,11.0,14.0,20.0,13.0,14.0,9.0,4.0,11.0,8.0,8.0,8.0,11.0,12.0,15.0,9.0,17.0,18.0,20.0,27.0,0.0,0.0,0.0,0.0,186.0,78.0,12.0,12.0,12.0,5.0,13.0,12.0,14.0,14.0,11.0,12.0,14.0,9.0,2.0,1.0,3.0,8.0,11.0,9.0,3.0,1.0,2.0,7.0,2.0,2.0,6.0,7.0,11.0,16.0,7.0,12.0,8.0,15.0,13.0,1.0,7.0,3.0,11.0,12.0,11.0,10.0,12.0,11.0,11.0,12.0,10.0,10.0,20.0,11.0,10.0,11.0,9.0,1.0,10.0,12.0,10.0,14.0,15.0,7.0,13.0,12.0,12.0,8.0,33.0,1.0,0.0,15.0,1.0,183.0,77.0,2.0,3.0,3.0,1.0,3.0,3.0,3.0,3.0,3.0,2.0,1.0,8.0,10.0,10.0,7.0,14.0,10.0,15.0,7.0,10.0,14.0,15.0,10.0,14.0,14.0,12.0,14.0,11.0,11.0,14.0,12.0,13.0,9.0,11.0,12.0,9.0,15.0,11.0,12.0,11.0,11.0,12.0,12.0,12.0,9.0,12.0,20.0,12.0,12.0,14.0,7.0,13.0,14.0,9.0,12.0,15.0,8.0,7.0,10.0,13.0,14.0,8.0,33.0,0.0,0.0,0.0,0.0,192.0,81.0,1.0,1.0,2.0,3.0,1.0,2.0,2.0,3.0,1.0,1.0,3.0,4.0,5.0,5.0,2.0,10.0,4.0,17.0,5.0,7.0,15.0,12.0,5.0,14.0,8.0,15.0,14.0,17.0,11.0,16.0,6.0,13.0,13.0,5.0,15.0,5.0,14.0,15.0,14.0,8.0,8.0,9.0,17.0,8.0,13.0,9.0,20.0,14.0,15.0,14.0,10.0,13.0,8.0,6.0,7.0,14.0,16.0,13.0,15.0,15.0,12.0,6.0,31.0,0.0,0.0,0.0,0.0,183.0,73.0,1.0,2.0,1.0,3.0,2.0,1.0,2.0,3.0,2.0,2.0,4.0,8.0,9.0,10.0,7.0,12.0,5.0,12.0,10.0,7.0,11.0,12.0,8.0,13.0,9.0,12.0,12.0,13.0,8.0,11.0,10.0,14.0,11.0,7.0,8.0,8.0,14.0,14.0,14.0,12.0,12.0,10.0,14.0,8.0,13.0,11.0,20.0,14.0,13.0,12.0,13.0,10.0,14.0,9.0,8.0,7.0,12.0,12.0,12.0,11.0,20.0,10.0,28.0,0.0,0.0,0.0,0.0,182.0,0.0,3.0,2.0,2.0,2.0,2.0,3.0,1.0,2.0,1.0,1.0,1.0,6.0,5.0,10.0,4.0,13.0,4.0,6.0,9.0,1.0,6.0,12.0,5.0,4.0,13.0,9.0,7.0,4.0,10.0,7.0,11.0,9.0,5.0,13.0,4.0,9.0,6.0,7.0,12.0,13.0,11.0,7.0,5.0,7.0,11.0,10.0,20.0,13.0,9.0,9.0,9.0,9.0,8.0,9.0,7.0,12.0,9.0,14.0,12.0,11.0,15.0,4.0,27.0,0.0,0.0,1.0,0.0,180.0,73.0,4.0,1.0,1.0,3.0,2.0,1.0,3.0,3.0,3.0,2.0,2.0,9.0,9.0,11.0,8.0,12.0,10.0,10.0,11.0,6.0,12.0,13.0,11.0,12.0,12.0,9.0,13.0,14.0,14.0,15.0,13.0,14.0,11.0,10.0,13.0,12.0,14.0,15.0,15.0,13.0,12.0,10.0,10.0,12.0,10.0,11.0,20.0,13.0,12.0,13.0,8.0,11.0,13.0,12.0,12.0,10.0,11.0,13.0,13.0,12.0,9.0,13.0,35.0,0.0,0.0,0.0,0.0,177.0,70.0,1.0,4.0,4.0,3.0,1.0,2.0,3.0,2.0,3.0,3.0,1.0,15.0,14.0,12.0,12.0,17.0,17.0,10.0,14.0,7.0,3.0,18.0,16.0,4.0,17.0,10.0,13.0,8.0,14.0,13.0,18.0,17.0,12.0,17.0,15.0,11.0,8.0,12.0,9.0,9.0,8.0,10.0,7.0,16.0,11.0,9.0,20.0,12.0,9.0,13.0,6.0,12.0,12.0,11.0,12.0,15.0,9.0,12.0,13.0,11.0,12.0,10.0,29.0,4.0,3.0,0.0,0.0,185.0,81.0,1.0,4.0,2.0,3.0,3.0,1.0,2.0,1.0,2.0,3.0,3.0,10.0,14.0,15.0,13.0,15.0,16.0,13.0,14.0,8.0,9.0,15.0,14.0,10.0,15.0,16.0,15.0,16.0,14.0,17.0,14.0,14.0,14.0,14.0,11.0,14.0,11.0,16.0,15.0,10.0,13.0,10.0,14.0,20.0,11.0,14.0,10.0,14.0,14.0,8.0,14.0,11.0,13.0,15.0,12.0,15.0,10.0,9.0,14.0,13.0,8.0,8.0,25.0,0.0,0.0,0.0,0.0,180.0,67.0,3.0,3.0,2.0,4.0,2.0,2.0,2.0,3.0,1.0,3.0,2.0,12.0,13.0,12.0,13.0,13.0,11.0,7.0,12.0,5.0,7.0,14.0,12.0,9.0,14.0,9.0,14.0,9.0,14.0,14.0,14.0,13.0,14.0,14.0,11.0,14.0,10.0,12.0,10.0,13.0,15.0,11.0,8.0,14.0,14.0,12.0,20.0,13.0,10.0,10.0,5.0,12.0,10.0,10.0,15.0,13.0,13.0,12.0,12.0,14.0,16.0,9.0,25.0,0.0,0.0,0.0,0.0,175.0,74.0,3.0,3.0,3.0,3.0,3.0,3.0,3.0,1.0,3.0,2.0,3.0,7.0,7.0,4.0,7.0,14.0,7.0,7.0,10.0,4.0,9.0,14.0,4.0,14.0,10.0,9.0,9.0,8.0,6.0,9.0,11.0,14.0,3.0,1.0,10.0,5.0,14.0,8.0,11.0,14.0,10.0,8.0,6.0,4.0,10.0,11.0,20.0,10.0,7.0,9.0,5.0,8.0,3.0,9.0,14.0,12.0,13.0,10.0,12.0,11.0,18.0,1.0,34.0,0.0,0.0,0.0,0.0,179.0,77.0,1.0,4.0,3.0,1.0,4.0,1.0,1.0,3.0,2.0,1.0,1.0,7.0,11.0,13.0,15.0,15.0,8.0,13.0,12.0,5.0,4.0,13.0,13.0,7.0,14.0,8.0,13.0,14.0,14.0,13.0,13.0,13.0,13.0,16.0,9.0,14.0,7.0,14.0,13.0,12.0,13.0,14.0,12.0,12.0,12.0,12.0,20.0,13.0,13.0,13.0,5.0,12.0,8.0,5.0,3.0,13.0,12.0,12.0,13.0,12.0,11.0,9.0
0,2,29.0,0.0,0.0,0.0,0.0,184.0,86.0,13.0,13.0,12.0,6.0,14.0,12.0,14.0,17.0,11.0,9.0,13.0,7.0,1.0,2.0,2.0,8.0,9.0,6.0,1.0,2.0,2.0,10.0,3.0,2.0,9.0,10.0,12.0,13.0,11.0,13.0,6.0,13.0,8.0,6.0,11.0,2.0,15.0,11.0,13.0,10.0,14.0,13.0,11.0,11.0,13.0,12.0,20.0,14.0,15.0,16.0,7.0,12.0,7.0,12.0,9.0,10.0,13.0,11.0,8.0,12.0,11.0,3.0,29.0,4.0,0.0,0.0,0.0,185.0,83.0,2.0,3.0,1.0,1.0,3.0,2.0,1.0,1.0,1.0,2.0,2.0,5.0,8.0,6.0,7.0,9.0,9.0,13.0,9.0,7.0,13.0,9.0,9.0,13.0,9.0,14.0,12.0,17.0,13.0,13.0,7.0,11.0,7.0,6.0,13.0,8.0,12.0,14.0,14.0,9.0,9.0,12.0,13.0,12.0,15.0,10.0,20.0,17.0,17.0,13.0,11.0,13.0,7.0,9.0,15.0,12.0,11.0,11.0,14.0,13.0,13.0,3.0,29.0,0.0,0.0,0.0,0.0,188.0,84.0,3.0,1.0,2.0,3.0,1.0,4.0,2.0,1.0,1.0,1.0,1.0,5.0,5.0,10.0,8.0,11.0,13.0,14.0,8.0,10.0,15.0,12.0,16.0,15.0,14.0,12.0,13.0,13.0,13.0,14.0,12.0,13.0,16.0,10.0,14.0,11.0,13.0,15.0,13.0,13.0,12.0,10.0,15.0,8.0,13.0,14.0,20.0,14.0,15.0,16.0,9.0,13.0,5.0,10.0,12.0,13.0,11.0,11.0,13.0,13.0,10.0,3.0,23.0,0.0,0.0,22.0,1.0,184.0,78.0,3.0,3.0,2.0,3.0,3.0,2.0,1.0,1.0,1.0,2.0,3.0,11.0,13.0,11.0,8.0,11.0,9.0,11.0,9.0,13.0,11.0,12.0,4.0,13.0,11.0,12.0,11.0,13.0,12.0,12.0,9.0,10.0,13.0,8.0,13.0,11.0,13.0,14.0,15.0,14.0,11.0,14.0,11.0,20.0,13.0,15.0,8.0,16.0,13.0,13.0,9.0,14.0,8.0,12.0,10.0,13.0,14.0,11.0,15.0,14.0,14.0,5.0,23.0,0.0,0.0,8.0,0.0,183.0,77.0,2.0,3.0,1.0,2.0,1.0,3.0,3.0,3.0,3.0,2.0,2.0,7.0,13.0,12.0,7.0,12.0,6.0,8.0,9.0,11.0,12.0,9.0,7.0,12.0,12.0,10.0,12.0,14.0,13.0,12.0,11.0,11.0,15.0,11.0,7.0,13.0,12.0,12.0,13.0,16.0,13.0,14.0,11.0,8.0,15.0,15.0,20.0,13.0,13.0,11.0,10.0,13.0,7.0,8.0,11.0,13.0,14.0,11.0,14.0,15.0,15.0,5.0,30.0,0.0,0.0,0.0,0.0,174.0,71.0,2.0,2.0,2.0,2.0,1.0,1.0,1.0,3.0,3.0,4.0,3.0,11.0,13.0,12.0,10.0,14.0,12.0,8.0,15.0,9.0,7.0,15.0,9.0,9.0,14.0,10.0,14.0,10.0,14.0,14.0,15.0,15.0,8.0,12.0,9.0,13.0,12.0,15.0,14.0,11.0,13.0,11.0,7.0,20.0,10.0,13.0,8.0,13.0,9.0,11.0,9.0,10.0,11.0,13.0,9.0,10.0,11.0,12.0,9.0,11.0,20.0,7.0,28.0,0.0,0.0,0.0,0.0,178.0,71.0,2.0,2.0,3.0,1.0,3.0,1.0,2.0,3.0,2.0,3.0,2.0,11.0,10.0,10.0,11.0,16.0,10.0,10.0,12.0,4.0,10.0,15.0,10.0,11.0,15.0,12.0,15.0,10.0,15.0,14.0,16.0,16.0,15.0,12.0,16.0,13.0,13.0,16.0,15.0,11.0,12.0,13.0,8.0,10.0,8.0,11.0,20.0,13.0,10.0,14.0,13.0,15.0,15.0,12.0,12.0,14.0,15.0,15.0,16.0,16.0,16.0,15.0,27.0,0.0,0.0,5.0,0.0,178.0,76.0,2.0,4.0,2.0,2.0,1.0,1.0,1.0,3.0,4.0,1.0,3.0,9.0,12.0,12.0,8.0,15.0,8.0,8.0,11.0,6.0,11.0,14.0,10.0,12.0,13.0,14.0,14.0,13.0,14.0,17.0,12.0,14.0,15.0,13.0,13.0,11.0,14.0,14.0,13.0,13.0,13.0,13.0,11.0,9.0,12.0,12.0,20.0,16.0,14.0,16.0,12.0,13.0,7.0,13.0,13.0,14.0,13.0,14.0,15.0,11.0,13.0,7.0,25.0,0.0,0.0,0.0,0.0,182.0,74.0,3.0,1.0,1.0,3.0,3.0,2.0,1.0,3.0,1.0,1.0,3.0,13.0,12.0,14.0,12.0,14.0,13.0,9.0,13.0,6.0,4.0,12.0,13.0,11.0,17.0,8.0,15.0,7.0,13.0,11.0,15.0,10.0,12.0,18.0,8.0,13.0,7.0,7.0,13.0,13.0,14.0,15.0,10.0,20.0,15.0,13.0,9.0,12.0,9.0,11.0,6.0,14.0,7.0,12.0,8.0,16.0,12.0,12.0,15.0,12.0,14.0,14.0,19.0,6.0,0.0,7.0,1.0,185.0,79.0,3.0,4.0,3.0,2.0,3.0,2.0,1.0,1.0,2.0,3.0,2.0,9.0,11.0,12.0,15.0,14.0,12.0,10.0,11.0,2.0,3.0,10.0,8.0,3.0,13.0,14.0,13.0,12.0,12.0,10.0,10.0,12.0,15.0,16.0,4.0,14.0,7.0,15.0,17.0,16.0,14.0,11.0,11.0,8.0,13.0,15.0,20.0,13.0,12.0,13.0,8.0,14.0,10.0,11.0,12.0,12.0,12.0,10.0,11.0,12.0,10.0,8.0,20.0,0.0,0.0,4.0,2.0,186.0,86.0,2.0,1.0,3.0,1.0,2.0,3.0,1.0,3.0,3.0,2.0,3.0,8.0,11.0,14.0,13.0,11.0,9.0,8.0,12.0,4.0,6.0,10.0,11.0,7.0,14.0,8.0,12.0,11.0,11.0,9.0,9.0,10.0,8.0,16.0,7.0,13.0,4.0,10.0,12.0,14.0,12.0,13.0,11.0,10.0,15.0,16.0,20.0,13.0,15.0,11.0,7.0,11.0,6.0,14.0,13.0,14.0,12.0,7.0,7.0,10.0,7.0,14.0,30.0,0.0,0.0,0.0,0.0,180.0,0.0,3.0,2.0,3.0,3.0,2.0,3.0,1.0,2.0,1.0,2.0,2.0,9.0,12.0,9.0,10.0,11.0,6.0,6.0,5.0,6.0,6.0,4.0,1.0,4.0,9.0,8.0,8.0,8.0,7.0,7.0,10.0,12.0,9.0,9.0,13.0,8.0,6.0,7.0,6.0,13.0,13.0,7.0,5.0,20.0,12.0,13.0,10.0,10.0,9.0,9.0,9.0,3.0,9.0,9.0,13.0,12.0,10.0,12.0,9.0,10.0,18.0,5.0,30.0,0.0,0.0,6.0,0.0,183.0,81.0,1.0,3.0,1.0,1.0,1.0,2.0,1.0,2.0,2.0,2.0,1.0,5.0,7.0,7.0,5.0,9.0,7.0,15.0,6.0,9.0,17.0,11.0,8.0,16.0,8.0,17.0,15.0,18.0,12.0,13.0,9.0,15.0,15.0,6.0,16.0,6.0,17.0,16.0,16.0,12.0,11.0,9.0,13.0,8.0,16.0,14.0,20.0,13.0,16.0,14.0,17.0,15.0,6.0,12.0,14.0,15.0,13.0,14.0,13.0,7.0,9.0,11.0,25.0,0.0,0.0,12.0,0.0,174.0,75.0,1.0,2.0,1.0,3.0,2.0,2.0,3.0,1.0,3.0,3.0,1.0,4.0,13.0,10.0,6.0,12.0,7.0,9.0,6.0,14.0,13.0,12.0,9.0,15.0,12.0,16.0,14.0,16.0,14.0,16.0,10.0,13.0,15.0,7.0,12.0,13.0,15.0,15.0,16.0,15.0,13.0,13.0,9.0,12.0,13.0,14.0,20.0,15.0,14.0,15.0,9.0,13.0,7.0,8.0,19.0,13.0,15.0,11.0,11.0,8.0,6.0,3.0,25.0,0.0,0.0,44.0,0.0,173.0,76.0,3.0,1.0,2.0,1.0,3.0,4.0,3.0,3.0,3.0,2.0,3.0,9.0,11.0,10.0,7.0,12.0,9.0,12.0,8.0,13.0,12.0,13.0,8.0,13.0,12.0,16.0,14.0,13.0,12.0,15.0,12.0,13.0,12.0,8.0,12.0,13.0,13.0,14.0,17.0,14.0,12.0,14.0,7.0,20.0,15.0,12.0,8.0,16.0,13.0,13.0,10.0,11.0,7.0,11.0,9.0,11.0,9.0,11.0,10.0,10.0,13.0,6.0,17.0,0.0,0.0,0.0,0.0,173.0,0.0,1.0,4.0,2.0,1.0,1.0,4.0,1.0,4.0,2.0,1.0,3.0,4.0,2.0,13.0,13.0,13.0,6.0,13.0,7.0,1.0,4.0,7.0,3.0,1.0,13.0,9.0,10.0,7.0,6.0,3.0,2.0,13.0,3.0,13.0,11.0,11.0,2.0,6.0,7.0,13.0,13.0,7.0,7.0,4.0,9.0,13.0,20.0,7.0,8.0,9.0,9.0,9.0,9.0,9.0,8.0,14.0,9.0,12.0,12.0,6.0,19.0,2.0,27.0,14.0,0.0,14.0,0.0,178.0,70.0,1.0,1.0,3.0,3.0,3.0,2.0,1.0,1.0,1.0,3.0,2.0,13.0,13.0,12.0,9.0,14.0,16.0,11.0,11.0,14.0,11.0,13.0,9.0,13.0,14.0,14.0,13.0,12.0,11.0,13.0,11.0,11.0,13.0,11.0,8.0,11.0,10.0,12.0,13.0,14.0,12.0,12.0,11.0,9.0,12.0,13.0,20.0,13.0,11.0,15.0,10.0,14.0,7.0,19.0,17.0,16.0,13.0,17.0,15.0,13.0,10.0,7.0,30.0,9.0,1.0,0.0,0.0,177.0,74.0,3.0,2.0,2.0,1.0,3.0,1.0,3.0,3.0,3.0,4.0,3.0,11.0,16.0,14.0,11.0,15.0,6.0,8.0,10.0,5.0,8.0,13.0,8.0,12.0,13.0,15.0,15.0,15.0,14.0,15.0,13.0,16.0,16.0,12.0,7.0,13.0,13.0,16.0,17.0,13.0,14.0,12.0,9.0,14.0,14.0,13.0,20.0,15.0,12.0,16.0,13.0,13.0,12.0,12.0,9.0,13.0,15.0,13.0,15.0,15.0,10.0,8.0,24.0,0.0,0.0,0.0,0.0,185.0,71.0,1.0,3.0,2.0,2.0,1.0,3.0,2.0,2.0,3.0,3.0,1.0,10.0,11.0,13.0,11.0,14.0,12.0,11.0,13.0,12.0,8.0,14.0,14.0,9.0,15.0,6.0,11.0,8.0,12.0,11.0,14.0,13.0,2.0,14.0,7.0,14.0,12.0,13.0,12.0,13.0,13.0,11.0,12.0,8.0,15.0,14.0,20.0,10.0,9.0,12.0,4.0,3.0,4.0,10.0,12.0,13.0,12.0,11.0,11.0,10.0,12.0,3.0,30.0,39.0,2.0,0.0,0.0,171.0,58.0,2.0,1.0,3.0,1.0,3.0,3.0,1.0,2.0,3.0,3.0,1.0,15.0,16.0,15.0,12.0,14.0,11.0,8.0,11.0,8.0,7.0,13.0,14.0,8.0,14.0,12.0,13.0,11.0,8.0,12.0,13.0,11.0,11.0,13.0,9.0,16.0,9.0,13.0,13.0,17.0,17.0,17.0,6.0,12.0,13.0,15.0,20.0,12.0,8.0,11.0,13.0,13.0,7.0,7.0,10.0,10.0,9.0,14.0,10.0,13.0,7.0,12.0,28.0,0.0,0.0,0.0,0.0,176.0,67.0,2.0,1.0,1.0,3.0,3.0,2.0,3.0,4.0,2.0,1.0,4.0,13.0,11.0,15.0,15.0,16.0,15.0,14.0,14.0,7.0,6.0,14.0,16.0,7.0,14.0,12.0,15.0,15.0,14.0,14.0,14.0,14.0,15.0,15.0,10.0,16.0,7.0,11.0,16.0,15.0,14.0,13.0,11.0,20.0,15.0,15.0,10.0,14.0,9.0,12.0,6.0,16.0,5.0,14.0,10.0,14.0,16.0,13.0,11.0,8.0,6.0,15.0,20.0,0.0,0.0,4.0,1.0,177.0,70.0,3.0,2.0,3.0,4.0,1.0,1.0,2.0,3.0,2.0,2.0,1.0,10.0,10.0,15.0,12.0,14.0,10.0,7.0,10.0,9.0,6.0,13.0,6.0,7.0,14.0,15.0,12.0,13.0,11.0,13.0,9.0,9.0,10.0,15.0,9.0,13.0,6.0,13.0,13.0,17.0,16.0,12.0,13.0,20.0,12.0,16.0,12.0,12.0,10.0,12.0,9.0,14.0,7.0,12.0,17.0,14.0,11.0,12.0,8.0,10.0,8.0,2.0
1,3,32.0,0.0,0.0,1.0,0.0,187.0,79.0,14.0,14.0,14.0,15.0,15.0,13.0,16.0,15.0,15.0,16.0,15.0,7.0,12.0,12.0,3.0,12.0,11.0,8.0,15.0,3.0,2.0,12.0,2.0,2.0,11.0,10.0,12.0,14.0,14.0,12.0,12.0,11.0,14.0,12.0,17.0,7.0,13.0,11.0,11.0,14.0,12.0,10.0,13.0,20.0,13.0,12.0,10.0,11.0,10.0,13.0,10.0,17.0,11.0,11.0,18.0,13.0,15.0,13.0,10.0,11.0,7.0,13.0,22.0,1.0,0.0,0.0,0.0,187.0,79.0,3.0,2.0,1.0,2.0,2.0,2.0,2.0,2.0,2.0,3.0,3.0,5.0,5.0,7.0,6.0,9.0,5.0,14.0,6.0,6.0,13.0,9.0,4.0,14.0,10.0,13.0,12.0,13.0,10.0,11.0,7.0,11.0,13.0,5.0,10.0,7.0,13.0,13.0,13.0,11.0,13.0,13.0,14.0,11.0,14.0,12.0,20.0,14.0,13.0,10.0,12.0,10.0,4.0,8.0,8.0,13.0,14.0,11.0,13.0,10.0,9.0,12.0,19.0,0.0,0.0,1.0,0.0,182.0,77.0,2.0,4.0,2.0,3.0,1.0,1.0,3.0,1.0,1.0,2.0,3.0,6.0,7.0,11.0,7.0,12.0,7.0,13.0,7.0,8.0,15.0,14.0,6.0,14.0,14.0,8.0,14.0,13.0,14.0,13.0,12.0,12.0,12.0,12.0,14.0,11.0,14.0,15.0,16.0,12.0,14.0,9.0,9.0,11.0,16.0,13.0,20.0,17.0,16.0,15.0,12.0,14.0,5.0,4.0,19.0,10.0,10.0,11.0,12.0,11.0,14.0,3.0,24.0,0.0,0.0,0.0,0.0,181.0,72.0,3.0,4.0,2.0,2.0,2.0,2.0,3.0,1.0,2.0,2.0,3.0,8.0,13.0,12.0,10.0,11.0,10.0,9.0,11.0,15.0,10.0,13.0,9.0,12.0,12.0,12.0,11.0,11.0,12.0,11.0,14.0,11.0,18.0,14.0,8.0,12.0,11.0,13.0,13.0,11.0,13.0,9.0,8.0,20.0,12.0,15.0,10.0,12.0,9.0,13.0,5.0,14.0,14.0,15.0,18.0,13.0,13.0,12.0,11.0,11.0,13.0,6.0,28.0,0.0,0.0,19.0,0.0,180.0,73.0,1.0,1.0,3.0,3.0,1.0,3.0,4.0,3.0,1.0,3.0,1.0,12.0,13.0,11.0,10.0,11.0,9.0,9.0,9.0,13.0,11.0,15.0,12.0,13.0,13.0,6.0,9.0,9.0,10.0,11.0,11.0,12.0,12.0,11.0,14.0,13.0,11.0,17.0,15.0,12.0,11.0,11.0,9.0,20.0,12.0,12.0,10.0,13.0,11.0,12.0,4.0,14.0,12.0,12.0,9.0,10.0,16.0,9.0,12.0,13.0,11.0,6.0,29.0,0.0,0.0,0.0,0.0,168.0,67.0,2.0,2.0,1.0,2.0,3.0,2.0,3.0,3.0,2.0,3.0,2.0,7.0,11.0,10.0,9.0,12.0,4.0,11.0,12.0,10.0,12.0,13.0,12.0,12.0,12.0,12.0,12.0,17.0,16.0,11.0,9.0,10.0,12.0,13.0,16.0,9.0,11.0,15.0,16.0,11.0,12.0,15.0,5.0,10.0,12.0,11.0,20.0,15.0,14.0,10.0,11.0,16.0,13.0,20.0,14.0,10.0,14.0,13.0,18.0,17.0,20.0,1.0,28.0,0.0,0.0,0.0,0.0,175.0,66.0,1.0,3.0,4.0,3.0,2.0,3.0,2.0,2.0,3.0,3.0,4.0,12.0,12.0,11.0,10.0,13.0,12.0,7.0,12.0,7.0,12.0,14.0,13.0,12.0,14.0,11.0,12.0,13.0,11.0,13.0,14.0,13.0,12.0,14.0,11.0,11.0,13.0,15.0,14.0,11.0,12.0,12.0,8.0,20.0,11.0,11.0,10.0,12.0,11.0,12.0,7.0,12.0,10.0,5.0,10.0,9.0,14.0,11.0,10.0,12.0,18.0,2.0,23.0,0.0,0.0,0.0,0.0,181.0,74.0,2.0,3.0,2.0,3.0,3.0,1.0,1.0,3.0,3.0,3.0,4.0,13.0,13.0,11.0,10.0,15.0,11.0,6.0,12.0,6.0,10.0,14.0,14.0,11.0,16.0,14.0,16.0,15.0,16.0,12.0,13.0,14.0,15.0,11.0,8.0,12.0,13.0,16.0,15.0,11.0,13.0,15.0,9.0,9.0,14.0,11.0,20.0,17.0,12.0,10.0,13.0,12.0,8.0,10.0,12.0,14.0,12.0,14.0,15.0,9.0,11.0,4.0,17.0,0.0,0.0,0.0,0.0,176.0,0.0,3.0,3.0,3.0,2.0,1.0,3.0,1.0,3.0,2.0,4.0,3.0,1.0,1.0,1.0,2.0,6.0,1.0,12.0,2.0,2.0,8.0,2.0,1.0,8.0,1.0,15.0,8.0,5.0,1.0,5.0,3.0,10.0,4.0,2.0,9.0,1.0,6.0,7.0,10.0,5.0,7.0,12.0,7.0,13.0,15.0,7.0,20.0,6.0,5.0,14.0,9.0,12.0,2.0,6.0,7.0,5.0,12.0,7.0,8.0,9.0,10.0,10.0,20.0,9.0,0.0,6.0,0.0,170.0,61.0,3.0,3.0,4.0,1.0,3.0,2.0,3.0,2.0,3.0,3.0,2.0,14.0,12.0,18.0,12.0,17.0,11.0,5.0,14.0,6.0,5.0,13.0,11.0,7.0,17.0,9.0,11.0,7.0,13.0,9.0,15.0,10.0,11.0,18.0,6.0,12.0,7.0,8.0,9.0,15.0,17.0,10.0,6.0,20.0,12.0,12.0,10.0,11.0,7.0,11.0,10.0,11.0,6.0,12.0,10.0,18.0,7.0,13.0,10.0,8.0,10.0,14.0,17.0,0.0,0.0,0.0,0.0,183.0,0.0,1.0,1.0,3.0,2.0,2.0,3.0,1.0,1.0,3.0,3.0,1.0,6.0,4.0,5.0,3.0,7.0,2.0,12.0,5.0,3.0,13.0,5.0,5.0,11.0,4.0,11.0,12.0,7.0,5.0,8.0,6.0,13.0,8.0,5.0,5.0,5.0,9.0,7.0,11.0,11.0,8.0,11.0,10.0,2.0,11.0,8.0,20.0,8.0,10.0,7.0,11.0,13.0,13.0,7.0,5.0,9.0,9.0,7.0,16.0,11.0,14.0,8.0,19.0,0.0,0.0,0.0,0.0,171.0,70.0,3.0,2.0,3.0,3.0,2.0,1.0,2.0,2.0,2.0,2.0,1.0,5.0,8.0,7.0,3.0,11.0,4.0,10.0,9.0,8.0,11.0,11.0,6.0,12.0,10.0,10.0,5.0,11.0,9.0,8.0,5.0,15.0,3.0,9.0,10.0,9.0,9.0,10.0,10.0,14.0,12.0,10.0,3.0,20.0,6.0,11.0,8.0,8.0,8.0,10.0,7.0,9.0,10.0,10.0,20.0,11.0,10.0,11.0,13.0,8.0,17.0,1.0,29.0,80.0,5.0,12.0,1.0,193.0,85.0,3.0,1.0,1.0,1.0,1.0,1.0,2.0,3.0,2.0,2.0,3.0,8.0,10.0,13.0,10.0,15.0,7.0,16.0,8.0,8.0,16.0,16.0,13.0,15.0,16.0,14.0,16.0,15.0,18.0,15.0,15.0,17.0,13.0,11.0,16.0,9.0,18.0,15.0,15.0,11.0,10.0,9.0,16.0,12.0,15.0,13.0,20.0,15.0,15.0,16.0,12.0,18.0,8.0,9.0,16.0,15.0,14.0,14.0,12.0,9.0,10.0,16.0,32.0,4.0,0.0,13.0,2.0,189.0,84.0,2.0,2.0,1.0,1.0,2.0,1.0,3.0,1.0,3.0,1.0,2.0,12.0,11.0,10.0,8.0,10.0,11.0,15.0,14.0,14.0,16.0,12.0,11.0,15.0,14.0,12.0,14.0,14.0,13.0,14.0,10.0,15.0,13.0,8.0,11.0,11.0,16.0,15.0,16.0,11.0,10.0,10.0,16.0,20.0,13.0,13.0,7.0,15.0,15.0,14.0,11.0,14.0,13.0,17.0,11.0,15.0,13.0,14.0,14.0,14.0,16.0,5.0,34.0,0.0,0.0,0.0,0.0,178.0,76.0,1.0,1.0,3.0,4.0,1.0,2.0,3.0,1.0,3.0,2.0,2.0,3.0,6.0,12.0,12.0,11.0,5.0,9.0,7.0,5.0,7.0,12.0,8.0,6.0,12.0,11.0,11.0,17.0,10.0,10.0,9.0,11.0,11.0,13.0,7.0,11.0,12.0,11.0,11.0,11.0,13.0,10.0,9.0,8.0,16.0,13.0,20.0,13.0,10.0,14.0,11.0,12.0,5.0,10.0,17.0,13.0,12.0,11.0,7.0,12.0,12.0,11.0,27.0,87.0,2.0,3.0,1.0,189.0,76.0,1.0,1.0,3.0,1.0,2.0,3.0,3.0,1.0,3.0,2.0,1.0,8.0,11.0,13.0,9.0,16.0,8.0,13.0,10.0,8.0,16.0,17.0,11.0,15.0,15.0,12.0,19.0,13.0,17.0,17.0,16.0,18.0,16.0,9.0,10.0,11.0,19.0,19.0,15.0,10.0,13.0,9.0,14.0,12.0,13.0,12.0,20.0,16.0,13.0,18.0,13.0,16.0,7.0,13.0,11.0,14.0,14.0,14.0,14.0,6.0,8.0,7.0,28.0,80.0,12.0,4.0,2.0,184.0,78.0,2.0,3.0,3.0,3.0,3.0,3.0,3.0,4.0,3.0,3.0,3.0,18.0,15.0,14.0,13.0,17.0,16.0,8.0,18.0,10.0,9.0,18.0,16.0,10.0,17.0,11.0,14.0,11.0,14.0,14.0,17.0,15.0,12.0,12.0,14.0,14.0,12.0,14.0,13.0,12.0,11.0,11.0,12.0,14.0,12.0,14.0,20.0,15.0,14.0,14.0,12.0,13.0,6.0,12.0,14.0,14.0,13.0,11.0,13.0,14.0,18.0,12.0,29.0,94.0,17.0,2.0,0.0,176.0,72.0,1.0,1.0,3.0,2.0,3.0,2.0,1.0,3.0,1.0,1.0,1.0,14.0,16.0,17.0,13.0,16.0,14.0,13.0,13.0,6.0,6.0,16.0,13.0,10.0,18.0,11.0,15.0,12.0,17.0,13.0,17.0,17.0,12.0,17.0,14.0,14.0,8.0,11.0,12.0,14.0,15.0,14.0,8.0,13.0,9.0,12.0,20.0,12.0,11.0,13.0,10.0,16.0,10.0,16.0,11.0,16.0,13.0,14.0,12.0,12.0,9.0,13.0,26.0,1.0,0.0,0.0,0.0,176.0,70.0,3.0,2.0,3.0,2.0,1.0,1.0,1.0,3.0,2.0,2.0,3.0,11.0,12.0,15.0,11.0,14.0,8.0,7.0,10.0,12.0,11.0,13.0,12.0,11.0,15.0,12.0,12.0,14.0,11.0,13.0,12.0,13.0,15.0,16.0,9.0,15.0,10.0,13.0,16.0,15.0,13.0,12.0,8.0,12.0,15.0,14.0,20.0,13.0,9.0,15.0,10.0,12.0,7.0,16.0,11.0,16.0,8.0,14.0,13.0,11.0,9.0,10.0,29.0,113.0,55.0,18.0,14.0,170.0,72.0,4.0,3.0,3.0,1.0,2.0,1.0,3.0,1.0,3.0,1.0,2.0,15.0,16.0,20.0,20.0,19.0,19.0,11.0,17.0,4.0,4.0,20.0,17.0,8.0,20.0,7.0,19.0,10.0,18.0,13.0,20.0,20.0,20.0,20.0,13.0,16.0,5.0,14.0,7.0,18.0,20.0,20.0,6.0,20.0,14.0,15.0,14.0,13.0,9.0,17.0,9.0,18.0,10.0,12.0,17.0,20.0,13.0,19.0,16.0,15.0,14.0,6.0,24.0,70.0,46.0,7.0,9.0,174.0,68.0,2.0,3.0,2.0,1.0,3.0,1.0,2.0,3.0,1.0,1.0,3.0,16.0,16.0,20.0,16.0,17.0,16.0,9.0,13.0,3.0,4.0,16.0,16.0,4.0,20.0,10.0,17.0,14.0,15.0,15.0,16.0,15.0,15.0,19.0,13.0,19.0,4.0,13.0,12.0,18.0,19.0,14.0,6.0,15.0,16.0,16.0,20.0,13.0,10.0,14.0,11.0,15.0,6.0,12.0,15.0,16.0,19.0,14.0,15.0,8.0,8.0,17.0,18.0,0.0,0.0,0.0,0.0,185.0,80.0,1.0,2.0,1.0,2.0,2.0,1.0,1.0,1.0,3.0,2.0,2.0,6.0,4.0,10.0,11.0,13.0,6.0,13.0,4.0,3.0,4.0,7.0,2.0,4.0,11.0,7.0,12.0,6.0,12.0,9.0,8.0,9.0,10.0,9.0,4.0,9.0,9.0,9.0,10.0,10.0,9.0,7.0,7.0,16.0,11.0,11.0,20.0,6.0,6.0,9.0,8.0,8.0,9.0,9.0,11.0,12.0,9.0,10.0,10.0,9.0,6.0,7.0
1,2,32.0,0.0,0.0,1.0,0.0,187.0,79.0,14.0,14.0,14.0,15.0,15.0,13.0,16.0,15.0,15.0,16.0,15.0,7.0,12.0,12.0,3.0,12.0,11.0,8.0,15.0,3.0,2.0,12.0,2.0,2.0,11.0,10.0,12.0,14.0,14.0,12.0,12.0,11.0,14.0,12.0,17.0,7.0,13.0,11.0,11.0,14.0,12.0,10.0,13.0,20.0,13.0,12.0,10.0,11.0,10.0,13.0,10.0,17.0,11.0,11.0,18.0,13.0,15.0,13.0,10.0,11.0,7.0,13.0,26.0,0.0,0.0,0.0,0.0,187.0,76.0,2.0,3.0,2.0,2.0,3.0,1.0,3.0,4.0,2.0,3.0,1.0,5.0,3.0,4.0,6.0,8.0,7.0,12.0,4.0,1.0,10.0,9.0,5.0,13.0,4.0,6.0,14.0,9.0,8.0,11.0,6.0,10.0,2.0,5.0,7.0,5.0,12.0,8.0,9.0,14.0,11.0,9.0,14.0,20.0,9.0,10.0,10.0,14.0,13.0,10.0,10.0,10.0,4.0,10.0,17.0,9.0,8.0,11.0,11.0,6.0,10.0,3.0,19.0,0.0,0.0,1.0,0.0,182.0,77.0,2.0,4.0,2.0,3.0,1.0,1.0,3.0,1.0,1.0,2.0,3.0,6.0,7.0,11.0,7.0,12.0,7.0,13.0,7.0,8.0,15.0,14.0,6.0,14.0,14.0,8.0,14.0,13.0,14.0,13.0,12.0,12.0,12.0,12.0,14.0,11.0,14.0,15.0,16.0,12.0,14.0,9.0,9.0,11.0,16.0,13.0,20.0,17.0,16.0,15.0,12.0,14.0,5.0,4.0,19.0,10.0,10.0,11.0,12.0,11.0,14.0,3.0,16.0,0.0,0.0,0.0,0.0,189.0,0.0,3.0,3.0,3.0,1.0,1.0,3.0,1.0,3.0,1.0,1.0,2.0,5.0,7.0,5.0,4.0,6.0,6.0,1.0,1.0,4.0,2.0,5.0,3.0,5.0,10.0,10.0,4.0,5.0,6.0,3.0,7.0,7.0,5.0,11.0,3.0,4.0,3.0,7.0,7.0,11.0,7.0,4.0,12.0,20.0,9.0,9.0,9.0,9.0,6.0,5.0,11.0,4.0,10.0,12.0,10.0,11.0,12.0,12.0,9.0,7.0,7.0,10.0,26.0,0.0,0.0,0.0,0.0,180.0,75.0,1.0,2.0,1.0,1.0,4.0,1.0,3.0,2.0,1.0,3.0,1.0,12.0,14.0,14.0,12.0,13.0,10.0,9.0,12.0,7.0,12.0,14.0,12.0,12.0,14.0,9.0,12.0,10.0,13.0,12.0,14.0,11.0,11.0,12.0,13.0,13.0,13.0,14.0,14.0,12.0,12.0,10.0,8.0,20.0,13.0,14.0,11.0,13.0,12.0,8.0,4.0,12.0,11.0,12.0,8.0,12.0,10.0,8.0,7.0,10.0,11.0,12.0,28.0,0.0,0.0,0.0,0.0,175.0,66.0,1.0,3.0,4.0,3.0,2.0,3.0,2.0,2.0,3.0,3.0,4.0,12.0,12.0,11.0,10.0,13.0,12.0,7.0,12.0,7.0,12.0,14.0,13.0,12.0,14.0,11.0,12.0,13.0,11.0,13.0,14.0,13.0,12.0,14.0,11.0,11.0,13.0,15.0,14.0,11.0,12.0,12.0,8.0,20.0,11.0,11.0,10.0,12.0,11.0,12.0,7.0,12.0,10.0,5.0,10.0,9.0,14.0,11.0,10.0,12.0,18.0,2.0,23.0,0.0,0.0,0.0,0.0,181.0,74.0,2.0,3.0,2.0,3.0,3.0,1.0,1.0,3.0,3.0,3.0,4.0,13.0,13.0,11.0,10.0,15.0,11.0,6.0,12.0,6.0,10.0,14.0,14.0,11.0,16.0,14.0,16.0,15.0,16.0,12.0,13.0,14.0,15.0,11.0,8.0,12.0,13.0,16.0,15.0,11.0,13.0,15.0,9.0,9.0,14.0,11.0,20.0,17.0,12.0,10.0,13.0,12.0,8.0,10.0,12.0,14.0,12.0,14.0,15.0,9.0,11.0,4.0,27.0,0.0,0.0,0.0,0.0,171.0,63.0,2.0,1.0,1.0,3.0,1.0,2.0,4.0,2.0,2.0,2.0,3.0,8.0,4.0,6.0,6.0,13.0,8.0,8.0,6.0,1.0,14.0,13.0,5.0,8.0,14.0,6.0,10.0,9.0,8.0,9.0,14.0,12.0,10.0,10.0,11.0,12.0,11.0,9.0,13.0,14.0,14.0,9.0,5.0,5.0,10.0,14.0,20.0,9.0,6.0,10.0,7.0,10.0,10.0,10.0,13.0,13.0,9.0,9.0,12.0,11.0,14.0,2.0,20.0,9.0,0.0,6.0,0.0,170.0,61.0,3.0,3.0,4.0,1.0,3.0,2.0,3.0,2.0,3.0,3.0,2.0,14.0,12.0,18.0,12.0,17.0,11.0,5.0,14.0,6.0,5.0,13.0,11.0,7.0,17.0,9.0,11.0,7.0,13.0,9.0,15.0,10.0,11.0,18.0,6.0,12.0,7.0,8.0,9.0,15.0,17.0,10.0,6.0,20.0,12.0,12.0,10.0,11.0,7.0,11.0,10.0,11.0,6.0,12.0,10.0,18.0,7.0,13.0,10.0,8.0,10.0,14.0,25.0,0.0,0.0,0.0,0.0,181.0,77.0,3.0,1.0,1.0,2.0,1.0,2.0,1.0,3.0,3.0,3.0,2.0,9.0,10.0,11.0,12.0,11.0,14.0,13.0,10.0,6.0,9.0,11.0,15.0,9.0,11.0,15.0,11.0,15.0,12.0,12.0,12.0,12.0,9.0,12.0,12.0,13.0,10.0,14.0,15.0,12.0,12.0,11.0,12.0,12.0,15.0,12.0,20.0,14.0,16.0,12.0,9.0,17.0,12.0,11.0,16.0,10.0,11.0,11.0,13.0,13.0,17.0,6.0,20.0,5.0,0.0,5.0,0.0,181.0,74.0,3.0,1.0,2.0,1.0,1.0,3.0,3.0,2.0,3.0,1.0,1.0,7.0,9.0,15.0,15.0,17.0,7.0,12.0,11.0,5.0,5.0,9.0,7.0,6.0,16.0,13.0,12.0,14.0,12.0,10.0,13.0,10.0,12.0,11.0,9.0,13.0,12.0,11.0,10.0,14.0,15.0,13.0,9.0,12.0,12.0,12.0,20.0,13.0,12.0,9.0,9.0,8.0,13.0,9.0,11.0,13.0,12.0,11.0,12.0,6.0,17.0,4.0,29.0,0.0,0.0,0.0,0.0,190.0,80.0,14.0,13.0,13.0,6.0,15.0,14.0,12.0,15.0,13.0,17.0,15.0,7.0,1.0,3.0,2.0,8.0,9.0,8.0,2.0,3.0,3.0,8.0,2.0,3.0,10.0,6.0,13.0,13.0,7.0,15.0,10.0,13.0,15.0,3.0,9.0,2.0,16.0,11.0,11.0,9.0,13.0,14.0,15.0,8.0,13.0,11.0,20.0,14.0,13.0,10.0,4.0,12.0,6.0,12.0,12.0,15.0,13.0,11.0,14.0,15.0,11.0,8.0,26.0,0.0,0.0,0.0,0.0,185.0,80.0,3.0,1.0,1.0,2.0,2.0,3.0,2.0,2.0,2.0,2.0,3.0,6.0,8.0,10.0,9.0,10.0,7.0,13.0,10.0,13.0,13.0,12.0,5.0,13.0,13.0,14.0,12.0,14.0,14.0,12.0,8.0,13.0,14.0,8.0,12.0,8.0,14.0,15.0,14.0,13.0,12.0,13.0,13.0,10.0,12.0,12.0,20.0,14.0,14.0,11.0,14.0,12.0,8.0,12.0,12.0,16.0,14.0,11.0,14.0,11.0,12.0,11.0,27.0,3.0,0.0,0.0,0.0,191.0,83.0,3.0,1.0,3.0,1.0,3.0,2.0,1.0,3.0,3.0,2.0,3.0,6.0,11.0,12.0,8.0,12.0,5.0,15.0,11.0,11.0,14.0,13.0,14.0,15.0,13.0,12.0,13.0,12.0,16.0,13.0,7.0,13.0,12.0,9.0,11.0,9.0,14.0,13.0,14.0,11.0,9.0,16.0,17.0,7.0,14.0,11.0,20.0,14.0,15.0,10.0,11.0,11.0,14.0,12.0,16.0,14.0,13.0,11.0,16.0,11.0,13.0,4.0,30.0,0.0,0.0,0.0,0.0,178.0,76.0,3.0,1.0,3.0,1.0,1.0,3.0,2.0,1.0,2.0,2.0,1.0,9.0,13.0,12.0,7.0,13.0,12.0,10.0,12.0,12.0,12.0,10.0,9.0,13.0,10.0,10.0,12.0,14.0,13.0,13.0,8.0,14.0,11.0,6.0,14.0,6.0,15.0,15.0,14.0,12.0,12.0,12.0,9.0,20.0,15.0,13.0,10.0,15.0,11.0,13.0,7.0,11.0,10.0,10.0,16.0,14.0,11.0,14.0,11.0,13.0,15.0,5.0,28.0,0.0,0.0,26.0,0.0,173.0,74.0,1.0,1.0,1.0,1.0,3.0,2.0,2.0,2.0,1.0,1.0,2.0,18.0,14.0,13.0,7.0,12.0,14.0,7.0,13.0,14.0,11.0,13.0,3.0,13.0,13.0,16.0,11.0,18.0,8.0,11.0,11.0,10.0,12.0,15.0,11.0,15.0,10.0,16.0,17.0,14.0,14.0,15.0,9.0,8.0,15.0,11.0,20.0,16.0,10.0,11.0,14.0,10.0,4.0,15.0,12.0,11.0,7.0,6.0,11.0,7.0,14.0,5.0,32.0,44.0,0.0,0.0,0.0,176.0,60.0,1.0,3.0,2.0,1.0,1.0,3.0,2.0,2.0,1.0,3.0,2.0,7.0,9.0,10.0,7.0,13.0,13.0,12.0,14.0,12.0,13.0,11.0,11.0,15.0,11.0,15.0,14.0,17.0,10.0,13.0,10.0,14.0,15.0,8.0,12.0,12.0,14.0,17.0,17.0,13.0,13.0,13.0,10.0,20.0,17.0,13.0,10.0,16.0,12.0,14.0,14.0,15.0,7.0,14.0,17.0,14.0,8.0,15.0,15.0,9.0,8.0,10.0,22.0,0.0,0.0,0.0,0.0,186.0,0.0,3.0,1.0,3.0,1.0,2.0,2.0,2.0,1.0,1.0,1.0,1.0,8.0,3.0,8.0,6.0,11.0,3.0,12.0,6.0,5.0,11.0,11.0,4.0,11.0,6.0,10.0,8.0,11.0,7.0,9.0,9.0,13.0,9.0,7.0,11.0,10.0,13.0,10.0,12.0,12.0,10.0,11.0,13.0,20.0,10.0,11.0,8.0,12.0,12.0,10.0,10.0,6.0,5.0,10.0,18.0,11.0,9.0,13.0,9.0,4.0,5.0,1.0,29.0,0.0,0.0,6.0,1.0,183.0,81.0,1.0,2.0,3.0,2.0,2.0,2.0,4.0,4.0,1.0,4.0,2.0,18.0,18.0,16.0,11.0,16.0,17.0,7.0,15.0,7.0,5.0,16.0,13.0,6.0,18.0,9.0,12.0,9.0,15.0,11.0,17.0,14.0,10.0,17.0,13.0,15.0,7.0,10.0,9.0,13.0,14.0,10.0,11.0,10.0,9.0,12.0,20.0,11.0,9.0,10.0,12.0,15.0,13.0,11.0,14.0,13.0,6.0,11.0,12.0,12.0,13.0,14.0,22.0,0.0,0.0,0.0,0.0,189.0,0.0,3.0,1.0,1.0,3.0,2.0,3.0,3.0,2.0,3.0,2.0,1.0,7.0,11.0,13.0,9.0,11.0,7.0,4.0,9.0,4.0,7.0,10.0,8.0,4.0,11.0,10.0,6.0,9.0,5.0,7.0,10.0,11.0,10.0,10.0,10.0,9.0,7.0,8.0,12.0,13.0,11.0,5.0,12.0,10.0,7.0,11.0,20.0,13.0,9.0,10.0,7.0,9.0,10.0,10.0,11.0,10.0,10.0,13.0,10.0,3.0,8.0,4.0,26.0,8.0,1.0,12.0,7.0,187.0,79.0,8.0,9.0,7.0,4.0,5.0,10.0,3.0,3.0,4.0,4.0,4.0,8.0,10.0,10.0,15.0,13.0,12.0,15.0,12.0,10.0,8.0,9.0,16.0,10.0,11.0,13.0,13.0,13.0,9.0,12.0,12.0,13.0,10.0,14.0,13.0,15.0,14.0,11.0,9.0,11.0,12.0,7.0,14.0,8.0,11.0,12.0,20.0,12.0,14.0,12.0,9.0,12.0,9.0,10.0,12.0,15.0,13.0,14.0,13.0,13.0,11.0,5.0,24.0,0.0,0.0,13.0,2.0,174.0,70.0,1.0,1.0,3.0,3.0,1.0,2.0,2.0,3.0,3.0,1.0,3.0,14.0,15.0,16.0,11.0,16.0,16.0,8.0,12.0,5.0,8.0,16.0,12.0,6.0,17.0,10.0,11.0,10.0,12.0,11.0,15.0,12.0,9.0,16.0,8.0,14.0,5.0,11.0,10.0,15.0,16.0,9.0,7.0,20.0,12.0,14.0,8.0,13.0,9.0,12.0,9.0,15.0,10.0,14.0,17.0,12.0,10.0,12.0,13.0,14.0,10.0,10.0
4,0,19.0,0.0,0.0,0.0,0.0,171.0,70.0,3.0,2.0,3.0,3.0,2.0,1.0,2.0,2.0,2.0,2.0,1.0,5.0,8.0,7.0,3.0,11.0,4.0,10.0,9.0,8.0,11.0,11.0,6.0,12.0,10.0,10.0,5.0,11.0,9.0,8.0,5.0,15.0,3.0,9.0,10.0,9.0,9.0,10.0,10.0,14.0,12.0,10.0,3.0,20.0,6.0,11.0,8.0,8.0,8.0,10.0,7.0,9.0,10.0,10.0,20.0,11.0,10.0,11.0,13.0,8.0,17.0,1.0,29.0,80.0,5.0,12.0,1.0,193.0,85.0,3.0,1.0,1.0,1.0,1.0,1.0,2.0,3.0,2.0,2.0,3.0,8.0,10.0,13.0,10.0,15.0,7.0,16.0,8.0,8.0,16.0,16.0,13.0,15.0,16.0,14.0,16.0,15.0,18.0,15.0,15.0,17.0,13.0,11.0,16.0,9.0,18.0,15.0,15.0,11.0,10.0,9.0,16.0,12.0,15.0,13.0,20.0,15.0,15.0,16.0,12.0,18.0,8.0,9.0,16.0,15.0,14.0,14.0,12.0,9.0,10.0,16.0,30.0,57.0,1.0,12.0,1.0,183.0,80.0,2.0,2.0,1.0,2.0,1.0,3.0,1.0,1.0,1.0,2.0,2.0,7.0,8.0,10.0,9.0,13.0,10.0,17.0,13.0,13.0,15.0,13.0,11.0,16.0,14.0,15.0,15.0,14.0,15.0,13.0,11.0,14.0,18.0,7.0,14.0,13.0,14.0,15.0,16.0,11.0,11.0,13.0,16.0,20.0,9.0,13.0,10.0,14.0,14.0,14.0,11.0,14.0,15.0,13.0,18.0,14.0,15.0,13.0,16.0,13.0,11.0,3.0,27.0,47.0,6.0,4.0,0.0,170.0,68.0,1.0,1.0,1.0,1.0,3.0,3.0,1.0,2.0,1.0,3.0,2.0,12.0,14.0,13.0,11.0,15.0,10.0,5.0,10.0,12.0,11.0,11.0,10.0,14.0,15.0,15.0,15.0,15.0,13.0,12.0,14.0,15.0,16.0,13.0,10.0,17.0,12.0,15.0,16.0,18.0,16.0,15.0,6.0,20.0,13.0,16.0,8.0,18.0,9.0,15.0,14.0,14.0,12.0,12.0,15.0,18.0,14.0,14.0,16.0,8.0,8.0,9.0,24.0,1.0,0.0,13.0,1.0,178.0,71.0,2.0,1.0,2.0,1.0,3.0,1.0,2.0,3.0,2.0,3.0,3.0,10.0,12.0,13.0,10.0,16.0,8.0,12.0,13.0,10.0,12.0,15.0,12.0,12.0,14.0,11.0,13.0,13.0,15.0,16.0,14.0,14.0,12.0,11.0,9.0,15.0,13.0,18.0,18.0,15.0,13.0,12.0,9.0,12.0,14.0,15.0,20.0,17.0,10.0,15.0,10.0,12.0,9.0,19.0,19.0,13.0,20.0,12.0,17.0,16.0,16.0,4.0,29.0,94.0,17.0,2.0,0.0,176.0,72.0,1.0,1.0,3.0,2.0,3.0,2.0,1.0,3.0,1.0,1.0,1.0,14.0,16.0,17.0,13.0,16.0,14.0,13.0,13.0,6.0,6.0,16.0,13.0,10.0,18.0,11.0,15.0,12.0,17.0,13.0,17.0,17.0,12.0,17.0,14.0,14.0,8.0,11.0,12.0,14.0,15.0,14.0,8.0,13.0,9.0,12.0,20.0,12.0,11.0,13.0,10.0,16.0,10.0,16.0,11.0,16.0,13.0,14.0,12.0,12.0,9.0,13.0,26.0,1.0,0.0,0.0,0.0,176.0,70.0,3.0,2.0,3.0,2.0,1.0,1.0,1.0,3.0,2.0,2.0,3.0,11.0,12.0,15.0,11.0,14.0,8.0,7.0,10.0,12.0,11.0,13.0,12.0,11.0,15.0,12.0,12.0,14.0,11.0,13.0,12.0,13.0,15.0,16.0,9.0,15.0,10.0,13.0,16.0,15.0,13.0,12.0,8.0,12.0,15.0,14.0,20.0,13.0,9.0,15.0,10.0,12.0,7.0,16.0,11.0,16.0,8.0,14.0,13.0,11.0,9.0,10.0,28.0,80.0,12.0,4.0,2.0,184.0,78.0,2.0,3.0,3.0,3.0,3.0,3.0,3.0,4.0,3.0,3.0,3.0,18.0,15.0,14.0,13.0,17.0,16.0,8.0,18.0,10.0,9.0,18.0,16.0,10.0,17.0,11.0,14.0,11.0,14.0,14.0,17.0,15.0,12.0,12.0,14.0,14.0,12.0,14.0,13.0,12.0,11.0,11.0,12.0,14.0,12.0,14.0,20.0,15.0,14.0,14.0,12.0,13.0,6.0,12.0,14.0,14.0,13.0,11.0,13.0,14.0,18.0,12.0,29.0,113.0,55.0,18.0,14.0,170.0,72.0,4.0,3.0,3.0,1.0,2.0,1.0,3.0,1.0,3.0,1.0,2.0,15.0,16.0,20.0,20.0,19.0,19.0,11.0,17.0,4.0,4.0,20.0,17.0,8.0,20.0,7.0,19.0,10.0,18.0,13.0,20.0,20.0,20.0,20.0,13.0,16.0,5.0,14.0,7.0,18.0,20.0,20.0,6.0,20.0,14.0,15.0,14.0,13.0,9.0,17.0,9.0,18.0,10.0,12.0,17.0,20.0,13.0,19.0,16.0,15.0,14.0,6.0,24.0,70.0,46.0,7.0,9.0,174.0,68.0,2.0,3.0,2.0,1.0,3.0,1.0,2.0,3.0,1.0,1.0,3.0,16.0,16.0,20.0,16.0,17.0,16.0,9.0,13.0,3.0,4.0,16.0,16.0,4.0,20.0,10.0,17.0,14.0,15.0,15.0,16.0,15.0,15.0,19.0,13.0,19.0,4.0,13.0,12.0,18.0,19.0,14.0,6.0,15.0,16.0,16.0,20.0,13.0,10.0,14.0,11.0,15.0,6.0,12.0,15.0,16.0,19.0,14.0,15.0,8.0,8.0,17.0,18.0,0.0,0.0,0.0,0.0,185.0,80.0,1.0,2.0,1.0,2.0,2.0,1.0,1.0,1.0,3.0,2.0,2.0,6.0,4.0,10.0,11.0,13.0,6.0,13.0,4.0,3.0,4.0,7.0,2.0,4.0,11.0,7.0,12.0,6.0,12.0,9.0,8.0,9.0,10.0,9.0,4.0,9.0,9.0,9.0,10.0,10.0,9.0,7.0,7.0,16.0,11.0,11.0,20.0,6.0,6.0,9.0,8.0,8.0,9.0,9.0,11.0,12.0,9.0,10.0,10.0,9.0,6.0,7.0,29.0,0.0,0.0,0.0,0.0,184.0,86.0,13.0,13.0,12.0,6.0,14.0,12.0,14.0,17.0,11.0,9.0,13.0,7.0,1.0,2.0,2.0,8.0,9.0,6.0,1.0,2.0,2.0,10.0,3.0,2.0,9.0,10.0,12.0,13.0,11.0,13.0,6.0,13.0,8.0,6.0,11.0,2.0,15.0,11.0,13.0,10.0,14.0,13.0,11.0,11.0,13.0,12.0,20.0,14.0,15.0,16.0,7.0,12.0,7.0,12.0,9.0,10.0,13.0,11.0,8.0,12.0,11.0,3.0,21.0,1.0,0.0,4.0,0.0,189.0,84.0,1.0,2.0,2.0,3.0,2.0,3.0,2.0,3.0,1.0,3.0,2.0,5.0,5.0,10.0,6.0,11.0,11.0,15.0,10.0,12.0,14.0,11.0,11.0,14.0,11.0,10.0,13.0,12.0,11.0,12.0,10.0,11.0,12.0,12.0,12.0,10.0,12.0,14.0,12.0,14.0,13.0,14.0,15.0,20.0,15.0,13.0,6.0,14.0,15.0,11.0,5.0,15.0,5.0,6.0,6.0,8.0,10.0,12.0,10.0,12.0,10.0,12.0,29.0,0.0,0.0,0.0,0.0,188.0,84.0,3.0,1.0,2.0,3.0,1.0,4.0,2.0,1.0,1.0,1.0,1.0,5.0,5.0,10.0,8.0,11.0,13.0,14.0,8.0,10.0,15.0,12.0,16.0,15.0,14.0,12.0,13.0,13.0,13.0,14.0,12.0,13.0,16.0,10.0,14.0,11.0,13.0,15.0,13.0,13.0,12.0,10.0,15.0,8.0,13.0,14.0,20.0,14.0,15.0,16.0,9.0,13.0,5.0,10.0,12.0,13.0,11.0,11.0,13.0,13.0,10.0,3.0,23.0,0.0,0.0,22.0,1.0,184.0,78.0,3.0,3.0,2.0,3.0,3.0,2.0,1.0,1.0,1.0,2.0,3.0,11.0,13.0,11.0,8.0,11.0,9.0,11.0,9.0,13.0,11.0,12.0,4.0,13.0,11.0,12.0,11.0,13.0,12.0,12.0,9.0,10.0,13.0,8.0,13.0,11.0,13.0,14.0,15.0,14.0,11.0,14.0,11.0,20.0,13.0,15.0,8.0,16.0,13.0,13.0,9.0,14.0,8.0,12.0,10.0,13.0,14.0,11.0,15.0,14.0,14.0,5.0,26.0,25.0,1.0,7.0,0.0,189.0,78.0,1.0,1.0,1.0,1.0,1.0,1.0,1.0,1.0,1.0,1.0,1.0,8.0,9.0,10.0,6.0,12.0,8.0,13.0,14.0,7.0,11.0,14.0,11.0,13.0,13.0,13.0,13.0,16.0,13.0,13.0,12.0,13.0,14.0,10.0,10.0,12.0,13.0,15.0,15.0,12.0,11.0,9.0,15.0,10.0,14.0,13.0,20.0,14.0,14.0,12.0,13.0,11.0,14.0,12.0,14.0,11.0,14.0,12.0,16.0,15.0,13.0,5.0,27.0,0.0,0.0,5.0,0.0,178.0,76.0,2.0,4.0,2.0,2.0,1.0,1.0,1.0,3.0,4.0,1.0,3.0,9.0,12.0,12.0,8.0,15.0,8.0,8.0,11.0,6.0,11.0,14.0,10.0,12.0,13.0,14.0,14.0,13.0,14.0,17.0,12.0,14.0,15.0,13.0,13.0,11.0,14.0,14.0,13.0,13.0,13.0,13.0,11.0,9.0,12.0,12.0,20.0,16.0,14.0,16.0,12.0,13.0,7.0,13.0,13.0,14.0,13.0,14.0,15.0,11.0,13.0,7.0,20.0,0.0,0.0,0.0,0.0,185.0,75.0,1.0,1.0,3.0,1.0,1.0,1.0,3.0,3.0,2.0,1.0,1.0,3.0,9.0,10.0,6.0,13.0,4.0,14.0,9.0,6.0,12.0,12.0,6.0,13.0,11.0,13.0,14.0,15.0,11.0,14.0,10.0,14.0,11.0,10.0,11.0,12.0,14.0,15.0,14.0,11.0,12.0,10.0,16.0,9.0,14.0,12.0,20.0,16.0,15.0,13.0,4.0,12.0,5.0,13.0,11.0,9.0,11.0,12.0,11.0,12.0,10.0,3.0,25.0,0.0,0.0,0.0,0.0,182.0,74.0,3.0,1.0,1.0,3.0,3.0,2.0,1.0,3.0,1.0,1.0,3.0,13.0,12.0,14.0,12.0,14.0,13.0,9.0,13.0,6.0,4.0,12.0,13.0,11.0,17.0,8.0,15.0,7.0,13.0,11.0,15.0,10.0,12.0,18.0,8.0,13.0,7.0,7.0,13.0,13.0,14.0,15.0,10.0,20.0,15.0,13.0,9.0,12.0,9.0,11.0,6.0,14.0,7.0,12.0,8.0,16.0,12.0,12.0,15.0,12.0,14.0,14.0,30.0,0.0,0.0,0.0,0.0,178.0,73.0,3.0,3.0,4.0,2.0,3.0,3.0,3.0,1.0,1.0,2.0,2.0,6.0,10.0,13.0,11.0,9.0,7.0,8.0,10.0,5.0,6.0,10.0,7.0,5.0,13.0,11.0,10.0,8.0,12.0,8.0,7.0,7.0,10.0,14.0,7.0,13.0,5.0,10.0,14.0,15.0,15.0,13.0,9.0,9.0,14.0,16.0,20.0,14.0,13.0,14.0,11.0,10.0,5.0,12.0,18.0,12.0,9.0,12.0,7.0,10.0,7.0,14.0,19.0,6.0,0.0,7.0,1.0,185.0,79.0,3.0,4.0,3.0,2.0,3.0,2.0,1.0,1.0,2.0,3.0,2.0,9.0,11.0,12.0,15.0,14.0,12.0,10.0,11.0,2.0,3.0,10.0,8.0,3.0,13.0,14.0,13.0,12.0,12.0,10.0,10.0,12.0,15.0,16.0,4.0,14.0,7.0,15.0,17.0,16.0,14.0,11.0,11.0,8.0,13.0,15.0,20.0,13.0,12.0,13.0,8.0,14.0,10.0,11.0,12.0,12.0,12.0,10.0,11.0,12.0,10.0,8.0,20.0,0.0,0.0,4.0,2.0,186.0,86.0,2.0,1.0,3.0,1.0,2.0,3.0,1.0,3.0,3.0,2.0,3.0,8.0,11.0,14.0,13.0,11.0,9.0,8.0,12.0,4.0,6.0,10.0,11.0,7.0,14.0,8.0,12.0,11.0,11.0,9.0,9.0,10.0,8.0,16.0,7.0,13.0,4.0,10.0,12.0,14.0,12.0,13.0,11.0,10.0,15.0,16.0,20.0,13.0,15.0,11.0,7.0,11.0,6.0,14.0,13.0,14.0,12.0,7.0,7.0,10.0,7.0,14.0
